game_id,team_id,time_on_ice,pim,shots,saves,power_play_saves,short_handed_saves,goals_against,save_percentage
2000020001,21,3880,0.0,21,19,9,0,2,90.47619048
2000020001,25,3900,0.0,28,26,9,0,2,92.85714286
2000020002,9,3900,0.0,38,34,13,2,4,89.47368421
2000020002,6,3900,0.0,33,29,3,3,4,87.87878788
2000020003,16,3600,0.0,30,26,8,1,4,86.66666667
2000020003,7,2905,0.0,17,15,4,0,2,88.23529412
2000020003,7,695,0.0,4,4,2,0,0,100.0
2000020004,23,3560,0.0,32,27,5,4,5,84.375
2000020004,4,3591,0.0,29,26,3,2,3,89.65517241
2000020005,17,3595,0.0,21,18,8,2,3,85.71428571
2000020005,20,3542,0.0,28,24,3,6,4,85.71428571
2000020006,19,3597,0.0,20,16,4,1,4,80.0
2000020006,27,3600,0.0,33,32,5,0,1,96.96969697
2000020007,8,2101,0.0,21,18,3,4,3,85.71428571
2000020007,8,1499,0.0,13,8,0,1,5,61.53846154
2000020007,1,3600,0.0,30,26,8,1,4,86.66666667
2000020008,26,3600,0.0,20,19,5,1,1,95.0
2000020008,15,3600,0.0,31,27,9,0,4,87.09677419
2000020009,2,3897,0.0,24,21,5,1,3,87.5
2000020009,14,3890,0.0,36,33,9,5,3,91.66666667
2000020010,23,3740,0.0,24,21,5,3,3,87.5
2000020010,13,3735,0.0,21,17,4,5,4,80.95238095
2000020011,17,3521,0.0,29,27,5,1,2,93.10344828
2000020011,22,3600,0.0,34,33,6,1,1,97.05882353
2000020012,30,3550,0.0,39,36,5,1,3,92.30769231
2000020012,24,3600,0.0,36,35,11,2,1,97.22222222
2000020013,19,3596,0.0,19,18,6,0,1,94.73684211
2000020013,28,3593,0.0,29,25,11,3,4,86.20689655
2000020014,26,3531,2.0,23,19,3,0,4,82.60869565
2000020014,7,3597,0.0,22,19,4,0,3,86.36363636
2000020015,8,3538,0.0,18,16,4,1,2,88.88888889
2000020015,10,3597,0.0,26,26,9,2,0,100.0
2000020016,25,3591,0.0,19,17,5,1,2,89.47368421
2000020016,9,3600,0.0,24,23,9,1,1,95.83333333
2000020017,6,690,0.0,4,4,0,1,0,100.0
2000020017,6,2910,0.0,28,27,9,4,1,96.42857143
2000020017,4,952,0.0,6,6,1,0,0,100.0
2000020017,4,2648,2.0,19,14,4,1,5,73.68421053
2000020018,18,3600,0.0,26,25,0,0,1,96.15384615
2000020018,5,3582,0.0,32,30,0,0,2,93.75
2000020019,15,3894,0.0,27,24,8,0,3,88.88888889
2000020019,12,3900,0.0,28,25,4,2,3,89.28571429
2000020020,3,3596,0.0,28,27,8,0,1,96.42857143
2000020020,11,3522,0.0,28,26,7,4,2,92.85714286
2000020021,16,3600,0.0,21,18,6,0,3,85.71428571
2000020021,29,3521,0.0,25,20,6,3,5,80.0
2000020022,21,3900,0.0,21,20,4,0,1,95.23809524
2000020022,22,3900,0.0,26,25,6,0,1,96.15384615
2000020023,30,3597,0.0,27,23,11,0,4,85.18518519
2000020023,27,3504,0.0,22,21,5,0,1,95.45454545
2000020023,27,89,0.0,0,0,0,0,0,
2000020024,23,1533,0.0,4,4,0,0,0,100.0
2000020024,23,2067,0.0,12,8,1,2,4,66.66666667
2000020024,14,3594,0.0,41,36,8,1,5,87.80487805
2000020025,5,3600,0.0,22,21,0,0,1,95.45454545
2000020025,18,3558,0.0,40,38,0,0,2,95.0
2000020026,19,3591,0.0,25,24,3,4,1,96.0
2000020026,24,3600,0.0,40,35,13,2,5,87.5
2000020027,13,3540,0.0,22,18,4,0,4,81.81818182
2000020027,6,3594,0.0,31,29,8,4,2,93.5483871
2000020028,25,3600,0.0,31,30,0,1,1,96.77419355
2000020028,10,3552,0.0,23,20,1,0,3,86.95652174
2000020029,26,3588,0.0,28,27,7,0,1,96.42857143
2000020029,29,3600,0.0,39,32,9,4,7,82.05128205
2000020030,22,3549,0.0,22,18,3,1,4,81.81818182
2000020030,8,3600,0.0,18,16,2,1,2,88.88888889
2000020031,25,3594,4.0,22,17,4,0,5,77.27272727
2000020031,12,3600,0.0,21,19,6,0,2,90.47619048
2000020032,21,3594,0.0,30,29,13,2,1,96.66666667
2000020032,20,3583,0.0,19,16,3,3,3,84.21052632
2000020033,2,3535,2.0,33,30,8,0,3,90.90909091
2000020033,10,3600,0.0,20,18,6,1,2,90.0
2000020034,13,3714,0.0,26,20,2,0,6,76.92307692
2000020034,1,3715,0.0,21,16,1,0,5,76.19047619
2000020035,8,3499,0.0,32,29,4,3,3,90.625
2000020035,3,3594,0.0,29,28,13,0,1,96.55172414
2000020036,15,3900,0.0,30,27,13,0,3,90.0
2000020036,11,3900,0.0,24,21,1,2,3,87.5
2000020037,22,3600,0.0,36,33,6,0,3,91.66666667
2000020037,17,3494,0.0,25,21,4,0,4,84.0
2000020038,4,3898,0.0,22,19,2,1,3,86.36363636
2000020038,30,3900,0.0,39,36,8,3,3,92.30769231
2000020039,6,3689,0.0,30,28,5,3,2,93.33333333
2000020039,24,3723,0.0,28,25,9,2,3,89.28571429
2000020040,19,3874,0.0,25,21,6,0,4,84.0
2000020040,26,3900,0.0,31,27,3,2,4,87.09677419
2000020041,17,3600,0.0,23,23,6,1,0,100.0
2000020041,16,508,0.0,4,1,0,0,3,25.0
2000020041,16,3081,0.0,15,14,4,1,1,93.33333333
2000020042,4,3584,0.0,21,18,3,0,3,85.71428571
2000020042,25,3600,0.0,27,26,6,2,1,96.2962963
2000020043,29,3600,0.0,21,19,7,1,2,90.47619048
2000020043,20,3566,0.0,27,24,8,1,3,88.88888889
2000020044,21,3600,0.0,21,19,7,1,2,90.47619048
2000020044,23,3596,0.0,23,18,5,3,5,78.26086957
2000020045,27,3544,0.0,16,14,5,1,2,87.5
2000020045,28,3548,0.0,26,25,7,1,1,96.15384615
2000020045,28,52,0.0,0,0,0,0,0,
2000020046,1,3583,0.0,24,22,7,0,2,91.66666667
2000020046,9,3600,0.0,31,30,3,4,1,96.77419355
2000020047,14,3512,0.0,26,23,6,0,3,88.46153846
2000020047,5,3600,0.0,25,23,1,2,2,92.0
2000020048,12,3900,0.0,28,26,7,0,2,92.85714286
2000020048,13,3900,0.0,24,22,1,0,2,91.66666667
2000020049,30,3574,0.0,21,20,4,2,1,95.23809524
2000020049,19,3600,0.0,16,16,5,1,0,100.0
2000020050,15,3521,0.0,27,25,2,0,2,92.59259259
2000020050,18,3600,0.0,30,29,1,1,1,96.66666667
2000020051,7,3524,0.0,37,34,9,3,3,91.89189189
2000020051,22,3600,0.0,25,23,4,1,2,92.0
2000020052,6,2400,0.0,16,14,3,3,2,87.5
2000020052,6,1200,0.0,11,8,0,0,3,72.72727273
2000020052,26,3597,0.0,18,18,2,1,0,100.0
2000020053,9,3588,0.0,26,26,8,1,0,100.0
2000020053,10,3600,0.0,34,30,7,0,4,88.23529412
2000020054,16,3759,0.0,28,23,5,3,5,82.14285714
2000020054,8,3716,0.0,25,21,0,1,4,84.0
2000020055,24,2171,0.0,24,20,5,0,4,83.33333333
2000020055,24,1377,0.0,7,7,5,0,0,100.0
2000020055,1,3600,0.0,24,22,2,0,2,91.66666667
2000020056,20,3594,0.0,25,25,12,0,0,100.0
2000020056,2,3502,0.0,28,26,4,0,2,92.85714286
2000020057,3,583,0.0,2,2,0,0,0,100.0
2000020057,3,2952,0.0,33,25,10,0,8,75.75757576
2000020057,5,3592,0.0,25,19,6,1,6,76.0
2000020058,15,3600,0.0,20,17,5,0,3,85.0
2000020058,25,3574,0.0,12,12,1,1,0,100.0
2000020059,12,3527,0.0,34,32,3,2,2,94.11764706
2000020059,18,3579,0.0,24,23,7,0,1,95.83333333
2000020060,29,3600,0.0,33,30,9,1,3,90.90909091
2000020060,21,3572,0.0,15,14,3,4,1,93.33333333
2000020061,7,3600,2.0,32,28,6,1,4,87.5
2000020061,23,3600,0.0,27,27,4,3,0,100.0
2000020062,4,3545,0.0,30,25,7,3,5,83.33333333
2000020062,27,3600,0.0,36,33,12,1,3,91.66666667
2000020063,6,3596,0.0,30,26,8,0,4,86.66666667
2000020063,28,3600,0.0,23,21,4,1,2,91.30434783
2000020064,11,3600,0.0,31,26,13,0,5,83.87096774
2000020064,14,3599,0.0,22,20,4,1,2,90.90909091
2000020065,20,3600,0.0,30,28,8,5,2,93.33333333
2000020065,17,3492,0.0,37,33,8,2,4,89.18918919
2000020066,29,3525,0.0,31,29,5,0,2,93.5483871
2000020066,16,3600,0.0,16,15,2,0,1,93.75
2000020067,22,3600,0.0,28,25,7,1,3,89.28571429
2000020067,30,3548,0.0,26,21,2,3,5,80.76923077
2000020068,27,3600,0.0,35,30,8,0,5,85.71428571
2000020068,26,1774,0.0,10,8,0,0,2,80.0
2000020068,26,1757,0.0,11,7,3,0,4,63.63636364
2000020069,24,3592,0.0,28,25,4,0,3,89.28571429
2000020069,3,3540,0.0,29,25,4,0,4,86.20689655
2000020070,10,3585,2.0,28,24,12,0,4,85.71428571
2000020070,23,3592,0.0,15,13,3,0,2,86.66666667
2000020071,7,3599,0.0,30,26,4,3,4,86.66666667
2000020071,8,3599,0.0,29,26,6,0,3,89.65517241
2000020072,24,3600,0.0,27,24,2,0,3,88.88888889
2000020072,2,3560,0.0,32,28,6,1,4,87.5
2000020073,9,3600,0.0,22,21,3,0,1,95.45454545
2000020073,4,972,0.0,8,7,0,0,1,87.5
2000020073,4,2624,0.0,22,17,4,1,5,77.27272727
2000020074,21,3757,0.0,30,27,13,0,3,90.0
2000020074,15,3755,0.0,34,30,6,1,4,88.23529412
2000020075,1,3898,0.0,16,13,0,0,3,81.25
2000020075,11,3900,0.0,37,34,6,1,3,91.89189189
2000020076,19,3573,0.0,23,21,4,3,2,91.30434783
2000020076,17,3600,0.0,31,30,7,3,1,96.77419355
2000020077,26,3887,0.0,35,34,5,1,1,97.14285714
2000020077,18,3900,0.0,26,25,4,0,1,96.15384615
2000020078,6,1595,0.0,10,6,1,0,4,60.0
2000020078,6,2005,0.0,9,7,0,1,2,77.77777778
2000020078,22,3594,0.0,23,22,1,2,1,95.65217391
2000020079,12,3597,0.0,33,31,7,2,2,93.93939394
2000020079,5,3552,0.0,32,29,5,3,3,90.625
2000020080,21,3600,0.0,21,20,4,0,1,95.23809524
2000020080,29,3600,0.0,41,36,14,0,5,87.80487805
2000020081,3,3600,0.0,40,38,3,2,2,95.0
2000020081,16,3560,0.0,24,21,4,0,3,87.5
2000020082,28,3541,0.0,25,23,8,1,2,92.0
2000020082,25,3600,0.0,13,12,3,1,1,92.30769231
2000020083,14,3540,0.0,34,29,1,2,5,85.29411765
2000020083,14,24,0.0,0,0,0,0,0,
2000020083,30,3584,0.0,24,19,4,2,5,79.16666667
2000020084,20,3581,0.0,25,21,5,0,4,84.0
2000020084,23,3600,0.0,23,22,4,0,1,95.65217391
2000020085,13,3675,0.0,24,22,5,0,2,91.66666667
2000020085,27,3675,0.0,31,30,7,0,1,96.77419355
2000020086,5,3892,0.0,34,31,5,1,3,91.17647059
2000020086,9,3894,0.0,24,21,2,3,3,87.5
2000020087,8,3895,0.0,45,42,11,3,3,93.33333333
2000020087,4,3900,0.0,28,25,2,2,3,89.28571429
2000020088,1,2010,0.0,11,7,0,0,4,63.63636364
2000020088,1,1562,0.0,7,6,5,0,1,85.71428571
2000020088,15,3600,0.0,36,34,7,1,2,94.44444444
2000020089,18,3711,0.0,45,44,9,1,1,97.77777778
2000020089,17,3693,0.0,28,26,5,1,2,92.85714286
2000020090,26,3600,0.0,30,23,11,0,7,76.66666667
2000020090,19,3600,0.0,18,17,5,0,1,94.44444444
2000020091,10,3600,0.0,19,18,4,0,1,94.73684211
2000020091,22,3600,0.0,19,15,1,1,4,78.94736842
2000020092,24,3898,0.0,36,34,6,2,2,94.44444444
2000020092,7,3815,0.0,19,17,2,1,2,89.47368421
2000020092,7,27,0.0,0,0,0,0,0,
2000020093,2,3600,0.0,27,24,9,2,3,88.88888889
2000020093,11,2701,0.0,12,11,6,0,1,91.66666667
2000020093,11,899,0.0,17,13,5,1,4,76.47058824
2000020094,25,3598,0.0,18,17,1,1,1,94.44444444
2000020094,16,3600,0.0,35,30,6,1,5,85.71428571
2000020095,28,3597,0.0,22,21,4,1,1,95.45454545
2000020095,30,3586,0.0,33,30,10,2,3,90.90909091
2000020096,13,3600,0.0,39,34,13,3,5,87.17948718
2000020096,21,3600,2.0,25,24,5,0,1,96.0
2000020097,6,3575,0.0,30,27,2,2,3,90.0
2000020097,20,3600,0.0,20,18,3,0,2,90.0
2000020098,12,3559,0.0,22,18,4,0,4,81.81818182
2000020098,8,3593,0.0,20,18,3,1,2,90.0
2000020099,11,3892,0.0,38,32,4,1,6,84.21052632
2000020099,9,3900,0.0,39,33,5,0,6,84.61538462
2000020100,14,1194,0.0,12,12,0,2,0,100.0
2000020100,14,2400,0.0,32,25,7,0,7,78.125
2000020100,1,3600,0.0,15,13,4,0,2,86.66666667
2000020101,24,3583,0.0,32,29,6,2,3,90.625
2000020101,4,3542,0.0,23,19,2,2,4,82.60869565
2000020102,29,3586,0.0,35,31,10,5,4,88.57142857
2000020102,5,3600,0.0,37,35,10,1,2,94.59459459
2000020103,2,3900,0.0,42,38,5,1,4,90.47619048
2000020103,15,3900,0.0,26,22,2,1,4,84.61538462
2000020104,7,3867,0.0,27,22,3,1,5,81.48148148
2000020104,17,3867,0.0,33,29,5,0,4,87.87878788
2000020105,16,3529,0.0,28,27,2,3,1,96.42857143
2000020105,19,3573,0.0,16,16,1,0,0,100.0
2000020106,26,3526,0.0,37,33,8,0,4,89.18918919
2000020106,25,3594,0.0,27,24,5,2,3,88.88888889
2000020107,28,3578,0.0,30,27,4,4,3,90.0
2000020107,18,3495,0.0,36,31,9,4,5,86.11111111
2000020108,10,3600,0.0,33,32,7,0,1,96.96969697
2000020108,20,3520,0.0,19,17,6,0,2,89.47368421
2000020109,27,3616,0.0,39,37,12,1,2,94.87179487
2000020109,23,3616,0.0,23,20,1,1,3,86.95652174
2000020110,14,3592,0.0,34,32,7,1,2,94.11764706
2000020110,3,3532,0.0,22,18,8,1,4,81.81818182
2000020111,17,3721,0.0,47,46,7,2,1,97.87234043
2000020111,29,3692,0.0,36,34,3,2,2,94.44444444
2000020112,13,3900,0.0,20,20,6,2,0,100.0
2000020112,30,3900,0.0,24,24,3,1,0,100.0
2000020113,27,3900,0.0,39,36,2,1,3,92.30769231
2000020113,22,3900,0.0,15,12,0,1,3,80.0
2000020114,26,3664,0.0,24,20,5,1,4,83.33333333
2000020114,24,3662,0.0,35,30,6,0,5,85.71428571
2000020115,30,3894,0.0,35,33,4,3,2,94.28571429
2000020115,8,2261,0.0,14,13,3,1,1,92.85714286
2000020115,8,1630,0.0,9,8,0,0,1,88.88888889
2000020116,4,3600,0.0,25,21,7,2,4,84.0
2000020116,3,3474,0.0,19,14,3,0,5,73.68421053
2000020117,28,2765,0.0,27,26,11,2,1,96.2962963
2000020117,28,835,0.0,1,0,0,0,1,0.0
2000020117,12,3554,0.0,26,23,5,1,3,88.46153846
2000020118,23,3879,0.0,33,29,1,1,4,87.87878788
2000020118,18,3900,0.0,34,30,5,3,4,88.23529412
2000020119,27,3900,0.0,27,25,2,0,2,92.59259259
2000020119,20,3900,0.0,20,18,3,1,2,90.0
2000020120,12,3600,0.0,31,27,2,0,4,87.09677419
2000020120,7,3597,0.0,31,30,2,0,1,96.77419355
2000020121,30,1188,0.0,9,5,0,0,4,55.55555556
2000020121,30,2400,0.0,20,18,11,0,2,90.0
2000020121,10,3585,0.0,29,28,10,2,1,96.55172414
2000020122,9,3600,0.0,33,31,5,0,2,93.93939394
2000020122,5,3538,0.0,25,22,4,1,3,88.0
2000020123,1,3596,0.0,21,20,3,0,1,95.23809524
2000020123,13,3567,0.0,28,26,1,5,2,92.85714286
2000020124,14,3600,0.0,41,36,6,1,5,87.80487805
2000020124,17,3578,0.0,26,25,2,0,1,96.15384615
2000020125,28,3600,0.0,36,35,11,2,1,97.22222222
2000020125,29,3557,0.0,21,19,6,3,2,90.47619048
2000020126,23,3597,0.0,24,22,5,1,2,91.66666667
2000020126,25,1325,0.0,13,11,2,0,2,84.61538462
2000020126,25,2275,0.0,12,8,1,1,4,66.66666667
2000020127,18,3838,0.0,42,40,8,1,2,95.23809524
2000020127,21,3835,0.0,20,19,2,3,1,95.0
2000020128,11,3600,0.0,27,26,7,0,1,96.2962963
2000020128,22,3551,0.0,24,22,1,1,2,91.66666667
2000020129,24,1874,0.0,22,20,7,1,2,90.90909091
2000020129,24,1723,0.0,13,9,1,0,4,69.23076923
2000020129,26,3582,0.0,18,16,5,0,2,88.88888889
2000020130,15,3600,0.0,33,29,15,1,4,87.87878788
2000020130,6,3600,0.0,28,27,6,2,1,96.42857143
2000020131,3,3480,0.0,30,28,2,1,2,93.33333333
2000020131,4,3600,0.0,32,32,6,1,0,100.0
2000020132,21,3600,0.0,18,18,0,0,0,100.0
2000020132,16,3567,0.0,28,26,4,2,2,92.85714286
2000020133,20,3526,0.0,21,17,5,2,4,80.95238095
2000020133,19,3594,0.0,21,18,7,0,3,85.71428571
2000020134,10,3526,0.0,32,30,3,1,2,93.75
2000020134,7,3600,0.0,20,19,2,0,1,95.0
2000020135,8,3527,0.0,32,30,2,2,2,93.75
2000020135,2,3600,0.0,38,37,9,0,1,97.36842105
2000020136,5,3594,0.0,28,27,9,3,1,96.42857143
2000020136,3,3600,0.0,33,29,14,1,4,87.87878788
2000020137,1,3900,0.0,29,26,5,0,3,89.65517241
2000020137,12,3900,0.0,31,28,8,1,3,90.32258065
2000020138,9,3600,0.0,24,24,2,2,0,100.0
2000020138,14,1565,0.0,17,13,0,1,4,76.47058824
2000020138,14,2035,0.0,18,16,2,1,2,88.88888889
2000020139,15,3553,0.0,19,16,4,0,3,84.21052632
2000020139,29,3581,0.0,33,32,12,3,1,96.96969697
2000020140,27,3580,0.0,30,28,5,0,2,93.33333333
2000020140,25,3592,0.0,17,14,2,0,3,82.35294118
2000020141,13,3900,0.0,45,42,13,1,3,93.33333333
2000020141,18,1194,0.0,10,9,3,0,1,90.0
2000020141,18,2700,0.0,19,17,2,0,2,89.47368421
2000020142,20,3512,0.0,13,10,3,2,3,76.92307692
2000020142,30,3600,2.0,31,30,10,2,1,96.77419355
2000020143,11,3895,4.0,27,26,6,3,1,96.2962963
2000020143,23,3900,0.0,24,23,6,3,1,95.83333333
2000020144,22,3539,0.0,21,18,4,0,3,85.71428571
2000020144,24,3600,0.0,31,29,1,4,2,93.5483871
2000020145,10,3816,2.0,28,27,7,3,1,96.42857143
2000020145,6,3816,0.0,20,18,2,2,2,90.0
2000020146,2,3600,0.0,34,33,7,0,1,97.05882353
2000020146,8,3530,0.0,18,16,2,1,2,88.88888889
2000020147,1,3600,0.0,21,21,0,0,0,100.0
2000020147,5,2400,0.0,26,21,1,0,5,80.76923077
2000020147,5,1200,0.0,16,12,2,0,4,75.0
2000020148,9,3546,0.0,25,23,8,2,2,92.0
2000020148,13,3599,0.0,31,30,7,1,1,96.77419355
2000020149,29,3600,0.0,36,32,9,3,4,88.88888889
2000020149,17,3580,0.0,15,14,2,1,1,93.33333333
2000020150,7,3598,2.0,23,22,3,1,1,95.65217391
2000020150,16,3523,0.0,24,21,2,2,3,87.5
2000020151,25,3615,0.0,30,26,5,1,4,86.66666667
2000020151,19,3615,0.0,24,21,5,0,3,87.5
2000020152,22,3600,0.0,29,25,5,0,4,86.20689655
2000020152,21,3591,0.0,27,25,6,1,2,92.59259259
2000020153,26,3542,0.0,27,24,0,2,3,88.88888889
2000020153,27,3600,0.0,18,17,5,2,1,94.44444444
2000020154,11,3896,2.0,32,30,9,1,2,93.75
2000020154,28,3900,0.0,30,28,2,3,2,93.33333333
2000020155,6,606,0.0,7,6,1,0,1,85.71428571
2000020155,6,2989,0.0,33,29,9,1,4,87.87878788
2000020155,3,3600,0.0,32,31,3,3,1,96.875
2000020156,15,3900,0.0,31,30,8,0,1,96.77419355
2000020156,4,3898,0.0,22,21,2,3,1,95.45454545
2000020157,19,3593,0.0,32,31,7,0,1,96.875
2000020157,12,3600,0.0,30,26,1,3,4,86.66666667
2000020158,16,3600,0.0,26,24,7,0,2,92.30769231
2000020158,30,3547,0.0,19,16,9,0,3,84.21052632
2000020159,24,3600,0.0,25,22,6,0,3,88.0
2000020159,20,3597,0.0,27,21,1,0,6,77.77777778
2000020160,27,3600,0.0,45,45,7,3,0,100.0
2000020160,21,3600,0.0,16,12,1,0,4,75.0
2000020161,24,3508,0.0,37,32,5,1,5,86.48648649
2000020161,22,3600,0.0,19,16,2,1,3,84.21052632
2000020162,10,3537,0.0,24,20,2,0,4,83.33333333
2000020162,9,3600,0.0,23,20,8,0,3,86.95652174
2000020163,6,3506,0.0,12,9,2,0,3,75.0
2000020163,2,3579,0.0,34,32,1,4,2,94.11764706
2000020164,17,3600,0.0,35,29,6,0,6,82.85714286
2000020164,15,3600,0.0,24,22,3,0,2,91.66666667
2000020165,14,3707,0.0,32,26,3,0,6,81.25
2000020165,14,23,0.0,0,0,0,0,0,
2000020165,12,3750,0.0,25,20,2,0,5,80.0
2000020166,26,3561,0.0,30,27,7,3,3,90.0
2000020166,29,3600,0.0,46,45,14,1,1,97.82608696
2000020167,19,3600,0.0,22,20,11,1,2,90.90909091
2000020167,18,3532,0.0,26,23,7,1,3,88.46153846
2000020168,17,3600,0.0,22,20,6,1,2,90.90909091
2000020168,8,3566,0.0,38,34,11,2,4,89.47368421
2000020169,4,3893,0.0,33,32,1,0,1,96.96969697
2000020169,1,3900,0.0,29,28,2,0,1,96.55172414
2000020170,14,2670,0.0,28,22,4,0,6,78.57142857
2000020170,14,927,0.0,8,8,0,0,0,100.0
2000020170,3,3597,0.0,32,31,2,0,1,96.875
2000020171,2,3600,0.0,23,23,7,3,0,100.0
2000020171,13,3600,0.0,31,28,10,1,3,90.32258065
2000020172,29,3589,0.0,29,25,2,0,4,86.20689655
2000020172,25,3600,0.0,14,14,0,0,0,100.0
2000020173,20,2856,0.0,18,18,3,0,0,100.0
2000020173,20,684,0.0,8,5,1,0,3,62.5
2000020173,22,3600,0.0,29,27,2,0,2,93.10344828
2000020174,21,3537,0.0,24,20,2,1,4,83.33333333
2000020174,23,3600,0.0,37,34,4,2,3,91.89189189
2000020175,27,3891,0.0,26,25,7,2,1,96.15384615
2000020175,24,3896,0.0,16,15,6,0,1,93.75
2000020176,5,3563,0.0,33,30,8,1,3,90.90909091
2000020176,28,3591,0.0,26,24,1,1,2,92.30769231
2000020177,16,3523,0.0,26,21,2,1,5,80.76923077
2000020177,6,3595,0.0,23,19,6,0,4,82.60869565
2000020178,1,2784,0.0,25,22,6,0,3,88.0
2000020178,1,816,0.0,7,5,1,0,2,71.42857143
2000020178,10,3600,0.0,23,20,2,2,3,86.95652174
2000020179,3,3524,2.0,38,32,4,0,6,84.21052632
2000020179,9,3600,0.0,37,32,8,0,5,86.48648649
2000020180,18,3600,0.0,28,27,8,1,1,96.42857143
2000020180,4,3564,0.0,19,17,0,3,2,89.47368421
2000020181,26,3600,0.0,24,22,5,3,2,91.66666667
2000020181,11,3600,0.0,30,25,2,0,5,83.33333333
2000020182,15,3559,2.0,25,24,3,2,1,96.0
2000020182,19,3600,0.0,30,30,7,0,0,100.0
2000020183,8,2763,0.0,10,8,1,1,2,80.0
2000020183,8,816,0.0,5,2,1,0,3,40.0
2000020183,7,3599,0.0,35,31,9,2,4,88.57142857
2000020184,2,3765,0.0,33,29,1,2,4,87.87878788
2000020184,14,3660,0.0,34,31,5,1,3,91.17647059
2000020184,14,73,0.0,1,1,0,0,0,100.0
2000020185,16,3600,0.0,31,30,4,0,1,96.77419355
2000020185,17,1740,0.0,26,22,2,1,4,84.61538462
2000020185,17,1853,0.0,10,8,1,0,2,80.0
2000020186,12,1139,0.0,5,5,0,0,0,100.0
2000020186,12,2396,0.0,18,14,3,0,4,77.77777778
2000020186,21,3600,0.0,26,23,5,1,3,88.46153846
2000020187,30,3600,0.0,19,16,3,0,3,84.21052632
2000020187,22,3600,0.0,20,20,3,1,0,100.0
2000020188,5,3600,0.0,32,30,5,1,2,93.75
2000020188,23,3549,0.0,13,10,2,2,3,76.92307692
2000020189,25,3884,0.0,17,15,3,0,2,88.23529412
2000020189,27,3900,0.0,32,30,5,0,2,93.75
2000020190,11,2400,0.0,23,21,6,1,2,91.30434783
2000020190,11,1200,0.0,12,11,5,0,1,91.66666667
2000020190,6,1200,0.0,8,6,1,0,2,75.0
2000020190,6,2400,0.0,19,13,0,2,6,68.42105263
2000020191,3,3600,0.0,37,35,6,0,2,94.59459459
2000020191,8,3594,0.0,23,18,1,1,5,78.26086957
2000020192,29,3900,0.0,27,25,6,0,2,92.59259259
2000020192,9,3900,0.0,18,16,3,0,2,88.88888889
2000020193,26,3596,0.0,34,33,1,0,1,97.05882353
2000020193,1,3570,0.0,16,14,4,0,2,87.5
2000020194,7,3600,0.0,24,21,0,0,3,87.5
2000020194,4,3600,0.0,18,18,3,0,0,100.0
2000020195,15,3600,0.0,34,32,6,1,2,94.11764706
2000020195,13,3521,0.0,30,27,8,1,3,90.0
2000020196,10,3900,0.0,36,36,8,0,0,100.0
2000020196,19,3897,0.0,16,16,3,0,0,100.0
2000020197,24,3900,0.0,23,20,6,1,3,86.95652174
2000020197,18,3900,0.0,24,21,8,0,3,87.5
2000020198,5,3900,0.0,21,20,3,1,1,95.23809524
2000020198,20,3899,0.0,32,31,8,0,1,96.875
2000020199,12,3580,0.0,28,24,9,0,4,85.71428571
2000020199,28,3600,0.0,20,19,4,0,1,95.0
2000020200,6,2396,0.0,26,21,6,2,5,80.76923077
2000020200,6,1180,0.0,10,8,5,0,2,80.0
2000020200,10,3600,0.0,22,21,5,1,1,95.45454545
2000020201,26,3597,0.0,31,30,6,0,1,96.77419355
2000020201,2,3528,0.0,26,23,3,3,3,88.46153846
2000020202,15,3600,0.0,26,21,10,0,5,80.76923077
2000020202,14,3600,0.0,26,24,2,3,2,92.30769231
2000020203,22,3584,0.0,29,27,8,2,2,93.10344828
2000020203,29,3546,0.0,29,26,8,1,3,89.65517241
2000020204,24,15,0.0,0,0,0,0,0,
2000020204,24,3555,0.0,36,33,10,0,3,91.66666667
2000020204,16,3600,0.0,17,15,2,1,2,88.23529412
2000020205,30,3791,0.0,24,22,0,1,2,91.66666667
2000020205,20,3791,0.0,29,26,3,0,3,89.65517241
2000020206,28,3900,0.0,24,22,2,1,2,91.66666667
2000020206,23,3893,0.0,19,17,3,1,2,89.47368421
2000020207,9,3600,0.0,33,31,5,1,2,93.93939394
2000020207,11,3557,0.0,20,17,1,1,3,85.0
2000020208,18,3538,0.0,30,28,0,0,2,93.33333333
2000020208,2,3600,0.0,33,32,4,2,1,96.96969697
2000020209,22,3579,0.0,41,37,6,4,4,90.24390244
2000020209,3,3583,0.0,21,18,3,0,3,85.71428571
2000020210,30,3600,0.0,27,25,2,0,2,92.59259259
2000020210,21,3600,0.0,23,23,0,1,0,100.0
2000020211,27,3900,2.0,29,26,5,0,3,89.65517241
2000020211,26,3900,0.0,25,22,4,0,3,88.0
2000020212,12,1668,0.0,8,5,0,0,3,62.5
2000020212,12,1928,0.0,15,13,5,1,2,86.66666667
2000020212,10,3600,0.0,27,27,3,1,0,100.0
2000020213,18,3600,0.0,36,33,5,1,3,91.66666667
2000020213,1,3597,0.0,36,32,10,1,4,88.88888889
2000020214,4,1600,0.0,13,12,2,0,1,92.30769231
2000020214,4,2000,0.0,24,20,10,0,4,83.33333333
2000020214,5,3600,0.0,31,29,6,3,2,93.5483871
2000020215,8,3596,0.0,29,27,8,3,2,93.10344828
2000020215,13,3559,0.0,36,32,9,2,4,88.88888889
2000020216,28,3837,0.0,31,29,1,1,2,93.5483871
2000020216,16,3866,0.0,32,29,1,1,3,90.625
2000020217,20,3600,0.0,22,22,3,3,0,100.0
2000020217,30,3533,0.0,19,18,5,1,1,94.73684211
2000020218,17,3596,0.0,28,26,6,1,2,92.85714286
2000020218,27,71,0.0,1,1,0,0,0,100.0
2000020218,27,3431,0.0,23,19,1,0,4,82.60869565
2000020219,23,3600,0.0,38,36,2,4,2,94.73684211
2000020219,24,1453,0.0,17,13,2,0,4,76.47058824
2000020219,24,2147,0.0,26,23,7,0,3,88.46153846
2000020220,9,3537,0.0,23,21,4,3,2,91.30434783
2000020220,6,3600,0.0,33,32,9,1,1,96.96969697
2000020221,2,3568,0.0,29,26,8,1,3,89.65517241
2000020221,7,3600,0.0,22,22,5,2,0,100.0
2000020222,22,3508,0.0,26,24,0,3,2,92.30769231
2000020222,4,3600,0.0,28,28,6,0,0,100.0
2000020223,3,3598,0.0,30,27,4,0,3,90.0
2000020223,15,3543,0.0,27,23,10,1,4,85.18518519
2000020224,28,3600,0.0,31,26,4,2,5,83.87096774
2000020224,29,3570,0.0,31,29,8,1,2,93.5483871
2000020225,19,3895,0.0,22,19,2,0,3,86.36363636
2000020225,21,3900,0.0,30,27,7,0,3,90.0
2000020226,23,3550,0.0,30,28,5,1,2,93.33333333
2000020226,26,3600,0.0,25,25,1,2,0,100.0
2000020227,5,3600,0.0,44,42,2,0,2,95.45454545
2000020227,1,2150,0.0,17,15,0,1,2,88.23529412
2000020227,1,1450,0.0,9,7,0,0,2,77.77777778
2000020228,10,3591,0.0,22,19,4,0,3,86.36363636
2000020228,12,3598,0.0,25,24,5,0,1,96.0
2000020229,8,3545,0.0,16,14,1,0,2,87.5
2000020229,14,3598,0.0,27,26,7,2,1,96.2962963
2000020230,20,3900,0.0,32,29,8,2,3,90.625
2000020230,13,3900,0.0,27,24,10,2,3,88.88888889
2000020231,30,3600,0.0,24,22,7,1,2,91.66666667
2000020231,16,3600,0.0,26,21,3,1,5,80.76923077
2000020232,18,3900,0.0,24,22,2,1,2,91.66666667
2000020232,6,3853,0.0,23,21,1,4,2,91.30434783
2000020233,16,3854,0.0,39,36,7,1,3,92.30769231
2000020233,10,3900,0.0,22,19,2,1,3,86.36363636
2000020234,7,3600,0.0,23,23,7,1,0,100.0
2000020234,1,3600,0.0,31,27,3,0,4,87.09677419
2000020235,28,3600,0.0,24,24,4,2,0,100.0
2000020235,2,3575,0.0,30,26,8,2,4,86.66666667
2000020236,9,3549,0.0,18,14,2,3,4,77.77777778
2000020236,4,3596,0.0,31,28,3,0,3,90.32258065
2000020237,22,3519,0.0,29,25,2,0,4,86.20689655
2000020237,5,3600,0.0,33,31,8,1,2,93.93939394
2000020238,20,3600,0.0,32,29,5,1,3,90.625
2000020238,14,3425,0.0,40,36,6,0,4,90.0
2000020238,14,23,0.0,0,0,0,0,0,
2000020239,27,3560,0.0,35,33,4,1,2,94.28571429
2000020239,29,3600,0.0,25,24,2,1,1,96.0
2000020240,8,3552,2.0,19,18,1,1,1,94.73684211
2000020240,25,3600,0.0,24,24,1,3,0,100.0
2000020241,24,3536,0.0,26,23,5,0,3,88.46153846
2000020241,21,3600,0.0,19,18,3,0,1,94.73684211
2000020242,19,3600,0.0,29,27,3,0,2,93.10344828
2000020242,23,3600,0.0,29,24,4,1,5,82.75862069
2000020243,17,3900,0.0,26,24,10,2,2,92.30769231
2000020243,26,3900,0.0,31,29,3,1,2,93.5483871
2000020244,27,3600,0.0,39,39,5,3,0,100.0
2000020244,3,3505,0.0,27,25,5,0,2,92.59259259
2000020245,11,3900,0.0,30,28,3,1,2,93.33333333
2000020245,15,3896,0.0,26,24,4,0,2,92.30769231
2000020246,9,3563,0.0,28,24,10,0,4,85.71428571
2000020246,12,3600,0.0,29,29,5,2,0,100.0
2000020247,22,3678,0.0,31,27,9,0,4,87.09677419
2000020247,30,3684,0.0,19,14,8,0,5,73.68421053
2000020248,17,3600,0.0,24,22,3,0,2,91.66666667
2000020248,24,3577,0.0,34,31,11,1,3,91.17647059
2000020249,20,3689,0.0,35,32,6,1,3,91.42857143
2000020249,7,3689,0.0,19,17,3,1,2,89.47368421
2000020250,11,3598,0.0,22,21,2,2,1,95.45454545
2000020250,13,1200,0.0,7,6,1,1,1,85.71428571
2000020250,13,2400,0.0,26,23,10,1,3,88.46153846
2000020251,5,3829,0.0,21,18,1,0,3,85.71428571
2000020251,21,3836,0.0,29,27,3,0,2,93.10344828
2000020252,14,3600,0.0,34,34,12,3,0,100.0
2000020252,8,3561,0.0,23,22,4,2,1,95.65217391
2000020253,28,3600,0.0,22,20,0,0,2,90.90909091
2000020253,1,3551,0.0,17,14,2,1,3,82.35294118
2000020254,27,3900,0.0,26,24,2,1,2,92.30769231
2000020254,15,3870,0.0,27,25,4,1,2,92.59259259
2000020255,25,3578,0.0,30,27,5,0,3,90.0
2000020255,29,3600,0.0,28,26,4,0,2,92.85714286
2000020256,19,3543,0.0,16,14,4,0,2,87.5
2000020256,22,3600,0.0,29,29,7,1,0,100.0
2000020257,16,3575,0.0,47,43,12,0,4,91.4893617
2000020257,23,3600,0.0,19,17,1,0,2,89.47368421
2000020258,25,3892,0.0,21,19,5,1,2,90.47619048
2000020258,7,3895,0.0,26,24,11,0,2,92.30769231
2000020259,4,3806,0.0,31,30,2,0,1,96.77419355
2000020259,10,3806,0.0,31,29,4,1,2,93.5483871
2000020260,13,3600,0.0,23,22,2,0,1,95.65217391
2000020260,12,3541,0.0,20,17,0,1,3,85.0
2000020261,18,3578,0.0,22,21,3,0,1,95.45454545
2000020261,11,3600,0.0,37,37,4,0,0,100.0
2000020262,28,3598,0.0,32,28,5,2,4,87.5
2000020262,17,3600,0.0,26,25,8,2,1,96.15384615
2000020263,3,3596,0.0,19,17,4,1,2,89.47368421
2000020263,30,3579,0.0,22,19,7,1,3,86.36363636
2000020264,21,3600,0.0,41,41,3,0,0,100.0
2000020264,24,3598,0.0,20,17,2,0,3,85.0
2000020265,1,3898,0.0,38,36,1,0,2,94.73684211
2000020265,6,3898,0.0,37,34,4,0,3,91.89189189
2000020266,12,3600,0.0,27,27,10,3,0,100.0
2000020266,9,3521,0.0,25,24,4,4,1,96.0
2000020267,5,3555,0.0,34,30,8,1,4,88.23529412
2000020267,19,3600,0.0,20,17,2,1,3,85.0
2000020268,29,3598,0.0,31,30,2,1,1,96.77419355
2000020268,18,3600,0.0,27,22,3,1,5,81.48148148
2000020269,16,3600,0.0,33,31,6,0,2,93.93939394
2000020269,20,3600,0.0,39,34,1,0,5,87.17948718
2000020270,21,3595,0.0,28,22,6,0,6,78.57142857
2000020270,27,3599,0.0,21,18,1,3,3,85.71428571
2000020271,2,3600,0.0,29,24,5,0,5,82.75862069
2000020271,26,3600,0.0,28,27,6,1,1,96.42857143
2000020272,30,3550,0.0,36,34,9,0,2,94.44444444
2000020272,7,3600,0.0,23,22,1,0,1,95.65217391
2000020273,14,3900,0.0,36,34,6,1,2,94.44444444
2000020273,10,3900,0.0,21,19,2,1,2,90.47619048
2000020274,8,2279,0.0,19,18,2,1,1,94.73684211
2000020274,8,1242,0.0,7,4,0,0,3,57.14285714
2000020274,15,3600,0.0,32,29,13,1,3,90.625
2000020275,4,3655,0.0,27,25,1,4,2,92.59259259
2000020275,11,3655,0.0,32,29,2,3,3,90.625
2000020276,25,3600,0.0,33,33,2,0,0,100.0
2000020276,17,3575,0.0,30,29,4,2,1,96.66666667
2000020277,13,3598,0.0,30,30,8,2,0,100.0
2000020277,29,3600,0.0,21,18,3,0,3,85.71428571
2000020278,16,3886,0.0,24,21,4,1,3,87.5
2000020278,22,3895,0.0,28,25,5,1,3,89.28571429
2000020279,3,3575,0.0,32,28,15,3,4,87.5
2000020279,23,3600,0.0,32,29,4,3,3,90.625
2000020280,30,3598,0.0,24,23,4,1,1,95.83333333
2000020280,6,3600,0.0,31,25,11,2,6,80.64516129
2000020281,10,3600,0.0,32,31,10,1,1,96.875
2000020281,8,1424,0.0,13,10,1,1,3,76.92307692
2000020281,8,2174,0.0,11,8,3,0,3,72.72727273
2000020282,13,2384,0.0,20,17,2,2,3,85.0
2000020282,13,1200,0.0,13,11,2,0,2,84.61538462
2000020282,9,3600,0.0,29,27,5,0,2,93.10344828
2000020283,12,3860,0.0,39,36,4,3,3,92.30769231
2000020283,1,3860,0.0,18,16,6,1,2,88.88888889
2000020284,15,3515,0.0,26,21,4,2,5,80.76923077
2000020284,4,3600,0.0,38,35,5,0,3,92.10526316
2000020285,11,3600,0.0,30,27,5,1,3,90.0
2000020285,5,3600,0.0,26,25,5,2,1,96.15384615
2000020286,7,3579,0.0,38,35,9,2,3,92.10526316
2000020286,19,3600,0.0,21,20,3,1,1,95.23809524
2000020287,17,3592,0.0,27,24,10,0,3,88.88888889
2000020287,18,3600,0.0,21,19,5,0,2,90.47619048
2000020288,3,3764,0.0,37,33,10,1,4,89.18918919
2000020288,20,3764,0.0,25,20,6,3,5,80.0
2000020289,24,3598,0.0,24,22,6,3,2,91.66666667
2000020289,27,3600,0.0,31,25,7,4,6,80.64516129
2000020290,21,3546,0.0,21,16,2,0,5,76.19047619
2000020290,26,3600,0.0,47,43,10,0,4,91.4893617
2000020291,2,3582,0.0,33,28,10,1,5,84.84848485
2000020291,28,3600,0.0,27,24,2,2,3,88.88888889
2000020292,23,3599,0.0,29,28,7,1,1,96.55172414
2000020292,29,3600,0.0,39,33,9,0,6,84.61538462
2000020293,20,3552,0.0,22,20,5,1,2,90.90909091
2000020293,22,3600,0.0,23,23,6,0,0,100.0
2000020294,2,3566,0.0,31,29,6,2,2,93.5483871
2000020294,24,3595,0.0,22,21,2,1,1,95.45454545
2000020295,18,3600,0.0,34,28,3,0,6,82.35294118
2000020295,17,1200,0.0,8,8,0,0,0,100.0
2000020295,17,2400,0.0,19,16,0,0,3,84.21052632
2000020296,14,2400,0.0,20,15,1,0,5,75.0
2000020296,14,1199,0.0,5,4,0,0,1,80.0
2000020296,25,3600,0.0,20,18,3,1,2,90.0
2000020297,13,3600,0.0,22,21,6,1,1,95.45454545
2000020297,8,3561,0.0,19,16,3,0,3,84.21052632
2000020298,6,3561,0.0,30,28,8,2,2,93.33333333
2000020298,9,3599,0.0,23,22,2,2,1,95.65217391
2000020299,10,3600,0.0,32,31,9,0,1,96.875
2000020299,3,3558,0.0,26,23,4,0,3,88.46153846
2000020300,23,3600,0.0,33,30,4,0,3,90.90909091
2000020300,19,3519,0.0,24,20,3,1,4,83.33333333
2000020301,16,3588,0.0,24,23,1,0,1,95.83333333
2000020301,27,3598,0.0,32,28,1,1,4,87.5
2000020302,4,3585,0.0,21,20,1,2,1,95.23809524
2000020302,7,3537,0.0,32,29,10,1,3,90.625
2000020303,22,3566,0.0,19,15,4,1,4,78.94736842
2000020303,10,3600,0.0,24,21,4,3,3,87.5
2000020304,3,3865,0.0,35,32,8,1,3,91.42857143
2000020304,2,3865,0.0,24,20,6,1,4,83.33333333
2000020305,12,3600,0.0,35,34,8,0,1,97.14285714
2000020305,5,3562,0.0,21,19,0,1,2,90.47619048
2000020306,23,3857,0.0,30,27,1,1,3,90.0
2000020306,15,3857,0.0,29,27,7,1,2,93.10344828
2000020307,11,1815,0.0,17,13,0,0,4,76.47058824
2000020307,11,1785,0.0,16,12,0,1,4,75.0
2000020307,14,3600,0.0,27,25,5,0,2,92.59259259
2000020308,6,3598,0.0,46,42,13,3,4,91.30434783
2000020308,17,3466,0.0,25,20,4,1,5,80.0
2000020308,17,75,0.0,0,0,0,0,0,
2000020309,25,3599,0.0,24,24,0,2,0,100.0
2000020309,18,3521,0.0,25,24,4,1,1,96.0
2000020310,20,3888,2.0,25,24,8,3,1,96.0
2000020310,30,3900,0.0,23,22,10,0,1,95.65217391
2000020311,29,1200,0.0,6,6,0,0,0,100.0
2000020311,29,2400,0.0,20,15,2,0,5,75.0
2000020311,21,3594,0.0,27,25,3,0,2,92.59259259
2000020312,1,3597,0.0,28,26,2,0,2,92.85714286
2000020312,24,2175,0.0,23,20,4,0,3,86.95652174
2000020312,24,1353,0.0,9,8,0,1,1,88.88888889
2000020313,16,3593,0.0,28,25,2,2,3,89.28571429
2000020313,28,3600,0.0,26,25,2,1,1,96.15384615
2000020314,22,3600,0.0,26,23,5,0,3,88.46153846
2000020314,9,3553,0.0,23,19,5,1,4,82.60869565
2000020315,8,3600,0.0,25,25,3,3,0,100.0
2000020315,11,2494,0.0,26,22,2,1,4,84.61538462
2000020315,11,1106,0.0,13,11,2,0,2,84.61538462
2000020316,1,3595,0.0,24,23,3,0,1,95.83333333
2000020316,26,3600,0.0,35,29,2,1,6,82.85714286
2000020317,12,3598,2.0,17,16,4,0,1,94.11764706
2000020317,6,3562,0.0,30,27,7,1,3,90.0
2000020318,3,3499,0.0,30,27,1,2,3,90.0
2000020318,7,3600,10.0,26,24,3,1,2,92.30769231
2000020319,5,3600,0.0,36,36,7,0,0,100.0
2000020319,4,3524,0.0,25,24,1,1,1,96.0
2000020320,2,3521,0.0,21,20,4,0,1,95.23809524
2000020320,15,3600,0.0,22,22,4,1,0,100.0
2000020321,13,3538,2.0,22,20,4,0,2,90.90909091
2000020321,14,3600,0.0,21,20,2,0,1,95.23809524
2000020322,23,3593,0.0,32,29,8,4,3,90.625
2000020322,17,3600,0.0,36,34,9,0,2,94.44444444
2000020323,29,3600,0.0,25,22,1,0,3,88.0
2000020323,25,3592,0.0,23,23,1,0,0,100.0
2000020324,19,3597,0.0,28,28,5,1,0,100.0
2000020324,18,3597,0.0,29,25,1,2,4,86.20689655
2000020325,16,3567,0.0,18,16,2,0,2,88.88888889
2000020325,30,3595,0.0,27,27,2,1,0,100.0
2000020326,24,3900,0.0,27,25,3,1,2,92.59259259
2000020326,20,3884,0.0,23,21,5,0,2,91.30434783
2000020327,9,3600,0.0,26,24,2,1,2,92.30769231
2000020327,10,3600,0.0,21,17,1,1,4,80.95238095
2000020328,7,3595,0.0,32,29,9,0,3,90.625
2000020328,8,3575,0.0,18,14,3,0,4,77.77777778
2000020329,17,3600,0.0,30,27,4,0,3,90.0
2000020329,2,3547,0.0,37,33,6,7,4,89.18918919
2000020330,26,3900,0.0,31,29,10,0,2,93.5483871
2000020330,5,3865,0.0,28,26,5,1,2,92.85714286
2000020331,15,3522,0.0,26,24,6,0,2,92.30769231
2000020331,11,3600,0.0,28,27,4,2,1,96.42857143
2000020332,14,3767,0.0,27,25,2,2,2,92.59259259
2000020332,13,3767,0.0,22,21,5,0,1,95.45454545
2000020333,25,3600,0.0,21,19,2,1,2,90.47619048
2000020333,29,3551,0.0,24,20,5,0,4,83.33333333
2000020334,27,3600,2.0,31,26,5,1,5,83.87096774
2000020334,19,3600,0.0,26,25,9,0,1,96.15384615
2000020335,20,3628,0.0,31,28,5,0,3,90.32258065
2000020335,21,3639,2.0,26,24,6,0,2,92.30769231
2000020336,24,3540,0.0,18,15,1,1,3,83.33333333
2000020336,22,3600,0.0,32,30,12,0,2,93.75
2000020337,1,3597,0.0,24,22,5,0,2,91.66666667
2000020337,28,3553,2.0,22,19,4,0,3,86.36363636
2000020338,26,3900,2.0,36,32,6,0,4,88.88888889
2000020338,6,3900,0.0,35,31,1,2,4,88.57142857
2000020339,9,3597,0.0,30,27,5,1,3,90.0
2000020339,3,3600,0.0,32,30,7,1,2,93.75
2000020340,27,3600,0.0,36,35,1,0,1,97.22222222
2000020340,4,3522,0.0,23,21,0,0,2,91.30434783
2000020341,18,3600,0.0,34,30,4,2,4,88.23529412
2000020341,12,1200,0.0,13,9,0,0,4,69.23076923
2000020341,12,2400,0.0,18,15,4,0,3,83.33333333
2000020342,23,3289,0.0,20,16,0,1,4,80.0
2000020342,30,3600,0.0,31,29,4,0,2,93.5483871
2000020343,11,3533,0.0,28,25,4,0,3,89.28571429
2000020343,8,3600,0.0,31,29,7,2,2,93.5483871
2000020344,14,1200,0.0,18,14,4,0,4,77.77777778
2000020344,14,2398,0.0,20,17,2,2,3,85.0
2000020344,2,2400,0.0,18,15,3,0,3,83.33333333
2000020344,2,1195,0.0,5,4,2,1,1,80.0
2000020345,16,3872,0.0,42,37,4,0,5,88.0952381
2000020345,17,3872,0.0,35,29,1,1,6,82.85714286
2000020346,5,3554,0.0,28,26,8,1,2,92.85714286
2000020346,6,3598,0.0,18,17,2,0,1,94.44444444
2000020347,7,3531,2.0,29,27,3,1,2,93.10344828
2000020347,9,3600,0.0,23,22,0,2,1,95.65217391
2000020348,26,1483,0.0,10,7,0,0,3,70.0
2000020348,26,2051,0.0,15,11,0,0,4,73.33333333
2000020348,3,3600,0.0,42,36,4,0,6,85.71428571
2000020349,20,1200,0.0,15,11,7,0,4,73.33333333
2000020349,20,2400,0.0,14,12,1,0,2,85.71428571
2000020349,18,3591,0.0,37,36,4,2,1,97.2972973
2000020350,24,3600,0.0,26,22,4,0,4,84.61538462
2000020350,23,3600,2.0,33,32,6,0,1,96.96969697
2000020351,30,3596,0.0,33,29,4,2,4,87.87878788
2000020351,28,3600,0.0,28,27,4,0,1,96.42857143
2000020352,19,1007,0.0,2,2,0,1,0,100.0
2000020352,19,2574,0.0,23,18,4,0,5,78.26086957
2000020352,10,3618,0.0,35,29,6,0,6,82.85714286
2000020353,3,3460,0.0,33,28,5,1,5,84.84848485
2000020353,1,3600,2.0,20,18,6,1,2,90.0
2000020354,14,3600,0.0,45,41,9,2,4,91.11111111
2000020354,15,3600,0.0,14,13,1,1,1,92.85714286
2000020355,17,3600,2.0,25,21,2,1,4,84.0
2000020355,11,2174,0.0,30,24,3,1,6,80.0
2000020355,11,1426,0.0,18,18,0,2,0,100.0
2000020356,12,3697,0.0,19,18,4,2,1,94.73684211
2000020356,13,3689,0.0,42,40,10,1,2,95.23809524
2000020357,4,3600,0.0,26,23,5,0,3,88.46153846
2000020357,29,3560,0.0,31,27,0,0,4,87.09677419
2000020358,20,3600,0.0,31,28,4,0,3,90.32258065
2000020358,25,3566,0.0,25,21,5,0,4,84.0
2000020359,27,3541,0.0,16,14,3,0,2,87.5
2000020359,21,3600,0.0,32,31,1,1,1,96.875
2000020360,8,3600,0.0,20,18,4,2,2,90.0
2000020360,22,3518,0.0,25,22,7,0,3,88.0
2000020361,10,3600,0.0,24,20,6,0,4,83.33333333
2000020361,2,3576,2.0,24,19,2,1,5,79.16666667
2000020362,4,3526,0.0,26,25,9,1,1,96.15384615
2000020362,12,3600,0.0,25,25,5,2,0,100.0
2000020363,18,3600,2.0,22,22,2,4,0,100.0
2000020363,16,3600,0.0,22,19,0,0,3,86.36363636
2000020364,8,3583,0.0,26,23,4,1,3,88.46153846
2000020364,23,1084,0.0,3,3,0,0,0,100.0
2000020364,23,2400,0.0,15,11,1,0,4,73.33333333
2000020365,30,3572,0.0,23,21,2,2,2,91.30434783
2000020365,27,3579,0.0,30,30,5,0,0,100.0
2000020366,24,3890,0.0,25,22,5,2,3,88.0
2000020366,28,3890,2.0,38,36,13,1,2,94.73684211
2000020367,5,3587,0.0,32,28,3,1,4,87.5
2000020367,7,3562,0.0,31,26,0,0,5,83.87096774
2000020368,2,3900,4.0,26,26,4,0,0,100.0
2000020368,1,3900,0.0,24,24,1,2,0,100.0
2000020369,6,3560,0.0,30,27,8,1,3,90.0
2000020369,15,3599,0.0,23,21,4,0,2,91.30434783
2000020370,14,3542,0.0,36,32,5,3,4,88.88888889
2000020370,11,3555,2.0,30,27,9,0,3,90.0
2000020371,17,3590,0.0,27,26,3,1,1,96.2962963
2000020371,13,3598,0.0,23,20,1,2,3,86.95652174
2000020372,16,3596,0.0,27,26,9,1,1,96.2962963
2000020372,18,3515,0.0,20,18,2,0,2,90.0
2000020373,25,3541,0.0,21,17,1,0,4,80.95238095
2000020373,21,3548,0.0,42,40,6,0,2,95.23809524
2000020374,15,3600,2.0,23,23,8,4,0,100.0
2000020374,6,3547,0.0,28,26,5,1,2,92.85714286
2000020375,3,1774,0.0,19,14,4,0,5,73.68421053
2000020375,3,1826,0.0,14,11,1,0,3,78.57142857
2000020375,10,3600,0.0,22,20,8,2,2,90.90909091
2000020376,4,3472,0.0,21,16,2,0,5,76.19047619
2000020376,9,3600,0.0,35,32,3,3,3,91.42857143
2000020377,7,3600,0.0,24,22,1,1,2,91.66666667
2000020377,5,3536,0.0,26,23,9,0,3,88.46153846
2000020378,17,124,0.0,2,2,0,2,0,100.0
2000020378,17,3451,2.0,30,27,14,1,3,90.0
2000020378,14,3596,0.0,26,26,5,0,0,100.0
2000020379,11,3597,0.0,29,28,3,1,1,96.55172414
2000020379,29,2322,0.0,15,14,6,0,1,93.33333333
2000020379,29,1200,0.0,11,10,1,0,1,90.90909091
2000020380,13,3600,0.0,40,35,5,1,5,87.5
2000020380,19,3600,0.0,15,13,1,0,2,86.66666667
2000020381,8,3900,0.0,24,23,5,1,1,95.83333333
2000020381,20,3900,2.0,36,35,2,2,1,97.22222222
2000020382,22,3600,0.0,28,23,2,0,5,82.14285714
2000020382,23,3600,2.0,30,28,8,1,2,93.33333333
2000020383,25,3596,0.0,23,21,3,3,2,91.30434783
2000020383,27,3600,0.0,27,22,10,0,5,81.48148148
2000020384,30,3544,0.0,23,20,4,2,3,86.95652174
2000020384,26,3595,0.0,26,24,4,0,2,92.30769231
2000020385,1,3900,2.0,23,22,7,1,1,95.65217391
2000020385,2,3900,0.0,46,45,10,4,1,97.82608696
2000020386,21,3600,0.0,24,21,3,2,3,87.5
2000020386,3,3548,0.0,30,26,1,1,4,86.66666667
2000020387,9,3600,0.0,28,28,4,0,0,100.0
2000020387,12,3530,0.0,19,17,1,1,2,89.47368421
2000020388,29,3578,0.0,23,18,1,2,5,78.26086957
2000020388,16,3576,0.0,29,29,4,0,0,100.0
2000020389,28,3871,0.0,24,21,7,0,3,87.5
2000020389,22,3900,0.0,21,18,2,1,3,85.71428571
2000020390,26,3594,0.0,37,33,5,3,4,89.18918919
2000020390,24,3600,0.0,29,29,10,2,0,100.0
2000020391,13,3900,2.0,34,30,3,0,4,88.23529412
2000020391,10,3898,0.0,33,29,3,3,4,87.87878788
2000020392,6,3539,0.0,26,21,6,2,5,80.76923077
2000020392,11,3600,0.0,33,29,6,2,4,87.87878788
2000020393,28,3600,0.0,21,21,8,2,0,100.0
2000020393,20,2777,0.0,23,19,5,2,4,82.60869565
2000020393,20,823,0.0,10,6,1,1,4,60.0
2000020394,18,3538,0.0,25,20,4,1,5,80.0
2000020394,23,3591,0.0,17,14,2,0,3,82.35294118
2000020395,7,3600,0.0,32,30,2,1,2,93.75
2000020395,8,3525,0.0,22,19,3,0,3,86.36363636
2000020396,5,3600,0.0,31,29,9,0,2,93.5483871
2000020396,9,3600,0.0,37,33,9,2,4,89.18918919
2000020397,21,1200,0.0,11,9,0,0,2,81.81818182
2000020397,21,2400,0.0,22,18,0,1,4,81.81818182
2000020397,1,3600,0.0,19,18,1,0,1,94.73684211
2000020398,24,3541,0.0,32,31,13,1,1,96.875
2000020398,19,3600,0.0,19,19,5,1,0,100.0
2000020399,1,3600,0.0,30,25,1,0,5,83.33333333
2000020399,7,3589,0.0,30,28,0,3,2,93.33333333
2000020400,15,3534,0.0,29,26,4,2,3,89.65517241
2000020400,3,3589,0.0,36,34,10,2,2,94.44444444
2000020401,14,3600,0.0,40,34,3,4,6,85.0
2000020401,4,3600,0.0,23,20,1,0,3,86.95652174
2000020402,6,3599,0.0,29,27,4,1,2,93.10344828
2000020402,5,3570,0.0,36,33,4,0,3,91.66666667
2000020403,12,3600,0.0,21,18,2,0,3,85.71428571
2000020403,11,2998,0.0,29,24,1,0,5,82.75862069
2000020403,11,503,0.0,3,3,1,0,0,100.0
2000020404,2,3600,0.0,30,29,11,2,1,96.66666667
2000020404,13,1762,0.0,10,10,2,3,0,100.0
2000020404,13,1813,0.0,20,17,3,0,3,85.0
2000020405,10,3600,0.0,29,29,4,0,0,100.0
2000020405,17,3600,0.0,19,16,0,1,3,84.21052632
2000020406,24,732,0.0,6,3,0,0,3,50.0
2000020406,24,2868,0.0,16,14,4,0,2,87.5
2000020406,29,3597,0.0,38,36,3,2,2,94.73684211
2000020407,18,3596,0.0,24,20,3,1,4,83.33333333
2000020407,22,3600,0.0,18,18,3,0,0,100.0
2000020408,23,3900,0.0,22,21,7,1,1,95.45454545
2000020408,27,3896,0.0,32,31,5,1,1,96.875
2000020409,25,3898,0.0,26,24,2,0,2,92.30769231
2000020409,28,3900,0.0,33,31,7,5,2,93.93939394
2000020410,30,3600,0.0,29,27,5,0,2,93.10344828
2000020410,16,3571,0.0,22,19,1,1,3,86.36363636
2000020411,10,3548,0.0,19,17,1,0,2,89.47368421
2000020411,19,3600,0.0,27,26,2,0,1,96.2962963
2000020412,18,3476,0.0,22,19,4,0,3,86.36363636
2000020412,20,3600,0.0,15,15,4,1,0,100.0
2000020413,25,3596,0.0,25,20,4,3,5,80.0
2000020413,26,3588,0.0,31,29,10,1,2,93.5483871
2000020414,8,3563,0.0,22,21,1,0,1,95.45454545
2000020414,9,3600,0.0,22,22,7,0,0,100.0
2000020415,7,3588,0.0,27,22,5,1,5,81.48148148
2000020415,3,3595,0.0,25,23,3,1,2,92.0
2000020416,13,3622,0.0,28,24,3,0,4,85.71428571
2000020416,11,3600,0.0,36,33,6,1,3,91.66666667
2000020417,21,3593,0.0,24,24,0,1,0,100.0
2000020417,14,24,0.0,0,0,0,0,0,
2000020417,14,3446,0.0,29,27,5,1,2,93.10344828
2000020418,4,3600,0.0,32,27,4,1,5,84.375
2000020418,17,3600,0.0,30,29,8,0,1,96.66666667
2000020419,6,3891,0.0,34,31,6,0,3,91.17647059
2000020419,29,3891,0.0,28,26,2,2,2,92.85714286
2000020420,24,3621,0.0,27,27,13,0,0,100.0
2000020420,30,3618,0.0,22,21,7,1,1,95.45454545
2000020421,23,3600,0.0,28,27,3,2,1,96.42857143
2000020421,28,2393,0.0,23,19,5,0,4,82.60869565
2000020421,28,1200,0.0,11,9,0,0,2,81.81818182
2000020422,3,3547,0.0,34,28,2,0,6,82.35294118
2000020422,6,3600,0.0,22,18,5,1,4,81.81818182
2000020423,5,3579,0.0,32,27,1,1,5,84.375
2000020423,10,3600,0.0,30,29,1,1,1,96.66666667
2000020424,9,3600,0.0,25,23,5,0,2,92.0
2000020424,8,3575,0.0,39,36,5,1,3,92.30769231
2000020425,15,3600,0.0,35,33,12,0,2,94.28571429
2000020425,1,3544,0.0,26,23,5,2,3,88.46153846
2000020426,11,3600,0.0,33,31,6,0,2,93.93939394
2000020426,2,2612,0.0,14,12,1,2,2,85.71428571
2000020426,2,819,0.0,9,7,1,0,2,77.77777778
2000020427,21,3600,2.0,20,18,1,0,2,90.0
2000020427,13,3522,0.0,21,18,4,1,3,85.71428571
2000020428,16,3557,0.0,23,18,2,1,5,78.26086957
2000020428,19,3600,0.0,29,25,6,2,4,86.20689655
2000020429,12,762,0.0,7,4,1,0,3,57.14285714
2000020429,12,2837,0.0,22,18,10,0,4,81.81818182
2000020429,20,3600,0.0,25,23,7,2,2,92.0
2000020430,26,3600,0.0,24,22,7,0,2,91.66666667
2000020430,22,3543,0.0,26,22,0,1,4,84.61538462
2000020431,2,3589,0.0,40,35,1,1,5,87.5
2000020431,4,3600,0.0,18,16,2,0,2,88.88888889
2000020432,5,3590,0.0,37,34,17,2,3,91.89189189
2000020432,17,3544,0.0,30,26,11,2,4,86.66666667
2000020433,19,3600,0.0,23,22,2,1,1,95.65217391
2000020433,16,3600,0.0,23,17,2,1,6,73.91304348
2000020434,18,3598,0.0,26,25,4,1,1,96.15384615
2000020434,30,3548,0.0,19,17,5,2,2,89.47368421
2000020435,26,3595,0.0,18,17,5,1,1,94.44444444
2000020435,23,3550,0.0,29,27,3,4,2,93.10344828
2000020436,29,3892,0.0,40,39,9,0,1,97.5
2000020436,27,3900,0.0,30,29,9,2,1,96.66666667
2000020437,25,3600,0.0,29,29,0,0,0,100.0
2000020437,24,3505,0.0,28,27,0,0,1,96.42857143
2000020438,11,3600,0.0,44,40,4,2,4,90.90909091
2000020438,1,3595,0.0,19,19,3,0,0,100.0
2000020439,14,3873,0.0,33,31,4,1,2,93.93939394
2000020439,14,23,0.0,0,0,0,0,0,
2000020439,21,3898,0.0,26,24,0,0,2,92.30769231
2000020440,7,3600,0.0,22,22,5,2,0,100.0
2000020440,6,1055,0.0,6,6,0,2,0,100.0
2000020440,6,2515,0.0,23,21,8,0,2,91.30434783
2000020441,15,3582,2.0,23,21,10,2,2,91.30434783
2000020441,2,3570,0.0,19,16,0,1,3,84.21052632
2000020442,4,3897,0.0,20,18,2,1,2,90.0
2000020442,18,3900,0.0,31,29,8,0,2,93.5483871
2000020443,3,3552,0.0,34,31,2,5,3,91.17647059
2000020443,28,3600,0.0,33,31,3,2,2,93.93939394
2000020444,20,3600,0.0,17,16,2,3,1,94.11764706
2000020444,8,3590,0.0,30,28,11,3,2,93.33333333
2000020445,10,3600,0.0,35,31,13,0,4,88.57142857
2000020445,5,978,0.0,4,4,0,0,0,100.0
2000020445,5,2587,0.0,18,12,3,0,6,66.66666667
2000020446,16,3565,0.0,23,21,4,0,2,91.30434783
2000020446,11,3586,0.0,33,32,1,2,1,96.96969697
2000020447,13,3891,0.0,35,32,5,1,3,91.42857143
2000020447,17,3900,0.0,35,32,9,0,3,91.42857143
2000020448,22,3600,0.0,28,23,8,0,5,82.14285714
2000020448,25,3600,0.0,16,14,1,2,2,87.5
2000020449,12,3900,0.0,29,28,4,0,1,96.55172414
2000020449,30,3900,0.0,19,18,4,0,1,94.73684211
2000020450,4,3824,0.0,25,22,7,0,3,88.0
2000020450,21,3900,0.0,31,28,6,1,3,90.32258065
2000020451,29,3733,0.0,30,25,5,1,5,83.33333333
2000020451,24,3733,0.0,22,18,5,1,4,81.81818182
2000020452,20,3557,0.0,30,27,6,0,3,90.0
2000020452,9,3600,0.0,21,19,4,0,2,90.47619048
2000020453,30,3588,0.0,20,18,0,0,2,90.0
2000020453,15,3581,0.0,29,28,0,2,1,96.55172414
2000020454,22,3600,0.0,38,36,11,1,2,94.73684211
2000020454,18,3598,0.0,32,26,5,3,6,81.25
2000020455,14,3523,2.0,35,32,3,2,3,91.42857143
2000020455,14,6,0.0,0,0,0,0,0,
2000020455,27,3592,0.0,22,20,4,2,2,90.90909091
2000020456,3,3900,0.0,34,29,5,0,5,85.29411765
2000020456,26,3888,0.0,25,20,4,0,5,80.0
2000020457,29,3554,0.0,29,27,4,0,2,93.10344828
2000020457,28,3600,0.0,21,20,0,0,1,95.23809524
2000020458,8,3535,0.0,30,28,5,2,2,93.33333333
2000020458,1,3600,0.0,18,17,4,2,1,94.44444444
2000020459,10,3515,0.0,22,19,4,0,3,86.36363636
2000020459,2,3581,0.0,30,28,7,0,2,93.33333333
2000020460,13,3600,0.0,36,35,12,3,1,97.22222222
2000020460,5,3600,4.0,29,25,2,2,4,86.20689655
2000020461,7,2424,0.0,21,17,2,1,4,80.95238095
2000020461,7,1067,0.0,4,3,0,0,1,75.0
2000020461,12,3600,0.0,28,25,9,0,3,89.28571429
2000020462,19,3592,0.0,22,19,1,1,3,86.36363636
2000020462,11,3596,2.0,37,32,5,0,5,86.48648649
2000020463,16,3600,0.0,25,21,4,2,4,84.0
2000020463,25,3595,0.0,30,29,3,2,1,96.66666667
2000020464,17,3596,0.0,36,33,4,0,3,91.66666667
2000020464,21,3484,0.0,25,20,1,0,5,80.0
2000020465,3,3600,0.0,42,36,9,4,6,85.71428571
2000020465,24,3600,0.0,30,26,7,2,4,86.66666667
2000020466,12,3597,0.0,34,30,12,2,4,88.23529412
2000020466,6,3600,0.0,18,17,7,2,1,94.44444444
2000020467,13,3515,0.0,22,19,2,0,3,86.36363636
2000020467,7,3598,0.0,30,28,9,3,2,93.33333333
2000020468,20,3627,0.0,27,22,9,0,5,81.48148148
2000020468,10,3609,0.0,31,25,4,1,6,80.64516129
2000020469,5,3900,0.0,26,22,4,0,4,84.61538462
2000020469,8,3899,0.0,53,49,9,3,4,92.45283019
2000020470,2,1807,0.0,8,7,1,1,1,87.5
2000020470,2,1793,0.0,15,10,4,0,5,66.66666667
2000020470,9,3600,0.0,26,26,3,5,0,100.0
2000020471,1,3600,0.0,26,20,4,1,6,76.92307692
2000020471,4,3600,0.0,33,30,7,4,3,90.90909091
2000020472,22,3600,0.0,30,26,2,0,4,86.66666667
2000020472,15,3595,0.0,14,14,2,0,0,100.0
2000020473,17,3900,0.0,20,18,3,1,2,90.0
2000020473,19,3900,2.0,21,19,0,1,2,90.47619048
2000020474,16,3600,0.0,24,24,0,2,0,100.0
2000020474,18,3600,0.0,34,31,9,0,3,91.17647059
2000020475,29,3520,0.0,26,22,5,1,4,84.61538462
2000020475,23,3600,0.0,27,24,5,1,3,88.88888889
2000020476,28,3713,0.0,28,27,9,1,1,96.42857143
2000020476,27,3713,0.0,19,17,2,3,2,89.47368421
2000020477,14,3600,0.0,41,38,6,2,3,92.68292683
2000020477,26,1899,0.0,16,15,2,1,1,93.75
2000020477,26,1565,0.0,8,5,1,0,3,62.5
2000020478,25,3600,0.0,28,22,3,1,6,78.57142857
2000020478,30,3600,0.0,24,24,5,0,0,100.0
2000020479,14,3552,0.0,26,24,0,1,2,92.30769231
2000020479,24,3600,0.0,26,25,7,1,1,96.15384615
2000020480,29,3600,0.0,27,27,6,0,0,100.0
2000020480,8,3504,0.0,16,14,1,0,2,87.5
2000020481,13,3582,0.0,27,22,2,1,5,81.48148148
2000020481,3,3600,0.0,31,28,2,3,3,90.32258065
2000020482,28,3600,0.0,26,23,3,0,3,88.46153846
2000020482,15,3530,0.0,26,22,0,0,4,84.61538462
2000020483,22,3785,0.0,39,35,13,2,4,89.74358974
2000020483,17,3736,0.0,28,25,4,1,3,89.28571429
2000020484,4,3895,0.0,31,27,2,2,4,87.09677419
2000020484,6,3899,0.0,24,20,5,2,4,83.33333333
2000020485,12,3535,0.0,29,27,10,3,2,93.10344828
2000020485,2,3598,0.0,21,20,2,4,1,95.23809524
2000020486,20,3594,0.0,34,34,8,3,0,100.0
2000020486,21,3549,0.0,20,18,1,0,2,90.0
2000020487,11,3680,2.0,40,34,7,1,6,85.0
2000020487,26,2007,0.0,14,12,2,0,2,85.71428571
2000020487,26,1613,2.0,11,6,0,0,5,54.54545455
2000020488,18,3600,0.0,30,29,0,0,1,96.66666667
2000020488,10,3549,0.0,27,25,2,1,2,92.59259259
2000020489,25,2938,0.0,14,14,1,0,0,100.0
2000020489,25,629,0.0,9,5,0,0,4,55.55555556
2000020489,1,3600,0.0,24,23,2,0,1,95.83333333
2000020490,19,3600,0.0,23,20,7,0,3,86.95652174
2000020490,3,3588,0.0,28,23,6,1,5,82.14285714
2000020491,7,3900,0.0,32,30,4,1,2,93.75
2000020491,15,3900,0.0,23,21,3,1,2,91.30434783
2000020492,5,3900,0.0,22,20,4,0,2,90.90909091
2000020492,13,3900,0.0,26,24,6,2,2,92.30769231
2000020493,28,3599,0.0,31,31,8,0,0,100.0
2000020493,17,3532,0.0,20,18,4,2,2,90.0
2000020494,9,3900,0.0,26,24,3,1,2,92.30769231
2000020494,30,3900,0.0,33,31,5,2,2,93.93939394
2000020495,23,3760,0.0,34,31,8,0,3,91.17647059
2000020495,22,3757,0.0,24,22,2,2,2,91.66666667
2000020496,20,3565,0.0,28,24,3,1,4,85.71428571
2000020496,27,3600,0.0,27,25,5,0,2,92.59259259
2000020497,11,3600,0.0,31,29,6,0,2,93.5483871
2000020497,24,3515,0.0,35,31,3,3,4,88.57142857
2000020498,10,3600,0.0,27,23,8,0,4,85.18518519
2000020498,6,3585,0.0,23,23,4,3,0,100.0
2000020499,15,3600,0.0,21,20,7,0,1,95.23809524
2000020499,7,3516,0.0,28,25,4,2,3,89.28571429
2000020500,18,2316,0.0,17,14,3,0,3,82.35294118
2000020500,18,1200,0.0,9,8,0,0,1,88.88888889
2000020500,8,3595,0.0,33,31,6,1,2,93.93939394
2000020501,25,3600,0.0,28,27,1,1,1,96.42857143
2000020501,2,3600,0.0,20,17,4,2,3,85.0
2000020502,28,2192,0.0,24,23,0,2,1,95.83333333
2000020502,28,1341,0.0,10,7,0,0,3,70.0
2000020502,4,3600,0.0,28,25,2,2,3,89.28571429
2000020503,5,3900,0.0,32,31,8,0,1,96.875
2000020503,14,3900,0.0,39,38,3,3,1,97.43589744
2000020504,9,3899,0.0,34,31,10,1,3,91.17647059
2000020504,29,3891,0.0,26,23,6,2,3,88.46153846
2000020505,23,3572,0.0,31,26,3,0,5,83.87096774
2000020505,16,2400,0.0,19,18,3,0,1,94.73684211
2000020505,16,1200,0.0,11,8,0,0,3,72.72727273
2000020506,26,3591,0.0,26,21,5,0,5,80.76923077
2000020506,21,3582,0.0,16,14,3,0,2,87.5
2000020507,1,3600,0.0,22,22,1,1,0,100.0
2000020507,13,3566,0.0,37,35,3,2,2,94.59459459
2000020508,24,3619,0.0,44,42,12,1,2,95.45454545
2000020508,17,3619,0.0,17,16,1,1,1,94.11764706
2000020509,26,2249,0.0,16,13,0,0,3,81.25
2000020509,26,1256,0.0,10,9,0,0,1,90.0
2000020509,30,3600,0.0,37,34,1,0,3,91.89189189
2000020510,22,3900,2.0,29,28,7,0,1,96.55172414
2000020510,20,3900,0.0,25,24,9,0,1,96.0
2000020511,11,3561,0.0,36,33,8,0,3,91.66666667
2000020511,27,3599,0.0,22,21,2,5,1,95.45454545
2000020512,17,3690,0.0,35,34,8,4,1,97.14285714
2000020512,6,3690,2.0,21,19,1,1,2,90.47619048
2000020513,28,3597,0.0,24,19,2,0,5,79.16666667
2000020513,7,3599,0.0,32,30,8,0,2,93.75
2000020514,10,3600,0.0,21,19,8,0,2,90.47619048
2000020514,8,1190,0.0,7,6,1,1,1,85.71428571
2000020514,8,2396,0.0,19,15,4,0,4,78.94736842
2000020515,16,3600,2.0,34,32,3,0,2,94.11764706
2000020515,9,3536,0.0,21,18,2,2,3,85.71428571
2000020516,29,3599,0.0,27,22,1,1,5,81.48148148
2000020516,2,3573,0.0,27,21,4,2,6,77.77777778
2000020517,18,3797,0.0,28,26,4,2,2,92.85714286
2000020517,3,3797,0.0,41,38,8,1,3,92.68292683
2000020518,12,3814,0.0,25,23,5,0,2,92.0
2000020518,4,3827,0.0,36,35,8,2,1,97.22222222
2000020519,25,3600,0.0,29,27,2,0,2,93.10344828
2000020519,5,816,0.0,6,4,0,0,2,66.66666667
2000020519,5,2784,0.0,30,24,8,0,6,80.0
2000020520,13,1200,0.0,10,10,1,2,0,100.0
2000020520,13,2400,0.0,24,19,12,0,5,79.16666667
2000020520,15,3597,0.0,30,27,1,3,3,90.0
2000020521,1,3600,0.0,29,28,1,1,1,96.55172414
2000020521,14,2046,0.0,13,9,3,1,4,69.23076923
2000020521,14,1551,0.0,13,12,2,0,1,92.30769231
2000020522,24,3600,0.0,38,33,4,1,5,86.84210526
2000020522,19,3600,0.0,24,22,2,4,2,91.66666667
2000020523,23,3834,0.0,31,28,7,0,3,90.32258065
2000020523,21,3836,0.0,36,34,8,5,2,94.44444444
2000020524,5,3584,2.0,24,21,4,1,3,87.5
2000020524,7,1327,0.0,16,13,1,2,3,81.25
2000020524,7,2252,0.0,18,16,2,0,2,88.88888889
2000020525,10,3541,0.0,13,9,0,0,4,69.23076923
2000020525,11,3600,2.0,37,34,5,3,3,91.89189189
2000020526,12,3525,2.0,22,19,7,0,3,86.36363636
2000020526,14,3599,0.0,22,20,4,2,2,90.90909091
2000020527,29,849,0.0,7,6,0,0,1,85.71428571
2000020527,29,2744,0.0,24,20,8,1,4,83.33333333
2000020527,19,3600,0.0,24,24,7,1,0,100.0
2000020528,21,3500,0.0,25,21,4,0,4,84.0
2000020528,21,34,0.0,0,0,0,0,0,
2000020528,18,3597,0.0,30,28,6,1,2,93.33333333
2000020529,28,3600,0.0,30,29,7,1,1,96.66666667
2000020529,26,3515,0.0,32,30,3,2,2,93.75
2000020530,15,3600,0.0,32,31,0,1,1,96.875
2000020530,9,1200,0.0,12,11,0,0,1,91.66666667
2000020530,9,2400,0.0,21,17,4,0,4,80.95238095
2000020531,29,3900,0.0,44,42,6,0,2,95.45454545
2000020531,1,3885,0.0,21,19,3,0,2,90.47619048
2000020532,6,3600,0.0,33,31,7,2,2,93.93939394
2000020532,2,3600,0.0,47,42,7,1,5,89.36170213
2000020533,10,3600,0.0,31,26,6,1,5,83.87096774
2000020533,5,3597,0.0,40,40,8,0,0,100.0
2000020534,3,1532,0.0,16,13,3,0,3,81.25
2000020534,3,2003,0.0,14,13,3,0,1,92.85714286
2000020534,12,3600,0.0,31,28,8,2,3,90.32258065
2000020535,4,3596,0.0,31,29,5,1,2,93.5483871
2000020535,13,3600,0.0,34,29,2,0,5,85.29411765
2000020536,30,3600,0.0,37,34,11,0,3,91.89189189
2000020536,17,1150,0.0,6,6,0,0,0,100.0
2000020536,17,2400,0.0,16,12,0,1,4,75.0
2000020537,27,3900,0.0,25,24,5,0,1,96.0
2000020537,16,3900,0.0,19,18,3,1,1,94.73684211
2000020538,24,3512,0.0,21,18,1,0,3,85.71428571
2000020538,25,3600,0.0,20,19,0,0,1,95.0
2000020539,22,3529,0.0,31,28,10,1,3,90.32258065
2000020539,21,3598,0.0,20,18,2,2,2,90.0
2000020540,8,3532,0.0,32,29,7,2,3,90.625
2000020540,23,3600,0.0,22,20,2,4,2,90.90909091
2000020541,11,3600,0.0,31,30,3,0,1,96.77419355
2000020541,3,3599,0.0,27,23,4,3,4,85.18518519
2000020542,4,3514,0.0,18,14,0,1,4,77.77777778
2000020542,14,3600,0.0,35,32,7,2,3,91.42857143
2000020543,26,3600,0.0,35,33,6,3,2,94.28571429
2000020543,19,3566,0.0,36,31,4,1,5,86.11111111
2000020544,24,3900,0.0,37,35,4,0,2,94.59459459
2000020544,18,3900,0.0,31,29,3,1,2,93.5483871
2000020545,22,3879,0.0,29,27,5,2,2,93.10344828
2000020545,28,3896,0.0,23,21,3,4,2,91.30434783
2000020546,9,3484,0.0,19,17,5,2,2,89.47368421
2000020546,7,3600,0.0,34,34,1,2,0,100.0
2000020547,15,3549,0.0,26,22,1,0,4,84.61538462
2000020547,1,3600,0.0,28,26,1,0,2,92.85714286
2000020548,11,751,0.0,8,4,1,0,4,50.0
2000020548,11,2841,0.0,25,24,15,1,1,96.0
2000020548,2,3596,0.0,27,25,7,2,2,92.59259259
2000020549,6,2586,0.0,18,16,5,0,2,88.88888889
2000020549,6,1014,0.0,10,9,0,0,1,90.0
2000020549,13,3586,0.0,24,24,7,0,0,100.0
2000020550,12,3505,0.0,23,20,8,0,3,86.95652174
2000020550,29,3592,0.0,32,31,6,1,1,96.875
2000020551,17,3742,0.0,16,13,1,0,3,81.25
2000020551,16,3742,0.0,31,29,2,0,2,93.5483871
2000020552,26,3593,0.0,21,20,6,0,1,95.23809524
2000020552,25,3600,0.0,16,12,5,1,4,75.0
2000020553,27,3900,0.0,27,25,6,0,2,92.59259259
2000020553,30,3900,0.0,24,22,0,0,2,91.66666667
2000020554,18,3589,0.0,32,29,8,1,3,90.625
2000020554,21,3600,0.0,18,17,5,1,1,94.44444444
2000020555,23,3600,0.0,30,25,9,0,5,83.33333333
2000020555,20,3585,0.0,26,26,5,3,0,100.0
2000020556,7,3591,0.0,15,15,3,2,0,100.0
2000020556,2,3592,2.0,25,24,6,2,1,96.0
2000020557,9,3557,0.0,31,27,6,1,4,87.09677419
2000020557,5,3600,0.0,31,28,4,0,3,90.32258065
2000020558,4,2400,0.0,14,12,3,0,2,85.71428571
2000020558,4,1137,0.0,7,5,0,0,2,71.42857143
2000020558,15,3600,0.0,36,33,8,0,3,91.66666667
2000020559,6,3895,0.0,23,22,4,1,1,95.65217391
2000020559,14,3900,0.0,34,33,5,3,1,97.05882353
2000020560,10,3600,0.0,25,24,4,4,1,96.0
2000020560,13,3600,0.0,30,26,4,0,4,86.66666667
2000020561,27,3578,2.0,45,43,13,2,2,95.55555556
2000020561,19,3600,0.0,19,18,4,0,1,94.73684211
2000020562,8,3705,0.0,29,26,4,4,3,89.65517241
2000020562,22,3709,0.0,15,13,1,2,2,86.66666667
2000020563,23,3594,0.0,30,27,7,5,3,90.0
2000020563,28,3574,0.0,34,28,4,4,6,82.35294118
2000020564,16,3591,0.0,27,25,10,1,2,92.59259259
2000020564,12,3600,0.0,23,22,3,1,1,95.65217391
2000020565,10,3600,0.0,24,22,0,0,2,91.66666667
2000020565,14,3527,0.0,34,31,1,0,3,91.17647059
2000020565,14,51,0.0,1,1,0,0,0,100.0
2000020566,26,3570,0.0,24,22,4,0,2,91.66666667
2000020566,17,3600,0.0,23,22,4,0,1,95.65217391
2000020567,1,3600,0.0,18,15,3,0,3,83.33333333
2000020567,29,3590,0.0,31,25,5,0,6,80.64516129
2000020568,3,3600,0.0,30,24,8,0,6,80.0
2000020568,25,3588,0.0,15,14,4,2,1,93.33333333
2000020569,24,3563,0.0,26,23,5,1,3,88.46153846
2000020569,30,3588,0.0,31,29,5,1,2,93.5483871
2000020570,8,3657,0.0,26,21,5,0,5,80.76923077
2000020570,20,3694,0.0,28,24,4,2,4,85.71428571
2000020571,6,3600,0.0,36,33,12,2,3,91.66666667
2000020571,7,3441,0.0,27,23,5,1,4,85.18518519
2000020571,7,4,0.0,0,0,0,0,0,
2000020572,11,3600,0.0,22,18,3,1,4,81.81818182
2000020572,15,3600,0.0,30,28,7,1,2,93.33333333
2000020573,22,1200,0.0,12,10,4,0,2,83.33333333
2000020573,22,2400,0.0,27,24,3,0,3,88.88888889
2000020573,19,3600,0.0,21,19,1,0,2,90.47619048
2000020574,23,3600,0.0,28,26,7,1,2,92.85714286
2000020574,18,3568,0.0,36,32,10,0,4,88.88888889
2000020575,28,3598,0.0,24,22,8,4,2,91.66666667
2000020575,27,3513,0.0,28,25,6,0,3,89.28571429
2000020576,19,3542,0.0,26,24,3,0,2,92.30769231
2000020576,9,3600,0.0,34,33,6,2,1,97.05882353
2000020577,4,3889,0.0,22,21,0,3,1,95.45454545
2000020577,1,3900,0.0,25,24,2,0,1,96.0
2000020578,8,3600,0.0,32,32,9,1,0,100.0
2000020578,2,3498,0.0,34,32,7,2,2,94.11764706
2000020579,26,3600,0.0,34,28,2,1,6,82.35294118
2000020579,21,3600,0.0,29,27,1,0,2,93.10344828
2000020580,7,3900,0.0,22,21,1,2,1,95.45454545
2000020580,10,3900,0.0,25,24,5,1,1,96.0
2000020581,15,3537,0.0,29,26,2,0,3,89.65517241
2000020581,5,3600,0.0,26,24,0,0,2,92.30769231
2000020582,14,2262,0.0,12,12,1,0,0,100.0
2000020582,14,1259,2.0,8,5,2,0,3,62.5
2000020582,12,3600,0.0,38,36,9,3,2,94.73684211
2000020583,22,3529,0.0,22,18,0,0,4,81.81818182
2000020583,29,3600,0.0,32,30,3,2,2,93.75
2000020584,23,1000,0.0,7,5,0,0,2,71.42857143
2000020584,23,2600,0.0,17,13,3,1,4,76.47058824
2000020584,16,3600,0.0,27,27,10,1,0,100.0
2000020585,11,3900,0.0,36,35,5,1,1,97.22222222
2000020585,30,3900,0.0,22,21,4,3,1,95.45454545
2000020586,13,3841,0.0,31,28,9,2,3,90.32258065
2000020586,24,3841,0.0,25,23,3,2,2,92.0
2000020587,20,3598,0.0,30,30,5,0,0,100.0
2000020587,28,3521,0.0,23,22,5,2,1,95.65217391
2000020588,14,1680,0.0,21,17,0,3,4,80.95238095
2000020588,14,1891,0.0,23,19,2,1,4,82.60869565
2000020588,9,3596,0.0,25,22,8,0,3,88.0
2000020589,2,1757,0.0,12,11,0,1,1,91.66666667
2000020589,2,1843,0.0,15,12,5,0,3,80.0
2000020589,1,3597,0.0,31,29,6,1,2,93.5483871
2000020590,25,3577,0.0,30,26,3,0,4,86.66666667
2000020590,17,3598,0.0,20,18,3,0,2,90.0
2000020591,18,3600,0.0,25,23,3,1,2,92.0
2000020591,19,3529,0.0,25,22,3,2,3,88.0
2000020592,28,3900,0.0,40,38,11,2,2,95.0
2000020592,21,3880,0.0,21,19,1,2,2,90.47619048
2000020593,3,3529,0.0,25,23,10,0,2,92.0
2000020593,27,3600,0.0,35,34,8,2,1,97.14285714
2000020594,13,3595,0.0,49,46,12,0,3,93.87755102
2000020594,26,3534,0.0,19,15,0,2,4,78.94736842
2000020595,10,3900,0.0,17,14,0,1,3,82.35294118
2000020595,7,3900,0.0,25,22,0,0,3,88.0
2000020596,8,3600,0.0,32,29,0,0,3,90.625
2000020596,5,3548,0.0,21,17,2,0,4,80.95238095
2000020597,6,3900,0.0,30,29,5,2,1,96.66666667
2000020597,15,3900,0.0,31,30,3,1,1,96.77419355
2000020598,4,3599,0.0,29,25,3,2,4,86.20689655
2000020598,11,3450,0.0,20,18,5,3,2,90.0
2000020598,11,139,0.0,3,0,0,0,3,0.0
2000020599,22,3600,0.0,20,19,2,1,1,95.0
2000020599,16,3549,0.0,17,15,0,2,2,88.23529412
2000020600,17,3778,0.0,27,24,7,0,3,88.88888889
2000020600,30,3778,0.0,34,32,8,1,2,94.11764706
2000020601,20,3900,0.0,31,27,3,0,4,87.09677419
2000020601,24,3900,0.0,26,22,3,1,4,84.61538462
2000020602,25,3600,0.0,33,33,4,2,0,100.0
2000020602,6,3600,0.0,24,20,2,1,4,83.33333333
2000020603,15,3600,0.0,26,24,5,1,2,92.30769231
2000020603,10,3535,0.0,25,22,3,2,3,88.0
2000020604,8,3569,2.0,30,26,2,0,4,86.66666667
2000020604,9,3597,0.0,25,22,6,0,3,88.0
2000020605,27,3600,0.0,28,27,3,1,1,96.42857143
2000020605,2,3552,0.0,24,22,4,1,2,91.66666667
2000020606,1,3897,2.0,26,21,4,3,5,80.76923077
2000020606,3,3900,0.0,35,30,7,1,5,85.71428571
2000020607,11,3892,0.0,39,37,7,2,2,94.87179487
2000020607,4,3900,0.0,20,18,3,3,2,90.0
2000020608,21,3900,0.0,21,19,8,0,2,90.47619048
2000020608,12,3900,0.0,36,34,12,1,2,94.44444444
2000020609,30,2400,0.0,34,30,9,0,4,88.23529412
2000020609,30,1200,0.0,16,15,1,1,1,93.75
2000020609,19,3600,0.0,21,20,8,0,1,95.23809524
2000020610,7,3600,0.0,29,29,2,1,0,100.0
2000020610,18,3534,0.0,26,24,0,2,2,92.30769231
2000020611,29,3522,0.0,17,13,0,0,4,76.47058824
2000020611,23,3600,0.0,25,22,3,0,3,88.0
2000020612,20,3595,0.0,26,21,3,1,5,80.76923077
2000020612,26,3577,0.0,22,22,6,0,0,100.0
2000020613,13,3575,0.0,39,36,11,3,3,92.30769231
2000020613,28,3600,0.0,27,26,5,1,1,96.2962963
2000020614,27,3600,0.0,30,25,3,0,5,83.33333333
2000020614,1,3600,0.0,22,21,3,0,1,95.45454545
2000020615,2,3600,0.0,24,19,3,0,5,79.16666667
2000020615,12,3594,0.0,24,22,0,0,2,91.66666667
2000020616,21,3636,0.0,37,33,3,1,4,89.18918919
2000020616,17,3668,0.0,24,21,4,0,3,87.5
2000020617,14,1487,0.0,18,16,4,0,2,88.88888889
2000020617,14,2067,0.0,24,20,0,0,4,83.33333333
2000020617,16,3600,0.0,20,16,0,0,4,80.0
2000020618,29,3536,0.0,23,19,3,2,4,82.60869565
2000020618,22,3600,0.0,19,17,2,0,2,89.47368421
2000020619,25,3600,0.0,38,37,8,2,1,97.36842105
2000020619,3,3538,0.0,18,16,4,0,2,88.88888889
2000020620,5,3600,0.0,27,24,5,1,3,88.88888889
2000020620,15,3546,0.0,30,26,0,1,4,86.66666667
2000020621,4,3719,0.0,27,26,3,1,1,96.2962963
2000020621,19,3719,0.0,22,20,3,0,2,90.90909091
2000020622,18,3535,0.0,27,25,5,0,2,92.59259259
2000020622,23,3599,0.0,17,16,0,0,1,94.11764706
2000020623,5,3590,0.0,26,21,4,1,5,80.76923077
2000020623,6,3595,0.0,22,20,3,3,2,90.90909091
2000020624,16,3600,0.0,41,38,21,0,3,92.68292683
2000020624,2,2067,0.0,6,4,0,1,2,66.66666667
2000020624,2,1528,0.0,13,9,0,0,4,69.23076923
2000020625,13,2869,0.0,19,15,9,0,4,78.94736842
2000020625,13,731,0.0,7,4,1,0,3,57.14285714
2000020625,12,3598,0.0,25,22,2,1,3,88.0
2000020626,27,3899,2.0,41,39,14,3,2,95.12195122
2000020626,17,3889,0.0,15,13,8,0,2,86.66666667
2000020627,7,3533,0.0,20,18,5,2,2,90.0
2000020627,28,3591,0.0,23,22,8,0,1,95.65217391
2000020628,14,3600,0.0,28,27,4,2,1,96.42857143
2000020628,10,3541,0.0,23,21,5,0,2,91.30434783
2000020629,6,3597,0.0,18,17,4,0,1,94.44444444
2000020629,8,3599,0.0,25,23,5,0,2,92.0
2000020630,16,3577,0.0,36,32,4,0,4,88.88888889
2000020630,1,3600,0.0,25,22,1,0,3,88.0
2000020631,25,3600,4.0,33,31,11,4,2,93.93939394
2000020631,11,3534,0.0,21,18,3,1,3,85.71428571
2000020632,21,3600,0.0,21,19,2,1,2,90.47619048
2000020632,29,3538,0.0,14,10,0,0,4,71.42857143
2000020633,15,778,0.0,5,5,0,0,0,100.0
2000020633,15,2822,0.0,23,20,3,2,3,86.95652174
2000020633,30,3585,0.0,17,17,0,1,0,100.0
2000020634,18,3600,0.0,28,26,2,0,2,92.85714286
2000020634,22,3585,0.0,15,11,2,0,4,73.33333333
2000020635,9,3600,2.0,33,32,4,2,1,96.96969697
2000020635,23,3600,0.0,24,19,1,1,5,79.16666667
2000020636,19,3598,0.0,22,20,8,0,2,90.90909091
2000020636,24,3444,0.0,41,37,5,3,4,90.24390244
2000020637,18,3550,0.0,30,28,6,0,2,93.33333333
2000020637,20,3600,0.0,19,18,2,1,1,94.73684211
2000020638,7,3545,0.0,30,27,2,1,3,90.0
2000020638,26,3600,0.0,21,19,2,0,2,90.47619048
2000020639,19,3565,0.0,24,19,5,1,5,79.16666667
2000020639,28,3592,2.0,24,21,1,1,3,87.5
2000020640,27,3566,2.0,28,25,11,1,3,89.28571429
2000020640,10,3600,0.0,17,15,2,0,2,88.23529412
2000020641,2,3574,0.0,27,23,1,1,4,85.18518519
2000020641,5,3600,0.0,33,30,10,0,3,90.90909091
2000020642,8,3593,0.0,24,24,7,1,0,100.0
2000020642,11,3600,2.0,36,33,6,2,3,91.66666667
2000020643,4,3600,0.0,21,21,3,0,0,100.0
2000020643,14,3600,0.0,34,31,4,1,3,91.17647059
2000020644,12,3898,0.0,25,23,1,0,2,92.0
2000020644,13,3895,0.0,35,33,5,0,2,94.28571429
2000020645,16,3600,0.0,24,23,1,2,1,95.83333333
2000020645,29,3506,0.0,25,23,0,0,2,92.0
2000020646,17,3600,0.0,23,21,10,0,2,91.30434783
2000020646,25,3555,0.0,28,25,5,0,3,89.28571429
2000020647,21,3600,0.0,21,21,2,3,0,100.0
2000020647,30,3600,0.0,31,26,4,0,5,83.87096774
2000020648,23,3600,0.0,30,28,3,0,2,93.33333333
2000020648,22,3530,0.0,18,15,0,0,3,83.33333333
2000020649,7,3600,0.0,21,21,2,2,0,100.0
2000020649,24,3600,0.0,26,22,3,0,4,84.61538462
2000020650,3,3600,0.0,24,20,2,1,4,83.33333333
2000020650,6,3600,0.0,27,26,6,0,1,96.2962963
2000020651,27,3598,4.0,30,25,5,1,5,83.33333333
2000020651,8,3598,0.0,20,18,2,4,2,90.0
2000020652,10,3900,0.0,34,30,3,1,4,88.23529412
2000020652,1,3885,0.0,28,24,3,0,4,85.71428571
2000020653,5,3552,0.0,30,24,8,2,6,80.0
2000020653,2,3583,0.0,33,28,12,3,5,84.84848485
2000020654,11,3560,0.0,32,28,6,2,4,87.5
2000020654,15,3600,0.0,36,35,11,2,1,97.22222222
2000020655,4,3596,0.0,25,24,5,0,1,96.0
2000020655,13,3600,0.0,41,37,11,3,4,90.24390244
2000020656,9,3600,0.0,40,38,11,1,2,95.0
2000020656,20,3579,0.0,26,22,4,3,4,84.61538462
2000020657,19,3599,0.0,21,19,4,0,2,90.47619048
2000020657,26,3481,0.0,30,26,6,1,4,86.66666667
2000020658,18,3600,0.0,29,26,3,0,3,89.65517241
2000020658,28,3567,0.0,30,26,4,0,4,86.66666667
2000020659,30,3600,0.0,34,30,8,0,4,88.23529412
2000020659,3,3599,0.0,32,30,7,0,2,93.75
2000020660,24,3600,0.0,19,15,5,0,4,78.94736842
2000020660,12,3600,0.0,27,27,8,1,0,100.0
2000020661,25,3568,0.0,24,22,1,1,2,91.66666667
2000020661,14,3551,0.0,19,16,2,0,3,84.21052632
2000020662,21,3900,0.0,23,21,0,1,2,91.30434783
2000020662,16,3900,0.0,23,21,6,0,2,91.30434783
2000020663,9,3592,0.0,21,18,6,1,3,85.71428571
2000020663,22,3600,0.0,19,18,1,5,1,94.73684211
2000020664,20,1442,0.0,8,7,3,0,1,87.5
2000020664,20,2158,0.0,20,16,2,0,4,80.0
2000020664,23,3600,0.0,24,23,3,1,1,95.83333333
2000020665,24,3557,0.0,27,24,1,2,3,88.88888889
2000020665,5,3600,0.0,25,23,5,0,2,92.0
2000020666,25,3529,0.0,20,18,3,0,2,90.0
2000020666,13,3600,0.0,30,30,4,3,0,100.0
2000020667,30,3554,0.0,29,27,11,0,2,93.10344828
2000020667,29,3600,0.0,31,31,3,0,0,100.0
2000020668,19,3443,0.0,17,14,4,1,3,82.35294118
2000020668,27,3599,0.0,33,32,15,1,1,96.96969697
2000020669,17,3600,0.0,39,37,10,1,2,94.87179487
2000020669,28,3574,0.0,20,17,2,1,3,85.0
2000020670,14,3502,2.0,31,28,8,2,3,90.32258065
2000020670,7,3600,0.0,41,40,6,0,1,97.56097561
2000020671,12,3596,0.0,30,28,7,0,2,93.33333333
2000020671,8,3633,0.0,23,20,1,2,3,86.95652174
2000020672,26,1906,0.0,15,10,0,0,5,66.66666667
2000020672,26,1813,0.0,12,11,0,0,1,91.66666667
2000020672,9,3718,0.0,37,30,6,1,7,81.08108108
2000020673,6,3394,0.0,28,24,7,0,4,85.71428571
2000020673,6,206,0.0,1,1,0,0,0,100.0
2000020673,1,3549,0.0,28,23,5,1,5,82.14285714
2000020674,4,3766,0.0,24,20,0,0,4,83.33333333
2000020674,3,3766,0.0,34,31,3,0,3,91.17647059
2000020675,22,3589,0.0,36,35,5,0,1,97.22222222
2000020675,18,3539,0.0,32,30,4,0,2,93.75
2000020676,2,3600,0.0,26,22,3,3,4,84.61538462
2000020676,21,3600,0.0,30,29,8,1,1,96.66666667
2000020677,17,3599,0.0,29,27,7,1,2,93.10344828
2000020677,23,3433,0.0,25,21,3,1,4,84.0
2000020678,26,3600,0.0,35,34,8,1,1,97.14285714
2000020678,10,3538,0.0,18,16,4,0,2,88.88888889
2000020679,24,3595,0.0,37,35,5,3,2,94.59459459
2000020679,11,1200,0.0,13,10,0,0,3,76.92307692
2000020679,11,2399,0.0,15,13,2,0,2,86.66666667
2000020680,13,3600,0.0,28,23,5,1,5,82.14285714
2000020680,16,3598,0.0,16,16,1,0,0,100.0
2000020681,18,3701,0.0,29,25,8,0,4,86.20689655
2000020681,25,3688,0.0,27,24,11,0,3,88.88888889
2000020682,29,3830,0.0,33,30,4,1,3,90.90909091
2000020682,30,3833,0.0,26,24,11,2,2,92.30769231
2000020683,5,3531,0.0,29,24,10,1,5,82.75862069
2000020683,27,3594,0.0,24,20,3,0,4,83.33333333
2000020684,20,3899,0.0,46,42,10,1,4,91.30434783
2000020684,28,1497,0.0,8,8,3,0,0,100.0
2000020684,28,2400,0.0,16,12,1,0,4,75.0
2000020685,14,3540,0.0,29,27,2,1,2,93.10344828
2000020685,8,3600,0.0,13,12,4,0,1,92.30769231
2000020686,15,3512,0.0,26,21,6,0,5,80.76923077
2000020686,9,3596,0.0,28,24,0,2,4,85.71428571
2000020687,10,3864,0.0,29,27,8,0,2,93.10344828
2000020687,3,3873,0.0,31,30,8,0,1,96.77419355
2000020688,1,3600,0.0,19,18,3,0,1,94.73684211
2000020688,4,2400,0.0,21,16,0,0,5,76.19047619
2000020688,4,1200,0.0,4,2,2,0,2,50.0
2000020689,6,397,0.0,5,3,1,0,2,60.0
2000020689,6,3199,0.0,16,14,3,0,2,87.5
2000020689,12,3580,0.0,30,28,5,2,2,93.33333333
2000020690,22,3590,0.0,36,32,6,0,4,88.88888889
2000020690,19,3593,0.0,15,14,4,1,1,93.33333333
2000020691,23,1461,0.0,8,6,0,1,2,75.0
2000020691,23,2132,0.0,26,22,9,0,4,84.61538462
2000020691,21,3600,0.0,38,35,9,4,3,92.10526316
2000020692,13,3592,0.0,36,35,8,0,1,97.22222222
2000020692,7,3600,0.0,21,21,2,2,0,100.0
2000020693,15,3579,0.0,21,19,2,2,2,90.47619048
2000020693,16,3600,0.0,25,24,2,0,1,96.0
2000020694,5,3642,0.0,34,28,6,0,6,82.35294118
2000020694,25,3639,0.0,26,21,0,2,5,80.76923077
2000020695,6,3744,0.0,22,21,4,1,1,95.45454545
2000020695,18,3744,0.0,35,35,11,1,0,100.0
2000020696,2,3547,0.0,26,23,6,0,3,88.46153846
2000020696,30,3600,0.0,24,22,1,1,2,91.66666667
2000020697,27,3597,0.0,28,25,4,1,3,89.28571429
2000020697,24,3540,0.0,27,23,2,3,4,85.18518519
2000020698,7,3545,0.0,40,38,11,3,2,95.0
2000020698,10,3600,0.0,28,28,3,0,0,100.0
2000020699,3,3897,0.0,29,27,0,0,2,93.10344828
2000020699,8,3900,0.0,25,23,0,0,2,92.0
2000020700,14,3600,2.0,42,39,13,1,3,92.85714286
2000020700,9,3593,0.0,18,18,5,1,0,100.0
2000020701,11,3532,0.0,39,36,4,0,3,92.30769231
2000020701,1,3600,0.0,38,36,14,0,2,94.73684211
2000020702,13,3533,2.0,46,42,5,0,4,91.30434783
2000020702,4,3600,0.0,30,27,4,0,3,90.0
2000020703,26,3594,0.0,25,22,6,1,3,88.0
2000020703,12,3555,0.0,24,19,1,0,5,79.16666667
2000020704,23,3600,0.0,27,24,8,0,3,88.88888889
2000020704,19,3600,0.0,27,27,4,1,0,100.0
2000020705,17,3532,0.0,25,23,4,2,2,92.0
2000020705,22,3594,0.0,30,29,1,2,1,96.66666667
2000020706,21,3600,2.0,22,21,2,0,1,95.45454545
2000020706,28,3584,0.0,22,20,0,3,2,90.90909091
2000020707,2,3900,0.0,29,25,0,1,4,86.20689655
2000020707,11,3900,0.0,34,30,7,1,4,88.23529412
2000020708,14,3538,0.0,29,27,3,0,2,93.10344828
2000020708,29,3599,0.0,27,26,3,0,1,96.2962963
2000020709,5,3597,0.0,24,24,4,3,0,100.0
2000020709,16,3600,0.0,19,15,3,1,4,78.94736842
2000020710,19,3532,0.0,24,21,5,0,3,87.5
2000020710,18,3599,0.0,33,32,5,3,1,96.96969697
2000020711,1,3600,0.0,22,20,2,0,2,90.90909091
2000020711,30,3568,0.0,21,17,0,1,4,80.95238095
2000020712,17,3470,0.0,35,31,7,0,4,88.57142857
2000020712,20,3589,0.0,36,34,3,0,2,94.44444444
2000020713,25,1194,0.0,5,5,0,0,0,100.0
2000020713,25,2400,0.0,25,20,4,0,5,80.0
2000020713,27,3600,0.0,25,23,2,1,2,92.0
2000020714,21,3600,0.0,18,16,2,0,2,88.88888889
2000020714,24,2309,0.0,10,10,0,0,0,100.0
2000020714,24,1200,0.0,9,5,0,0,4,55.55555556
2000020715,13,3600,0.0,35,33,4,0,2,94.28571429
2000020715,6,3563,0.0,22,19,3,1,3,86.36363636
2000020716,26,3472,0.0,22,20,5,2,2,90.90909091
2000020716,4,3594,0.0,27,27,7,2,0,100.0
2000020717,3,3600,0.0,31,29,8,1,2,93.5483871
2000020717,12,3564,0.0,30,26,3,5,4,86.66666667
2000020718,23,3512,0.0,30,28,6,1,2,93.33333333
2000020718,25,3580,2.0,27,26,10,2,1,96.2962963
2000020719,28,3900,0.0,23,21,3,0,2,91.30434783
2000020719,22,3868,0.0,25,23,4,0,2,92.0
2000020720,29,3600,0.0,23,22,2,2,1,95.65217391
2000020720,7,3525,0.0,18,16,1,0,2,88.88888889
2000020721,19,3585,0.0,23,21,8,1,2,91.30434783
2000020721,8,3594,0.0,29,24,3,1,5,82.75862069
2000020722,9,3600,0.0,24,22,3,0,2,91.66666667
2000020722,2,3570,0.0,38,35,4,0,3,92.10526316
2000020723,15,3557,0.0,29,27,4,0,2,93.10344828
2000020723,14,3542,0.0,32,28,6,0,4,87.5
2000020724,11,3543,0.0,43,39,6,3,4,90.69767442
2000020724,18,3599,0.0,22,19,2,0,3,86.36363636
2000020725,27,3597,0.0,26,24,3,0,2,92.30769231
2000020725,20,2618,0.0,15,15,0,0,0,100.0
2000020725,20,883,0.0,10,6,0,0,4,60.0
2000020726,6,3600,0.0,21,20,6,0,1,95.23809524
2000020726,10,3534,0.0,30,28,4,3,2,93.33333333
2000020727,12,3600,0.0,28,26,3,1,2,92.85714286
2000020727,3,3521,0.0,34,31,5,2,3,91.17647059
2000020728,8,3551,0.0,27,24,13,0,3,88.88888889
2000020728,5,3600,2.0,20,19,8,1,1,95.0
2000020729,13,3536,0.0,25,23,5,1,2,92.0
2000020729,15,3597,0.0,32,31,8,4,1,96.875
2000020730,18,3548,0.0,41,37,5,2,4,90.24390244
2000020730,17,3588,0.0,20,17,4,0,3,85.0
2000020731,1,3600,0.0,33,32,5,0,1,96.96969697
2000020731,25,681,0.0,7,3,0,0,4,42.85714286
2000020731,25,2800,0.0,12,12,1,1,0,100.0
2000020732,27,3595,0.0,34,28,8,1,6,82.35294118
2000020732,23,3591,0.0,23,21,7,1,2,91.30434783
2000020733,30,3570,0.0,20,20,4,0,0,100.0
2000020733,24,3600,0.0,26,21,3,3,5,80.76923077
2000020734,22,3597,0.0,27,21,4,3,6,77.77777778
2000020734,28,3572,0.0,23,22,12,0,1,95.65217391
2000020735,10,3639,0.0,26,25,4,0,1,96.15384615
2000020735,11,3639,0.0,33,31,6,0,2,93.93939394
2000020736,9,3600,0.0,15,13,0,0,2,86.66666667
2000020736,14,3552,0.0,37,33,4,1,4,89.18918919
2000020737,4,3592,0.0,26,25,5,0,1,96.15384615
2000020737,16,1598,0.0,11,7,0,0,4,63.63636364
2000020737,16,1973,0.0,8,7,1,0,1,87.5
2000020738,1,3797,2.0,25,21,3,0,4,84.0
2000020738,19,3797,0.0,31,28,0,0,3,90.32258065
2000020739,20,3600,0.0,21,21,3,1,0,100.0
2000020739,26,3559,0.0,23,21,1,0,2,91.30434783
2000020740,6,3588,0.0,30,29,5,2,1,96.66666667
2000020740,7,3556,0.0,20,18,2,0,2,90.0
2000020741,2,3600,0.0,34,32,4,3,2,94.11764706
2000020741,3,3548,0.0,32,29,5,1,3,90.625
2000020742,9,3774,0.0,22,18,1,0,4,81.81818182
2000020742,13,3769,0.0,33,28,4,6,5,84.84848485
2000020743,24,3600,0.0,37,34,4,2,3,91.89189189
2000020743,17,3600,0.0,19,17,2,0,2,89.47368421
2000020744,28,3600,0.0,29,28,5,0,1,96.55172414
2000020744,25,3563,0.0,18,16,2,2,2,88.88888889
2000020745,16,3600,0.0,25,20,2,0,5,80.0
2000020745,21,3600,0.0,24,22,9,1,2,91.66666667
2000020746,27,3900,0.0,27,26,5,0,1,96.2962963
2000020746,22,3900,0.0,21,20,4,3,1,95.23809524
2000020747,1,3670,0.0,42,38,3,3,4,90.47619048
2000020747,6,3674,0.0,33,30,3,2,3,90.90909091
2000020748,3,3512,0.0,25,22,5,1,3,88.0
2000020748,10,3596,0.0,30,29,4,1,1,96.66666667
2000020749,15,3516,0.0,27,23,2,1,4,85.18518519
2000020749,8,3587,0.0,22,20,3,0,2,90.90909091
2000020750,7,3600,0.0,24,23,3,1,1,95.83333333
2000020750,2,221,0.0,1,1,0,0,0,100.0
2000020750,2,3354,0.0,31,29,6,0,2,93.5483871
2000020751,11,3600,0.0,39,34,4,2,5,87.17948718
2000020751,5,3600,0.0,29,28,5,1,1,96.55172414
2000020752,4,3600,0.0,18,15,1,1,3,83.33333333
2000020752,12,3575,0.0,37,33,2,0,4,89.18918919
2000020753,14,3659,0.0,30,27,7,0,3,90.0
2000020753,13,3653,0.0,21,19,1,0,2,90.47619048
2000020754,24,3526,0.0,21,19,3,2,2,90.47619048
2000020754,29,3600,0.0,28,27,8,0,1,96.42857143
2000020755,28,3711,2.0,31,28,9,4,3,90.32258065
2000020755,19,3711,0.0,14,10,1,1,4,71.42857143
2000020756,21,3560,0.0,9,8,2,0,1,88.88888889
2000020756,18,3596,0.0,36,31,4,0,5,86.11111111
2000020757,23,3599,0.0,22,19,1,0,3,86.36363636
2000020757,20,3587,0.0,27,23,2,3,4,85.18518519
2000020758,30,3600,2.0,36,35,7,2,1,97.22222222
2000020758,26,3592,0.0,21,18,5,0,3,85.71428571
2000020759,9,3548,0.0,15,12,3,1,3,80.0
2000020759,8,3600,0.0,30,29,6,1,1,96.66666667
2000020760,4,3558,0.0,18,15,0,1,3,83.33333333
2000020760,15,3600,0.0,35,33,7,1,2,94.28571429
2000020761,16,3600,0.0,40,38,10,0,2,95.0
2000020761,23,1200,0.0,11,9,4,0,2,81.81818182
2000020761,23,2396,0.0,18,14,1,2,4,77.77777778
2000020762,11,3600,0.0,30,28,3,3,2,93.33333333
2000020762,3,3596,0.0,37,30,8,0,7,81.08108108
2000020763,14,3600,0.0,35,30,3,1,5,85.71428571
2000020763,12,3600,0.0,16,14,2,1,2,87.5
2000020764,18,3600,0.0,24,22,4,3,2,91.66666667
2000020764,27,3595,0.0,26,21,5,1,5,80.76923077
2000020765,19,1200,0.0,11,8,4,0,3,72.72727273
2000020765,19,2400,0.0,20,18,0,1,2,90.0
2000020765,6,3600,0.0,28,27,2,0,1,96.42857143
2000020766,17,3523,0.0,37,34,7,1,3,91.89189189
2000020766,1,3600,0.0,29,28,0,1,1,96.55172414
2000020767,9,3897,0.0,24,23,2,0,1,95.83333333
2000020767,15,3896,0.0,33,32,7,0,1,96.96969697
2000020768,5,3600,0.0,26,23,11,2,3,88.46153846
2000020768,11,3545,0.0,32,27,13,4,5,84.375
2000020769,13,3537,0.0,26,22,4,3,4,84.61538462
2000020769,14,3597,0.0,26,23,9,2,3,88.46153846
2000020770,22,3600,0.0,25,22,5,2,3,88.0
2000020770,20,38,0.0,0,0,0,0,0,
2000020770,20,3521,0.0,29,25,4,0,4,86.20689655
2000020771,30,3703,0.0,34,31,11,1,3,91.17647059
2000020771,23,3702,0.0,20,18,2,0,2,90.0
2000020772,25,3588,2.0,36,28,6,1,8,77.77777778
2000020772,26,3600,0.0,23,23,0,1,0,100.0
2000020773,21,3598,0.0,26,25,5,1,1,96.15384615
2000020773,28,3534,0.0,22,19,4,0,3,86.36363636
2000020774,1,3544,0.0,20,17,9,0,3,85.0
2000020774,2,3600,0.0,39,37,7,0,2,94.87179487
2000020775,8,3531,0.0,36,33,1,0,3,91.66666667
2000020775,3,3600,0.0,24,22,3,0,2,91.66666667
2000020776,4,3600,0.0,31,30,9,2,1,96.77419355
2000020776,5,3600,0.0,27,22,4,1,5,81.48148148
2000020777,10,3599,0.0,23,20,1,1,3,86.95652174
2000020777,12,3552,0.0,24,20,5,0,4,83.33333333
2000020778,7,3600,2.0,25,20,2,1,5,80.0
2000020778,13,3600,2.0,40,38,5,2,2,95.0
2000020779,17,3656,0.0,28,26,6,1,2,92.85714286
2000020779,29,3656,0.0,30,27,10,1,3,90.0
2000020780,16,3543,0.0,26,23,3,1,3,88.46153846
2000020780,22,3600,0.0,25,23,3,0,2,92.0
2000020781,18,3593,0.0,26,26,11,2,0,100.0
2000020781,24,3600,0.0,24,21,1,1,3,87.5
2000020782,8,3600,0.0,39,39,7,2,0,100.0
2000020782,6,3503,0.0,12,10,0,0,2,83.33333333
2000020782,6,39,0.0,0,0,0,0,0,
2000020783,2,3581,0.0,27,26,12,0,1,96.2962963
2000020783,4,3597,0.0,22,22,4,2,0,100.0
2000020784,10,3540,0.0,36,31,6,0,5,86.11111111
2000020784,15,3600,0.0,31,27,10,0,4,87.09677419
2000020785,12,3587,0.0,21,20,3,1,1,95.23809524
2000020785,11,3592,0.0,26,23,1,1,3,88.46153846
2000020786,7,3549,0.0,19,15,1,1,4,78.94736842
2000020786,14,3600,0.0,25,23,2,1,2,92.0
2000020787,29,3900,0.0,30,28,1,0,2,93.33333333
2000020787,19,3900,0.0,16,14,2,0,2,87.5
2000020788,16,3596,0.0,32,27,6,1,5,84.375
2000020788,20,3600,0.0,27,24,0,2,3,88.88888889
2000020789,21,3,0.0,0,0,0,0,0,
2000020789,21,3555,0.0,40,36,7,0,4,90.0
2000020789,23,3600,0.0,29,26,9,1,3,89.65517241
2000020790,24,3600,0.0,38,36,4,1,2,94.73684211
2000020790,27,3570,2.0,23,20,3,0,3,86.95652174
2000020791,18,3600,0.0,27,23,2,1,4,85.18518519
2000020791,26,3543,0.0,25,20,2,0,5,80.0
2000020792,25,35,0.0,0,0,0,0,0,
2000020792,25,3565,0.0,27,25,9,4,2,92.59259259
2000020792,28,907,0.0,3,3,1,0,0,100.0
2000020792,28,2650,0.0,20,16,4,0,4,80.0
2000020793,4,3498,0.0,31,27,8,2,4,87.09677419
2000020793,6,3600,2.0,27,24,1,2,3,88.88888889
2000020794,1,3600,0.0,27,27,2,1,0,100.0
2000020794,8,1200,0.0,11,7,0,1,4,63.63636364
2000020794,8,2400,0.0,14,14,2,0,0,100.0
2000020795,7,3593,0.0,27,24,4,1,3,88.88888889
2000020795,3,3600,0.0,30,24,6,0,6,80.0
2000020796,30,3600,2.0,33,31,6,1,2,93.93939394
2000020796,14,3588,0.0,20,17,1,1,3,85.0
2000020797,9,3562,0.0,26,23,3,1,3,88.46153846
2000020797,17,3600,0.0,28,26,4,0,2,92.85714286
2000020798,19,3821,0.0,26,24,10,1,2,92.30769231
2000020798,29,3900,2.0,41,39,5,1,2,95.12195122
2000020799,28,3887,0.0,28,27,12,0,1,96.42857143
2000020799,20,3881,10.0,25,24,6,2,1,96.0
2000020800,16,3900,0.0,40,37,1,0,3,92.5
2000020800,26,3900,0.0,23,20,1,0,3,86.95652174
2000020801,2,3642,2.0,29,27,7,0,2,93.10344828
2000020801,7,3642,2.0,31,30,9,3,1,96.77419355
2000020802,11,3597,0.0,27,20,3,0,7,74.07407407
2000020802,10,3600,0.0,36,35,8,0,1,97.22222222
2000020803,4,1639,0.0,20,14,8,0,6,70.0
2000020803,4,1961,0.0,13,10,0,0,3,76.92307692
2000020803,5,1200,0.0,13,10,1,0,3,76.92307692
2000020803,5,2400,0.0,13,12,4,0,1,92.30769231
2000020804,30,3569,0.0,31,29,0,0,2,93.5483871
2000020804,13,3600,0.0,20,19,4,0,1,95.0
2000020805,22,3533,0.0,19,16,1,2,3,84.21052632
2000020805,25,3600,0.0,22,20,8,1,2,90.90909091
2000020806,15,3600,0.0,32,31,5,2,1,96.875
2000020806,21,3588,0.0,22,20,3,1,2,90.90909091
2000020807,12,3618,0.0,19,18,4,2,1,94.73684211
2000020807,27,3625,0.0,23,21,4,3,2,91.30434783
2000020808,16,3600,0.0,23,21,2,2,2,91.30434783
2000020808,24,3556,0.0,27,24,3,1,3,88.88888889
2000020809,1,3900,0.0,40,36,9,2,4,90.0
2000020809,9,3900,0.0,34,30,7,0,4,88.23529412
2000020810,10,3540,2.0,29,27,5,1,2,93.10344828
2000020810,17,3600,0.0,27,26,8,1,1,96.2962963
2000020811,14,3600,0.0,36,32,2,3,4,88.88888889
2000020811,19,3600,0.0,27,26,8,0,1,96.2962963
2000020812,29,3521,0.0,36,33,6,2,3,91.66666667
2000020812,18,3599,0.0,29,28,6,0,1,96.55172414
2000020813,28,3900,0.0,26,26,3,1,0,100.0
2000020813,23,3900,0.0,31,31,2,1,0,100.0
2000020814,12,3516,0.0,24,20,3,1,4,83.33333333
2000020814,26,3598,0.0,30,28,8,0,2,93.33333333
2000020815,4,3598,0.0,25,23,6,1,2,92.0
2000020815,2,3589,0.0,21,16,4,3,5,76.19047619
2000020816,6,2069,2.0,17,15,2,0,2,88.23529412
2000020816,6,1524,0.0,15,12,2,0,3,80.0
2000020816,11,3600,0.0,35,34,8,4,1,97.14285714
2000020817,3,3600,0.0,26,24,5,0,2,92.30769231
2000020817,13,3559,0.0,29,26,1,6,3,89.65517241
2000020818,30,3600,0.0,29,28,4,1,1,96.55172414
2000020818,25,3559,0.0,11,9,0,0,2,81.81818182
2000020819,20,3600,0.0,37,34,5,0,3,91.89189189
2000020819,21,3517,0.0,22,18,2,1,4,81.81818182
2000020819,21,26,0.0,0,0,0,0,0,
2000020820,22,3528,0.0,15,13,0,1,2,86.66666667
2000020820,27,3599,0.0,38,38,9,0,0,100.0
2000020821,15,3600,0.0,25,22,5,2,3,88.0
2000020821,24,3554,0.0,26,22,4,0,4,84.61538462
2000020822,14,2251,0.0,17,13,2,1,4,76.47058824
2000020822,14,1349,0.0,6,4,0,2,2,66.66666667
2000020822,6,84,0.0,1,0,0,0,1,0.0
2000020822,6,3516,0.0,19,18,2,0,1,94.73684211
2000020823,17,3863,0.0,35,32,10,3,3,91.42857143
2000020823,10,3883,0.0,34,31,5,2,3,91.17647059
2000020824,2,3,0.0,0,0,0,0,0,
2000020824,2,3552,0.0,16,12,2,0,4,75.0
2000020824,8,3600,0.0,36,33,4,2,3,91.66666667
2000020825,7,3712,0.0,33,32,0,0,1,96.96969697
2000020825,9,3712,0.0,23,21,0,1,2,91.30434783
2000020826,1,3604,0.0,24,19,0,6,5,79.16666667
2000020826,5,2846,0.0,15,14,4,0,1,93.33333333
2000020826,5,772,0.0,9,6,1,0,3,66.66666667
2000020827,13,3599,0.0,23,20,3,2,3,86.95652174
2000020827,11,2400,0.0,27,22,5,0,5,81.48148148
2000020827,11,1200,0.0,15,13,8,0,2,86.66666667
2000020828,18,3531,0.0,28,25,5,2,3,89.28571429
2000020828,29,3600,0.0,27,25,5,0,2,92.59259259
2000020829,19,3650,0.0,37,34,8,0,3,91.89189189
2000020829,21,3650,0.0,32,28,9,0,4,87.5
2000020830,20,3600,0.0,35,34,11,1,1,97.14285714
2000020830,23,3523,0.0,30,26,11,1,4,86.66666667
2000020830,23,77,0.0,0,0,0,0,0,
2000020831,15,3600,2.0,30,27,5,0,3,90.0
2000020831,26,1157,0.0,1,1,0,0,0,100.0
2000020831,26,2398,0.0,20,16,6,1,4,80.0
2000020832,16,3727,0.0,31,28,4,0,3,90.32258065
2000020832,28,3727,0.0,29,27,1,1,2,93.10344828
2000020833,8,3597,0.0,26,23,3,1,3,88.46153846
2000020833,7,3554,0.0,30,26,7,0,4,86.66666667
2000020834,1,3877,2.0,34,33,1,1,1,97.05882353
2000020834,3,3897,0.0,28,27,3,2,1,96.42857143
2000020835,19,3900,2.0,23,20,5,2,3,86.95652174
2000020835,25,3885,0.0,29,26,2,0,3,89.65517241
2000020836,5,3540,0.0,25,22,3,0,3,88.0
2000020836,30,3600,0.0,29,27,5,2,2,93.10344828
2000020837,16,3564,0.0,27,24,4,0,3,88.88888889
2000020837,27,3600,0.0,28,26,6,1,2,92.85714286
2000020838,12,3900,0.0,34,32,4,0,2,94.11764706
2000020838,24,3900,0.0,29,27,2,0,2,93.10344828
2000020839,2,3383,0.0,34,31,3,5,3,91.17647059
2000020839,9,3595,0.0,37,36,10,2,1,97.2972973
2000020840,3,3600,0.0,40,37,3,0,3,92.5
2000020840,29,3498,0.0,24,20,6,0,4,83.33333333
2000020841,22,3596,0.0,28,25,6,2,3,89.28571429
2000020841,26,2190,0.0,13,11,6,0,2,84.61538462
2000020841,26,1316,0.0,15,12,4,1,3,80.0
2000020842,21,3737,0.0,18,16,5,2,2,88.88888889
2000020842,8,3741,0.0,23,20,7,2,3,86.95652174
2000020843,7,3544,0.0,36,31,8,2,5,86.11111111
2000020843,11,3600,0.0,37,33,7,1,4,89.18918919
2000020844,27,3600,0.0,24,22,2,3,2,91.66666667
2000020844,14,3501,0.0,26,22,3,2,4,84.61538462
2000020845,25,3600,0.0,24,23,6,1,1,95.83333333
2000020845,18,3582,0.0,35,33,1,0,2,94.28571429
2000020846,15,3900,0.0,31,27,3,1,4,87.09677419
2000020846,20,3900,0.0,31,27,7,1,4,87.09677419
2000020847,29,3900,0.0,29,27,9,0,2,93.10344828
2000020847,10,3900,0.0,24,22,4,2,2,91.66666667
2000020848,9,3600,0.0,27,25,1,0,2,92.59259259
2000020848,1,3594,0.0,22,19,1,1,3,86.36363636
2000020849,4,3600,0.0,25,24,4,1,1,96.0
2000020849,2,3466,0.0,22,19,2,1,3,86.36363636
2000020850,30,3584,0.0,35,33,8,1,2,94.28571429
2000020850,5,3600,0.0,14,13,2,1,1,92.85714286
2000020851,27,3528,0.0,23,19,3,3,4,82.60869565
2000020851,13,3600,0.0,22,19,2,1,3,86.36363636
2000020852,12,3771,0.0,35,31,5,2,4,88.57142857
2000020852,17,3756,0.0,41,38,9,0,3,92.68292683
2000020853,28,3600,0.0,31,31,8,0,0,100.0
2000020853,16,2400,0.0,20,15,1,1,5,75.0
2000020853,16,1200,0.0,10,8,0,0,2,80.0
2000020854,26,3575,0.0,23,20,4,1,3,86.95652174
2000020854,25,3590,0.0,22,20,3,0,2,90.90909091
2000020855,15,3859,0.0,25,22,7,0,3,88.0
2000020855,23,3837,0.0,29,25,9,0,4,86.20689655
2000020856,22,3900,0.0,22,19,3,1,3,86.36363636
2000020856,24,3891,0.0,40,37,9,3,3,92.5
2000020857,11,3595,0.0,31,28,4,3,3,90.32258065
2000020857,7,3591,0.0,21,20,1,2,1,95.23809524
2000020858,21,3574,0.0,20,16,3,1,4,80.0
2000020858,9,3600,0.0,26,25,7,2,1,96.15384615
2000020859,10,1200,0.0,7,7,1,0,0,100.0
2000020859,10,2400,0.0,20,15,3,2,5,75.0
2000020859,4,3600,0.0,34,32,8,2,2,94.11764706
2000020860,6,3600,0.0,29,26,8,1,3,89.65517241
2000020860,14,3600,0.0,17,11,4,0,6,64.70588235
2000020861,20,3568,0.0,27,24,1,4,3,88.88888889
2000020861,19,3597,0.0,26,25,6,1,1,96.15384615
2000020862,5,3900,0.0,31,27,4,0,4,87.09677419
2000020862,1,3900,0.0,25,21,5,0,4,84.0
2000020863,27,3600,0.0,33,33,7,3,0,100.0
2000020863,12,3574,0.0,17,16,6,0,1,94.11764706
2000020864,6,2007,0.0,9,9,4,0,0,100.0
2000020864,6,1553,0.0,11,9,2,0,2,81.81818182
2000020864,13,3600,0.0,26,25,1,1,1,96.15384615
2000020865,29,3495,0.0,38,35,8,0,3,92.10526316
2000020865,17,3600,0.0,18,16,2,1,2,88.88888889
2000020866,19,3600,0.0,23,17,0,1,6,73.91304348
2000020866,16,3600,0.0,31,29,2,0,2,93.5483871
2000020867,24,3693,0.0,27,24,6,0,3,88.88888889
2000020867,25,3695,0.0,20,18,3,0,2,90.0
2000020868,28,3600,0.0,19,19,4,1,0,100.0
2000020868,18,3551,0.0,24,22,2,0,2,91.66666667
2000020869,26,3594,0.0,21,21,1,0,0,100.0
2000020869,30,3600,0.0,31,27,1,0,4,87.09677419
2000020870,2,3594,0.0,26,24,4,2,2,92.30769231
2000020870,22,3521,0.0,31,28,7,1,3,90.32258065
2000020871,1,2007,0.0,18,14,4,0,4,77.77777778
2000020871,1,1593,0.0,8,7,3,0,1,87.5
2000020871,7,3592,0.0,33,32,4,0,1,96.96969697
2000020872,21,3900,0.0,22,17,1,0,5,77.27272727
2000020872,10,3900,0.0,33,28,5,0,5,84.84848485
2000020873,15,3600,0.0,21,18,5,0,3,85.71428571
2000020873,8,2394,0.0,21,16,3,0,5,76.19047619
2000020873,8,1152,0.0,6,6,0,0,0,100.0
2000020874,11,3600,2.0,28,23,5,4,5,82.14285714
2000020874,4,3588,0.0,29,28,8,4,1,96.55172414
2000020875,3,3600,0.0,33,29,4,0,4,87.87878788
2000020875,14,3572,0.0,27,22,1,3,5,81.48148148
2000020876,5,3663,0.0,34,32,4,1,2,94.11764706
2000020876,29,3679,0.0,27,24,5,1,3,88.88888889
2000020877,23,3654,2.0,32,27,10,4,5,84.375
2000020877,22,3644,0.0,37,31,6,1,6,83.78378378
2000020878,8,3597,0.0,33,29,5,1,4,87.87878788
2000020878,9,3600,0.0,25,25,8,0,0,100.0
2000020879,6,3560,0.0,24,20,3,0,4,83.33333333
2000020879,12,3594,0.0,35,31,4,0,4,88.57142857
2000020880,26,3578,0.0,19,17,1,1,2,89.47368421
2000020880,16,3600,0.0,19,19,3,2,0,100.0
2000020881,17,3585,0.0,25,24,3,1,1,96.0
2000020881,25,3579,2.0,31,29,6,2,2,93.5483871
2000020882,14,3572,0.0,34,31,9,2,3,91.17647059
2000020882,18,3592,0.0,16,14,3,1,2,87.5
2000020883,28,3540,0.0,18,15,6,1,3,83.33333333
2000020883,30,3590,0.0,28,27,7,4,1,96.42857143
2000020884,2,3545,2.0,31,28,11,0,3,90.32258065
2000020884,23,3599,0.0,24,22,6,5,2,91.66666667
2000020885,20,3600,0.0,32,31,5,1,1,96.875
2000020885,27,3522,0.0,30,27,8,1,3,90.0
2000020886,9,3596,0.0,20,18,4,0,2,90.0
2000020886,7,3600,0.0,30,30,11,1,0,100.0
2000020887,1,3600,0.0,29,29,7,1,0,100.0
2000020887,10,3540,0.0,31,29,3,1,2,93.5483871
2000020888,16,3600,0.0,35,31,7,2,4,88.57142857
2000020888,3,1103,0.0,6,5,1,0,1,83.33333333
2000020888,3,2497,0.0,22,21,4,1,1,95.45454545
2000020889,12,1191,0.0,12,10,2,0,2,83.33333333
2000020889,12,2397,0.0,13,11,2,1,2,84.61538462
2000020889,4,3574,0.0,21,21,8,1,0,100.0
2000020890,21,3600,0.0,32,31,6,3,1,96.875
2000020890,5,3585,0.0,30,25,3,0,5,83.33333333
2000020891,19,3540,0.0,25,23,7,0,2,92.0
2000020891,13,3600,0.0,35,35,5,3,0,100.0
2000020892,20,3592,0.0,27,21,5,1,6,77.77777778
2000020892,24,3600,2.0,28,26,5,0,2,92.85714286
2000020893,19,3523,0.0,20,17,4,0,3,85.0
2000020893,14,3600,0.0,30,28,8,3,2,93.33333333
2000020894,17,3900,0.0,28,25,4,0,3,89.28571429
2000020894,18,2840,0.0,22,20,4,2,2,90.90909091
2000020894,18,1060,0.0,12,11,0,0,1,91.66666667
2000020895,26,3595,0.0,27,22,7,1,5,81.48148148
2000020895,22,3590,0.0,21,21,3,1,0,100.0
2000020896,29,3858,0.0,43,40,15,0,3,93.02325581
2000020896,28,3852,0.0,22,20,3,1,2,90.90909091
2000020897,23,3597,0.0,27,26,8,0,1,96.2962963
2000020897,8,3539,0.0,22,20,2,4,2,90.90909091
2000020898,13,3720,0.0,33,30,9,0,3,90.90909091
2000020898,5,3730,0.0,20,18,2,1,2,90.0
2000020899,18,3535,0.0,18,16,1,2,2,88.88888889
2000020899,15,3589,0.0,25,24,6,0,1,96.0
2000020900,11,3595,0.0,35,29,5,3,6,82.85714286
2000020900,12,3600,0.0,31,28,6,1,3,90.32258065
2000020901,17,3598,0.0,24,21,2,0,3,87.5
2000020901,16,3600,0.0,30,23,3,2,7,76.66666667
2000020902,30,3596,0.0,32,26,4,1,6,81.25
2000020902,25,3598,0.0,26,24,5,0,2,92.30769231
2000020903,6,468,0.0,4,2,0,0,2,50.0
2000020903,6,3128,0.0,26,20,1,0,6,76.92307692
2000020903,21,3600,0.0,18,16,0,0,2,88.88888889
2000020904,29,3555,0.0,33,30,3,2,3,90.90909091
2000020904,27,3600,0.0,33,31,6,0,2,93.93939394
2000020905,28,3540,2.0,17,16,1,1,1,94.11764706
2000020905,24,3600,0.0,24,24,3,0,0,100.0
2000020906,23,3596,0.0,25,21,3,1,4,84.0
2000020906,10,3600,0.0,36,35,8,0,1,97.22222222
2000020907,13,3600,0.0,47,43,11,2,4,91.4893617
2000020907,9,3597,0.0,15,13,2,1,2,86.66666667
2000020908,7,3597,0.0,24,24,5,1,0,100.0
2000020908,1,3541,0.0,17,16,3,0,1,94.11764706
2000020909,4,3867,2.0,28,24,0,2,4,85.71428571
2000020909,2,3873,0.0,23,20,2,2,3,86.95652174
2000020910,26,3598,2.0,19,19,4,2,0,100.0
2000020910,20,3595,0.0,31,29,5,0,2,93.5483871
2000020911,27,3600,0.0,30,27,6,1,3,90.0
2000020911,7,2400,0.0,22,18,8,1,4,81.81818182
2000020911,7,1200,0.0,9,6,0,0,3,66.66666667
2000020912,3,3543,0.0,32,26,6,0,6,81.25
2000020912,5,3600,0.0,27,23,5,1,4,85.18518519
2000020913,8,3516,0.0,32,29,2,4,3,90.625
2000020913,15,3592,0.0,26,25,3,2,1,96.15384615
2000020914,1,3530,0.0,22,19,5,0,3,86.36363636
2000020914,12,3600,0.0,28,26,0,2,2,92.85714286
2000020915,19,3536,0.0,27,23,5,1,4,85.18518519
2000020915,17,3599,0.0,30,28,3,1,2,93.33333333
2000020916,11,3559,0.0,26,25,0,3,1,96.15384615
2000020916,16,3600,0.0,27,27,6,1,0,100.0
2000020917,6,3653,0.0,19,14,1,1,5,73.68421053
2000020917,25,3660,0.0,27,23,8,0,4,85.18518519
2000020918,30,3600,2.0,29,25,6,0,4,86.20689655
2000020918,21,3600,0.0,21,20,4,1,1,95.23809524
2000020919,24,3455,0.0,35,32,8,1,3,91.42857143
2000020919,28,3597,0.0,20,19,7,0,1,95.0
2000020920,8,3600,0.0,29,24,4,0,5,82.75862069
2000020920,10,3600,0.0,24,23,7,1,1,95.83333333
2000020921,23,3600,0.0,29,26,10,0,3,89.65517241
2000020921,9,3600,0.0,25,25,6,2,0,100.0
2000020922,13,53,0.0,1,1,0,1,0,100.0
2000020922,13,3489,0.0,39,34,9,1,5,87.17948718
2000020922,2,3600,0.0,29,25,3,3,4,86.20689655
2000020923,14,3900,0.0,27,27,2,1,0,100.0
2000020923,4,3900,0.0,36,36,10,2,0,100.0
2000020924,15,3593,0.0,22,21,12,0,1,95.45454545
2000020924,12,3591,0.0,30,28,2,0,2,93.33333333
2000020925,6,3680,0.0,25,22,1,1,3,88.0
2000020925,19,3675,0.0,18,16,2,0,2,88.88888889
2000020926,30,3555,0.0,27,25,3,1,2,92.59259259
2000020926,18,3600,0.0,29,28,4,2,1,96.55172414
2000020927,22,3600,0.0,34,33,7,0,1,97.05882353
2000020927,20,2840,0.0,11,10,2,0,1,90.90909091
2000020927,20,720,0.0,4,2,1,0,2,50.0
2000020928,29,3526,0.0,31,29,2,1,2,93.5483871
2000020928,26,3600,0.0,17,16,6,0,1,94.11764706
2000020929,14,3524,0.0,37,32,10,1,5,86.48648649
2000020929,7,3591,0.0,26,22,2,1,4,84.61538462
2000020930,3,3536,0.0,21,19,5,2,2,90.47619048
2000020930,4,3600,0.0,32,31,3,1,1,96.875
2000020931,2,3581,0.0,26,20,2,1,6,76.92307692
2000020931,2,19,0.0,0,0,0,0,0,
2000020931,5,3600,0.0,23,22,4,0,1,95.65217391
2000020932,27,3600,0.0,44,38,11,1,6,86.36363636
2000020932,17,1200,0.0,10,7,1,1,3,70.0
2000020932,17,2400,0.0,18,18,2,0,0,100.0
2000020933,10,3554,0.0,26,21,2,3,5,80.76923077
2000020933,16,3600,0.0,18,14,1,0,4,77.77777778
2000020934,11,1295,0.0,10,9,2,0,1,90.0
2000020934,11,2305,2.0,27,23,10,0,4,85.18518519
2000020934,21,3593,0.0,28,26,3,3,2,92.85714286
2000020935,25,3631,0.0,34,31,4,1,3,91.17647059
2000020935,22,3631,0.0,34,32,2,1,2,94.11764706
2000020936,29,3600,0.0,25,23,2,0,2,92.0
2000020936,24,3590,0.0,18,14,2,1,4,77.77777778
2000020937,13,3555,0.0,36,32,11,2,4,88.88888889
2000020937,1,3600,0.0,25,22,4,2,3,88.0
2000020938,9,3600,0.0,32,30,7,0,2,93.75
2000020938,3,3513,0.0,42,39,7,0,3,92.85714286
2000020939,28,3600,0.0,29,22,1,2,7,75.86206897
2000020939,19,3600,0.0,27,25,9,2,2,92.59259259
2000020940,23,3600,0.0,17,15,2,5,2,88.23529412
2000020940,30,3600,0.0,32,27,9,1,5,84.375
2000020941,25,3540,0.0,27,24,11,2,3,88.88888889
2000020941,20,3600,0.0,23,21,4,2,2,91.30434783
2000020942,27,2363,0.0,19,17,1,0,2,89.47368421
2000020942,27,1200,0.0,16,12,0,0,4,75.0
2000020942,6,3600,0.0,26,22,0,2,4,84.61538462
2000020943,7,3598,0.0,30,29,10,0,1,96.66666667
2000020943,9,3600,0.0,20,16,2,1,4,80.0
2000020944,1,3587,2.0,22,21,4,8,1,95.45454545
2000020944,2,3600,0.0,33,29,3,0,4,87.87878788
2000020945,8,3600,0.0,31,29,3,4,2,93.5483871
2000020945,4,3539,0.0,13,10,2,0,3,76.92307692
2000020946,16,3600,0.0,22,20,5,0,2,90.90909091
2000020946,15,3537,0.0,29,26,6,0,3,89.65517241
2000020947,12,3900,0.0,44,43,2,2,1,97.72727273
2000020947,11,3900,0.0,29,28,2,0,1,96.55172414
2000020948,26,3600,0.0,21,20,2,1,1,95.23809524
2000020948,18,3515,0.0,32,30,3,1,2,93.75
2000020949,28,3550,0.0,28,26,11,0,2,92.85714286
2000020949,10,3600,2.0,39,38,12,3,1,97.43589744
2000020950,5,3512,0.0,39,35,5,1,4,89.74358974
2000020950,8,3600,0.0,28,26,10,1,2,92.85714286
2000020951,13,2394,0.0,26,23,3,0,3,88.46153846
2000020951,13,1068,0.0,8,7,0,0,1,87.5
2000020951,3,3600,0.0,40,38,12,1,2,95.0
2000020952,27,3532,0.0,33,29,10,0,4,87.87878788
2000020952,29,3590,0.0,27,25,6,2,2,92.59259259
2000020953,19,3567,0.0,24,20,3,2,4,83.33333333
2000020953,22,3592,0.0,16,13,1,1,3,81.25
2000020954,25,3541,0.0,25,20,3,3,5,80.0
2000020954,23,3600,0.0,22,18,3,2,4,81.81818182
2000020955,17,3597,0.0,25,24,3,2,1,96.0
2000020955,24,3600,2.0,34,31,9,3,3,91.17647059
2000020956,14,3600,0.0,30,27,5,2,3,90.0
2000020956,6,3600,0.0,19,18,4,0,1,94.73684211
2000020957,28,2336,0.0,23,18,1,0,5,78.26086957
2000020957,28,1250,0.0,16,13,4,0,3,81.25
2000020957,9,3600,0.0,22,18,4,0,4,81.81818182
2000020958,12,3600,0.0,37,36,2,3,1,97.2972973
2000020958,2,3502,0.0,27,24,6,0,3,88.88888889
2000020959,7,3526,0.0,31,29,6,0,2,93.5483871
2000020959,4,3594,0.0,26,26,4,1,0,100.0
2000020960,10,3676,0.0,27,25,5,1,2,92.59259259
2000020960,15,3673,2.0,45,42,10,2,3,93.33333333
2000020961,26,3900,0.0,22,20,5,0,2,90.90909091
2000020961,16,3882,0.0,35,33,4,2,2,94.28571429
2000020962,29,3600,0.0,29,27,4,1,2,93.10344828
2000020962,18,2400,0.0,23,19,0,2,4,82.60869565
2000020962,18,1115,0.0,9,9,1,0,0,100.0
2000020963,30,3900,0.0,26,25,2,0,1,96.15384615
2000020963,20,3900,0.0,21,20,0,1,1,95.23809524
2000020964,12,1692,0.0,19,15,3,0,4,78.94736842
2000020964,12,1908,0.0,14,11,0,0,3,78.57142857
2000020964,1,3586,0.0,29,26,3,2,3,89.65517241
2000020965,5,3595,0.0,34,29,8,2,5,85.29411765
2000020965,3,3500,0.0,28,21,3,1,7,75.0
2000020966,11,3600,0.0,39,36,9,0,3,92.30769231
2000020966,13,3495,0.0,23,19,0,0,4,82.60869565
2000020967,30,3600,0.0,29,26,9,1,3,89.65517241
2000020967,22,3591,0.0,23,22,1,8,1,95.65217391
2000020968,19,3793,0.0,24,21,1,1,3,87.5
2000020968,23,3820,0.0,26,24,5,0,2,92.30769231
2000020969,17,3870,0.0,29,27,4,1,2,93.10344828
2000020969,27,2811,0.0,20,19,3,3,1,95.0
2000020969,27,1087,0.0,8,7,2,0,1,87.5
2000020970,25,3600,0.0,29,27,5,0,2,93.10344828
2000020970,24,3600,0.0,25,20,5,0,5,80.0
2000020971,28,3527,0.0,28,25,6,0,3,89.28571429
2000020971,6,3600,2.0,28,26,5,1,2,92.85714286
2000020972,9,3642,0.0,29,27,6,2,2,93.10344828
2000020972,10,3642,0.0,42,39,12,1,3,92.85714286
2000020973,4,3552,0.0,25,22,1,0,3,88.0
2000020973,8,3600,0.0,34,33,15,2,1,97.05882353
2000020974,14,3593,0.0,25,25,12,1,0,100.0
2000020974,2,1887,0.0,13,9,0,0,4,69.23076923
2000020974,2,1698,0.0,13,11,7,0,2,84.61538462
2000020975,5,3559,0.0,46,42,13,2,4,91.30434783
2000020975,15,3596,0.0,28,25,6,1,3,89.28571429
2000020976,13,3893,0.0,41,39,5,0,2,95.12195122
2000020976,11,3900,0.0,43,41,14,4,2,95.34883721
2000020977,7,3728,0.0,35,33,8,0,2,94.28571429
2000020977,21,3728,0.0,16,13,0,3,3,81.25
2000020978,19,3841,0.0,25,22,5,0,3,88.0
2000020978,20,3841,0.0,21,19,2,6,2,90.47619048
2000020979,17,1620,0.0,21,15,6,0,6,71.42857143
2000020979,17,1978,0.0,4,4,0,1,0,100.0
2000020979,26,3600,0.0,32,29,12,3,3,90.625
2000020980,14,3586,0.0,30,24,4,0,6,80.0
2000020980,1,3600,0.0,15,15,0,1,0,100.0
2000020981,12,3600,0.0,25,22,3,2,3,88.0
2000020981,16,3592,0.0,30,24,9,1,6,80.0
2000020982,7,3597,0.0,17,13,0,1,4,76.47058824
2000020982,25,3597,0.0,20,19,7,0,1,95.0
2000020983,3,3591,0.0,30,25,4,0,5,83.33333333
2000020983,18,3600,0.0,29,27,3,2,2,93.10344828
2000020984,30,3746,0.0,31,28,6,2,3,90.32258065
2000020984,23,744,0.0,10,7,1,0,3,70.0
2000020984,23,3000,0.0,16,15,1,0,1,93.75
2000020985,21,3600,0.0,28,28,8,1,0,100.0
2000020985,27,3600,0.0,43,38,9,0,5,88.37209302
2000020986,26,3592,0.0,19,15,5,1,4,78.94736842
2000020986,24,3600,0.0,25,25,4,0,0,100.0
2000020987,2,3600,0.0,42,40,10,1,2,95.23809524
2000020987,3,3598,0.0,34,29,11,4,5,85.29411765
2000020988,6,3572,0.0,34,29,3,2,5,85.29411765
2000020988,4,3596,0.0,24,20,3,1,4,83.33333333
2000020989,7,3600,0.0,21,20,1,4,1,95.23809524
2000020989,6,3539,0.0,29,27,2,0,2,93.10344828
2000020990,9,3628,0.0,27,24,6,1,3,88.88888889
2000020990,1,3628,0.0,18,16,3,0,2,88.88888889
2000020991,15,3595,2.0,19,18,13,0,1,94.73684211
2000020991,2,3600,0.0,33,28,2,2,5,84.84848485
2000020992,21,3591,0.0,24,22,2,3,2,91.66666667
2000020992,11,3540,0.0,28,24,6,0,4,85.71428571
2000020993,28,3842,0.0,30,28,8,1,2,93.33333333
2000020993,14,3840,0.0,18,17,8,1,1,94.44444444
2000020994,19,3900,0.0,29,26,7,3,3,89.65517241
2000020994,30,3900,0.0,35,32,5,2,3,91.42857143
2000020995,10,3598,0.0,21,20,6,1,1,95.23809524
2000020995,20,3580,0.0,26,24,2,0,2,92.30769231
2000020996,17,3600,0.0,23,20,7,3,3,86.95652174
2000020996,23,3513,0.0,20,16,5,1,4,80.0
2000020997,18,3600,0.0,24,19,2,1,5,79.16666667
2000020997,27,3600,0.0,25,24,3,2,1,96.0
2000020998,8,3549,0.0,25,21,10,0,4,84.0
2000020998,26,3596,0.0,25,22,7,0,3,88.0
2000020999,15,3600,0.0,33,30,4,1,3,90.90909091
2000020999,5,3514,0.0,24,20,6,1,4,83.33333333
2000021000,29,3525,0.0,26,24,0,1,2,92.30769231
2000021000,12,3600,0.0,17,16,2,2,1,94.11764706
2000021001,28,3889,0.0,37,34,7,1,3,91.89189189
2000021001,13,3885,0.0,34,31,6,5,3,91.17647059
2000021002,16,3600,0.0,19,18,2,1,1,94.73684211
2000021002,25,1157,0.0,10,10,0,0,0,100.0
2000021002,25,2399,0.0,21,18,5,1,3,85.71428571
2000021003,10,3600,0.0,35,31,8,0,4,88.57142857
2000021003,22,3597,0.0,25,25,5,1,0,100.0
2000021004,8,1487,0.0,12,9,4,0,3,75.0
2000021004,8,2038,0.0,11,10,5,1,1,90.90909091
2000021004,24,3600,0.0,29,27,2,2,2,93.10344828
2000021005,9,3600,0.0,28,25,4,0,3,89.28571429
2000021005,6,3565,0.0,27,22,3,1,5,81.48148148
2000021006,30,3600,2.0,27,21,3,0,6,77.77777778
2000021006,1,3596,0.0,28,26,0,0,2,92.85714286
2000021007,20,3568,0.0,31,27,2,0,4,87.09677419
2000021007,4,3600,0.0,24,22,3,0,2,91.66666667
2000021008,5,3600,0.0,30,27,1,4,3,90.0
2000021008,11,3556,0.0,22,18,2,0,4,81.81818182
2000021009,12,3573,0.0,15,14,0,1,1,93.33333333
2000021009,14,3600,0.0,20,20,3,0,0,100.0
2000021010,21,3600,0.0,24,22,9,0,2,91.66666667
2000021010,19,1200,2.0,8,8,3,0,0,100.0
2000021010,19,2400,0.0,19,14,4,1,5,73.68421053
2000021011,23,3634,0.0,30,27,4,0,3,90.0
2000021011,27,3638,0.0,39,37,6,0,2,94.87179487
2000021012,18,3600,0.0,19,15,3,1,4,78.94736842
2000021012,26,3591,0.0,21,20,8,1,1,95.23809524
2000021013,22,3600,0.0,28,28,7,1,0,100.0
2000021013,7,3600,2.0,29,25,7,0,4,86.20689655
2000021014,30,3600,0.0,23,22,4,1,1,95.65217391
2000021014,2,3594,0.0,25,21,6,0,4,84.0
2000021015,3,3596,0.0,33,28,5,2,5,84.84848485
2000021015,15,3597,0.0,27,24,4,1,3,88.88888889
2000021016,29,3643,0.0,29,23,4,0,6,79.31034483
2000021016,13,3642,0.0,34,27,11,0,7,79.41176471
2000021017,16,3530,0.0,21,19,0,1,2,90.47619048
2000021017,24,3600,0.0,35,34,3,0,1,97.14285714
2000021018,11,3583,0.0,45,40,14,2,5,88.88888889
2000021018,6,752,0.0,11,8,1,0,3,72.72727273
2000021018,6,2827,0.0,19,16,4,0,3,84.21052632
2000021019,3,3600,0.0,30,28,6,3,2,93.33333333
2000021019,9,3517,0.0,25,22,4,2,3,88.0
2000021020,1,3595,0.0,26,24,3,3,2,92.30769231
2000021020,4,3564,0.0,33,30,2,3,3,90.90909091
2000021021,20,3574,0.0,27,22,11,0,5,81.48148148
2000021021,5,3600,2.0,34,31,12,0,3,91.17647059
2000021022,29,3600,0.0,33,29,4,3,4,87.87878788
2000021022,14,3599,0.0,22,21,7,1,1,95.45454545
2000021023,17,3892,0.0,28,26,1,2,2,92.85714286
2000021023,19,3857,0.0,27,25,4,1,2,92.59259259
2000021024,21,3707,0.0,23,20,3,1,3,86.95652174
2000021024,25,3686,0.0,32,30,11,4,2,93.75
2000021025,10,3900,0.0,33,30,12,1,3,90.90909091
2000021025,23,3900,0.0,15,12,2,1,3,80.0
2000021026,8,3900,0.0,36,33,5,1,3,91.66666667
2000021026,27,3900,0.0,31,28,3,2,3,90.32258065
2000021027,16,3893,0.0,25,23,2,0,2,92.0
2000021027,26,3898,0.0,32,30,6,1,2,93.75
2000021028,18,3600,0.0,17,17,2,1,0,100.0
2000021028,28,3570,0.0,24,22,2,3,2,91.66666667
2000021029,13,3600,0.0,29,28,5,0,1,96.55172414
2000021029,2,3567,0.0,26,23,2,2,3,88.46153846
2000021030,9,3542,0.0,36,30,4,0,6,83.33333333
2000021030,15,1200,0.0,8,8,0,0,0,100.0
2000021030,15,2400,0.0,26,21,6,0,5,80.76923077
2000021031,22,3597,0.0,23,21,1,0,2,91.30434783
2000021031,12,3551,0.0,23,20,3,0,3,86.95652174
2000021032,20,3889,0.0,43,40,12,2,3,93.02325581
2000021032,11,3900,0.0,34,31,8,0,3,91.17647059
2000021033,17,3637,0.0,22,20,3,0,2,90.90909091
2000021033,30,3632,2.0,38,35,13,1,3,92.10526316
2000021034,25,108,0.0,1,1,0,1,0,100.0
2000021034,25,3418,0.0,34,31,10,3,3,91.17647059
2000021034,21,3582,0.0,18,16,4,0,2,88.88888889
2000021035,18,3820,0.0,23,22,5,0,1,95.65217391
2000021035,24,3820,0.0,31,31,3,0,0,100.0
2000021036,5,3900,0.0,28,25,6,0,3,89.28571429
2000021036,3,3900,0.0,38,35,12,1,3,92.10526316
2000021037,8,3594,0.0,44,42,6,6,2,95.45454545
2000021037,28,3562,0.0,20,20,1,1,0,100.0
2000021037,28,38,0.0,0,0,0,0,0,
2000021038,19,3530,0.0,27,23,7,0,4,85.18518519
2000021038,4,3600,0.0,30,28,2,3,2,93.33333333
2000021039,24,3600,0.0,33,33,3,2,0,100.0
2000021039,15,3565,0.0,26,24,6,0,2,92.30769231
2000021040,22,3677,0.0,21,17,5,2,4,80.95238095
2000021040,14,3669,0.0,30,25,5,0,5,83.33333333
2000021041,23,3900,0.0,39,37,8,6,2,94.87179487
2000021041,17,36,0.0,0,0,0,0,0,
2000021041,17,3788,0.0,21,19,6,2,2,90.47619048
2000021042,25,3600,2.0,27,27,6,1,0,100.0
2000021042,16,3594,0.0,18,15,0,0,3,83.33333333
2000021043,1,3595,2.0,37,34,8,3,3,91.89189189
2000021043,21,1702,0.0,11,11,2,2,0,100.0
2000021043,21,1842,2.0,13,8,1,0,5,61.53846154
2000021044,3,3581,0.0,31,26,6,1,5,83.87096774
2000021044,7,3600,0.0,27,24,8,4,3,88.88888889
2000021045,24,3588,0.0,29,26,4,0,3,89.65517241
2000021045,10,3591,0.0,22,20,3,2,2,90.90909091
2000021046,11,2203,0.0,15,10,2,0,5,66.66666667
2000021046,11,1397,0.0,17,14,3,0,3,82.35294118
2000021046,9,3600,0.0,30,29,6,0,1,96.66666667
2000021047,2,3600,0.0,34,33,8,1,1,97.05882353
2000021047,5,3532,2.0,30,28,5,0,2,93.33333333
2000021048,8,3600,0.0,33,30,9,0,3,90.90909091
2000021048,12,3587,2.0,28,22,2,1,6,78.57142857
2000021049,22,3857,0.0,25,23,3,3,2,92.0
2000021049,13,3897,0.0,23,21,4,0,2,91.30434783
2000021050,20,3600,0.0,23,20,6,0,3,86.95652174
2000021050,29,3600,0.0,30,30,3,2,0,100.0
2000021051,19,3789,0.0,21,21,3,0,0,100.0
2000021051,30,3789,0.0,15,14,1,1,1,93.33333333
2000021052,1,3600,0.0,19,17,4,2,2,89.47368421
2000021052,27,3596,0.0,41,38,4,0,3,92.68292683
2000021053,26,3600,0.0,40,39,4,0,1,97.5
2000021053,28,3600,0.0,20,16,3,1,4,80.0
2000021054,23,3900,0.0,22,20,4,0,2,90.90909091
2000021054,6,3900,0.0,23,21,3,1,2,91.30434783
2000021055,30,1555,0.0,14,13,2,0,1,92.85714286
2000021055,30,2045,0.0,22,20,2,1,2,90.90909091
2000021055,4,3589,0.0,15,15,2,0,0,100.0
2000021056,12,3590,0.0,25,25,5,1,0,100.0
2000021056,15,3572,0.0,26,23,9,3,3,88.46153846
2000021057,10,3600,0.0,23,20,4,2,3,86.95652174
2000021057,14,3600,0.0,28,26,3,3,2,92.85714286
2000021058,20,3595,2.0,40,36,11,1,4,90.0
2000021058,17,3589,0.0,24,22,3,0,2,91.66666667
2000021059,18,3564,0.0,19,16,0,1,3,84.21052632
2000021059,16,3600,0.0,24,22,2,0,2,91.66666667
2000021060,23,3558,0.0,30,27,4,3,3,90.0
2000021060,7,3600,0.0,21,19,4,0,2,90.47619048
2000021061,24,3589,0.0,30,27,1,2,3,90.0
2000021061,9,3598,0.0,31,30,3,1,1,96.77419355
2000021062,29,3600,0.0,34,34,14,1,0,100.0
2000021062,11,3528,0.0,26,24,10,0,2,92.30769231
2000021063,5,3600,0.0,44,41,14,1,3,93.18181818
2000021063,13,3600,0.0,30,24,4,2,6,80.0
2000021064,27,3900,0.0,26,25,7,1,1,96.15384615
2000021064,25,3897,0.0,22,21,2,0,1,95.45454545
2000021065,6,3600,0.0,16,14,0,1,2,87.5
2000021065,8,3541,0.0,33,30,2,1,3,90.90909091
2000021066,3,2400,0.0,20,18,5,0,2,90.0
2000021066,3,1153,0.0,6,6,0,0,0,100.0
2000021066,4,3591,0.0,31,30,5,0,1,96.77419355
2000021067,7,3595,0.0,44,42,12,2,2,95.45454545
2000021067,15,3534,0.0,23,20,8,2,3,86.95652174
2000021068,5,3600,0.0,20,15,1,3,5,75.0
2000021068,14,3600,0.0,26,25,9,2,1,96.15384615
2000021069,10,3600,0.0,24,21,5,1,3,87.5
2000021069,13,3540,0.0,39,35,8,3,4,89.74358974
2000021070,2,3900,0.0,32,29,13,3,3,90.625
2000021070,29,3900,0.0,25,22,5,0,3,88.0
2000021071,27,3554,0.0,21,18,6,0,3,85.71428571
2000021071,18,3600,0.0,31,30,12,0,1,96.77419355
2000021072,17,3542,0.0,27,23,10,3,4,85.18518519
2000021072,17,1,0.0,0,0,0,0,0,
2000021072,21,3600,0.0,26,23,6,1,3,88.46153846
2000021073,19,3900,0.0,29,27,11,1,2,93.10344828
2000021073,20,3848,0.0,31,29,5,0,2,93.5483871
2000021074,1,3888,0.0,34,29,1,3,5,85.29411765
2000021074,22,3889,0.0,40,34,7,1,6,85.0
2000021075,28,3640,0.0,20,19,6,2,1,95.0
2000021075,26,3634,0.0,18,18,4,1,0,100.0
2000021076,2,3546,0.0,36,34,10,0,2,94.44444444
2000021076,12,3600,0.0,20,19,3,0,1,95.0
2000021077,23,3588,0.0,32,29,8,0,3,90.625
2000021077,11,3531,0.0,34,30,5,3,4,88.23529412
2000021078,24,3600,0.0,38,37,4,1,1,97.36842105
2000021078,16,3600,0.0,24,20,1,1,4,83.33333333
2000021079,9,3600,0.0,25,20,5,1,5,80.0
2000021079,25,3600,0.0,27,26,8,1,1,96.2962963
2000021080,30,3571,0.0,35,31,6,0,4,88.57142857
2000021080,21,3600,0.0,28,25,1,3,3,89.28571429
2000021081,17,3600,2.0,34,30,11,0,4,88.23529412
2000021081,28,1200,0.0,11,8,0,2,3,72.72727273
2000021081,28,2337,0.0,14,12,1,2,2,85.71428571
2000021082,15,2400,0.0,12,10,1,2,2,83.33333333
2000021082,15,1200,0.0,13,9,1,1,4,69.23076923
2000021082,3,3600,0.0,31,28,8,2,3,90.32258065
2000021083,18,3600,0.0,19,18,1,2,1,94.73684211
2000021083,29,3483,0.0,26,24,8,1,2,92.30769231
2000021084,25,3600,0.0,23,22,7,4,1,95.65217391
2000021084,30,3600,0.0,24,20,6,1,4,83.33333333
2000021085,1,3594,0.0,13,11,1,0,2,84.61538462
2000021085,20,3592,0.0,34,30,7,0,4,88.23529412
2000021086,4,3600,0.0,27,25,2,0,2,92.59259259
2000021086,22,3492,0.0,25,21,0,0,4,84.0
2000021087,27,3588,0.0,23,17,1,3,6,73.91304348
2000021087,26,3600,0.0,28,26,6,1,2,92.85714286
2000021088,10,3584,0.0,35,32,4,0,3,91.42857143
2000021088,7,3593,0.0,16,16,3,0,0,100.0
2000021089,13,3900,0.0,28,25,1,0,3,89.28571429
2000021089,8,3883,0.0,28,25,3,3,3,89.28571429
2000021090,6,3897,0.0,24,22,6,2,2,91.66666667
2000021090,5,3898,0.0,29,27,3,2,2,93.10344828
2000021091,2,3623,0.0,23,20,3,0,3,86.95652174
2000021091,19,3614,0.0,20,16,4,2,4,80.0
2000021092,28,3580,0.0,31,28,2,0,3,90.32258065
2000021092,21,934,0.0,9,9,0,0,0,100.0
2000021092,21,2655,0.0,16,15,3,0,1,93.75
2000021093,13,3600,0.0,35,34,6,0,1,97.14285714
2000021093,10,3532,0.0,19,16,2,0,3,84.21052632
2000021094,3,3600,0.0,23,19,2,0,4,82.60869565
2000021094,1,3600,0.0,11,11,1,1,0,100.0
2000021095,7,3541,0.0,17,16,0,0,1,94.11764706
2000021095,12,3600,0.0,26,26,2,0,0,100.0
2000021096,14,3594,0.0,34,31,3,0,3,91.17647059
2000021096,11,3551,0.0,32,28,3,0,4,87.5
2000021097,23,3868,0.0,33,32,9,0,1,96.96969697
2000021097,29,3897,0.0,34,33,3,1,1,97.05882353
2000021098,24,2994,0.0,24,18,6,0,6,75.0
2000021098,24,606,0.0,6,4,0,0,2,66.66666667
2000021098,25,3600,0.0,17,17,1,0,0,100.0
2000021099,18,3900,0.0,23,23,6,0,0,100.0
2000021099,30,3900,0.0,27,27,6,2,0,100.0
2000021100,9,3600,0.0,27,25,5,2,2,92.59259259
2000021100,27,1200,2.0,25,21,7,0,4,84.0
2000021100,27,2388,0.0,5,4,1,0,1,80.0
2000021101,22,3600,0.0,28,28,9,0,0,100.0
2000021101,26,3580,0.0,17,10,3,2,7,58.82352941
2000021102,8,3769,0.0,35,32,8,4,3,91.42857143
2000021102,6,3769,0.0,17,15,3,0,2,88.23529412
2000021103,11,3600,0.0,29,29,6,2,0,100.0
2000021103,14,3600,0.0,30,28,9,1,2,93.33333333
2000021104,30,3600,0.0,28,24,0,1,4,85.71428571
2000021104,17,3600,0.0,23,21,2,0,2,91.30434783
2000021105,18,3714,0.0,22,21,0,0,1,95.45454545
2000021105,16,3714,0.0,24,22,3,0,2,91.66666667
2000021106,21,3600,0.0,28,27,7,0,1,96.42857143
2000021106,19,3520,0.0,22,19,6,2,3,86.36363636
2000021107,4,3586,0.0,23,21,1,1,2,91.30434783
2000021107,20,3600,0.0,16,15,1,1,1,93.75
2000021108,9,3600,0.0,33,32,10,1,1,96.96969697
2000021108,28,3548,0.0,17,15,3,0,2,88.23529412
2000021109,23,3598,0.0,15,11,2,0,4,73.33333333
2000021109,1,3600,0.0,23,23,4,1,0,100.0
2000021110,5,3535,0.0,27,23,2,0,4,85.18518519
2000021110,12,3600,0.0,23,20,5,2,3,86.95652174
2000021111,15,3511,0.0,15,12,4,1,3,80.0
2000021111,13,3600,0.0,39,38,9,0,1,97.43589744
2000021112,2,3516,0.0,22,20,7,1,2,90.90909091
2000021112,25,3598,0.0,23,22,2,2,1,95.65217391
2000021113,21,3600,0.0,38,36,10,1,2,94.73684211
2000021113,6,3494,0.0,29,25,0,3,4,86.20689655
2000021113,6,38,0.0,0,0,0,0,0,
2000021114,12,3531,0.0,21,19,3,2,2,90.47619048
2000021114,7,3591,0.0,23,22,2,2,1,95.65217391
2000021115,4,3547,0.0,25,21,3,1,4,84.0
2000021115,10,3600,0.0,28,25,8,3,3,89.28571429
2000021116,11,3600,0.0,30,28,8,2,2,93.33333333
2000021116,8,3508,0.0,28,25,6,2,3,89.28571429
2000021117,17,3600,0.0,24,24,0,0,0,100.0
2000021117,3,1755,0.0,28,23,2,0,5,82.14285714
2000021117,3,1845,0.0,19,18,0,0,1,94.73684211
2000021118,15,3597,0.0,22,20,0,3,2,90.90909091
2000021118,14,3544,0.0,40,37,10,3,3,92.5
2000021119,20,3600,0.0,23,17,5,0,6,73.91304348
2000021119,29,3600,0.0,29,25,1,1,4,86.20689655
2000021120,16,2050,0.0,14,14,0,2,0,100.0
2000021120,16,1550,0.0,19,14,7,1,5,73.68421053
2000021120,19,3600,0.0,23,22,10,0,1,95.65217391
2000021121,9,3596,0.0,20,20,1,0,0,100.0
2000021121,18,3600,2.0,38,34,0,1,4,89.47368421
2000021122,22,2290,2.0,20,15,2,1,5,75.0
2000021122,22,1310,0.0,6,4,2,0,2,66.66666667
2000021122,27,3600,0.0,38,34,8,1,4,89.47368421
2000021123,24,3894,2.0,39,36,4,1,3,92.30769231
2000021123,26,3894,0.0,23,20,5,0,3,86.95652174
2000021124,5,3600,0.0,27,25,4,0,2,92.59259259
2000021124,1,3536,0.0,19,16,4,0,3,84.21052632
2000021125,6,3597,0.0,23,21,4,1,2,91.30434783
2000021125,3,3549,0.0,32,29,11,1,3,90.625
2000021126,20,3600,0.0,27,26,5,1,1,96.2962963
2000021126,16,3600,0.0,27,24,6,3,3,88.88888889
2000021127,19,3881,0.0,27,26,7,1,1,96.2962963
2000021127,25,3900,0.0,29,28,3,1,1,96.55172414
2000021128,23,3889,0.0,25,23,2,2,2,92.0
2000021128,30,3896,0.0,30,28,9,1,2,93.33333333
2000021129,2,3895,2.0,20,18,4,0,2,90.0
2000021129,27,3900,0.0,25,23,3,1,2,92.0
2000021130,4,3900,0.0,31,28,7,1,3,90.32258065
2000021130,9,3899,0.0,33,30,1,1,3,90.90909091
2000021131,8,3600,0.0,35,33,9,0,2,94.28571429
2000021131,12,3560,0.0,16,13,1,2,3,81.25
2000021132,7,3600,0.0,19,19,4,0,0,100.0
2000021132,11,3600,0.0,31,27,4,1,4,87.09677419
2000021133,29,3544,0.0,28,25,6,1,3,89.28571429
2000021133,22,3594,0.0,21,19,0,0,2,90.47619048
2000021134,28,3897,0.0,27,27,4,3,0,100.0
2000021134,26,3897,0.0,15,15,1,2,0,100.0
2000021135,7,3600,0.0,18,14,5,0,4,77.77777778
2000021135,5,3600,0.0,19,18,4,2,1,94.73684211
2000021136,1,3600,0.0,26,25,3,0,1,96.15384615
2000021136,14,3600,0.0,35,28,4,0,7,80.0
2000021137,29,3598,0.0,29,26,0,0,3,89.65517241
2000021137,20,3586,0.0,19,19,1,0,0,100.0
2000021138,26,3713,0.0,29,26,5,2,3,89.65517241
2000021138,28,3713,0.0,19,17,2,2,2,89.47368421
2000021139,6,3600,0.0,24,24,0,0,0,100.0
2000021139,10,3600,0.0,24,21,0,0,3,87.5
2000021140,2,3600,0.0,27,23,7,3,4,85.18518519
2000021140,3,3572,0.0,36,34,7,0,2,94.44444444
2000021141,12,2010,0.0,21,17,5,1,4,80.95238095
2000021141,12,1590,0.0,20,17,2,0,3,85.0
2000021141,15,3587,0.0,18,18,2,1,0,100.0
2000021142,1,3592,0.0,31,29,1,0,2,93.5483871
2000021142,11,3576,0.0,29,25,2,0,4,86.20689655
2000021143,8,3883,0.0,25,23,6,0,2,92.0
2000021143,13,3883,0.0,40,38,4,2,2,95.0
2000021144,19,3536,0.0,32,28,5,1,4,87.5
2000021144,17,3600,0.0,27,25,0,1,2,92.59259259
2000021145,9,3596,0.0,19,17,1,0,2,89.47368421
2000021145,16,3592,0.0,30,25,1,2,5,83.33333333
2000021146,27,3600,0.0,29,29,4,3,0,100.0
2000021146,30,3575,0.0,19,17,2,0,2,89.47368421
2000021147,21,3552,0.0,29,26,1,0,3,89.65517241
2000021147,22,3590,0.0,25,24,1,1,1,96.0
2000021148,25,3597,0.0,28,27,3,3,1,96.42857143
2000021148,23,3491,0.0,29,26,6,1,3,89.65517241
2000021149,3,3600,0.0,30,26,13,3,4,86.66666667
2000021149,2,2359,0.0,16,11,4,2,5,68.75
2000021149,2,1191,0.0,7,7,0,1,0,100.0
2000021150,10,3594,0.0,39,38,4,1,1,97.43589744
2000021150,4,3516,2.0,27,25,3,0,2,92.59259259
2000021151,16,3561,0.0,30,26,3,0,4,86.66666667
2000021151,5,3600,0.0,24,22,0,1,2,91.66666667
2000021152,8,3600,0.0,31,29,4,3,2,93.5483871
2000021152,14,3584,0.0,24,18,4,0,6,75.0
2000021153,27,3636,0.0,32,28,3,0,4,87.5
2000021153,18,3636,0.0,30,27,2,0,3,90.0
2000021154,21,3600,0.0,29,29,10,1,0,100.0
2000021154,20,3529,0.0,16,15,4,4,1,93.75
2000021155,29,3600,0.0,31,28,2,3,3,90.32258065
2000021155,26,3600,0.0,27,27,4,1,0,100.0
2000021156,24,3591,2.0,35,29,3,1,6,82.85714286
2000021156,28,1147,0.0,8,5,1,1,3,62.5
2000021156,28,2453,0.0,13,12,4,0,1,92.30769231
2000021157,11,3598,0.0,28,24,3,0,4,85.71428571
2000021157,7,3600,0.0,30,30,4,1,0,100.0
2000021158,6,3746,0.0,26,21,3,3,5,80.76923077
2000021158,9,3744,0.0,48,44,14,0,4,91.66666667
2000021159,15,3785,2.0,37,33,13,1,4,89.18918919
2000021159,12,3783,0.0,21,18,3,0,3,85.71428571
2000021160,14,3600,0.0,34,32,4,1,2,94.11764706
2000021160,13,3563,0.0,26,23,2,0,3,88.46153846
2000021161,25,3600,0.0,23,19,2,1,4,82.60869565
2000021161,22,3505,0.0,21,16,1,1,5,76.19047619
2000021162,24,3900,0.0,33,31,4,0,2,93.93939394
2000021162,23,3899,0.0,23,21,3,1,2,91.30434783
2000021163,2,3570,2.0,23,20,5,0,3,86.95652174
2000021163,6,3600,0.0,23,21,0,0,2,91.30434783
2000021164,10,3566,0.0,21,18,2,0,3,85.71428571
2000021164,8,3600,2.0,33,32,5,0,1,96.96969697
2000021165,3,3600,0.0,41,38,7,3,3,92.68292683
2000021165,1,3545,0.0,19,15,3,0,4,78.94736842
2000021166,17,3528,2.0,31,30,5,1,1,96.77419355
2000021166,4,3600,0.0,21,21,0,1,0,100.0
2000021167,19,3564,0.0,18,14,2,0,4,77.77777778
2000021167,5,3596,0.0,34,31,4,0,3,91.17647059
2000021168,30,3599,0.0,30,26,2,0,4,86.66666667
2000021168,18,3600,0.0,42,41,7,1,1,97.61904762
2000021169,25,3600,0.0,27,27,3,0,0,100.0
2000021169,20,3547,0.0,17,15,0,0,2,88.23529412
2000021170,28,3569,0.0,33,31,4,0,2,93.93939394
2000021170,27,3590,0.0,17,16,0,0,1,94.11764706
2000021171,21,3600,0.0,20,16,3,0,4,80.0
2000021171,26,3600,0.0,19,19,4,0,0,100.0
2000021172,12,3678,0.0,24,22,3,0,2,91.66666667
2000021172,9,3676,0.0,35,32,4,0,3,91.42857143
2000021173,3,3600,0.0,34,32,6,0,2,94.11764706
2000021173,11,3590,0.0,28,25,5,2,3,89.28571429
2000021174,7,3600,0.0,22,20,5,1,2,90.90909091
2000021174,14,3590,0.0,24,21,3,1,3,87.5
2000021175,15,3604,0.0,42,40,15,2,2,95.23809524
2000021175,17,3611,0.0,22,21,2,0,1,95.45454545
2000021176,19,3529,0.0,17,15,5,0,2,88.23529412
2000021176,29,3600,0.0,30,29,1,4,1,96.66666667
2000021177,22,3891,0.0,27,24,4,0,3,88.88888889
2000021177,16,3900,0.0,29,26,4,3,3,89.65517241
2000021178,23,52,0.0,0,0,0,0,0,
2000021178,23,3503,0.0,15,13,1,0,2,86.66666667
2000021178,24,3600,0.0,30,29,2,0,1,96.66666667
2000021179,8,3773,0.0,34,31,3,0,3,91.17647059
2000021179,6,3773,0.0,25,23,5,2,2,92.0
2000021180,5,3600,0.0,29,25,4,0,4,86.20689655
2000021180,2,3600,0.0,36,35,2,1,1,97.22222222
2000021181,7,3600,0.0,20,17,3,0,3,85.0
2000021181,13,3564,0.0,32,28,6,2,4,87.5
2000021182,20,3900,0.0,26,22,1,4,4,84.61538462
2000021182,25,3900,0.0,39,35,4,2,4,89.74358974
2000021183,22,3586,0.0,28,24,7,0,4,85.71428571
2000021183,21,3593,0.0,25,22,6,0,3,88.0
2000021184,23,3499,0.0,16,13,1,0,3,81.25
2000021184,26,3600,0.0,32,31,3,0,1,96.875
2000021185,30,3585,0.0,31,27,6,2,4,87.09677419
2000021185,28,3600,0.0,23,21,3,3,2,91.30434783
2000021186,13,3600,0.0,40,39,3,2,1,97.5
2000021186,4,3513,0.0,19,17,0,0,2,89.47368421
2000021187,1,3594,0.0,26,22,2,1,4,84.61538462
2000021187,15,3497,0.0,35,29,6,0,6,82.85714286
2000021188,9,3581,0.0,20,16,5,1,4,80.0
2000021188,11,3595,0.0,33,31,8,1,2,93.93939394
2000021189,17,3559,4.0,25,23,9,0,2,92.0
2000021189,29,3600,0.0,36,35,5,2,1,97.22222222
2000021190,12,3861,0.0,32,30,2,0,2,93.75
2000021190,19,3900,2.0,27,25,4,0,2,92.59259259
2000021191,26,3900,0.0,25,23,7,3,2,92.0
2000021191,27,3900,0.0,23,21,6,0,2,91.30434783
2000021192,6,3600,0.0,27,25,1,1,2,92.59259259
2000021192,7,3544,0.0,22,19,0,4,3,86.36363636
2000021193,2,3600,0.0,40,36,4,0,4,90.0
2000021193,10,3600,0.0,27,25,1,0,2,92.59259259
2000021194,12,3595,0.0,25,24,1,0,1,96.0
2000021194,3,3541,0.0,38,36,9,0,2,94.73684211
2000021195,14,3590,0.0,36,33,4,1,3,91.66666667
2000021195,5,3600,0.0,25,23,4,1,2,92.0
2000021196,20,3600,0.0,31,29,10,0,2,93.5483871
2000021196,16,3581,0.0,20,16,1,0,4,80.0
2000021197,18,3518,0.0,20,16,3,2,4,80.0
2000021197,25,3600,0.0,21,20,4,1,1,95.23809524
2000021198,24,3900,0.0,28,27,2,0,1,96.42857143
2000021198,21,3878,0.0,29,28,4,1,1,96.55172414
2000021199,30,3900,0.0,43,41,11,1,2,95.34883721
2000021199,22,3866,0.0,19,17,4,1,2,89.47368421
2000021199,22,11,0.0,0,0,0,0,0,
2000021200,4,3829,0.0,24,21,3,1,3,87.5
2000021200,8,3829,0.0,31,29,2,1,2,93.5483871
2000021201,13,3598,0.0,34,31,9,2,3,91.17647059
2000021201,15,3586,0.0,28,28,13,0,0,100.0
2000021202,3,3803,0.0,28,25,5,2,3,89.28571429
2000021202,14,3803,0.0,35,31,4,0,4,88.57142857
2000021203,11,3600,2.0,37,33,6,3,4,89.18918919
2000021203,17,3595,0.0,16,16,2,2,0,100.0
2000021204,29,3600,2.0,40,36,10,0,4,90.0
2000021204,19,3597,0.0,27,26,2,2,1,96.2962963
2000021205,20,45,0.0,0,0,0,0,0,
2000021205,20,3555,2.0,30,26,4,0,4,86.66666667
2000021205,18,3600,0.0,33,33,4,3,0,100.0
2000021206,26,3799,0.0,30,27,0,0,3,90.0
2000021206,23,3799,0.0,21,19,4,1,2,90.47619048
2000021207,27,3477,0.0,24,22,0,0,2,91.66666667
2000021207,28,3600,0.0,28,28,6,3,0,100.0
2000021208,15,3519,0.0,27,25,7,0,2,92.59259259
2000021208,7,3600,0.0,42,41,5,2,1,97.61904762
2000021209,6,3527,0.0,32,27,0,2,5,84.375
2000021209,6,73,0.0,0,0,0,0,0,
2000021209,1,3600,0.0,16,14,0,0,2,87.5
2000021210,9,3600,0.0,28,25,4,0,3,89.28571429
2000021210,2,3600,0.0,24,20,2,0,4,83.33333333
2000021211,11,3560,0.0,26,23,6,1,3,88.46153846
2000021211,12,3600,0.0,24,22,5,1,2,91.66666667
2000021212,10,3600,0.0,27,27,5,2,0,100.0
2000021212,16,3519,2.0,17,16,6,0,1,94.11764706
2000021213,29,3568,0.0,32,29,4,1,3,90.625
2000021213,30,3600,0.0,19,17,3,0,2,89.47368421
2000021214,27,3600,0.0,34,32,10,2,2,94.11764706
2000021214,24,3600,2.0,23,18,4,1,5,78.26086957
2000021215,2,3541,0.0,27,23,0,0,4,85.18518519
2000021215,6,3600,0.0,31,29,0,0,2,93.5483871
2000021216,1,3600,0.0,21,21,5,2,0,100.0
2000021216,8,3598,0.0,33,31,3,1,2,93.93939394
2000021217,10,3600,0.0,34,29,7,0,5,85.29411765
2000021217,9,3595,0.0,38,35,7,3,3,92.10526316
2000021218,5,3879,0.0,39,35,13,1,4,89.74358974
2000021218,4,3865,0.0,14,11,1,0,3,78.57142857
2000021219,3,3600,0.0,24,21,1,8,3,87.5
2000021219,13,3567,0.0,25,25,10,0,0,100.0
2000021220,21,3546,0.0,30,26,9,0,4,86.66666667
2000021220,17,3598,0.0,31,28,6,1,3,90.32258065
2000021221,18,3599,0.0,27,26,3,0,1,96.2962963
2000021221,19,3600,0.0,19,19,3,0,0,100.0
2000021222,26,3600,0.0,33,31,9,2,2,93.93939394
2000021222,20,3522,0.0,28,25,8,3,3,89.28571429
2000021223,22,1852,0.0,22,21,6,2,1,95.45454545
2000021223,22,1748,2.0,7,6,3,0,1,85.71428571
2000021223,23,3515,0.0,15,12,3,3,3,80.0
2000021224,25,3730,0.0,23,19,2,0,4,82.60869565
2000021224,28,3708,0.0,28,23,0,3,5,82.14285714
2000021225,4,3600,0.0,37,36,9,1,1,97.2972973
2000021225,7,3572,0.0,17,15,2,1,2,88.23529412
2000021226,14,3494,0.0,25,23,3,0,2,92.0
2000021226,15,3562,0.0,24,23,2,1,1,95.83333333
2000021227,5,3600,0.0,31,27,8,0,4,87.09677419
2000021227,12,3505,0.0,22,16,1,1,6,72.72727273
2000021228,16,3757,2.0,28,24,7,0,4,85.71428571
2000021228,29,3757,0.0,32,29,5,1,3,90.625
2000021229,21,3600,0.0,21,19,2,0,2,90.47619048
2000021229,30,3575,0.0,27,24,5,0,3,88.88888889
2000021230,28,3600,0.0,23,22,2,0,1,95.65217391
2000021230,24,3600,0.0,28,24,0,0,4,85.71428571
2001020001,9,3600,0.0,27,23,7,0,4,85.18518519
2001020001,10,3554,0.0,24,19,8,1,5,79.16666667
2001020002,21,3600,0.0,33,32,9,1,1,96.96969697
2001020002,5,3600,0.0,20,17,3,0,3,85.0
2001020003,22,3550,0.0,28,27,9,2,1,96.42857143
2001020003,20,3600,0.0,24,24,16,0,0,100.0
2001020004,24,3556,2.0,37,33,3,0,4,89.18918919
2001020004,6,3597,0.0,23,21,4,0,2,91.30434783
2001020005,11,3599,0.0,28,27,8,0,1,96.42857143
2001020005,7,3536,0.0,20,18,0,3,2,90.0
2001020006,8,3600,0.0,41,37,7,0,4,90.24390244
2001020006,9,1174,0.0,11,9,2,0,2,81.81818182
2001020006,9,2400,0.0,15,11,3,0,4,73.33333333
2001020007,13,3522,0.0,29,25,3,0,4,86.20689655
2001020007,4,3600,0.0,34,32,8,0,2,94.11764706
2001020008,19,3900,0.0,31,28,6,0,3,90.32258065
2001020008,29,3864,0.0,43,40,6,7,3,93.02325581
2001020009,16,3600,0.0,27,23,1,2,4,85.18518519
2001020009,23,3525,0.0,33,28,3,1,5,84.84848485
2001020010,27,3900,0.0,33,31,5,1,2,93.93939394
2001020010,26,3897,0.0,17,15,6,2,2,88.23529412
2001020011,17,3699,0.0,21,18,7,1,3,85.71428571
2001020011,28,3692,0.0,39,35,8,2,4,89.74358974
2001020012,3,3592,0.0,31,28,3,1,3,90.32258065
2001020012,12,3600,2.0,30,29,6,2,1,96.66666667
2001020013,2,3600,0.0,25,23,5,0,2,92.0
2001020013,14,3559,0.0,34,31,7,3,3,91.17647059
2001020014,18,3600,0.0,17,13,2,0,4,76.47058824
2001020014,25,3600,0.0,19,18,4,0,1,94.73684211
2001020015,11,3758,0.0,42,38,2,4,4,90.47619048
2001020015,6,3758,0.0,20,17,4,1,3,85.0
2001020016,9,3547,0.0,30,27,6,1,3,90.0
2001020016,7,3597,0.0,32,30,10,0,2,93.75
2001020017,10,3900,0.0,22,20,1,0,2,90.90909091
2001020017,8,3900,0.0,29,27,4,1,2,93.10344828
2001020018,29,3900,0.0,40,37,8,0,3,92.5
2001020018,4,3880,0.0,18,15,1,2,3,83.33333333
2001020019,24,3600,0.0,43,41,7,3,2,95.34883721
2001020019,5,3539,0.0,20,16,5,1,4,80.0
2001020020,1,2400,0.0,20,15,2,3,5,75.0
2001020020,1,1200,0.0,5,4,0,0,1,80.0
2001020020,15,3596,0.0,38,37,8,0,1,97.36842105
2001020021,2,3586,0.0,31,31,8,3,0,100.0
2001020021,13,3531,0.0,22,20,3,1,2,90.90909091
2001020022,19,3894,0.0,23,21,8,1,2,91.30434783
2001020022,18,3875,0.0,27,25,13,0,2,92.59259259
2001020023,16,3600,0.0,25,21,3,0,4,84.0
2001020023,20,3600,0.0,23,23,9,0,0,100.0
2001020024,27,3590,0.0,40,35,10,0,5,87.5
2001020024,22,3595,0.0,16,14,2,1,2,87.5
2001020025,17,3569,0.0,30,29,13,1,1,96.66666667
2001020025,23,3596,2.0,19,15,5,0,4,78.94736842
2001020026,30,3900,0.0,36,36,9,2,0,100.0
2001020026,28,3900,0.0,19,19,1,4,0,100.0
2001020027,7,3762,0.0,27,22,2,2,5,81.48148148
2001020027,3,3759,0.0,25,21,6,0,4,84.0
2001020028,25,3600,0.0,28,25,5,0,3,89.28571429
2001020028,12,3599,0.0,32,32,7,0,0,100.0
2001020029,13,3600,0.0,28,28,10,3,0,100.0
2001020029,14,3600,0.0,37,32,5,0,5,86.48648649
2001020030,30,3600,0.0,31,28,2,0,3,90.32258065
2001020030,26,3560,0.0,27,23,4,2,4,85.18518519
2001020031,15,3597,0.0,32,28,12,3,4,87.5
2001020031,6,3589,0.0,22,22,5,1,0,100.0
2001020032,24,1922,0.0,12,11,4,0,1,91.66666667
2001020032,24,1678,0.0,19,14,2,0,5,73.68421053
2001020032,10,3600,0.0,22,21,6,0,1,95.45454545
2001020033,4,3898,0.0,30,28,7,1,2,93.33333333
2001020033,29,3900,0.0,32,30,7,2,2,93.75
2001020034,27,3625,0.0,27,26,15,0,1,96.2962963
2001020034,20,3623,0.0,27,25,7,1,2,92.59259259
2001020035,24,3518,0.0,17,15,3,2,2,88.23529412
2001020035,8,3594,0.0,25,24,6,0,1,96.0
2001020036,9,3600,0.0,27,25,5,0,2,92.59259259
2001020036,12,3600,0.0,27,21,8,0,6,77.77777778
2001020037,26,3568,0.0,19,17,4,0,2,89.47368421
2001020037,25,3600,2.0,26,25,4,1,1,96.15384615
2001020038,23,3565,0.0,31,26,9,1,5,83.87096774
2001020038,21,3600,0.0,32,28,3,0,4,87.5
2001020039,16,3528,0.0,29,28,5,1,1,96.55172414
2001020039,22,3598,0.0,11,11,6,1,0,100.0
2001020040,4,3527,0.0,23,21,8,2,2,91.30434783
2001020040,7,3600,0.0,27,26,2,2,1,96.2962963
2001020041,15,3576,0.0,27,25,9,1,2,92.59259259
2001020041,3,3549,0.0,42,37,18,0,5,88.0952381
2001020042,2,3600,0.0,32,29,7,1,3,90.625
2001020042,5,3584,0.0,24,19,5,0,5,79.16666667
2001020043,9,3581,0.0,36,36,5,1,0,100.0
2001020043,13,227,0.0,4,3,3,0,1,75.0
2001020043,13,3290,0.0,27,26,4,0,1,96.2962963
2001020044,20,3588,0.0,26,24,5,1,2,92.30769231
2001020044,17,3483,0.0,33,29,13,1,4,87.87878788
2001020045,6,3520,0.0,22,20,4,0,2,90.90909091
2001020045,30,3600,0.0,36,35,1,1,1,97.22222222
2001020046,2,3588,0.0,30,26,4,1,4,86.66666667
2001020046,1,3517,0.0,32,27,11,1,5,84.375
2001020047,10,3600,0.0,23,21,1,1,2,91.30434783
2001020047,12,3550,2.0,30,27,13,2,3,90.0
2001020048,27,3551,0.0,15,14,0,1,1,93.33333333
2001020048,16,3600,0.0,33,33,2,0,0,100.0
2001020049,26,3600,2.0,26,21,5,1,5,80.76923077
2001020049,19,3567,0.0,26,20,3,1,6,76.92307692
2001020050,23,3600,2.0,39,38,17,4,1,97.43589744
2001020050,25,3550,0.0,19,16,5,0,3,84.21052632
2001020051,20,3573,0.0,19,18,4,1,1,94.73684211
2001020051,18,3600,0.0,26,26,8,1,0,100.0
2001020052,21,3593,0.0,36,31,7,4,5,86.11111111
2001020052,22,3600,0.0,34,31,7,0,3,91.17647059
2001020053,14,3590,0.0,37,34,6,0,3,91.89189189
2001020053,28,3591,0.0,27,24,4,3,3,88.88888889
2001020054,7,3563,0.0,36,33,7,2,3,91.66666667
2001020054,17,3600,0.0,31,29,3,2,2,93.5483871
2001020055,8,3600,0.0,29,28,10,0,1,96.55172414
2001020055,29,3515,0.0,18,15,0,1,3,83.33333333
2001020056,16,1999,0.0,6,5,3,1,1,83.33333333
2001020056,16,1591,0.0,14,10,5,0,4,71.42857143
2001020056,30,3583,0.0,37,33,9,0,4,89.18918919
2001020057,15,3518,0.0,27,25,7,2,2,92.59259259
2001020057,24,3600,0.0,29,28,3,1,1,96.55172414
2001020058,19,3600,0.0,20,18,4,0,2,90.0
2001020058,10,3600,0.0,24,19,6,0,5,79.16666667
2001020059,1,3542,0.0,26,24,3,0,2,92.30769231
2001020059,8,3600,0.0,24,23,4,0,1,95.83333333
2001020060,3,3896,0.0,32,30,9,0,2,93.75
2001020060,9,3900,0.0,34,32,5,2,2,94.11764706
2001020061,17,3712,0.0,38,34,4,1,4,89.47368421
2001020061,2,3749,0.0,33,28,3,0,5,84.84848485
2001020062,12,3600,0.0,25,23,10,1,2,92.0
2001020062,11,3531,0.0,24,20,4,2,4,83.33333333
2001020063,4,3583,2.0,25,23,10,2,2,92.0
2001020063,13,3600,0.0,53,48,15,2,5,90.56603774
2001020064,20,3860,0.0,37,34,6,1,3,91.89189189
2001020064,25,3860,0.0,32,28,4,0,4,87.5
2001020065,22,3600,2.0,28,25,1,0,3,89.28571429
2001020065,18,3548,0.0,19,15,2,0,4,78.94736842
2001020066,21,3600,0.0,22,18,6,2,4,81.81818182
2001020066,23,3600,0.0,22,22,11,0,0,100.0
2001020067,15,3576,0.0,34,30,7,2,4,88.23529412
2001020067,27,3600,0.0,19,17,2,0,2,89.47368421
2001020068,14,3596,0.0,31,31,7,7,0,100.0
2001020068,26,3478,0.0,19,18,1,4,1,94.73684211
2001020069,6,3594,0.0,28,25,5,0,3,89.28571429
2001020069,28,3600,0.0,25,23,2,3,2,92.0
2001020070,5,3593,2.0,34,30,9,0,4,88.23529412
2001020070,7,3593,0.0,26,25,4,1,1,96.15384615
2001020071,29,3898,0.0,30,28,6,3,2,93.33333333
2001020071,16,3900,0.0,23,21,5,2,2,91.30434783
2001020072,22,3900,0.0,29,26,4,0,3,89.65517241
2001020072,30,3900,0.0,28,25,1,1,3,89.28571429
2001020073,14,3587,0.0,35,33,1,2,2,94.28571429
2001020073,24,3529,0.0,27,24,2,1,3,88.88888889
2001020074,3,3595,0.0,23,22,11,0,1,95.65217391
2001020074,8,3556,0.0,29,27,8,2,2,93.10344828
2001020075,18,3900,0.0,31,28,4,0,3,90.32258065
2001020075,7,3884,0.0,23,20,5,1,3,86.95652174
2001020076,9,3600,0.0,26,21,8,0,5,80.76923077
2001020076,5,3600,2.0,39,37,13,0,2,94.87179487
2001020077,4,3900,0.0,31,28,3,1,3,90.32258065
2001020077,11,3900,0.0,37,34,7,1,3,91.89189189
2001020078,29,3539,0.0,35,31,0,1,4,88.57142857
2001020078,17,3586,0.0,22,19,4,0,3,86.36363636
2001020079,28,3900,2.0,31,28,2,2,3,90.32258065
2001020079,30,3900,0.0,26,23,5,0,3,88.46153846
2001020080,14,3556,0.0,25,23,3,1,2,92.0
2001020080,21,3590,0.0,20,19,6,1,1,95.0
2001020081,10,3600,0.0,16,15,5,0,1,93.75
2001020081,22,2647,0.0,21,17,5,3,4,80.95238095
2001020081,22,945,0.0,4,4,0,0,0,100.0
2001020082,13,3897,0.0,20,18,2,1,2,90.0
2001020082,23,3897,0.0,26,24,3,1,2,92.30769231
2001020083,6,3897,0.0,32,31,6,0,1,96.875
2001020083,27,3895,0.0,35,34,6,2,1,97.14285714
2001020084,15,3605,0.0,32,30,7,0,2,93.75
2001020084,26,3621,0.0,32,29,8,1,3,90.625
2001020085,1,3672,0.0,32,28,5,1,4,87.5
2001020085,3,3680,0.0,49,46,11,0,3,93.87755102
2001020086,2,3593,0.0,20,20,6,2,0,100.0
2001020086,12,3600,2.0,29,25,6,1,4,86.20689655
2001020087,25,3900,0.0,32,30,4,0,2,93.75
2001020087,19,3894,0.0,26,24,3,0,2,92.30769231
2001020088,6,3900,0.0,31,29,7,0,2,93.5483871
2001020088,24,3894,0.0,41,39,1,2,2,95.12195122
2001020089,5,3599,0.0,29,29,9,4,0,100.0
2001020089,9,3581,0.0,31,29,10,1,2,93.5483871
2001020090,28,1679,0.0,20,16,7,2,4,80.0
2001020090,28,1914,0.0,17,15,0,2,2,88.23529412
2001020090,1,3600,0.0,25,24,4,1,1,96.0
2001020091,12,3823,0.0,37,35,15,0,2,94.59459459
2001020091,2,3817,0.0,20,19,0,0,1,95.0
2001020092,4,3600,2.0,37,34,6,1,3,91.89189189
2001020092,17,3564,0.0,21,19,5,0,2,90.47619048
2001020093,27,3572,0.0,18,16,6,0,2,88.88888889
2001020093,25,3570,0.0,21,20,1,1,1,95.23809524
2001020094,16,3595,0.0,23,20,5,1,3,86.95652174
2001020094,18,3550,0.0,39,35,3,2,4,89.74358974
2001020095,22,3600,0.0,29,28,9,0,1,96.55172414
2001020095,21,3600,0.0,30,26,6,3,4,86.66666667
2001020096,13,3540,0.0,20,17,5,0,3,85.0
2001020096,20,3600,0.0,20,19,2,1,1,95.0
2001020097,10,3600,0.0,30,25,7,0,5,83.33333333
2001020097,23,24,0.0,0,0,0,0,0,
2001020097,23,3529,0.0,18,12,0,0,6,66.66666667
2001020098,24,3550,0.0,26,23,4,2,3,88.46153846
2001020098,26,3600,0.0,24,23,5,3,1,95.83333333
2001020099,29,3600,0.0,30,29,8,0,1,96.66666667
2001020099,7,3537,0.0,16,14,5,0,2,87.5
2001020100,8,2398,0.0,26,22,4,0,4,84.61538462
2001020100,8,1200,0.0,9,9,1,1,0,100.0
2001020100,15,3600,0.0,29,28,3,2,1,96.55172414
2001020101,3,3600,2.0,35,32,6,0,3,91.42857143
2001020101,11,3517,0.0,43,39,8,0,4,90.69767442
2001020102,19,3623,0.0,16,14,1,1,2,87.5
2001020102,30,3646,0.0,34,31,1,1,3,91.17647059
2001020103,7,3596,0.0,30,29,6,2,1,96.66666667
2001020103,8,3523,0.0,21,19,5,2,2,90.47619048
2001020103,8,13,0.0,1,1,0,0,0,100.0
2001020104,9,3531,0.0,18,15,1,1,3,83.33333333
2001020104,1,3600,2.0,23,21,6,0,2,91.30434783
2001020105,28,3856,0.0,40,38,5,3,2,95.0
2001020105,2,3892,0.0,37,35,8,5,2,94.59459459
2001020106,15,1200,0.0,10,9,2,0,1,90.0
2001020106,15,2400,0.0,29,24,4,0,5,82.75862069
2001020106,4,3600,0.0,22,19,1,1,3,86.36363636
2001020107,11,3684,2.0,29,27,7,0,2,93.10344828
2001020107,12,3665,2.0,24,23,5,3,1,95.83333333
2001020108,3,2400,0.0,30,25,8,1,5,83.33333333
2001020108,3,1178,0.0,6,6,3,0,0,100.0
2001020108,14,3600,0.0,35,33,7,1,2,94.28571429
2001020109,26,3527,0.0,28,25,7,4,3,89.28571429
2001020109,17,3581,0.0,30,28,7,0,2,93.33333333
2001020110,21,3600,0.0,24,24,6,0,0,100.0
2001020110,29,1200,0.0,3,2,0,0,1,66.66666667
2001020110,29,2397,0.0,17,13,3,1,4,76.47058824
2001020111,5,3815,0.0,29,27,1,0,2,93.10344828
2001020111,19,3815,0.0,16,15,4,1,1,93.75
2001020112,16,3900,0.0,25,23,7,1,2,92.0
2001020112,25,3897,2.0,32,30,3,4,2,93.75
2001020113,6,3600,0.0,28,27,5,0,1,96.42857143
2001020113,18,3506,0.0,43,41,4,4,2,95.34883721
2001020114,10,3600,0.0,23,19,3,1,4,82.60869565
2001020114,20,3600,0.0,23,22,6,0,1,95.65217391
2001020115,13,3600,0.0,23,17,5,0,6,73.91304348
2001020115,22,3600,0.0,25,23,10,0,2,92.0
2001020116,23,3509,0.0,29,25,3,1,4,86.20689655
2001020116,27,3594,0.0,37,35,5,2,2,94.59459459
2001020117,21,3535,2.0,23,19,3,1,4,82.60869565
2001020117,16,3600,0.0,16,14,3,0,2,87.5
2001020118,23,243,0.0,0,0,0,0,0,
2001020118,23,3204,0.0,30,27,4,3,3,90.0
2001020118,24,3600,0.0,33,32,8,0,1,96.96969697
2001020119,28,3590,0.0,32,31,9,1,1,96.875
2001020119,3,3600,0.0,31,26,6,0,5,83.87096774
2001020120,20,3583,0.0,28,26,6,1,2,92.85714286
2001020120,19,3534,0.0,18,15,3,0,3,83.33333333
2001020121,18,3600,0.0,26,24,5,2,2,92.30769231
2001020121,22,3491,0.0,24,20,2,2,4,83.33333333
2001020122,28,3551,0.0,27,24,4,1,3,88.88888889
2001020122,7,3600,0.0,20,19,4,2,1,95.0
2001020123,6,3524,0.0,20,19,3,2,1,95.0
2001020123,10,3600,0.0,30,30,2,1,0,100.0
2001020124,1,3600,0.0,29,28,1,0,1,96.55172414
2001020124,9,3547,0.0,23,21,0,0,2,91.30434783
2001020125,5,3600,0.0,17,15,7,2,2,88.23529412
2001020125,11,3586,0.0,39,35,7,2,4,89.74358974
2001020126,15,3876,0.0,24,23,3,1,1,95.83333333
2001020126,14,3900,0.0,21,20,3,1,1,95.23809524
2001020127,26,3600,0.0,31,30,10,0,1,96.77419355
2001020127,29,3585,0.0,30,23,3,1,7,76.66666667
2001020128,20,3600,0.0,29,23,1,0,6,79.31034483
2001020128,16,3600,0.0,29,26,5,1,3,89.65517241
2001020129,12,3592,0.0,37,32,9,2,5,86.48648649
2001020129,21,3597,0.0,24,23,8,3,1,95.83333333
2001020130,18,3585,0.0,22,18,4,1,4,81.81818182
2001020130,23,3600,0.0,21,19,1,1,2,90.47619048
2001020131,25,3537,0.0,26,23,8,1,3,88.46153846
2001020131,5,3600,0.0,33,31,7,2,2,93.93939394
2001020132,15,3645,2.0,25,22,4,0,3,88.0
2001020132,13,3636,0.0,26,22,6,0,4,84.61538462
2001020133,22,2893,0.0,30,26,0,3,4,86.66666667
2001020133,22,707,0.0,7,7,0,0,0,100.0
2001020133,17,3600,0.0,28,27,4,1,1,96.42857143
2001020134,12,3600,0.0,24,21,9,1,3,87.5
2001020134,30,2800,0.0,28,22,0,0,6,78.57142857
2001020134,30,800,0.0,3,2,1,0,1,66.66666667
2001020135,24,3709,0.0,26,24,5,1,2,92.30769231
2001020135,27,3709,0.0,34,31,8,1,3,91.17647059
2001020136,10,3612,0.0,32,30,3,1,2,93.75
2001020136,6,3608,0.0,17,16,1,0,1,94.11764706
2001020137,9,3600,0.0,28,26,4,0,2,92.85714286
2001020137,4,2603,0.0,21,16,0,1,5,76.19047619
2001020137,4,997,0.0,4,2,1,0,2,50.0
2001020138,26,3485,0.0,18,15,3,0,3,83.33333333
2001020138,14,3600,0.0,28,28,2,0,0,100.0
2001020139,22,3600,0.0,30,28,9,2,2,93.33333333
2001020139,29,3552,0.0,30,26,3,1,4,86.66666667
2001020140,28,3524,0.0,30,27,3,4,3,90.0
2001020140,16,3588,0.0,24,22,7,1,2,91.66666667
2001020141,3,3599,0.0,40,35,5,0,5,87.5
2001020141,19,3569,0.0,15,14,4,0,1,93.33333333
2001020142,23,2034,0.0,9,8,5,0,1,88.88888889
2001020142,23,1431,0.0,7,4,0,0,3,57.14285714
2001020142,21,3592,0.0,28,27,6,1,1,96.42857143
2001020143,18,3800,0.0,30,26,1,0,4,86.66666667
2001020143,20,3778,0.0,27,22,4,0,5,81.48148148
2001020144,8,2478,0.0,27,26,10,0,1,96.2962963
2001020144,8,1122,0.0,12,11,0,0,1,91.66666667
2001020144,7,3593,0.0,27,22,1,0,5,81.48148148
2001020145,2,3781,0.0,30,28,16,0,2,93.33333333
2001020145,12,3779,0.0,20,17,5,1,3,85.0
2001020146,15,3545,0.0,21,20,2,0,1,95.23809524
2001020146,11,3600,0.0,37,37,7,1,0,100.0
2001020147,26,3537,0.0,25,22,7,1,3,88.0
2001020147,13,3562,0.0,33,31,7,0,2,93.93939394
2001020148,25,3600,0.0,45,42,9,2,3,93.33333333
2001020148,17,3458,0.0,45,40,13,1,5,88.88888889
2001020149,3,3875,0.0,46,45,4,2,1,97.82608696
2001020149,6,3875,0.0,28,26,3,1,2,92.85714286
2001020150,5,3600,0.0,25,21,1,1,4,84.0
2001020150,10,3600,0.0,23,23,4,1,0,100.0
2001020151,4,3600,0.0,28,27,3,2,1,96.42857143
2001020151,8,3585,0.0,35,30,1,0,5,85.71428571
2001020152,19,3539,0.0,35,32,7,0,3,91.42857143
2001020152,9,3593,0.0,26,25,0,1,1,96.15384615
2001020153,7,3586,0.0,10,8,0,0,2,80.0
2001020153,1,3600,0.0,21,20,3,0,1,95.23809524
2001020154,14,1206,0.0,11,8,0,0,3,72.72727273
2001020154,14,2338,0.0,14,13,0,0,1,92.85714286
2001020154,11,3600,0.0,32,29,4,0,3,90.625
2001020155,17,2058,0.0,15,15,5,1,0,100.0
2001020155,17,1542,0.0,4,4,1,0,0,100.0
2001020155,18,3595,0.0,33,32,8,1,1,96.96969697
2001020156,30,3600,0.0,28,24,2,0,4,85.71428571
2001020156,20,3600,0.0,21,19,3,0,2,90.47619048
2001020157,23,3506,0.0,27,24,4,1,3,88.88888889
2001020157,22,3597,0.0,25,23,0,1,2,92.0
2001020158,21,3484,0.0,22,21,6,0,1,95.45454545
2001020158,27,3600,2.0,29,29,8,1,0,100.0
2001020159,29,3523,0.0,21,19,3,0,2,90.47619048
2001020159,28,3591,0.0,16,16,2,0,0,100.0
2001020160,25,3805,0.0,46,43,7,1,3,93.47826087
2001020160,2,3794,0.0,43,41,4,4,2,95.34883721
2001020161,13,3900,0.0,32,30,6,0,2,93.75
2001020161,5,3889,0.0,27,25,4,1,2,92.59259259
2001020162,26,3693,0.0,25,22,6,0,3,88.0
2001020162,12,3690,0.0,20,18,2,0,2,90.0
2001020163,6,3812,2.0,36,33,7,1,3,91.66666667
2001020163,16,3900,0.0,25,22,2,2,3,88.0
2001020164,21,3600,2.0,23,21,6,0,2,91.30434783
2001020164,24,3504,0.0,22,19,9,1,3,86.36363636
2001020165,25,3535,0.0,23,19,3,2,4,82.60869565
2001020165,3,3568,0.0,38,36,5,1,2,94.73684211
2001020166,1,3652,0.0,30,27,2,1,3,90.0
2001020166,6,3652,0.0,18,14,2,1,4,77.77777778
2001020167,27,3600,0.0,26,24,4,0,2,92.30769231
2001020167,7,3525,0.0,19,16,3,0,3,84.21052632
2001020168,14,3518,0.0,35,32,2,1,3,91.42857143
2001020168,14,15,0.0,0,0,0,0,0,
2001020168,10,3600,2.0,22,20,3,0,2,90.90909091
2001020169,13,3584,0.0,37,34,10,1,3,91.89189189
2001020169,2,3596,0.0,28,26,2,4,2,92.85714286
2001020170,4,3600,0.0,32,32,12,1,0,100.0
2001020170,15,3600,0.0,18,15,2,1,3,83.33333333
2001020171,17,3600,0.0,28,26,8,2,2,92.85714286
2001020171,12,3589,0.0,21,17,3,1,4,80.95238095
2001020172,9,3600,0.0,30,27,1,0,3,90.0
2001020172,11,3573,0.0,39,34,10,1,5,87.17948718
2001020173,26,2398,0.0,21,17,6,0,4,80.95238095
2001020173,26,1200,0.0,4,3,1,0,1,75.0
2001020173,16,3600,0.0,26,25,7,3,1,96.15384615
2001020174,30,3600,0.0,29,27,8,1,2,93.10344828
2001020174,18,3523,0.0,22,19,6,2,3,86.36363636
2001020175,8,2398,0.0,19,16,2,0,3,84.21052632
2001020175,8,1085,0.0,14,14,0,2,0,100.0
2001020175,22,3600,0.0,36,35,4,0,1,97.22222222
2001020176,29,29,0.0,0,0,0,0,0,
2001020176,29,3571,0.0,36,33,14,0,3,91.66666667
2001020176,23,3600,0.0,23,22,12,1,1,95.65217391
2001020177,13,3600,0.0,32,31,2,2,1,96.875
2001020177,3,3584,0.0,28,25,0,0,3,89.28571429
2001020178,5,3600,0.0,28,25,7,0,3,89.28571429
2001020178,4,3600,0.0,27,27,5,1,0,100.0
2001020179,17,3648,0.0,23,20,4,0,3,86.95652174
2001020179,25,3648,0.0,28,24,4,0,4,85.71428571
2001020180,18,3568,0.0,17,13,0,1,4,76.47058824
2001020180,30,3600,0.0,23,17,2,0,6,73.91304348
2001020181,19,3596,0.0,26,26,4,0,0,100.0
2001020181,21,3536,0.0,22,21,5,2,1,95.45454545
2001020182,28,3588,0.0,31,29,7,1,2,93.5483871
2001020182,24,3516,0.0,25,21,3,0,4,84.0
2001020183,27,3596,2.0,32,27,5,0,5,84.375
2001020183,1,3600,0.0,24,22,1,0,2,91.66666667
2001020184,10,3584,0.0,18,15,0,1,3,83.33333333
2001020184,5,3600,0.0,27,26,8,0,1,96.2962963
2001020185,12,3535,0.0,33,29,12,0,4,87.87878788
2001020185,19,3600,0.0,33,30,7,2,3,90.90909091
2001020186,29,3531,0.0,25,23,5,2,2,92.0
2001020186,20,3589,0.0,27,26,12,0,1,96.2962963
2001020187,8,3595,0.0,30,26,5,0,4,86.66666667
2001020187,23,3594,0.0,17,17,2,1,0,100.0
2001020188,16,3600,0.0,31,29,6,0,2,93.5483871
2001020188,26,3458,0.0,21,18,3,1,3,85.71428571
2001020189,11,3576,0.0,40,36,11,0,4,90.0
2001020189,28,3596,0.0,16,14,2,1,2,87.5
2001020190,14,3600,0.0,34,30,4,0,4,88.23529412
2001020190,7,3600,0.0,27,26,6,1,1,96.2962963
2001020191,27,3900,2.0,34,32,6,0,2,94.11764706
2001020191,15,3877,0.0,19,17,0,2,2,89.47368421
2001020192,3,3543,0.0,32,29,8,0,3,90.625
2001020192,12,3600,0.0,34,32,6,3,2,94.11764706
2001020193,2,3560,0.0,28,26,2,1,2,92.85714286
2001020193,17,3600,0.0,26,25,5,1,1,96.15384615
2001020194,18,3600,0.0,24,21,2,0,3,87.5
2001020194,25,3594,0.0,16,16,3,2,0,100.0
2001020195,21,3582,0.0,17,14,2,0,3,82.35294118
2001020195,30,3600,0.0,34,32,8,0,2,94.11764706
2001020196,29,3600,0.0,32,31,6,2,1,96.875
2001020196,22,3516,0.0,17,15,2,1,2,88.23529412
2001020197,16,1233,0.0,18,16,3,1,2,88.88888889
2001020197,16,2362,0.0,11,8,2,1,3,72.72727273
2001020197,24,3600,0.0,31,29,5,3,2,93.5483871
2001020198,21,3569,0.0,27,24,10,1,3,88.88888889
2001020198,10,3600,0.0,24,23,5,0,1,95.83333333
2001020199,7,3563,0.0,25,22,2,1,3,88.0
2001020199,9,3600,0.0,28,28,5,1,0,100.0
2001020200,6,3600,0.0,20,19,6,0,1,95.0
2001020200,1,3520,0.0,22,20,2,1,2,90.90909091
2001020200,1,19,0.0,0,0,0,0,0,
2001020201,2,3593,0.0,29,28,6,1,1,96.55172414
2001020201,4,3519,0.0,30,28,4,2,2,93.33333333
2001020202,14,3676,0.0,30,28,14,0,2,93.33333333
2001020202,5,3711,0.0,30,29,8,3,1,96.66666667
2001020203,3,3592,0.0,23,20,3,1,3,86.95652174
2001020203,13,3590,0.0,30,26,8,2,4,86.66666667
2001020204,15,3600,0.0,28,24,10,0,4,85.71428571
2001020204,19,3594,0.0,23,22,9,1,1,95.65217391
2001020205,25,3570,0.0,32,29,10,0,3,90.625
2001020205,18,3600,2.0,40,39,6,2,1,97.5
2001020206,8,3600,0.0,36,30,4,2,6,83.33333333
2001020206,20,3600,0.0,24,22,10,2,2,91.66666667
2001020207,11,3564,0.0,37,34,8,1,3,91.89189189
2001020207,26,3600,0.0,16,15,1,0,1,93.75
2001020208,23,3600,0.0,35,30,6,3,5,85.71428571
2001020208,28,3600,0.0,34,33,9,1,1,97.05882353
2001020209,27,3652,0.0,27,26,2,0,1,96.2962963
2001020209,12,3649,0.0,28,28,2,2,0,100.0
2001020210,17,1664,0.0,4,4,0,1,0,100.0
2001020210,17,1873,2.0,14,9,3,0,5,64.28571429
2001020210,16,3598,0.0,29,25,2,0,4,86.20689655
2001020211,22,3600,0.0,20,20,2,0,0,100.0
2001020211,30,3596,0.0,23,21,0,0,2,91.30434783
2001020212,11,3600,0.0,34,29,5,0,5,85.29411765
2001020212,24,3599,0.0,24,24,4,2,0,100.0
2001020213,22,3659,0.0,35,34,2,1,1,97.14285714
2001020213,6,3659,0.0,20,20,4,2,0,100.0
2001020214,15,3538,0.0,36,32,6,3,4,88.88888889
2001020214,10,3596,0.0,38,36,14,2,2,94.73684211
2001020215,21,3900,0.0,30,29,8,0,1,96.66666667
2001020215,8,3900,0.0,33,32,5,1,1,96.96969697
2001020216,14,3534,0.0,21,19,7,2,2,90.47619048
2001020216,2,3600,0.0,29,29,6,1,0,100.0
2001020217,30,3600,0.0,35,32,1,1,3,91.42857143
2001020217,3,3600,0.0,24,23,1,1,1,95.83333333
2001020218,5,3900,0.0,33,31,9,1,2,93.93939394
2001020218,12,3890,0.0,23,21,3,1,2,91.30434783
2001020219,23,3600,0.0,28,26,6,0,2,92.85714286
2001020219,29,3518,0.0,25,22,4,1,3,88.0
2001020220,4,3530,0.0,27,25,6,0,2,92.59259259
2001020220,16,3590,0.0,28,27,9,1,1,96.42857143
2001020221,28,3597,2.0,32,31,7,0,1,96.875
2001020221,19,3600,0.0,23,19,5,3,4,82.60869565
2001020222,11,3564,0.0,21,18,3,0,3,85.71428571
2001020222,1,3600,0.0,25,23,3,0,2,92.0
2001020223,5,3524,0.0,30,28,0,3,2,93.33333333
2001020223,13,3600,0.0,17,17,2,0,0,100.0
2001020224,28,3898,0.0,32,30,7,0,2,93.75
2001020224,25,3859,0.0,29,27,4,1,2,93.10344828
2001020225,17,3600,0.0,17,16,1,3,1,94.11764706
2001020225,27,3478,0.0,31,28,8,4,3,90.32258065
2001020226,20,3900,0.0,34,31,2,1,3,91.17647059
2001020226,24,3900,0.0,26,23,2,2,3,88.46153846
2001020227,30,3600,2.0,56,53,5,3,3,94.64285714
2001020227,6,3489,0.0,16,11,1,0,5,68.75
2001020228,11,2705,0.0,34,28,5,1,6,82.35294118
2001020228,11,893,0.0,9,7,0,0,2,77.77777778
2001020228,7,3600,0.0,16,16,1,0,0,100.0
2001020229,18,3493,0.0,13,10,1,0,3,76.92307692
2001020229,8,3598,0.0,32,31,9,0,1,96.875
2001020230,21,3523,0.0,31,30,3,1,1,96.77419355
2001020230,9,3600,0.0,21,21,5,0,0,100.0
2001020231,3,3600,0.0,39,37,12,1,2,94.87179487
2001020231,2,3598,0.0,28,22,4,2,6,78.57142857
2001020232,12,3590,0.0,36,34,10,3,2,94.44444444
2001020232,15,3583,0.0,28,25,6,2,3,89.28571429
2001020233,4,3599,0.0,23,22,2,0,1,95.65217391
2001020233,14,3468,0.0,35,33,0,0,2,94.28571429
2001020233,14,16,0.0,0,0,0,0,0,
2001020234,23,3576,0.0,23,21,1,0,2,91.30434783
2001020234,19,3600,0.0,23,22,6,0,1,95.65217391
2001020235,20,3596,0.0,28,26,6,3,2,92.85714286
2001020235,26,3537,0.0,21,18,5,0,3,85.71428571
2001020236,10,3806,0.0,29,26,4,2,3,89.65517241
2001020236,1,3799,0.0,17,15,4,1,2,88.23529412
2001020237,28,3515,0.0,27,24,10,1,3,88.88888889
2001020237,12,3590,0.0,31,29,11,1,2,93.5483871
2001020238,22,3600,0.0,23,23,9,0,0,100.0
2001020238,29,3597,0.0,22,19,3,2,3,86.36363636
2001020239,23,3553,0.0,31,29,10,0,2,93.5483871
2001020239,16,3600,0.0,23,22,3,1,1,95.65217391
2001020240,27,3600,2.0,26,25,2,0,1,96.15384615
2001020240,25,3588,0.0,23,18,3,1,5,78.26086957
2001020241,17,3600,0.0,19,19,3,1,0,100.0
2001020241,24,3508,0.0,27,26,6,2,1,96.2962963
2001020242,29,3600,0.0,37,36,8,1,1,97.2972973
2001020242,6,3594,0.0,18,13,4,3,5,72.22222222
2001020243,3,3593,0.0,31,29,5,0,2,93.5483871
2001020243,7,3538,2.0,21,17,2,3,4,80.95238095
2001020244,1,3900,0.0,23,22,8,0,1,95.65217391
2001020244,10,3900,0.0,34,33,4,0,1,97.05882353
2001020245,2,1412,0.0,8,8,0,0,0,100.0
2001020245,2,2140,0.0,18,15,0,0,3,83.33333333
2001020245,8,3600,0.0,24,22,2,0,2,91.66666667
2001020246,18,3526,0.0,30,27,4,0,3,90.0
2001020246,9,3600,0.0,18,16,2,0,2,88.88888889
2001020247,11,3598,0.0,20,17,2,0,3,85.0
2001020247,15,3600,0.0,34,34,10,4,0,100.0
2001020248,5,3869,0.0,34,31,9,0,3,91.17647059
2001020248,14,3869,0.0,31,29,4,2,2,93.5483871
2001020249,4,3857,0.0,18,16,1,0,2,88.88888889
2001020249,13,3857,0.0,36,33,3,0,3,91.66666667
2001020250,27,3586,0.0,38,34,8,1,4,89.47368421
2001020250,19,3600,0.0,24,23,3,6,1,95.83333333
2001020251,21,3522,0.0,24,22,1,0,2,91.66666667
2001020251,20,3600,0.0,36,36,4,1,0,100.0
2001020252,17,3788,0.0,29,26,5,2,3,89.65517241
2001020252,26,3807,0.0,22,20,3,2,2,90.90909091
2001020253,8,3656,0.0,32,29,0,1,3,90.625
2001020253,3,3656,0.0,22,20,2,1,2,90.90909091
2001020254,22,3895,0.0,28,27,1,0,1,96.42857143
2001020254,12,3900,0.0,28,27,5,0,1,96.42857143
2001020255,28,3661,0.0,29,26,3,2,3,89.65517241
2001020255,16,3661,0.0,28,26,7,1,2,92.85714286
2001020256,23,3600,0.0,18,18,5,1,0,100.0
2001020256,30,2400,0.0,20,15,1,0,5,75.0
2001020256,30,1200,0.0,6,6,0,0,0,100.0
2001020257,25,3899,0.0,22,20,1,3,2,90.90909091
2001020257,24,3900,2.0,44,42,15,0,2,95.45454545
2001020258,7,3570,2.0,19,16,5,0,3,84.21052632
2001020258,13,3575,0.0,30,26,5,1,4,86.66666667
2001020259,8,3545,0.0,34,30,1,0,4,88.23529412
2001020259,6,3600,2.0,20,17,3,0,3,85.0
2001020260,5,3597,0.0,26,25,5,0,1,96.15384615
2001020260,1,3521,0.0,17,13,2,1,4,76.47058824
2001020261,9,3600,0.0,32,27,6,0,5,84.375
2001020261,15,2400,0.0,20,14,2,1,6,70.0
2001020261,15,1196,0.0,14,9,1,0,5,64.28571429
2001020262,12,3530,0.0,24,20,2,0,4,83.33333333
2001020262,17,3591,0.0,24,21,7,0,3,87.5
2001020263,19,3895,0.0,29,26,5,0,3,89.65517241
2001020263,29,3884,2.0,27,25,0,1,2,92.59259259
2001020264,7,1592,0.0,13,12,0,2,1,92.30769231
2001020264,7,2007,2.0,9,7,2,0,2,77.77777778
2001020264,18,3600,0.0,20,19,2,1,1,95.0
2001020265,11,3564,0.0,38,35,1,0,3,92.10526316
2001020265,30,3582,0.0,16,14,1,0,2,87.5
2001020266,16,3550,0.0,26,23,6,1,3,88.46153846
2001020266,23,3599,0.0,25,23,5,2,2,92.0
2001020267,22,3771,0.0,30,26,4,1,4,86.66666667
2001020267,27,3756,0.0,30,25,6,1,5,83.33333333
2001020268,4,3497,0.0,27,23,0,1,4,85.18518519
2001020268,3,3600,0.0,42,40,6,2,2,95.23809524
2001020269,2,3900,0.0,30,27,4,0,3,90.0
2001020269,5,3900,0.0,44,41,5,2,3,93.18181818
2001020270,10,3587,2.0,28,26,3,3,2,92.85714286
2001020270,13,3512,0.0,34,31,3,0,3,91.17647059
2001020271,30,3566,2.0,30,29,6,2,1,96.66666667
2001020271,21,3600,0.0,26,26,11,0,0,100.0
2001020272,28,3600,2.0,29,27,9,0,2,93.10344828
2001020272,24,3594,0.0,23,19,4,2,4,82.60869565
2001020273,1,3651,0.0,44,39,5,1,5,88.63636364
2001020273,6,3702,0.0,30,26,1,1,4,86.66666667
2001020274,12,3900,0.0,37,36,7,1,1,97.2972973
2001020274,9,3899,0.0,21,20,2,1,1,95.23809524
2001020275,15,3599,0.0,25,20,3,2,5,80.0
2001020275,4,1458,0.0,11,11,0,0,0,100.0
2001020275,4,2142,0.0,13,13,1,1,0,100.0
2001020276,10,3600,0.0,20,18,2,0,2,90.0
2001020276,14,3591,0.0,22,19,1,2,3,86.36363636
2001020277,16,3900,0.0,23,21,5,0,2,91.30434783
2001020277,20,3892,0.0,25,23,0,0,2,92.0
2001020278,19,3563,0.0,23,21,4,0,2,91.30434783
2001020278,23,3600,0.0,29,28,7,3,1,96.55172414
2001020279,28,3548,0.0,37,32,10,2,5,86.48648649
2001020279,27,3595,0.0,29,26,5,3,3,89.65517241
2001020280,25,3600,0.0,27,24,1,0,3,88.88888889
2001020280,26,2400,0.0,17,14,0,0,3,82.35294118
2001020280,26,1114,0.0,8,7,2,0,1,87.5
2001020281,13,3600,0.0,31,31,6,1,0,100.0
2001020281,7,3554,0.0,18,16,2,1,2,88.88888889
2001020282,18,3887,0.0,29,25,4,1,4,86.20689655
2001020282,11,3900,0.0,39,35,10,0,4,89.74358974
2001020283,30,1200,0.0,16,13,8,0,3,81.25
2001020283,30,2400,0.0,24,19,1,0,5,79.16666667
2001020283,17,3596,0.0,20,17,3,1,3,85.0
2001020284,24,3505,0.0,34,31,2,5,3,91.17647059
2001020284,29,3600,0.0,27,25,12,0,2,92.59259259
2001020285,2,3553,0.0,28,27,5,1,1,96.42857143
2001020285,21,3600,0.0,31,31,4,4,0,100.0
2001020286,16,1200,0.0,9,7,0,0,2,77.77777778
2001020286,16,2400,0.0,31,26,1,1,5,83.87096774
2001020286,22,3582,0.0,28,27,4,1,1,96.42857143
2001020287,7,3509,0.0,27,24,2,3,3,88.88888889
2001020287,6,3600,2.0,21,20,9,2,1,95.23809524
2001020288,13,3835,0.0,45,44,8,1,1,97.77777778
2001020288,8,3831,0.0,23,23,4,0,0,100.0
2001020289,10,3895,0.0,27,25,9,0,2,92.59259259
2001020289,9,3895,0.0,30,29,5,0,1,96.66666667
2001020290,4,3598,0.0,34,33,2,0,1,97.05882353
2001020290,1,3567,0.0,25,22,2,1,3,88.0
2001020291,3,3881,0.0,36,35,6,0,1,97.22222222
2001020291,5,3881,2.0,26,26,3,4,0,100.0
2001020292,24,3576,0.0,31,28,8,3,3,90.32258065
2001020292,15,3596,0.0,30,29,11,0,1,96.66666667
2001020293,12,3563,0.0,23,22,4,1,1,95.65217391
2001020293,14,3600,0.0,26,26,5,0,0,100.0
2001020294,26,3580,0.0,33,29,5,1,4,87.87878788
2001020294,17,3600,0.0,10,8,2,1,2,80.0
2001020295,29,3537,0.0,30,27,7,3,3,90.0
2001020295,18,3600,0.0,29,27,5,2,2,93.10344828
2001020296,19,3445,0.0,19,17,9,0,2,89.47368421
2001020296,20,3537,0.0,38,38,9,1,0,100.0
2001020296,20,54,0.0,0,0,0,0,0,
2001020297,22,3879,0.0,27,25,6,0,2,92.59259259
2001020297,23,3900,0.0,26,24,4,1,2,92.30769231
2001020298,2,453,0.0,3,1,0,0,2,33.33333333
2001020298,2,3132,0.0,21,17,4,0,4,80.95238095
2001020298,27,3600,0.0,21,20,4,3,1,95.23809524
2001020299,25,3650,0.0,29,27,6,0,2,93.10344828
2001020299,28,3649,0.0,25,22,3,1,3,88.0
2001020300,21,3589,0.0,33,33,8,0,0,100.0
2001020300,1,3580,0.0,21,19,3,0,2,90.47619048
2001020301,11,2396,0.0,39,35,14,0,4,89.74358974
2001020301,11,1200,0.0,7,5,2,0,2,71.42857143
2001020301,3,3599,0.0,40,38,6,4,2,95.0
2001020302,26,3897,0.0,18,16,3,0,2,88.88888889
2001020302,30,3900,0.0,17,15,1,1,2,88.23529412
2001020303,13,3600,0.0,45,40,12,2,5,88.88888889
2001020303,10,3600,0.0,18,17,2,3,1,94.44444444
2001020304,29,3583,0.0,37,33,9,1,4,89.18918919
2001020304,12,3592,0.0,18,16,2,1,2,88.88888889
2001020305,7,3544,0.0,25,22,2,0,3,88.0
2001020305,11,3600,0.0,32,30,5,2,2,93.75
2001020306,2,3591,0.0,19,17,5,1,2,89.47368421
2001020306,25,35,0.0,0,0,0,0,0,
2001020306,25,3498,0.0,17,14,8,0,3,82.35294118
2001020307,6,3528,0.0,25,22,3,0,3,88.0
2001020307,8,3600,0.0,35,33,5,0,2,94.28571429
2001020308,23,2859,0.0,14,11,2,0,3,78.57142857
2001020308,23,741,0.0,3,3,0,0,0,100.0
2001020308,9,3600,0.0,26,26,4,1,0,100.0
2001020309,21,1848,0.0,13,13,6,0,0,100.0
2001020309,21,1698,0.0,18,13,2,0,5,72.22222222
2001020309,3,3600,0.0,39,36,11,0,3,92.30769231
2001020310,1,3900,0.0,17,14,1,0,3,82.35294118
2001020310,4,3900,0.0,45,42,5,0,3,93.33333333
2001020311,24,3566,0.0,21,18,1,0,3,85.71428571
2001020311,14,3600,0.0,29,27,3,0,2,93.10344828
2001020312,18,3600,0.0,31,25,1,1,6,80.64516129
2001020312,17,3600,0.0,32,29,1,1,3,90.625
2001020313,26,1823,0.0,23,19,3,0,4,82.60869565
2001020313,26,2074,0.0,17,16,2,0,1,94.11764706
2001020313,20,3900,0.0,21,16,2,1,5,76.19047619
2001020314,19,3526,0.0,28,26,1,0,2,92.85714286
2001020314,22,3600,0.0,24,24,5,1,0,100.0
2001020315,30,3876,0.0,28,26,0,0,2,92.85714286
2001020315,27,3876,0.0,25,24,0,0,1,96.0
2001020316,10,3499,0.0,25,21,6,0,4,84.0
2001020316,7,3600,0.0,27,25,2,0,2,92.59259259
2001020317,21,3543,2.0,27,22,7,0,5,81.48148148
2001020317,2,3600,0.0,28,24,3,2,4,85.71428571
2001020318,23,3600,0.0,28,27,8,0,1,96.42857143
2001020318,5,3596,0.0,21,17,9,0,4,80.95238095
2001020319,14,13,0.0,0,0,0,0,0,
2001020319,14,3556,0.0,48,45,4,0,3,93.75
2001020319,15,3600,0.0,25,23,2,1,2,92.0
2001020320,24,3600,2.0,25,19,3,2,6,76.0
2001020320,13,3600,0.0,30,30,3,0,0,100.0
2001020321,17,3848,0.0,38,38,14,0,0,100.0
2001020321,29,3857,0.0,33,32,0,0,1,96.96969697
2001020322,12,3900,0.0,38,34,1,0,4,89.47368421
2001020322,25,3900,0.0,21,17,2,0,4,80.95238095
2001020323,16,3588,0.0,23,19,3,2,4,82.60869565
2001020323,18,1200,0.0,7,5,0,1,2,71.42857143
2001020323,18,2400,0.0,20,19,2,0,1,95.0
2001020324,30,3600,0.0,22,22,2,1,0,100.0
2001020324,28,3526,0.0,17,15,2,0,2,88.23529412
2001020325,20,3900,0.0,29,25,3,1,4,86.20689655
2001020325,9,3900,0.0,31,27,6,0,4,87.09677419
2001020326,8,3598,0.0,21,19,4,0,2,90.47619048
2001020326,11,3588,0.0,36,32,7,0,4,88.88888889
2001020327,26,3600,0.0,17,15,2,1,2,88.23529412
2001020327,22,3515,0.0,24,20,2,1,4,83.33333333
2001020328,23,3537,2.0,30,27,5,2,3,90.0
2001020328,6,3600,4.0,22,20,8,0,2,90.90909091
2001020329,20,3600,0.0,22,17,4,1,5,77.27272727
2001020329,7,3600,0.0,31,29,1,0,2,93.5483871
2001020330,10,3538,4.0,21,18,3,1,3,85.71428571
2001020330,2,3594,0.0,25,24,5,0,1,96.0
2001020331,3,3595,4.0,51,45,18,1,6,88.23529412
2001020331,15,3597,2.0,23,21,9,2,2,91.30434783
2001020332,1,3516,0.0,22,20,5,2,2,90.90909091
2001020332,14,3600,0.0,29,29,6,1,0,100.0
2001020333,19,3485,0.0,24,21,1,4,3,87.5
2001020333,17,3600,0.0,35,34,9,1,1,97.14285714
2001020334,16,3900,0.0,23,21,5,1,2,91.30434783
2001020334,29,3900,0.0,31,29,4,0,2,93.5483871
2001020335,4,3900,0.0,30,27,10,0,3,90.0
2001020335,25,3897,0.0,28,25,0,0,3,89.28571429
2001020336,5,3574,0.0,27,22,5,0,5,81.48148148
2001020336,18,3600,0.0,27,27,4,0,0,100.0
2001020337,27,1200,2.0,6,6,4,0,0,100.0
2001020337,27,2400,0.0,21,16,5,0,5,76.19047619
2001020337,30,3600,0.0,22,20,9,0,2,90.90909091
2001020338,6,3534,0.0,12,10,1,0,2,83.33333333
2001020338,10,3600,0.0,29,29,4,1,0,100.0
2001020339,15,3534,0.0,43,39,9,0,4,90.69767442
2001020339,8,3600,0.0,32,29,2,1,3,90.625
2001020340,11,3600,0.0,35,32,6,0,3,91.42857143
2001020340,9,1200,0.0,13,10,1,0,3,76.92307692
2001020340,9,2400,0.0,10,7,2,0,3,70.0
2001020341,24,1698,0.0,16,13,0,2,3,81.25
2001020341,24,1843,0.0,10,8,1,1,2,80.0
2001020341,2,3596,4.0,37,34,2,0,3,91.89189189
2001020342,7,3528,0.0,27,24,7,1,3,88.88888889
2001020342,5,3600,0.0,19,18,4,0,1,94.73684211
2001020343,1,3600,0.0,25,24,3,1,1,96.0
2001020343,13,3596,0.0,31,26,1,2,5,83.87096774
2001020344,27,2258,0.0,15,13,0,0,2,86.66666667
2001020344,27,1200,0.0,13,10,3,0,3,76.92307692
2001020344,19,3600,0.0,30,27,4,0,3,90.0
2001020345,22,3571,0.0,24,23,8,0,1,95.83333333
2001020345,21,3600,0.0,11,11,1,0,0,100.0
2001020346,28,2937,0.0,17,14,0,0,3,82.35294118
2001020346,28,591,0.0,2,2,0,0,0,100.0
2001020346,26,3576,0.0,23,22,4,1,1,95.65217391
2001020347,24,3600,0.0,35,33,7,6,2,94.28571429
2001020347,3,3513,0.0,15,12,6,0,3,80.0
2001020348,23,3600,0.0,24,23,8,1,1,95.83333333
2001020348,4,3553,0.0,19,16,3,0,3,84.21052632
2001020349,14,3600,0.0,41,41,13,0,0,100.0
2001020349,12,3600,0.0,28,24,6,3,4,85.71428571
2001020350,16,3893,0.0,21,17,3,0,4,80.95238095
2001020350,17,3900,0.0,35,31,8,0,4,88.57142857
2001020351,20,3529,0.0,16,12,3,1,4,75.0
2001020351,29,3600,0.0,32,29,9,0,3,90.625
2001020352,25,3593,0.0,20,17,2,0,3,85.0
2001020352,30,3548,0.0,21,17,0,0,4,80.95238095
2001020353,14,2400,0.0,24,20,1,0,4,83.33333333
2001020353,14,1068,0.0,5,4,0,0,1,80.0
2001020353,6,3600,0.0,25,22,1,1,3,88.0
2001020354,3,3840,0.0,49,47,10,1,2,95.91836735
2001020354,7,3872,0.0,32,30,8,0,2,93.75
2001020355,12,3600,0.0,28,26,0,3,2,92.85714286
2001020355,10,3586,2.0,19,15,3,0,4,78.94736842
2001020356,11,3600,0.0,26,21,1,0,5,80.76923077
2001020356,8,3600,0.0,31,30,3,1,1,96.77419355
2001020357,15,3900,0.0,38,33,9,1,5,86.84210526
2001020357,2,66,0.0,0,0,0,0,0,
2001020357,2,3792,0.0,29,24,5,0,5,82.75862069
2001020358,1,1502,0.0,9,7,3,0,2,77.77777778
2001020358,1,2098,0.0,8,4,1,0,4,50.0
2001020358,5,3600,0.0,39,39,2,1,0,100.0
2001020359,20,3600,0.0,32,28,4,0,4,87.5
2001020359,17,3600,0.0,21,19,0,2,2,90.47619048
2001020360,27,3596,2.0,25,22,5,0,3,88.0
2001020360,29,3597,0.0,26,26,4,0,0,100.0
2001020361,9,3600,0.0,23,19,1,0,4,82.60869565
2001020361,19,3600,0.0,30,28,2,0,2,93.33333333
2001020362,23,3473,0.0,18,16,2,1,2,88.88888889
2001020362,30,3600,0.0,27,26,2,1,1,96.2962963
2001020363,13,3574,0.0,26,23,1,1,3,88.46153846
2001020363,21,3600,0.0,14,13,1,0,1,92.85714286
2001020364,18,3584,0.0,21,18,3,0,3,85.71428571
2001020364,28,3600,0.0,16,14,3,1,2,87.5
2001020365,12,3600,0.0,30,25,5,2,5,83.33333333
2001020365,3,3600,0.0,22,22,4,0,0,100.0
2001020366,7,3600,0.0,32,30,3,0,2,93.75
2001020366,15,3542,0.0,25,21,1,0,4,84.0
2001020367,23,3887,0.0,30,27,9,0,3,90.0
2001020367,16,3900,0.0,30,27,7,0,3,90.0
2001020368,22,3600,0.0,27,27,11,1,0,100.0
2001020368,24,3519,0.0,24,22,1,3,2,91.66666667
2001020369,8,3900,0.0,31,30,4,1,1,96.77419355
2001020369,2,3900,0.0,21,20,2,0,1,95.23809524
2001020370,6,3802,0.0,30,28,1,0,2,93.33333333
2001020370,4,3802,0.0,35,32,0,1,3,91.42857143
2001020371,11,3600,0.0,38,33,3,3,5,86.84210526
2001020371,14,3600,0.0,41,39,4,0,2,95.12195122
2001020372,19,3600,0.0,15,14,3,0,1,93.33333333
2001020372,29,3587,0.0,23,21,1,4,2,91.30434783
2001020373,13,1934,0.0,15,10,1,1,5,66.66666667
2001020373,13,1666,0.0,5,4,0,0,1,80.0
2001020373,30,3575,0.0,29,29,6,4,0,100.0
2001020374,25,3585,0.0,19,19,2,1,0,100.0
2001020374,20,3600,0.0,22,19,1,0,3,86.36363636
2001020375,18,3555,0.0,24,23,4,0,1,95.83333333
2001020375,27,3567,0.0,27,27,3,5,0,100.0
2001020376,22,3572,0.0,18,17,10,0,1,94.44444444
2001020376,26,99,0.0,0,0,0,0,0,
2001020376,26,3433,2.0,29,27,14,4,2,93.10344828
2001020377,5,2397,0.0,21,16,4,0,5,76.19047619
2001020377,5,1200,0.0,3,3,0,0,0,100.0
2001020377,28,3596,0.0,38,38,4,2,0,100.0
2001020378,12,830,0.0,10,6,1,0,4,60.0
2001020378,12,2770,0.0,17,15,1,1,2,88.23529412
2001020378,15,3600,0.0,28,26,7,0,2,92.85714286
2001020379,1,3548,0.0,27,23,2,2,4,85.18518519
2001020379,17,3600,0.0,38,36,1,1,2,94.73684211
2001020380,10,3600,0.0,19,18,1,0,1,94.73684211
2001020380,16,3557,2.0,20,18,8,0,2,90.0
2001020381,21,3600,0.0,33,31,11,0,2,93.93939394
2001020381,23,819,0.0,10,7,1,1,3,70.0
2001020381,23,2774,0.0,9,7,1,0,2,77.77777778
2001020382,28,3600,0.0,34,32,3,3,2,94.11764706
2001020382,24,3600,0.0,26,21,6,1,5,80.76923077
2001020383,16,3571,0.0,32,28,4,2,4,87.5
2001020383,10,3600,0.0,31,30,9,4,1,96.77419355
2001020384,3,3600,0.0,46,45,6,1,1,97.82608696
2001020384,8,3563,0.0,27,25,3,4,2,92.59259259
2001020385,6,3654,0.0,24,22,1,0,2,91.66666667
2001020385,9,3654,0.0,35,34,4,1,1,97.14285714
2001020386,17,3600,0.0,29,25,2,0,4,86.20689655
2001020386,1,3600,0.0,17,16,4,0,1,94.11764706
2001020387,7,3600,0.0,25,23,2,4,2,92.0
2001020387,2,1121,0.0,8,8,0,0,0,100.0
2001020387,2,2400,0.0,21,18,5,3,3,85.71428571
2001020388,14,3600,0.0,42,40,8,0,2,95.23809524
2001020388,4,3600,0.0,15,15,0,1,0,100.0
2001020389,11,3600,0.0,33,31,1,1,2,93.93939394
2001020389,13,3543,0.0,27,23,1,0,4,85.18518519
2001020390,29,3540,0.0,37,33,5,5,4,89.18918919
2001020390,19,3600,0.0,22,19,4,0,3,86.36363636
2001020391,21,3897,0.0,31,29,3,2,2,93.5483871
2001020391,20,3899,0.0,26,24,5,2,2,92.30769231
2001020392,25,3600,0.0,33,29,6,0,4,87.87878788
2001020392,22,3571,0.0,23,18,2,0,5,78.26086957
2001020393,5,3598,0.0,39,34,9,2,5,87.17948718
2001020393,27,3600,0.0,21,19,4,2,2,90.47619048
2001020394,18,3466,0.0,35,31,2,0,4,88.57142857
2001020394,18,90,0.0,0,0,0,0,0,
2001020394,26,3575,0.0,22,20,5,2,2,90.90909091
2001020395,14,3570,0.0,27,26,4,1,1,96.2962963
2001020395,3,3600,0.0,20,20,1,1,0,100.0
2001020396,15,3769,0.0,26,23,7,0,3,88.46153846
2001020396,12,3804,0.0,27,23,6,0,4,85.18518519
2001020397,19,3893,0.0,27,23,3,1,4,85.18518519
2001020397,30,3900,0.0,34,30,10,3,4,88.23529412
2001020398,25,3600,2.0,28,26,7,4,2,92.85714286
2001020398,23,3394,0.0,27,23,8,0,4,85.18518519
2001020398,23,62,0.0,0,0,0,0,0,
2001020399,18,3533,0.0,31,27,5,0,4,87.09677419
2001020399,24,3600,0.0,23,21,3,0,2,91.30434783
2001020400,16,3600,0.0,23,21,2,0,2,91.30434783
2001020400,8,3537,0.0,36,33,4,0,3,91.66666667
2001020401,9,3594,0.0,25,21,1,0,4,84.0
2001020401,21,3600,0.0,34,32,1,1,2,94.11764706
2001020402,20,3600,2.0,26,26,10,0,0,100.0
2001020402,26,3566,0.0,19,18,3,0,1,94.73684211
2001020403,5,3600,0.0,27,27,3,0,0,100.0
2001020403,10,3569,0.0,23,22,3,0,1,95.65217391
2001020404,14,3891,0.0,42,41,2,2,1,97.61904762
2001020404,1,3900,0.0,11,10,1,0,1,90.90909091
2001020405,4,3597,0.0,20,18,5,0,2,90.0
2001020405,2,3540,0.0,40,37,10,2,3,92.5
2001020406,3,3600,0.0,35,30,0,1,5,85.71428571
2001020406,15,3600,0.0,20,18,0,0,2,90.0
2001020407,7,3600,0.0,27,25,4,0,2,92.59259259
2001020407,12,3536,0.0,24,20,1,1,4,83.33333333
2001020408,6,3600,0.0,25,23,2,1,2,92.0
2001020408,11,3549,0.0,35,32,0,0,3,91.42857143
2001020409,20,3900,0.0,34,32,5,0,2,94.11764706
2001020409,28,3892,0.0,22,20,1,0,2,90.90909091
2001020410,1,3600,0.0,27,26,2,1,1,96.2962963
2001020410,8,3569,0.0,28,26,3,1,2,92.85714286
2001020411,29,3589,0.0,29,27,2,1,2,93.10344828
2001020411,13,3600,0.0,23,23,3,1,0,100.0
2001020412,21,3600,0.0,31,30,5,2,1,96.77419355
2001020412,17,3600,0.0,18,14,4,0,4,77.77777778
2001020413,30,3600,0.0,27,23,3,0,4,85.18518519
2001020413,16,3600,0.0,21,19,0,0,2,90.47619048
2001020414,9,3600,0.0,23,20,3,0,3,86.95652174
2001020414,25,620,0.0,3,2,0,0,1,66.66666667
2001020414,25,2971,0.0,25,20,1,0,5,80.0
2001020415,24,3681,0.0,45,42,7,0,3,93.33333333
2001020415,22,3681,0.0,27,25,1,0,2,92.59259259
2001020416,19,3584,0.0,22,19,7,0,3,86.36363636
2001020416,27,3600,0.0,27,27,5,5,0,100.0
2001020417,5,3599,0.0,29,28,1,1,1,96.55172414
2001020417,6,3570,0.0,25,22,1,2,3,88.0
2001020418,10,3597,0.0,26,23,6,0,3,88.46153846
2001020418,3,3581,0.0,42,36,6,0,6,85.71428571
2001020419,2,3600,0.0,33,33,5,1,0,100.0
2001020419,4,3533,0.0,30,28,9,2,2,93.33333333
2001020420,15,3892,0.0,32,29,4,0,3,90.625
2001020420,11,3900,0.0,37,34,9,0,3,91.89189189
2001020421,29,3533,0.0,24,23,3,0,1,95.83333333
2001020421,14,3600,0.0,27,27,1,2,0,100.0
2001020422,9,3543,0.0,21,17,6,0,4,80.95238095
2001020422,18,3598,0.0,30,28,8,1,2,93.33333333
2001020423,28,3589,0.0,25,24,5,3,1,96.0
2001020423,20,1199,0.0,11,9,2,1,2,81.81818182
2001020423,20,2397,0.0,16,15,4,0,1,93.75
2001020424,24,3546,0.0,28,25,5,0,3,89.28571429
2001020424,23,3600,0.0,18,16,1,0,2,88.88888889
2001020425,19,3900,0.0,21,20,4,0,1,95.23809524
2001020425,26,3886,0.0,23,22,2,3,1,95.65217391
2001020426,21,3599,0.0,27,26,4,2,1,96.2962963
2001020426,7,3579,2.0,26,22,3,1,4,84.61538462
2001020427,27,3867,0.0,47,46,12,0,1,97.87234043
2001020427,17,3893,0.0,23,22,0,0,1,95.65217391
2001020428,2,3528,2.0,35,31,8,0,4,88.57142857
2001020428,16,3600,0.0,13,10,0,2,3,76.92307692
2001020429,22,2400,0.0,10,9,2,0,1,90.0
2001020429,22,1200,0.0,7,3,0,0,4,42.85714286
2001020429,25,3600,0.0,24,24,5,2,0,100.0
2001020430,7,1125,0.0,6,5,0,0,1,83.33333333
2001020430,7,2400,0.0,21,18,0,0,3,85.71428571
2001020430,6,3600,0.0,29,27,4,0,2,93.10344828
2001020431,3,3564,0.0,28,24,2,1,4,85.71428571
2001020431,10,3589,0.0,24,21,8,0,3,87.5
2001020432,27,3900,0.0,36,33,10,0,3,91.66666667
2001020432,8,3887,0.0,23,20,2,0,3,86.95652174
2001020433,14,3584,0.0,43,39,9,2,4,90.69767442
2001020433,9,3598,0.0,27,25,4,2,2,92.59259259
2001020434,15,3514,0.0,22,19,1,0,3,86.36363636
2001020434,1,3600,0.0,19,18,2,0,1,94.73684211
2001020435,30,1200,0.0,13,13,2,0,0,100.0
2001020435,30,2400,0.0,22,17,4,0,5,77.27272727
2001020435,4,3592,0.0,32,31,4,3,1,96.875
2001020436,11,1306,0.0,18,16,6,0,2,88.88888889
2001020436,11,2233,0.0,22,19,2,0,3,86.36363636
2001020436,5,3600,0.0,25,22,3,1,3,88.0
2001020437,12,3594,0.0,36,34,4,0,2,94.44444444
2001020437,13,3545,0.0,27,24,6,1,3,88.88888889
2001020438,21,3600,0.0,26,26,2,0,0,100.0
2001020438,29,3584,0.0,27,25,4,0,2,92.59259259
2001020439,26,3515,0.0,24,22,2,0,2,91.66666667
2001020439,19,3594,0.0,17,17,0,0,0,100.0
2001020440,22,3895,0.0,22,20,6,1,2,90.90909091
2001020440,18,3900,0.0,23,21,3,0,2,91.30434783
2001020441,24,3555,12.0,18,18,5,3,0,100.0
2001020441,24,32,0.0,0,0,0,0,0,
2001020441,20,3576,0.0,28,24,8,0,4,85.71428571
2001020442,28,3600,0.0,32,29,7,3,3,90.625
2001020442,23,3534,0.0,24,19,6,3,5,79.16666667
2001020443,26,3598,0.0,26,24,4,1,2,92.30769231
2001020443,16,1173,0.0,5,5,2,0,0,100.0
2001020443,16,2387,0.0,12,8,0,1,4,66.66666667
2001020444,30,3598,0.0,35,31,9,0,4,88.57142857
2001020444,8,3599,0.0,24,24,1,5,0,100.0
2001020445,12,3756,0.0,43,40,11,1,3,93.02325581
2001020445,3,3756,0.0,40,36,8,1,4,90.0
2001020446,4,3600,0.0,15,14,2,0,1,93.33333333
2001020446,11,3544,0.0,29,26,6,2,3,89.65517241
2001020447,1,3487,0.0,23,20,0,0,3,86.95652174
2001020447,29,3600,0.0,30,29,0,0,1,96.66666667
2001020448,24,3898,0.0,34,33,6,1,1,97.05882353
2001020448,21,3896,0.0,18,17,0,1,1,94.44444444
2001020449,17,3544,0.0,25,24,2,0,1,96.0
2001020449,20,3600,0.0,28,28,5,1,0,100.0
2001020450,14,3896,0.0,28,27,0,0,1,96.42857143
2001020450,23,3900,0.0,35,34,5,1,1,97.14285714
2001020451,27,3594,0.0,25,19,2,0,6,76.0
2001020451,10,3600,0.0,21,18,2,0,3,85.71428571
2001020452,9,3900,0.0,21,19,0,0,2,90.47619048
2001020452,2,3900,0.0,29,27,1,2,2,93.10344828
2001020453,5,3900,2.0,34,32,8,2,2,94.11764706
2001020453,15,3900,0.0,24,22,2,0,2,91.66666667
2001020454,26,3900,0.0,24,23,0,0,1,95.83333333
2001020454,18,3900,0.0,34,33,6,1,1,97.05882353
2001020455,22,3843,0.0,29,24,3,0,5,82.75862069
2001020455,28,3848,0.0,38,34,6,7,4,89.47368421
2001020456,2,3679,2.0,30,27,6,0,3,90.0
2001020456,1,3685,0.0,20,18,2,2,2,90.0
2001020457,18,3597,0.0,30,28,5,1,2,93.33333333
2001020457,3,3530,0.0,31,28,6,0,3,90.32258065
2001020458,6,3600,0.0,34,32,3,0,2,94.11764706
2001020458,5,3571,0.0,40,37,4,2,3,92.5
2001020459,13,1584,0.0,9,6,0,0,3,66.66666667
2001020459,13,2013,0.0,9,8,0,1,1,88.88888889
2001020459,12,3589,0.0,29,28,5,3,1,96.55172414
2001020460,8,3900,0.0,38,35,9,0,3,92.10526316
2001020460,11,3830,0.0,35,32,0,1,3,91.42857143
2001020461,19,3900,0.0,21,19,3,0,2,90.47619048
2001020461,16,3898,0.0,28,26,6,0,2,92.85714286
2001020462,7,3509,0.0,29,25,1,0,4,86.20689655
2001020462,25,472,0.0,4,2,0,0,2,50.0
2001020462,25,3128,0.0,14,13,2,0,1,92.85714286
2001020463,29,3600,0.0,43,38,3,0,5,88.37209302
2001020463,21,3600,0.0,20,19,2,1,1,95.0
2001020464,14,3600,0.0,29,28,4,1,1,96.55172414
2001020464,20,3505,0.0,21,18,3,0,3,85.71428571
2001020465,23,3833,0.0,26,26,7,2,0,100.0
2001020465,24,3818,2.0,38,37,3,3,1,97.36842105
2001020466,27,3600,0.0,39,33,1,0,6,84.61538462
2001020466,9,3600,0.0,18,18,3,0,0,100.0
2001020467,8,3600,0.0,33,31,12,0,2,93.93939394
2001020467,4,2400,0.0,15,12,0,1,3,80.0
2001020467,4,1138,0.0,6,6,0,0,0,100.0
2001020468,6,3509,0.0,20,18,2,1,2,90.0
2001020468,15,3587,0.0,36,35,6,2,1,97.22222222
2001020469,10,3643,0.0,28,25,7,0,3,89.28571429
2001020469,19,3643,0.0,18,14,0,0,4,77.77777778
2001020470,17,3600,0.0,23,22,6,0,1,95.65217391
2001020470,22,3543,0.0,29,27,5,2,2,93.10344828
2001020471,23,1200,0.0,11,8,0,3,3,72.72727273
2001020471,23,2278,0.0,11,9,3,1,2,81.81818182
2001020471,26,3600,0.0,29,26,5,0,3,89.65517241
2001020472,12,3650,0.0,39,36,9,1,3,92.30769231
2001020472,7,3650,0.0,24,22,3,0,2,91.66666667
2001020473,13,3597,0.0,28,26,0,1,2,92.85714286
2001020473,1,3519,0.0,22,19,1,1,3,86.36363636
2001020474,30,3600,0.0,41,39,14,2,2,95.12195122
2001020474,5,3563,0.0,20,16,3,0,4,80.0
2001020475,16,3600,0.0,31,30,3,0,1,96.77419355
2001020475,11,3513,0.0,31,28,2,1,3,90.32258065
2001020476,20,3600,0.0,28,25,2,0,3,89.28571429
2001020476,25,3561,0.0,17,13,1,0,4,76.47058824
2001020477,28,3600,0.0,38,38,8,3,0,100.0
2001020477,21,3597,0.0,16,13,3,1,3,81.25
2001020478,14,3544,0.0,35,33,0,3,2,94.28571429
2001020478,22,3600,0.0,23,22,3,1,1,95.65217391
2001020479,29,3600,0.0,37,35,6,0,2,94.59459459
2001020479,24,3532,0.0,20,17,1,0,3,85.0
2001020480,4,3600,0.0,34,32,5,3,2,94.11764706
2001020480,6,3600,0.0,31,26,1,0,5,83.87096774
2001020481,8,2400,0.0,31,27,4,1,4,87.09677419
2001020481,8,1166,0.0,17,15,3,0,2,88.23529412
2001020481,10,3600,0.0,16,12,0,0,4,75.0
2001020482,1,3600,0.0,39,39,10,0,0,100.0
2001020482,9,3527,0.0,18,16,2,1,2,88.88888889
2001020483,13,3600,0.0,37,36,3,1,1,97.2972973
2001020483,2,3538,0.0,19,17,2,0,2,89.47368421
2001020483,2,3,0.0,0,0,0,0,0,
2001020484,7,2708,0.0,21,18,5,0,3,85.71428571
2001020484,7,833,0.0,5,5,1,3,0,100.0
2001020484,3,3577,0.0,35,33,8,2,2,94.28571429
2001020485,11,3600,0.0,43,38,6,1,5,88.37209302
2001020485,15,3598,0.0,25,23,1,0,2,92.0
2001020486,20,3600,0.0,35,31,8,0,4,88.57142857
2001020486,19,3600,0.0,9,9,0,1,0,100.0
2001020487,16,3597,0.0,30,25,4,0,5,83.33333333
2001020487,18,3600,0.0,33,31,6,1,2,93.93939394
2001020488,17,3560,0.0,17,15,4,0,2,88.23529412
2001020488,23,3565,2.0,16,16,5,0,0,100.0
2001020489,25,3600,0.0,27,25,4,1,2,92.59259259
2001020489,27,3600,0.0,20,14,4,0,6,70.0
2001020490,29,3543,0.0,25,22,6,1,3,88.0
2001020490,26,3600,0.0,20,18,5,1,2,90.0
2001020491,22,3595,0.0,23,21,1,1,2,91.30434783
2001020491,4,3537,0.0,20,17,2,1,3,85.0
2001020492,12,3592,0.0,11,11,1,0,0,100.0
2001020492,5,2393,0.0,29,25,8,0,4,86.20689655
2001020492,5,1200,0.0,20,17,11,0,3,85.0
2001020493,21,3839,0.0,20,18,0,1,2,90.0
2001020493,30,3831,0.0,40,37,11,1,3,92.5
2001020494,26,3612,0.0,37,35,6,1,2,94.59459459
2001020494,24,3614,0.0,17,14,3,1,3,82.35294118
2001020495,14,3600,0.0,22,19,1,0,3,86.36363636
2001020495,8,3547,0.0,31,27,0,0,4,87.09677419
2001020496,13,3600,0.0,38,34,15,1,4,89.47368421
2001020496,3,3600,0.0,16,14,4,1,2,87.5
2001020497,16,3600,0.0,28,28,7,5,0,100.0
2001020497,17,3504,0.0,37,35,12,2,2,94.59459459
2001020498,28,3600,0.0,22,21,5,2,1,95.45454545
2001020498,25,3600,0.0,32,28,5,2,4,87.5
2001020499,29,3516,0.0,27,24,0,4,3,88.88888889
2001020499,27,3600,0.0,25,24,7,0,1,96.0
2001020500,11,3829,0.0,55,53,6,2,2,96.36363636
2001020500,6,3832,0.0,14,11,0,0,3,78.57142857
2001020501,26,3598,0.0,23,22,6,1,1,95.65217391
2001020501,10,3575,0.0,32,29,2,0,3,90.625
2001020502,22,3598,0.0,27,23,3,4,4,85.18518519
2001020502,2,3600,0.0,31,30,7,0,1,96.77419355
2001020503,19,3543,0.0,28,23,3,1,5,82.14285714
2001020503,4,3600,0.0,33,30,12,0,3,90.90909091
2001020504,9,3600,0.0,29,28,4,0,1,96.55172414
2001020504,12,3600,0.0,30,25,1,1,5,83.33333333
2001020505,24,3592,0.0,23,22,1,1,1,95.65217391
2001020505,30,3600,0.0,19,14,4,0,5,73.68421053
2001020506,16,3600,0.0,29,24,6,0,5,82.75862069
2001020506,7,1808,0.0,5,3,0,1,2,60.0
2001020506,7,1727,0.0,16,12,2,0,4,75.0
2001020507,1,3900,0.0,25,23,3,0,2,92.0
2001020507,3,3900,0.0,35,33,1,0,2,94.28571429
2001020508,8,3593,0.0,32,31,3,7,1,96.875
2001020508,5,3526,0.0,30,27,6,0,3,90.0
2001020509,28,3598,2.0,24,22,7,1,2,91.66666667
2001020509,11,3552,0.0,41,37,9,3,4,90.24390244
2001020510,15,3600,0.0,37,32,12,2,5,86.48648649
2001020510,13,3600,0.0,24,22,7,0,2,91.66666667
2001020511,23,3600,0.0,30,26,5,0,4,86.66666667
2001020511,17,3600,0.0,24,23,3,1,1,95.83333333
2001020512,24,3486,0.0,31,29,4,0,2,93.5483871
2001020512,21,3600,0.0,23,22,3,1,1,95.65217391
2001020513,20,3590,0.0,29,23,3,0,6,79.31034483
2001020513,27,3600,0.0,20,17,7,0,3,85.0
2001020514,8,3600,0.0,32,27,2,1,5,84.375
2001020514,6,3600,0.0,23,23,1,0,0,100.0
2001020515,26,2078,17.0,13,12,2,0,1,92.30769231
2001020515,26,1522,0.0,15,14,0,1,1,93.33333333
2001020515,9,2075,17.0,11,10,1,0,1,90.90909091
2001020515,9,1470,2.0,12,10,3,0,2,83.33333333
2001020516,22,3900,0.0,33,30,4,0,3,90.90909091
2001020516,1,3900,2.0,15,12,2,0,3,80.0
2001020517,25,3583,2.0,29,27,9,0,2,93.10344828
2001020517,4,3597,2.0,30,29,2,1,1,96.66666667
2001020518,23,3598,2.0,30,24,8,3,6,80.0
2001020518,18,3590,0.0,30,28,11,4,2,93.33333333
2001020519,10,3897,0.0,28,25,7,0,3,89.28571429
2001020519,7,3900,0.0,33,30,7,2,3,90.90909091
2001020520,2,3600,0.0,29,28,0,1,1,96.55172414
2001020520,3,3526,0.0,30,28,1,0,2,93.33333333
2001020521,15,1162,0.0,6,5,0,0,1,83.33333333
2001020521,15,2400,0.0,16,13,1,0,3,81.25
2001020521,5,3600,0.0,25,22,10,0,3,88.0
2001020522,11,3688,0.0,39,34,3,0,5,87.17948718
2001020522,12,3677,0.0,23,19,0,0,4,82.60869565
2001020523,19,3809,0.0,18,14,0,1,4,77.77777778
2001020523,14,3809,0.0,40,37,5,1,3,92.5
2001020524,28,3600,0.0,29,26,3,3,3,89.65517241
2001020524,17,3583,0.0,19,19,3,0,0,100.0
2001020525,22,3600,0.0,20,15,1,1,5,75.0
2001020525,16,3600,0.0,22,21,4,0,1,95.45454545
2001020526,20,3890,0.0,34,32,6,0,2,94.11764706
2001020526,21,3900,0.0,27,25,5,1,2,92.59259259
2001020527,27,3523,0.0,28,26,6,1,2,92.85714286
2001020527,24,3587,2.0,31,30,3,0,1,96.77419355
2001020528,7,3525,0.0,28,25,5,0,3,89.28571429
2001020528,10,3593,0.0,18,16,1,2,2,88.88888889
2001020529,26,3516,0.0,16,14,5,0,2,87.5
2001020529,26,29,0.0,0,0,0,0,0,
2001020529,8,3600,0.0,29,28,2,0,1,96.55172414
2001020530,9,3600,0.0,23,23,4,0,0,100.0
2001020530,1,3522,0.0,22,21,4,0,1,95.45454545
2001020531,6,3600,0.0,26,24,4,1,2,92.30769231
2001020531,2,3500,0.0,30,26,0,1,4,86.66666667
2001020532,12,3627,0.0,26,22,2,2,4,84.61538462
2001020532,4,3627,0.0,23,20,3,0,3,86.95652174
2001020533,5,3894,2.0,29,25,4,0,4,86.20689655
2001020533,15,3816,2.0,34,30,4,1,4,88.23529412
2001020534,19,3600,0.0,17,17,1,0,0,100.0
2001020534,13,3600,0.0,40,38,12,1,2,95.0
2001020535,25,3600,0.0,29,27,1,1,2,93.10344828
2001020535,29,3581,0.0,29,26,6,0,3,89.65517241
2001020536,28,3900,0.0,31,30,2,1,1,96.77419355
2001020536,18,3871,0.0,24,23,1,1,1,95.83333333
2001020537,30,3600,0.0,29,28,10,1,1,96.55172414
2001020537,23,3525,2.0,20,18,9,0,2,90.0
2001020538,9,3546,0.0,29,26,8,1,3,89.65517241
2001020538,3,3588,0.0,25,23,1,2,2,92.0
2001020539,25,3590,0.0,32,31,3,1,1,96.875
2001020539,11,3600,0.0,25,21,3,0,4,84.0
2001020540,17,3600,0.0,23,23,3,2,0,100.0
2001020540,16,1818,0.0,8,7,1,0,1,87.5
2001020540,16,1782,0.0,17,13,0,0,4,76.47058824
2001020541,30,3600,0.0,49,43,4,0,6,87.75510204
2001020541,21,3600,2.0,21,18,2,0,3,85.71428571
2001020542,24,3600,0.0,24,24,4,0,0,100.0
2001020542,27,2400,0.0,17,13,1,0,4,76.47058824
2001020542,27,1200,0.0,6,6,0,0,0,100.0
2001020543,9,3550,0.0,25,22,3,1,3,88.0
2001020543,6,3600,0.0,36,34,2,1,2,94.44444444
2001020544,8,3548,0.0,33,31,5,0,2,93.93939394
2001020544,7,3593,0.0,16,15,1,1,1,93.75
2001020545,5,2400,2.0,31,27,9,0,4,87.09677419
2001020545,5,1200,0.0,10,10,0,1,0,100.0
2001020545,1,3600,0.0,20,20,1,0,0,100.0
2001020546,4,3596,0.0,23,22,2,1,1,95.65217391
2001020546,15,3592,0.0,31,27,3,2,4,87.09677419
2001020547,10,3559,0.0,28,24,2,0,4,85.71428571
2001020547,12,3600,0.0,25,22,4,0,3,88.0
2001020548,13,1943,0.0,10,8,4,0,2,80.0
2001020548,13,1948,0.0,5,4,1,0,1,80.0
2001020548,11,3900,0.0,41,38,2,4,3,92.68292683
2001020549,16,3596,0.0,24,23,0,0,1,95.83333333
2001020549,19,3525,0.0,18,15,0,0,3,83.33333333
2001020550,21,3600,0.0,31,31,7,0,0,100.0
2001020550,25,3511,0.0,15,13,1,0,2,86.66666667
2001020551,14,3598,0.0,31,31,4,0,0,100.0
2001020551,18,3532,0.0,22,21,2,0,1,95.45454545
2001020552,17,3900,0.0,24,21,2,0,3,87.5
2001020552,30,3900,0.0,23,20,3,0,3,86.95652174
2001020553,20,3511,0.0,26,23,4,1,3,88.46153846
2001020553,22,3598,0.0,19,17,6,0,2,89.47368421
2001020554,26,3900,0.0,26,25,3,0,1,96.15384615
2001020554,27,3900,0.0,25,24,5,1,1,96.0
2001020555,24,3599,0.0,28,27,6,3,1,96.42857143
2001020555,28,3525,2.0,27,25,9,2,2,92.59259259
2001020556,2,3556,0.0,36,33,10,1,3,91.66666667
2001020556,9,3597,0.0,29,27,6,6,2,93.10344828
2001020557,12,3593,0.0,32,30,3,1,2,93.75
2001020557,14,3504,0.0,28,25,2,0,3,89.28571429
2001020558,29,3591,0.0,33,28,8,3,5,84.84848485
2001020558,17,3600,0.0,28,27,6,0,1,96.42857143
2001020559,21,3585,0.0,21,19,7,0,2,90.47619048
2001020559,16,3600,0.0,24,23,3,0,1,95.83333333
2001020560,20,3600,0.0,25,21,4,2,4,84.0
2001020560,23,3600,0.0,20,18,6,1,2,90.0
2001020561,24,3900,0.0,21,19,0,1,2,90.47619048
2001020561,26,3897,0.0,25,23,5,0,2,92.0
2001020562,10,3539,0.0,20,15,0,1,5,75.0
2001020562,11,3600,0.0,30,26,3,1,4,86.66666667
2001020563,6,3600,0.0,26,25,4,3,1,96.15384615
2001020563,13,1253,0.0,13,11,6,1,2,84.61538462
2001020563,13,2338,0.0,15,10,1,0,5,66.66666667
2001020564,8,3600,0.0,28,25,1,3,3,89.28571429
2001020564,19,3600,0.0,24,24,4,0,0,100.0
2001020565,15,3713,0.0,25,23,5,1,2,92.0
2001020565,25,3723,0.0,23,20,1,2,3,86.95652174
2001020566,30,3551,0.0,17,14,3,0,3,82.35294118
2001020566,22,3600,0.0,27,25,5,0,2,92.59259259
2001020567,4,2021,0.0,8,8,1,1,0,100.0
2001020567,4,1494,0.0,13,9,2,0,4,69.23076923
2001020567,27,3595,0.0,35,33,3,2,2,94.28571429
2001020568,3,3600,0.0,43,40,10,0,3,93.02325581
2001020568,28,2527,0.0,14,10,1,0,4,71.42857143
2001020568,28,989,0.0,3,2,0,0,1,66.66666667
2001020569,8,3670,0.0,36,30,6,0,6,83.33333333
2001020569,2,3670,0.0,30,25,5,0,5,83.33333333
2001020570,9,3600,0.0,26,24,6,3,2,92.30769231
2001020570,5,3600,0.0,31,26,9,2,5,83.87096774
2001020571,6,3754,0.0,28,24,6,0,4,85.71428571
2001020571,14,3753,0.0,39,34,1,1,5,87.17948718
2001020572,10,3600,0.0,31,27,7,2,4,87.09677419
2001020572,13,3600,0.0,32,30,10,2,2,93.75
2001020573,7,3900,0.0,27,25,2,0,2,92.59259259
2001020573,29,3900,0.0,32,30,4,1,2,93.75
2001020574,17,3740,0.0,35,32,4,1,3,91.42857143
2001020574,18,3721,0.0,28,26,2,2,2,92.85714286
2001020575,4,3600,0.0,33,31,5,0,2,93.93939394
2001020575,21,3572,0.0,23,19,3,0,4,82.60869565
2001020576,30,3566,0.0,30,26,5,0,4,86.66666667
2001020576,20,2397,0.0,18,17,1,0,1,94.44444444
2001020576,20,1200,0.0,12,10,0,1,2,83.33333333
2001020577,1,1953,0.0,16,15,0,0,1,93.75
2001020577,1,1575,0.0,12,9,0,0,3,75.0
2001020577,23,3600,0.0,34,32,4,3,2,94.11764706
2001020578,3,3600,0.0,35,31,9,1,4,88.57142857
2001020578,26,1944,0.0,16,12,2,0,4,75.0
2001020578,26,1501,0.0,6,5,0,1,1,83.33333333
2001020579,12,3900,0.0,41,36,11,1,5,87.80487805
2001020579,15,538,0.0,5,2,1,0,3,40.0
2001020579,15,3362,0.0,23,21,3,0,2,91.30434783
2001020580,24,3527,0.0,31,29,1,0,2,93.5483871
2001020580,16,3600,0.0,31,30,5,0,1,96.77419355
2001020581,18,3600,0.0,35,28,7,1,7,80.0
2001020581,19,3600,0.0,19,17,7,1,2,89.47368421
2001020582,1,3600,0.0,24,23,1,0,1,95.83333333
2001020582,22,3539,0.0,29,27,6,1,2,93.10344828
2001020583,27,3600,0.0,28,26,6,0,2,92.85714286
2001020583,28,3552,0.0,27,24,2,2,3,88.88888889
2001020584,12,3598,0.0,27,23,4,0,4,85.18518519
2001020584,7,1200,0.0,11,9,1,0,2,81.81818182
2001020584,7,2351,0.0,18,16,3,0,2,88.88888889
2001020585,16,3894,0.0,33,29,5,1,4,87.87878788
2001020585,9,3838,0.0,28,23,4,1,5,82.14285714
2001020586,10,3600,0.0,17,16,2,1,1,94.11764706
2001020586,14,3600,0.0,38,34,3,0,4,89.47368421
2001020587,11,3573,0.0,28,24,7,1,4,85.71428571
2001020587,13,3590,0.0,32,29,12,0,3,90.625
2001020588,30,3579,0.0,41,38,2,1,3,92.68292683
2001020588,17,3600,0.0,18,16,2,0,2,88.88888889
2001020589,24,3517,0.0,34,32,5,0,2,94.11764706
2001020589,29,3600,0.0,28,27,4,0,1,96.42857143
2001020590,6,3538,0.0,24,22,1,1,2,91.66666667
2001020590,25,3597,0.0,27,26,6,2,1,96.2962963
2001020591,22,3900,0.0,35,33,10,0,2,94.28571429
2001020591,20,3878,0.0,27,25,2,0,2,92.59259259
2001020592,4,3600,0.0,22,21,3,1,1,95.45454545
2001020592,23,3600,0.0,20,18,5,0,2,90.0
2001020593,3,3600,0.0,34,29,11,0,5,85.29411765
2001020593,27,3600,0.0,37,37,8,7,0,100.0
2001020594,19,3549,0.0,24,22,6,1,2,91.66666667
2001020594,1,3600,0.0,28,27,4,1,1,96.42857143
2001020595,2,3526,0.0,26,23,2,1,3,88.46153846
2001020595,15,3600,0.0,35,33,9,1,2,94.28571429
2001020596,21,3900,0.0,27,23,2,1,4,85.18518519
2001020596,18,3900,0.0,37,33,2,1,4,89.18918919
2001020597,6,3600,0.0,29,26,4,1,3,89.65517241
2001020597,12,3026,0.0,23,22,4,2,1,95.65217391
2001020597,12,530,0.0,8,5,1,0,3,62.5
2001020598,24,2048,0.0,15,14,1,3,1,93.33333333
2001020598,24,1539,0.0,13,9,1,0,4,69.23076923
2001020598,17,3600,0.0,29,26,6,0,3,89.65517241
2001020599,11,3559,0.0,29,27,6,0,2,93.10344828
2001020599,25,3600,0.0,21,20,0,4,1,95.23809524
2001020600,14,3486,0.0,20,18,0,0,2,90.0
2001020600,30,3596,0.0,36,36,6,0,0,100.0
2001020601,3,3600,0.0,29,25,1,3,4,86.20689655
2001020601,22,3600,0.0,22,21,9,1,1,95.45454545
2001020602,13,3551,0.0,37,34,2,0,3,91.89189189
2001020602,26,3600,0.0,30,29,2,1,1,96.66666667
2001020603,4,3600,0.0,36,31,7,0,5,86.11111111
2001020603,28,3600,0.0,24,22,0,3,2,91.66666667
2001020604,10,3596,0.0,22,21,3,1,1,95.45454545
2001020604,6,3543,0.0,22,20,4,0,2,90.90909091
2001020605,15,3600,0.0,37,33,1,0,4,89.18918919
2001020605,9,3600,0.0,20,19,3,0,1,95.0
2001020606,18,3600,0.0,35,32,7,2,3,91.42857143
2001020606,1,3531,0.0,27,23,6,0,4,85.18518519
2001020607,5,3545,0.0,35,31,8,0,4,88.57142857
2001020607,2,3592,0.0,20,18,7,1,2,90.0
2001020608,29,3600,0.0,30,26,6,0,4,86.66666667
2001020608,19,3583,0.0,11,9,2,0,2,81.81818182
2001020609,3,3700,0.0,32,29,5,1,3,90.625
2001020609,21,3696,0.0,37,35,3,2,2,94.59459459
2001020610,7,3512,0.0,24,21,10,0,3,87.5
2001020610,20,3600,0.0,29,28,5,2,1,96.55172414
2001020611,8,3587,0.0,31,27,0,1,4,87.09677419
2001020611,23,3600,0.0,29,27,4,0,2,93.10344828
2001020612,11,3581,0.0,33,31,3,0,2,93.93939394
2001020612,27,3600,0.0,26,25,3,1,1,96.15384615
2001020613,14,3509,0.0,29,27,2,2,2,93.10344828
2001020613,16,3600,0.0,17,17,1,1,0,100.0
2001020614,18,3517,0.0,25,23,3,0,2,92.0
2001020614,30,3600,0.0,20,19,3,3,1,95.0
2001020615,13,3600,0.0,27,26,4,0,1,96.2962963
2001020615,24,3517,0.0,27,25,3,2,2,92.59259259
2001020616,27,3505,2.0,25,20,6,3,5,80.0
2001020616,28,1296,0.0,12,9,3,0,3,75.0
2001020616,28,2304,0.0,25,25,4,1,0,100.0
2001020617,15,1673,0.0,14,13,1,1,1,92.85714286
2001020617,15,1927,0.0,25,19,5,0,6,76.0
2001020617,6,3597,0.0,23,19,2,2,4,82.60869565
2001020618,9,3600,0.0,22,19,2,1,3,86.36363636
2001020618,10,3584,0.0,10,9,1,0,1,90.0
2001020619,26,3600,0.0,28,28,3,1,0,100.0
2001020619,2,3583,0.0,34,32,6,1,2,94.11764706
2001020620,3,3600,0.0,32,28,6,0,4,87.5
2001020620,5,3584,2.0,36,35,12,0,1,97.22222222
2001020621,1,3600,0.0,23,22,1,0,1,95.65217391
2001020621,12,3569,0.0,31,29,1,1,2,93.5483871
2001020622,21,3502,0.0,35,32,3,1,3,91.42857143
2001020622,17,3600,0.0,14,13,2,0,1,92.85714286
2001020623,25,1200,0.0,12,11,3,1,1,91.66666667
2001020623,25,2398,0.0,23,19,2,1,4,82.60869565
2001020623,19,3600,0.0,31,29,10,3,2,93.5483871
2001020624,8,3600,0.0,21,19,2,0,2,90.47619048
2001020624,20,3579,0.0,25,22,1,1,3,88.0
2001020625,23,3600,0.0,34,31,5,1,3,91.17647059
2001020625,22,3578,0.0,28,24,2,1,4,85.71428571
2001020626,13,2619,0.0,23,20,5,0,3,86.95652174
2001020626,13,981,0.0,12,9,3,4,3,75.0
2001020626,28,3357,0.0,28,28,4,3,0,100.0
2001020627,4,3588,0.0,32,29,8,3,3,90.625
2001020627,12,3516,0.0,27,23,7,0,4,85.18518519
2001020628,2,3600,0.0,25,23,2,1,2,92.0
2001020628,11,3537,0.0,27,24,2,0,3,88.88888889
2001020629,18,3539,0.0,30,26,3,1,4,86.66666667
2001020629,29,3600,0.0,22,19,3,0,3,86.36363636
2001020630,5,3531,0.0,19,17,4,0,2,89.47368421
2001020630,16,3598,0.0,22,22,1,0,0,100.0
2001020631,7,3600,0.0,18,17,4,1,1,94.44444444
2001020631,30,3600,0.0,16,12,4,0,4,75.0
2001020632,8,3542,0.0,28,21,6,2,7,75.0
2001020632,22,1815,0.0,7,3,1,0,4,42.85714286
2001020632,22,1780,0.0,15,13,5,1,2,86.66666667
2001020633,14,3599,0.0,33,33,2,2,0,100.0
2001020633,27,3600,0.0,24,21,5,1,3,87.5
2001020634,10,3565,0.0,16,12,2,0,4,75.0
2001020634,9,3596,0.0,26,23,5,3,3,88.46153846
2001020635,26,3600,0.0,27,25,3,1,2,92.59259259
2001020635,1,3545,0.0,22,19,2,0,3,86.36363636
2001020636,13,3600,0.0,39,38,9,3,1,97.43589744
2001020636,15,3551,0.0,18,16,4,1,2,88.88888889
2001020637,23,3528,0.0,26,23,6,0,3,88.46153846
2001020637,7,3600,0.0,28,26,4,1,2,92.85714286
2001020638,18,3575,0.0,26,22,3,0,4,84.61538462
2001020638,10,3596,0.0,25,22,5,0,3,88.0
2001020639,20,3599,0.0,37,35,6,2,2,94.59459459
2001020639,2,2277,0.0,8,7,1,0,1,87.5
2001020639,2,1200,0.0,16,13,0,0,3,81.25
2001020640,11,1564,0.0,12,8,0,0,4,66.66666667
2001020640,11,2036,0.0,22,19,7,0,3,86.36363636
2001020640,4,3596,0.0,26,22,0,0,4,84.61538462
2001020641,6,3600,0.0,30,28,4,0,2,93.33333333
2001020641,5,3561,0.0,31,28,3,1,3,90.32258065
2001020642,25,3595,2.0,35,34,5,2,1,97.14285714
2001020642,14,3496,0.0,28,26,6,0,2,92.85714286
2001020643,8,3503,0.0,34,30,9,0,4,88.23529412
2001020643,30,3600,0.0,17,15,5,0,2,88.23529412
2001020644,19,3589,0.0,17,15,7,0,2,88.23529412
2001020644,28,3600,0.0,30,24,4,0,6,80.0
2001020645,20,3598,0.0,23,18,1,0,5,78.26086957
2001020645,1,3599,0.0,24,23,2,0,1,95.83333333
2001020646,26,3600,0.0,34,34,2,2,0,100.0
2001020646,3,3600,0.0,24,20,5,0,4,83.33333333
2001020647,29,3600,0.0,39,33,3,0,6,84.61538462
2001020647,15,3600,0.0,22,19,4,2,3,86.36363636
2001020648,9,3778,0.0,21,17,2,0,4,80.95238095
2001020648,11,3778,0.0,36,33,2,0,3,91.66666667
2001020649,25,3600,0.0,18,16,6,1,2,88.88888889
2001020649,13,3577,0.0,33,30,3,4,3,90.90909091
2001020650,23,3733,0.0,48,43,11,1,5,89.58333333
2001020650,17,3733,0.0,30,26,11,0,4,86.66666667
2001020651,16,3600,0.0,26,19,2,0,7,73.07692308
2001020651,21,3600,0.0,30,27,4,1,3,90.0
2001020652,28,3600,0.0,42,37,4,5,5,88.0952381
2001020652,27,3541,0.0,30,24,4,1,6,80.0
2001020653,19,3600,2.0,21,19,6,0,2,90.47619048
2001020653,24,3535,0.0,24,21,0,1,3,87.5
2001020654,26,3592,0.0,33,28,10,1,5,84.84848485
2001020654,6,1200,0.0,4,4,0,1,0,100.0
2001020654,6,2400,0.0,12,12,2,0,0,100.0
2001020655,5,3600,2.0,36,36,4,0,0,100.0
2001020655,7,3524,0.0,18,16,3,3,2,88.88888889
2001020656,2,3586,0.0,25,21,7,0,4,84.0
2001020656,8,3596,0.0,26,26,3,1,0,100.0
2001020657,1,3555,0.0,20,17,1,3,3,85.0
2001020657,4,3589,0.0,36,34,7,1,2,94.44444444
2001020658,29,3539,0.0,25,23,3,0,2,92.0
2001020658,16,3600,0.0,21,20,2,3,1,95.23809524
2001020659,30,3899,0.0,29,27,5,0,2,93.10344828
2001020659,18,3885,0.0,18,16,1,1,2,88.88888889
2001020660,12,3597,0.0,20,19,4,0,1,95.0
2001020660,22,3565,0.0,16,13,3,0,3,81.25
2001020661,10,3900,0.0,25,22,1,0,3,88.0
2001020661,15,3900,0.0,32,29,9,0,3,90.625
2001020662,20,3535,0.0,20,19,1,0,1,95.0
2001020662,11,3589,0.0,37,37,8,0,0,100.0
2001020663,9,3600,0.0,25,23,6,1,2,92.0
2001020663,13,1665,0.0,12,9,0,0,3,75.0
2001020663,13,1935,0.0,13,12,4,1,1,92.30769231
2001020664,24,3900,0.0,32,30,4,1,2,93.75
2001020664,30,3900,0.0,21,19,0,0,2,90.47619048
2001020665,2,3598,0.0,26,22,5,1,4,84.61538462
2001020665,6,3530,0.0,32,27,5,1,5,84.375
2001020666,1,3532,0.0,20,18,3,1,2,90.0
2001020666,7,3600,0.0,28,27,4,0,1,96.42857143
2001020667,8,3900,0.0,39,38,1,0,1,97.43589744
2001020667,10,3890,0.0,29,28,0,0,1,96.55172414
2001020668,3,3559,0.0,23,19,5,1,4,82.60869565
2001020668,4,3597,2.0,24,22,2,1,2,91.66666667
2001020669,19,3589,0.0,27,26,5,0,1,96.2962963
2001020669,5,3600,0.0,36,32,6,1,4,88.88888889
2001020670,9,3600,0.0,34,33,4,0,1,97.05882353
2001020670,14,3499,0.0,25,23,4,0,2,92.0
2001020671,15,3598,0.0,25,25,4,3,0,100.0
2001020671,13,3554,0.0,34,33,7,1,1,97.05882353
2001020672,25,3574,2.0,34,30,4,1,4,88.23529412
2001020672,17,3600,0.0,18,16,1,1,2,88.88888889
2001020673,16,3511,0.0,29,24,5,0,5,82.75862069
2001020673,29,3593,0.0,36,32,7,3,4,88.88888889
2001020674,24,3510,0.0,29,27,7,0,2,93.10344828
2001020674,18,3599,0.0,25,24,6,1,1,96.0
2001020675,21,3900,0.0,34,32,4,0,2,94.11764706
2001020675,22,3897,0.0,27,25,4,1,2,92.59259259
2001020676,12,3592,0.0,28,21,2,1,7,75.0
2001020676,23,3600,0.0,24,23,4,1,1,95.83333333
2001020677,26,3600,0.0,41,39,1,0,2,95.12195122
2001020677,28,3543,2.0,20,17,3,0,3,85.0
2001020678,14,3898,0.0,24,22,0,0,2,91.66666667
2001020678,11,3900,0.0,39,37,2,0,2,94.87179487
2001020679,25,3600,0.0,26,25,1,0,1,96.15384615
2001020679,30,3595,0.0,16,13,3,0,3,81.25
2001020680,4,1200,0.0,6,6,0,0,0,100.0
2001020680,4,2400,0.0,11,8,0,0,3,72.72727273
2001020680,8,3581,0.0,31,27,2,0,4,87.09677419
2001020681,29,3875,0.0,30,28,4,6,2,93.33333333
2001020681,3,3900,0.0,42,40,12,0,2,95.23809524
2001020682,6,3613,0.0,17,16,0,1,1,94.11764706
2001020682,15,3613,2.0,30,30,2,2,0,100.0
2001020683,22,3513,0.0,31,29,0,3,2,93.5483871
2001020683,16,3600,0.0,18,17,1,1,1,94.44444444
2001020684,18,1200,0.0,11,8,0,0,3,72.72727273
2001020684,18,2310,0.0,15,14,5,0,1,93.33333333
2001020684,24,3600,0.0,19,16,2,0,3,84.21052632
2001020685,11,3600,0.0,42,40,0,0,2,95.23809524
2001020685,10,3549,0.0,22,19,0,0,3,86.36363636
2001020686,4,3600,0.0,37,36,7,0,1,97.2972973
2001020686,9,3600,0.0,35,31,1,1,4,88.57142857
2001020687,14,1285,0.0,21,20,0,0,1,95.23809524
2001020687,14,2400,0.0,19,16,1,0,3,84.21052632
2001020687,1,3685,0.0,17,12,1,1,5,70.58823529
2001020688,30,3574,0.0,21,19,1,0,2,90.47619048
2001020688,12,3596,0.0,22,22,3,1,0,100.0
2001020689,22,3580,0.0,19,16,0,0,3,84.21052632
2001020689,19,3600,0.0,24,22,3,0,2,91.66666667
2001020690,28,3897,0.0,38,38,2,0,0,100.0
2001020690,21,3897,0.0,22,21,1,1,1,95.45454545
2001020691,2,3600,0.0,34,33,2,1,1,97.05882353
2001020691,20,3518,0.0,21,19,6,0,2,90.47619048
2001020692,5,3600,0.0,20,15,4,0,5,75.0
2001020692,23,3600,0.0,23,21,4,0,2,91.30434783
2001020693,17,3900,0.0,29,27,5,0,2,93.10344828
2001020693,27,3900,0.0,31,29,9,1,2,93.5483871
2001020694,18,3582,0.0,22,21,1,0,1,95.45454545
2001020694,26,3600,0.0,24,24,4,0,0,100.0
2001020695,15,3540,0.0,30,28,7,0,2,93.33333333
2001020695,8,3591,0.0,28,28,4,3,0,100.0
2001020696,16,3597,0.0,16,16,6,2,0,100.0
2001020696,13,3600,0.0,30,27,12,0,3,90.0
2001020697,3,3519,0.0,24,22,3,0,2,91.66666667
2001020697,29,3600,0.0,31,31,5,2,0,100.0
2001020698,17,3564,0.0,31,28,4,1,3,90.32258065
2001020698,25,3584,2.0,28,26,6,4,2,92.85714286
2001020699,7,3597,0.0,17,16,6,1,1,94.11764706
2001020699,24,3551,0.0,17,15,1,0,2,88.23529412
2001020700,9,520,0.0,1,1,0,1,0,100.0
2001020700,9,3076,17.0,33,28,8,0,5,84.84848485
2001020700,6,3076,17.0,20,19,4,0,1,95.0
2001020700,6,524,0.0,5,4,0,0,1,80.0
2001020701,3,3555,0.0,30,24,7,2,6,80.0
2001020701,1,3600,0.0,26,22,2,0,4,84.61538462
2001020702,11,3569,0.0,26,21,1,1,5,80.76923077
2001020702,4,3596,0.0,22,19,2,2,3,86.36363636
2001020703,8,3900,0.0,30,29,4,1,1,96.66666667
2001020703,12,3890,0.0,20,19,2,0,1,95.0
2001020704,23,3489,0.0,23,18,0,1,5,78.26086957
2001020704,19,3600,0.0,26,22,5,0,4,84.61538462
2001020705,10,3646,0.0,26,23,4,0,3,88.46153846
2001020705,18,3646,0.0,30,28,1,1,2,93.33333333
2001020706,27,3898,10.0,34,31,7,0,3,91.17647059
2001020706,21,3898,0.0,28,26,7,1,2,92.85714286
2001020707,5,3600,0.0,27,23,6,1,4,85.18518519
2001020707,20,3558,0.0,33,28,4,0,5,84.84848485
2001020707,20,6,0.0,0,0,0,0,0,
2001020708,7,3557,0.0,18,15,3,0,3,83.33333333
2001020708,26,3600,0.0,23,21,2,1,2,91.30434783
2001020709,2,3521,0.0,18,15,5,1,3,83.33333333
2001020709,28,3600,0.0,33,31,5,2,2,93.93939394
2001020710,16,3900,0.0,32,30,2,0,2,93.75
2001020710,14,3900,0.0,36,34,1,1,2,94.44444444
2001020711,15,3511,0.0,34,31,5,2,3,91.17647059
2001020711,17,3592,0.0,17,16,2,2,1,94.11764706
2001020712,30,3600,0.0,26,25,6,0,1,96.15384615
2001020712,29,3600,0.0,27,24,5,1,3,88.88888889
2001020713,13,3600,0.0,37,35,9,0,2,94.59459459
2001020713,25,3445,0.0,20,17,2,0,3,85.0
2001020714,24,3496,0.0,26,23,2,2,3,88.46153846
2001020714,22,3590,0.0,37,36,4,1,1,97.2972973
2001020715,4,3600,2.0,31,31,10,1,0,100.0
2001020715,10,3579,0.0,25,23,5,0,2,92.0
2001020716,30,3600,0.0,40,36,4,0,4,90.0
2001020716,9,3600,0.0,23,22,4,0,1,95.65217391
2001020717,12,3900,0.0,26,23,2,0,3,88.46153846
2001020717,1,3900,0.0,25,22,2,1,3,88.0
2001020718,23,3600,0.0,28,27,2,2,1,96.42857143
2001020718,15,3600,0.0,31,26,4,0,5,83.87096774
2001020719,8,3600,0.0,25,24,4,2,1,96.0
2001020719,14,1200,0.0,7,4,0,0,3,57.14285714
2001020719,14,2400,0.0,21,19,0,2,2,90.47619048
2001020720,11,3600,2.0,45,44,8,3,1,97.77777778
2001020720,13,727,0.0,4,2,1,1,2,50.0
2001020720,13,2870,0.0,24,20,4,1,4,83.33333333
2001020721,6,3809,0.0,29,27,4,0,2,93.10344828
2001020721,19,3809,0.0,29,28,2,0,1,96.55172414
2001020722,29,3540,0.0,36,34,1,1,2,94.44444444
2001020722,18,3568,0.0,19,18,4,0,1,94.73684211
2001020723,24,3536,0.0,28,26,2,2,2,92.85714286
2001020723,20,3600,0.0,26,25,3,0,1,96.15384615
2001020724,5,3600,0.0,25,25,9,0,0,100.0
2001020724,22,3563,0.0,15,14,6,4,1,93.33333333
2001020725,7,3597,0.0,33,32,4,0,1,96.96969697
2001020725,27,3579,0.0,21,19,3,0,2,90.47619048
2001020726,2,3598,0.0,25,23,4,2,2,92.0
2001020726,26,3508,0.0,25,22,7,0,3,88.0
2001020727,21,3600,0.0,23,22,7,0,1,95.65217391
2001020727,28,3566,0.0,27,24,7,0,3,88.88888889
2001020728,9,3659,0.0,39,36,10,2,3,92.30769231
2001020728,17,3659,0.0,22,20,7,3,2,90.90909091
2001020729,25,3577,0.0,24,21,1,0,3,87.5
2001020729,16,3596,0.0,26,24,4,1,2,92.30769231
2001020730,19,3768,0.0,24,21,5,0,3,87.5
2001020730,6,3765,0.0,22,18,4,2,4,81.81818182
2001020731,4,3600,0.0,27,22,3,0,5,81.48148148
2001020731,5,3600,0.0,24,22,1,0,2,91.66666667
2001020732,23,618,0.0,3,2,0,0,1,66.66666667
2001020732,23,2982,0.0,27,23,7,0,4,85.18518519
2001020732,12,1538,0.0,22,19,4,0,3,86.36363636
2001020732,12,2009,0.0,17,13,0,1,4,76.47058824
2001020733,1,3534,0.0,17,14,2,0,3,82.35294118
2001020733,14,3598,0.0,33,31,1,1,2,93.93939394
2001020734,8,2366,0.0,19,15,4,0,4,78.94736842
2001020734,8,1200,0.0,9,7,1,2,2,77.77777778
2001020734,13,3600,0.0,39,34,6,1,5,87.17948718
2001020735,25,3577,0.0,31,28,9,1,3,90.32258065
2001020735,29,3553,0.0,33,29,5,0,4,87.87878788
2001020736,27,3600,0.0,19,19,3,0,0,100.0
2001020736,18,3579,0.0,22,21,1,0,1,95.45454545
2001020737,7,3522,0.0,41,38,3,3,3,92.68292683
2001020737,21,3600,0.0,28,26,5,1,2,92.85714286
2001020738,26,3600,0.0,31,29,4,1,2,93.5483871
2001020738,24,3499,0.0,24,20,6,0,4,83.33333333
2001020739,22,3519,0.0,35,31,6,2,4,88.57142857
2001020739,28,3600,0.0,35,32,4,0,3,91.42857143
2001020740,3,3072,0.0,35,35,11,3,0,100.0
2001020740,3,528,0.0,7,3,1,0,4,42.85714286
2001020740,2,3550,0.0,19,14,3,1,5,73.68421053
2001020741,9,3900,0.0,43,42,0,0,1,97.6744186
2001020741,4,3900,0.0,34,33,2,0,1,97.05882353
2001020742,15,3600,0.0,27,27,8,1,0,100.0
2001020742,11,3600,0.0,26,23,4,1,3,88.46153846
2001020743,10,3600,0.0,29,28,5,0,1,96.55172414
2001020743,20,3600,0.0,31,25,4,1,6,80.64516129
2001020744,19,3600,0.0,25,23,0,2,2,92.0
2001020744,7,3536,0.0,26,22,5,4,4,84.61538462
2001020745,6,3597,0.0,26,18,1,2,8,69.23076923
2001020745,3,3600,0.0,33,29,7,2,4,87.87878788
2001020746,14,1720,0.0,11,8,0,0,3,72.72727273
2001020746,14,1880,0.0,16,14,0,0,2,87.5
2001020746,5,3596,0.0,27,26,8,1,1,96.2962963
2001020747,8,3590,0.0,33,30,1,1,3,90.90909091
2001020747,15,3545,0.0,27,23,1,1,4,85.18518519
2001020748,18,3897,0.0,31,29,4,0,2,93.5483871
2001020748,12,3874,0.0,22,20,4,0,2,90.90909091
2001020749,1,3600,0.0,22,21,2,0,1,95.45454545
2001020749,13,3597,0.0,37,34,10,1,3,91.89189189
2001020750,28,3900,0.0,29,27,8,0,2,93.10344828
2001020750,17,3900,0.0,31,29,2,1,2,93.5483871
2001020751,27,3591,0.0,24,23,4,1,1,95.83333333
2001020751,16,3584,0.0,23,20,2,2,3,86.95652174
2001020752,23,3595,0.0,22,20,5,2,2,90.90909091
2001020752,25,3591,0.0,40,37,9,1,3,92.5
2001020753,21,3600,0.0,30,28,6,1,2,93.33333333
2001020753,22,3563,0.0,24,21,4,1,3,87.5
2001020754,30,3799,0.0,30,27,3,1,3,90.0
2001020754,24,3842,0.0,29,27,6,3,2,93.10344828
2001020755,6,3559,0.0,35,31,9,0,4,88.57142857
2001020755,9,3600,0.0,25,22,6,1,3,88.0
2001020756,5,3689,0.0,27,23,3,3,4,85.18518519
2001020756,2,3689,0.0,27,22,6,0,5,81.48148148
2001020757,18,3676,0.0,29,27,3,0,2,93.10344828
2001020757,4,3672,0.0,27,24,1,0,3,88.88888889
2001020758,1,3529,0.0,22,19,3,0,3,86.36363636
2001020758,11,3600,0.0,49,47,6,2,2,95.91836735
2001020759,28,2164,2.0,24,21,6,1,3,87.5
2001020759,28,1428,0.0,6,3,1,0,3,50.0
2001020759,29,3590,0.0,22,20,5,2,2,90.90909091
2001020760,21,3600,0.0,25,25,4,0,0,100.0
2001020760,20,3556,0.0,19,18,3,2,1,94.73684211
2001020761,30,3600,2.0,22,18,2,0,4,81.81818182
2001020761,26,3600,0.0,20,19,6,0,1,95.0
2001020762,14,3600,0.0,33,29,2,4,4,87.87878788
2001020762,7,3599,0.0,22,21,11,2,1,95.45454545
2001020763,13,3900,0.0,45,44,10,0,1,97.77777778
2001020763,12,3892,0.0,28,27,2,7,1,96.42857143
2001020764,27,3600,2.0,35,31,3,1,4,88.57142857
2001020764,17,3600,0.0,29,28,2,1,1,96.55172414
2001020765,19,3529,0.0,27,25,7,3,2,92.59259259
2001020765,16,3600,0.0,26,25,1,2,1,96.15384615
2001020766,24,3587,0.0,21,20,4,3,1,95.23809524
2001020766,25,1970,0.0,9,8,2,0,1,88.88888889
2001020766,25,1626,0.0,22,17,6,0,5,77.27272727
2001020767,10,2866,0.0,24,19,5,0,5,79.16666667
2001020767,10,734,0.0,8,7,0,0,1,87.5
2001020767,23,3590,2.0,21,20,4,0,1,95.23809524
2001020768,13,3593,0.0,40,36,7,1,4,90.0
2001020768,6,3600,0.0,22,20,1,1,2,90.90909091
2001020769,9,3885,0.0,25,24,7,1,1,96.0
2001020769,8,3900,0.0,36,35,5,1,1,97.22222222
2001020770,14,3600,0.0,25,19,2,3,6,76.0
2001020770,2,3600,0.0,25,23,6,0,2,92.0
2001020771,15,3600,0.0,47,41,8,2,6,87.23404255
2001020771,3,3600,0.0,25,22,6,0,3,88.0
2001020772,12,1843,0.0,17,13,0,0,4,76.47058824
2001020772,12,1722,0.0,6,6,1,0,0,100.0
2001020772,4,3600,0.0,18,16,3,0,2,88.88888889
2001020773,11,3842,0.0,28,25,3,0,3,89.28571429
2001020773,5,3839,0.0,35,33,7,1,2,94.28571429
2001020774,27,3600,0.0,33,31,3,0,2,93.93939394
2001020774,29,3540,0.0,24,21,0,0,3,87.5
2001020775,17,3600,0.0,31,29,6,0,2,93.5483871
2001020775,19,3520,0.0,31,27,7,0,4,87.09677419
2001020776,24,3600,0.0,19,18,1,0,1,94.73684211
2001020776,18,3452,0.0,18,15,5,0,3,83.33333333
2001020777,1,3900,0.0,36,34,10,1,2,94.44444444
2001020777,30,3900,0.0,27,25,1,0,2,92.59259259
2001020778,23,3600,0.0,29,29,10,0,0,100.0
2001020778,20,3503,0.0,21,19,4,1,2,90.47619048
2001020779,10,3569,0.0,19,16,2,2,3,84.21052632
2001020779,22,3597,0.0,23,22,2,1,1,95.65217391
2001020780,21,3589,0.0,17,15,1,2,2,88.23529412
2001020780,26,3566,0.0,21,17,8,0,4,80.95238095
2001020781,28,3495,0.0,22,19,5,0,3,86.36363636
2001020781,8,3599,0.0,27,26,2,1,1,96.2962963
2001020782,7,3676,0.0,31,29,0,0,2,93.5483871
2001020782,15,3690,0.0,34,31,6,0,3,91.17647059
2001020783,16,3592,0.0,22,20,4,1,2,90.90909091
2001020783,6,3600,0.0,27,26,5,0,1,96.2962963
2001020784,14,3598,0.0,42,42,1,0,0,100.0
2001020784,3,3545,0.0,21,20,1,0,1,95.23809524
2001020785,27,3600,2.0,16,14,1,1,2,87.5
2001020785,11,3542,0.0,35,32,8,0,3,91.42857143
2001020786,24,3600,0.0,15,15,1,0,0,100.0
2001020786,19,3517,0.0,18,17,4,0,1,94.44444444
2001020787,29,3555,0.0,30,27,8,0,3,90.0
2001020787,25,3587,0.0,24,22,7,1,2,91.66666667
2001020788,20,3622,0.0,33,31,8,1,2,93.93939394
2001020788,30,3646,0.0,27,24,5,0,3,88.88888889
2001020789,26,3600,0.0,30,26,5,0,4,86.66666667
2001020789,21,3529,0.0,27,22,1,1,5,81.48148148
2001020790,17,3900,0.0,36,35,8,2,1,97.22222222
2001020790,22,3900,0.0,22,21,2,0,1,95.45454545
2001020791,18,2400,0.0,28,24,7,2,4,85.71428571
2001020791,18,1200,0.0,8,7,0,0,1,87.5
2001020791,23,3598,0.0,14,13,2,0,1,92.85714286
2001020792,28,3582,0.0,33,29,6,0,4,87.87878788
2001020792,10,3600,0.0,25,22,2,1,3,88.0
2001020793,1,3600,0.0,21,20,0,0,1,95.23809524
2001020793,2,3600,0.0,21,18,0,0,3,85.71428571
2001020794,5,3707,0.0,32,29,3,1,3,90.625
2001020794,4,3652,0.0,22,20,1,1,2,90.90909091
2001020795,7,3897,0.0,36,34,2,2,2,94.44444444
2001020795,12,3226,0.0,36,34,7,0,2,94.44444444
2001020795,12,674,0.0,3,3,0,0,0,100.0
2001020796,6,3676,0.0,25,22,4,1,3,88.0
2001020796,8,3659,0.0,35,31,2,0,4,88.57142857
2001020797,4,3554,0.0,31,29,8,0,2,93.5483871
2001020797,9,3600,0.0,19,18,3,1,1,94.73684211
2001020798,16,3586,0.0,29,26,3,2,3,89.65517241
2001020798,1,3600,0.0,28,27,6,2,1,96.42857143
2001020799,2,3564,2.0,34,31,5,3,3,91.17647059
2001020799,3,1200,2.0,11,7,1,0,4,63.63636364
2001020799,3,2400,2.0,19,17,6,0,2,89.47368421
2001020800,28,3600,0.0,28,25,7,1,3,89.28571429
2001020800,5,3600,0.0,23,17,2,1,6,73.91304348
2001020801,19,3592,0.0,25,24,2,1,1,96.0
2001020801,15,3588,0.0,28,24,9,1,4,85.71428571
2001020802,10,3598,0.0,17,17,1,1,0,100.0
2001020802,11,920,0.0,12,9,0,0,3,75.0
2001020802,11,2680,0.0,28,25,1,3,3,89.28571429
2001020803,12,3600,0.0,19,18,2,0,1,94.73684211
2001020803,14,3480,0.0,40,37,8,1,3,92.5
2001020804,27,3600,0.0,42,41,9,2,1,97.61904762
2001020804,13,2641,0.0,21,18,1,4,3,85.71428571
2001020804,13,622,0.0,7,7,4,1,0,100.0
2001020805,26,3600,0.0,20,20,4,1,0,100.0
2001020805,30,3577,2.0,28,26,6,0,2,92.85714286
2001020806,18,3578,0.0,28,26,4,1,2,92.85714286
2001020806,21,3563,0.0,26,22,6,0,4,84.61538462
2001020807,17,3538,0.0,22,18,3,0,4,81.81818182
2001020807,20,3600,0.0,36,33,5,2,3,91.66666667
2001020808,22,3899,0.0,22,20,0,0,2,90.90909091
2001020808,23,3900,0.0,34,32,4,0,2,94.11764706
2001020809,29,3598,0.0,31,28,2,1,3,90.32258065
2001020809,24,3600,0.0,26,25,1,1,1,96.15384615
2001020810,9,3873,0.0,31,27,2,0,4,87.09677419
2001020810,14,3900,0.0,33,29,5,0,4,87.87878788
2001020811,2,1144,0.0,6,5,1,0,1,83.33333333
2001020811,2,2754,0.0,23,18,0,1,5,78.26086957
2001020811,13,840,0.0,12,10,4,0,2,83.33333333
2001020811,13,3059,0.0,30,26,8,0,4,86.66666667
2001020812,6,3600,0.0,30,30,5,0,0,100.0
2001020812,29,3600,0.0,25,17,0,1,8,68.0
2001020813,17,3600,0.0,24,23,5,0,1,95.83333333
2001020813,21,3588,0.0,33,31,4,3,2,93.93939394
2001020814,27,3516,0.0,23,19,4,1,4,82.60869565
2001020814,23,3598,0.0,24,22,1,2,2,91.66666667
2001020815,4,3600,0.0,21,20,0,0,1,95.23809524
2001020815,26,3550,0.0,29,26,4,1,3,89.65517241
2001020816,7,3900,0.0,39,37,0,3,2,94.87179487
2001020816,6,3900,0.0,34,32,4,1,2,94.11764706
2001020817,30,3600,0.0,35,32,7,0,3,91.42857143
2001020817,10,3582,0.0,24,23,5,1,1,95.83333333
2001020818,8,3600,0.0,19,19,1,0,0,100.0
2001020818,1,3556,0.0,15,14,2,0,1,93.33333333
2001020819,19,3589,0.0,20,16,2,1,4,80.0
2001020819,2,2400,0.0,18,17,4,0,1,94.44444444
2001020819,2,1200,0.0,14,12,0,0,2,85.71428571
2001020820,5,3900,0.0,40,37,7,2,3,92.5
2001020820,12,3900,0.0,31,28,7,2,3,90.32258065
2001020821,22,3519,0.0,35,32,3,0,3,91.42857143
2001020821,11,3594,0.0,41,39,6,2,2,95.12195122
2001020822,30,3569,0.0,19,17,3,0,2,89.47368421
2001020822,15,3600,0.0,30,29,7,2,1,96.66666667
2001020823,14,3600,0.0,39,37,2,0,2,94.87179487
2001020823,13,3536,0.0,21,18,2,0,3,85.71428571
2001020824,3,3600,0.0,35,32,3,0,3,91.42857143
2001020824,17,3598,0.0,27,26,1,0,1,96.2962963
2001020825,9,3600,0.0,28,24,2,0,4,85.71428571
2001020825,29,3569,0.0,29,24,7,0,5,82.75862069
2001020826,25,3553,0.0,21,19,2,2,2,90.47619048
2001020826,18,3600,0.0,34,33,7,2,1,97.05882353
2001020827,16,3600,0.0,21,19,5,0,2,90.47619048
2001020827,27,3279,0.0,35,33,1,1,2,94.28571429
2001020827,27,315,0.0,6,4,0,0,2,66.66666667
2001020828,4,3593,0.0,31,26,3,0,5,83.87096774
2001020828,24,3574,0.0,32,28,3,1,4,87.5
2001020829,20,3553,0.0,26,24,3,0,2,92.30769231
2001020829,28,3600,0.0,27,27,2,0,0,100.0
2001020830,5,3572,0.0,28,27,2,1,1,96.42857143
2001020830,8,3591,0.0,30,30,6,0,0,100.0
2001020831,11,3855,0.0,33,30,6,0,3,90.90909091
2001020831,1,3900,0.0,19,16,0,1,3,84.21052632
2001020832,10,3528,0.0,25,22,5,1,3,88.0
2001020832,2,3599,0.0,27,26,4,0,1,96.2962963
2001020833,13,3600,0.0,37,36,5,0,1,97.2972973
2001020833,14,3551,0.0,26,23,1,0,3,88.46153846
2001020834,22,3561,0.0,14,11,1,1,3,78.57142857
2001020834,19,3600,0.0,28,27,6,3,1,96.42857143
2001020835,12,3566,0.0,28,26,4,0,2,92.85714286
2001020835,26,3600,0.0,18,17,2,1,1,94.44444444
2001020836,9,3859,0.0,25,22,5,2,3,88.0
2001020836,7,3861,0.0,20,18,4,0,2,90.0
2001020837,3,3600,0.0,30,29,5,1,1,96.66666667
2001020837,11,3565,0.0,34,32,12,3,2,94.11764706
2001020838,29,3600,0.0,35,33,3,0,2,94.28571429
2001020838,17,3521,0.0,25,22,7,0,3,88.0
2001020839,22,3833,0.0,28,27,3,0,1,96.42857143
2001020839,25,3886,0.0,21,20,3,1,1,95.23809524
2001020840,15,1500,0.0,8,7,1,0,1,87.5
2001020840,15,2400,0.0,22,20,2,0,2,90.90909091
2001020840,18,3900,0.0,33,30,2,1,3,90.90909091
2001020841,21,3600,0.0,24,24,5,0,0,100.0
2001020841,30,1200,0.0,12,9,5,0,3,75.0
2001020841,30,2399,0.0,14,11,0,0,3,78.57142857
2001020842,23,3600,0.0,26,25,6,1,1,96.15384615
2001020842,20,3600,0.0,27,23,7,0,4,85.18518519
2001020843,26,3866,0.0,34,28,4,1,6,82.35294118
2001020843,27,3866,0.0,28,23,5,0,5,82.14285714
2001020844,12,3600,0.0,20,19,5,2,1,95.0
2001020844,24,3600,0.0,28,24,5,1,4,85.71428571
2001020845,16,3597,0.0,34,30,9,0,4,88.23529412
2001020845,28,3587,0.0,28,26,4,1,2,92.85714286
2001020846,13,2400,0.0,23,20,3,0,3,86.95652174
2001020846,13,1200,0.0,7,6,1,0,1,85.71428571
2001020846,6,3580,4.0,24,23,1,1,1,95.83333333
2001020847,8,3574,0.0,45,42,11,0,3,93.33333333
2001020847,10,3592,2.0,22,21,4,0,1,95.45454545
2001020848,17,3600,0.0,22,20,2,0,2,90.90909091
2001020848,9,3559,0.0,26,23,3,1,3,88.46153846
2001020849,1,3891,2.0,20,19,2,0,1,95.0
2001020849,5,3891,0.0,41,39,12,0,2,95.12195122
2001020850,15,3600,0.0,21,19,0,0,2,90.47619048
2001020850,14,1947,0.0,12,9,0,1,3,75.0
2001020850,14,1600,0.0,9,9,0,0,0,100.0
2001020851,18,3765,0.0,25,25,7,3,0,100.0
2001020851,29,3765,0.0,24,23,3,0,1,95.83333333
2001020852,4,3600,0.0,30,30,2,0,0,100.0
2001020852,19,3600,0.0,23,18,3,0,5,78.26086957
2001020853,16,3600,0.0,23,21,3,0,2,91.30434783
2001020853,21,3521,0.0,21,18,1,0,3,85.71428571
2001020854,20,3600,0.0,31,28,5,0,3,90.32258065
2001020854,23,3551,0.0,29,25,6,1,4,86.20689655
2001020855,7,1200,0.0,4,4,0,0,0,100.0
2001020855,7,2400,0.0,13,9,1,0,4,69.23076923
2001020855,1,3600,0.0,22,21,6,2,1,95.45454545
2001020856,5,3583,0.0,33,29,7,6,4,87.87878788
2001020856,3,3600,0.0,27,24,6,0,3,88.88888889
2001020857,2,3536,0.0,18,14,3,0,4,77.77777778
2001020857,30,3592,0.0,31,28,5,0,3,90.32258065
2001020858,22,3593,0.0,24,21,2,0,3,87.5
2001020858,27,3513,2.0,31,27,2,4,4,87.09677419
2001020859,25,3600,0.0,35,34,4,1,1,97.14285714
2001020859,24,3600,0.0,26,21,5,0,5,80.76923077
2001020860,12,3596,0.0,27,23,5,0,4,85.18518519
2001020860,28,3595,0.0,24,24,5,0,0,100.0
2001020861,11,3551,0.0,29,24,4,0,5,82.75862069
2001020861,10,3600,0.0,25,21,3,1,4,84.0
2001020862,17,3592,0.0,23,21,4,0,2,91.30434783
2001020862,8,3600,0.0,34,31,4,2,3,91.17647059
2001020863,14,1616,0.0,12,11,1,1,1,91.66666667
2001020863,14,1960,0.0,19,17,3,0,2,89.47368421
2001020863,15,3598,0.0,20,19,1,0,1,95.0
2001020864,6,3600,0.0,25,20,1,0,5,80.0
2001020864,21,3600,0.0,18,16,0,1,2,88.88888889
2001020865,25,3523,0.0,15,13,3,1,2,86.66666667
2001020865,26,3596,0.0,33,32,8,1,1,96.96969697
2001020866,1,3890,2.0,22,20,1,2,2,90.90909091
2001020866,7,3900,0.0,26,24,3,1,2,92.30769231
2001020867,5,3600,0.0,37,32,10,1,5,86.48648649
2001020867,9,3600,0.0,26,25,6,1,1,96.15384615
2001020868,2,3891,2.0,25,25,5,2,0,100.0
2001020868,4,3884,0.0,18,17,8,1,1,94.44444444
2001020869,30,3895,0.0,30,27,2,2,3,90.0
2001020869,29,3900,0.0,34,31,8,2,3,91.17647059
2001020870,11,3600,0.0,35,32,1,2,3,91.42857143
2001020870,19,3595,0.0,11,11,0,0,0,100.0
2001020871,13,3560,0.0,31,30,6,2,1,96.77419355
2001020871,18,3600,0.0,21,21,1,6,0,100.0
2001020872,28,3600,0.0,22,20,0,3,2,90.90909091
2001020872,22,3559,0.0,31,28,2,0,3,90.32258065
2001020873,6,3723,0.0,25,24,6,1,1,96.0
2001020873,23,3723,0.0,29,27,7,1,2,93.10344828
2001020874,20,3610,0.0,24,20,4,1,4,83.33333333
2001020874,27,3653,0.0,21,18,2,0,3,85.71428571
2001020875,13,48,0.0,0,0,0,0,0,
2001020875,13,3521,0.0,35,30,10,0,5,85.71428571
2001020875,16,2289,0.0,11,10,0,0,1,90.90909091
2001020875,16,1280,0.0,9,6,1,1,3,66.66666667
2001020876,3,3600,0.0,23,19,2,1,4,82.60869565
2001020876,25,3600,0.0,26,24,6,1,2,92.30769231
2001020877,17,3595,2.0,21,21,4,2,0,100.0
2001020877,30,3600,0.0,24,22,3,1,2,91.66666667
2001020878,19,3573,0.0,18,16,2,0,2,88.88888889
2001020878,21,3596,0.0,34,33,4,1,1,97.05882353
2001020879,20,3570,0.0,24,21,5,0,3,87.5
2001020879,24,3600,0.0,21,19,0,1,2,90.47619048
2001020880,27,3899,0.0,39,37,7,2,2,94.87179487
2001020880,26,3900,0.0,34,32,3,1,2,94.11764706
2001020881,12,3538,0.0,24,21,5,2,3,87.5
2001020881,10,3098,0.0,27,26,7,0,1,96.2962963
2001020881,10,502,0.0,4,4,3,0,0,100.0
2001020882,9,3600,0.0,22,20,3,0,2,90.90909091
2001020882,8,3600,0.0,27,22,7,2,5,81.48148148
2001020883,6,3900,0.0,29,26,2,1,3,89.65517241
2001020883,2,3839,0.0,31,28,4,0,3,90.32258065
2001020884,1,3600,0.0,24,21,1,1,3,87.5
2001020884,3,3540,0.0,27,23,8,0,4,85.18518519
2001020885,16,1146,0.0,3,3,0,0,0,100.0
2001020885,16,2400,0.0,30,25,9,1,5,83.33333333
2001020885,4,3600,0.0,28,24,3,1,4,85.71428571
2001020886,13,3539,0.0,22,18,6,1,4,81.81818182
2001020886,15,3589,0.0,30,27,3,0,3,90.0
2001020887,7,3549,0.0,22,20,1,1,2,90.90909091
2001020887,11,3600,0.0,34,33,1,0,1,97.05882353
2001020888,17,3775,0.0,37,34,9,1,3,91.89189189
2001020888,14,3775,0.0,36,32,3,1,4,88.88888889
2001020889,26,3594,0.0,21,20,2,0,1,95.23809524
2001020889,29,3600,0.0,34,29,6,1,5,85.29411765
2001020890,28,3600,0.0,19,18,1,0,1,94.73684211
2001020890,18,3596,0.0,23,18,1,1,5,78.26086957
2001020891,20,3893,0.0,29,27,4,2,2,93.10344828
2001020891,21,3900,0.0,31,29,6,0,2,93.5483871
2001020892,19,3899,0.0,24,20,4,0,4,83.33333333
2001020892,23,3889,0.0,22,18,4,0,4,81.81818182
2001020893,25,1200,0.0,8,7,1,0,1,87.5
2001020893,25,2400,0.0,17,13,8,0,4,76.47058824
2001020893,27,3600,0.0,35,34,8,0,1,97.14285714
2001020894,4,3600,0.0,22,22,1,0,0,100.0
2001020894,1,3576,0.0,32,31,4,0,1,96.875
2001020895,26,3597,0.0,27,23,3,0,4,85.18518519
2001020895,5,3493,0.0,31,26,3,0,5,83.87096774
2001020896,17,3837,0.0,27,25,1,5,2,92.59259259
2001020896,13,3845,0.0,60,57,13,0,3,95.0
2001020897,8,3597,2.0,29,27,2,4,2,93.10344828
2001020897,16,3529,0.0,23,20,4,1,3,86.95652174
2001020898,30,3600,0.0,21,18,6,1,3,85.71428571
2001020898,24,3545,0.0,24,20,2,0,4,83.33333333
2001020899,12,3600,0.0,18,16,3,4,2,88.88888889
2001020899,6,3594,0.0,31,25,13,0,6,80.64516129
2001020900,9,3600,0.0,34,34,6,2,0,100.0
2001020900,3,3600,0.0,31,28,8,1,3,90.32258065
2001020901,28,3600,0.0,27,25,3,1,2,92.59259259
2001020901,15,3562,0.0,23,19,6,1,4,82.60869565
2001020902,5,3676,0.0,25,22,4,0,3,88.0
2001020902,29,3693,0.0,33,29,1,2,4,87.87878788
2001020903,27,3780,0.0,27,25,2,0,2,92.59259259
2001020903,21,3790,0.0,33,32,3,1,1,96.96969697
2001020904,19,3547,0.0,32,29,3,1,3,90.625
2001020904,20,3600,0.0,23,21,1,2,2,91.30434783
2001020905,18,3600,0.0,24,22,0,0,2,91.66666667
2001020905,22,3513,0.0,23,20,6,0,3,86.95652174
2001020906,25,3025,4.0,21,20,9,0,1,95.23809524
2001020906,25,871,0.0,7,5,1,0,2,71.42857143
2001020906,23,3899,0.0,31,27,11,2,4,87.09677419
2001020907,6,3532,0.0,32,28,0,1,4,87.5
2001020907,7,3600,0.0,32,29,5,0,3,90.625
2001020908,10,3600,0.0,26,22,10,1,4,84.61538462
2001020908,1,3600,0.0,21,19,1,3,2,90.47619048
2001020909,2,3529,2.0,29,25,5,3,4,86.20689655
2001020909,11,3584,0.0,35,32,5,1,3,91.42857143
2001020910,28,3565,0.0,29,26,0,0,3,89.65517241
2001020910,14,3600,0.0,27,25,2,1,2,92.59259259
2001020911,7,3900,0.0,26,23,2,1,3,88.46153846
2001020911,10,3900,0.0,28,25,6,0,3,89.28571429
2001020912,12,3600,0.0,19,16,0,1,3,84.21052632
2001020912,8,3564,0.0,41,37,5,0,4,90.24390244
2001020913,15,3713,0.0,32,30,3,1,2,93.75
2001020913,9,3713,0.0,29,26,9,1,3,89.65517241
2001020914,11,3586,0.0,26,23,8,2,3,88.46153846
2001020914,2,3573,0.0,14,13,3,0,1,92.85714286
2001020915,4,770,4.0,8,7,2,0,1,87.5
2001020915,4,2729,0.0,20,15,5,1,5,75.0
2001020915,3,3600,0.0,31,26,7,1,5,83.87096774
2001020916,17,3600,0.0,22,20,5,0,2,90.90909091
2001020916,5,3556,0.0,29,26,2,0,3,89.65517241
2001020917,13,3528,0.0,31,28,4,2,3,90.32258065
2001020917,14,3600,0.0,26,24,4,1,2,92.30769231
2001020918,25,3600,0.0,29,28,5,2,1,96.55172414
2001020918,21,3554,0.0,29,27,4,0,2,93.10344828
2001020919,18,2400,0.0,14,10,2,1,4,71.42857143
2001020919,18,1146,0.0,5,5,0,0,0,100.0
2001020919,20,3600,0.0,23,21,1,0,2,91.30434783
2001020920,19,3884,0.0,30,29,6,0,1,96.66666667
2001020920,22,3890,0.0,26,25,6,0,1,96.15384615
2001020921,30,2400,0.0,27,21,7,1,6,77.77777778
2001020921,30,1196,2.0,7,7,3,0,0,100.0
2001020921,23,3591,0.0,14,11,3,3,3,78.57142857
2001020922,29,3600,0.0,30,30,7,1,0,100.0
2001020922,26,3578,0.0,12,11,4,0,1,91.66666667
2001020923,24,3523,0.0,27,25,6,0,2,92.59259259
2001020923,16,3600,0.0,17,16,5,0,1,94.11764706
2001020924,28,3589,0.0,35,31,1,1,4,88.57142857
2001020924,25,3600,2.0,18,17,2,1,1,94.44444444
2001020925,29,3548,0.0,23,21,1,2,2,91.30434783
2001020925,27,3600,0.0,25,24,4,0,1,96.0
2001020926,4,3600,0.0,22,21,6,0,1,95.45454545
2001020926,6,3536,0.0,29,26,6,1,3,89.65517241
2001020927,22,3600,0.0,25,25,6,0,0,100.0
2001020927,7,883,0.0,3,3,0,0,0,100.0
2001020927,7,2713,0.0,33,30,4,2,3,90.90909091
2001020928,11,2999,2.0,23,22,2,0,1,95.65217391
2001020928,11,551,0.0,6,3,1,0,3,50.0
2001020928,8,3575,0.0,26,23,3,1,3,88.46153846
2001020929,5,3600,0.0,24,22,2,2,2,91.66666667
2001020929,2,3573,0.0,19,16,6,1,3,84.21052632
2001020930,20,3600,0.0,31,28,4,1,3,90.32258065
2001020930,3,3528,0.0,34,29,2,1,5,85.29411765
2001020931,10,3600,0.0,29,27,1,0,2,93.10344828
2001020931,15,3546,0.0,28,25,6,1,3,89.28571429
2001020932,1,3568,0.0,20,18,5,1,2,90.0
2001020932,21,3600,0.0,23,23,1,1,0,100.0
2001020933,9,3900,0.0,30,29,2,1,1,96.66666667
2001020933,26,3884,0.0,25,24,3,1,1,96.0
2001020934,13,3803,0.0,32,26,3,0,6,81.25
2001020934,5,3803,2.0,25,20,3,1,5,80.0
2001020935,12,3690,0.0,20,19,1,0,1,95.0
2001020935,16,3696,2.0,17,15,3,0,2,88.23529412
2001020936,3,3824,0.0,28,26,9,0,2,92.85714286
2001020936,30,3822,0.0,27,24,1,2,3,88.88888889
2001020937,1,3553,0.0,24,21,2,1,3,87.5
2001020937,27,3600,0.0,27,26,4,0,1,96.2962963
2001020938,18,3600,0.0,26,26,4,3,0,100.0
2001020938,28,3570,0.0,17,16,1,0,1,94.11764706
2001020939,6,3540,0.0,16,11,5,1,5,68.75
2001020939,8,690,0.0,2,2,0,0,0,100.0
2001020939,8,2910,0.0,39,36,6,1,3,92.30769231
2001020940,20,3519,0.0,20,17,4,0,3,85.0
2001020940,15,3600,0.0,21,19,1,2,2,90.47619048
2001020941,24,3597,0.0,22,21,3,1,1,95.45454545
2001020941,11,3600,0.0,40,36,4,1,4,90.0
2001020942,22,3600,0.0,37,35,10,1,2,94.59459459
2001020942,14,3596,0.0,39,36,10,6,3,92.30769231
2001020943,10,2400,0.0,12,9,2,0,3,75.0
2001020943,10,1200,0.0,13,10,2,0,3,76.92307692
2001020943,17,3600,0.0,35,33,3,4,2,94.28571429
2001020944,26,3833,0.0,31,28,3,0,3,90.32258065
2001020944,25,3833,0.0,26,24,2,1,2,92.30769231
2001020945,29,1200,0.0,3,2,0,0,1,66.66666667
2001020945,29,2399,0.0,20,17,2,2,3,85.0
2001020945,21,3600,0.0,33,32,10,0,1,96.96969697
2001020946,7,3594,0.0,26,26,4,1,0,100.0
2001020946,2,2400,0.0,12,10,0,0,2,83.33333333
2001020946,2,1200,0.0,8,5,1,0,3,62.5
2001020947,20,3600,0.0,35,33,3,5,2,94.28571429
2001020947,4,3575,0.0,31,28,9,1,3,90.32258065
2001020948,12,3600,0.0,16,15,4,0,1,93.75
2001020948,5,3510,0.0,21,18,4,0,3,85.71428571
2001020949,3,3600,2.0,31,26,4,2,5,83.87096774
2001020949,16,3600,0.0,18,17,2,0,1,94.44444444
2001020950,30,3578,0.0,28,28,5,1,0,100.0
2001020950,19,3600,0.0,26,23,4,2,3,88.46153846
2001020951,26,3600,0.0,25,23,4,1,2,92.0
2001020951,18,3600,0.0,27,24,4,0,3,88.88888889
2001020952,23,2921,2.0,22,18,5,1,4,81.81818182
2001020952,23,665,0.0,5,3,0,0,2,60.0
2001020952,27,3600,0.0,22,21,3,3,1,95.45454545
2001020953,9,2190,0.0,21,16,1,1,5,76.19047619
2001020953,9,1410,0.0,9,9,1,0,0,100.0
2001020953,28,3600,0.0,22,20,3,3,2,90.90909091
2001020954,8,3598,0.0,37,34,10,0,3,91.89189189
2001020954,7,3600,0.0,26,26,3,0,0,100.0
2001020955,15,16,0.0,0,0,0,0,0,
2001020955,15,3884,0.0,28,26,6,0,2,92.85714286
2001020955,12,3900,2.0,33,31,11,3,2,93.93939394
2001020956,6,3600,0.0,21,21,1,0,0,100.0
2001020956,11,3597,0.0,38,35,5,2,3,92.10526316
2001020957,4,3600,0.0,22,20,1,1,2,90.90909091
2001020957,14,3579,0.0,27,24,3,0,3,88.88888889
2001020958,22,2674,0.0,19,18,5,1,1,94.73684211
2001020958,22,839,0.0,10,6,0,1,4,60.0
2001020958,13,3600,0.0,44,40,5,3,4,90.90909091
2001020959,2,3543,0.0,16,13,3,0,3,81.25
2001020959,29,3600,0.0,41,39,4,2,2,95.12195122
2001020960,30,3600,0.0,26,23,1,0,3,88.46153846
2001020960,25,3550,0.0,21,17,2,0,4,80.95238095
2001020961,1,3482,0.0,19,17,1,2,2,89.47368421
2001020961,24,3600,0.0,45,44,4,0,1,97.77777778
2001020962,20,3533,0.0,23,20,2,0,3,86.95652174
2001020962,6,3600,0.0,31,29,7,1,2,93.5483871
2001020963,10,3900,0.0,21,20,7,1,1,95.23809524
2001020963,8,3897,0.0,28,27,2,0,1,96.42857143
2001020964,3,3637,0.0,31,28,9,1,3,90.32258065
2001020964,5,3637,0.0,26,24,5,2,2,92.30769231
2001020965,18,3900,0.0,30,28,3,0,2,93.33333333
2001020965,13,3900,0.0,24,22,2,0,2,91.66666667
2001020966,17,3600,0.0,30,28,3,4,2,93.33333333
2001020966,19,3593,0.0,25,21,9,0,4,84.0
2001020967,26,3540,0.0,24,20,1,0,4,83.33333333
2001020967,21,3600,0.0,21,18,2,0,3,85.71428571
2001020968,9,3593,0.0,29,26,3,1,3,89.65517241
2001020968,27,3600,0.0,21,19,3,0,2,90.47619048
2001020969,23,3502,2.0,22,20,3,1,2,90.90909091
2001020969,28,3600,0.0,32,32,7,0,0,100.0
2001020970,17,1200,0.0,7,6,5,0,1,85.71428571
2001020970,17,2400,0.0,22,18,5,0,4,81.81818182
2001020970,7,3600,0.0,20,19,6,1,1,95.0
2001020971,11,411,0.0,4,4,0,0,0,100.0
2001020971,11,3188,0.0,32,26,9,0,6,81.25
2001020971,2,3600,0.0,19,18,4,4,1,94.73684211
2001020972,10,3600,0.0,17,16,2,1,1,94.11764706
2001020972,4,3543,0.0,19,17,5,0,2,89.47368421
2001020973,22,3567,0.0,17,13,1,0,4,76.47058824
2001020973,15,3600,0.0,28,26,0,1,2,92.85714286
2001020974,18,2599,0.0,24,20,3,1,4,83.33333333
2001020974,18,1001,0.0,10,9,0,0,1,90.0
2001020974,14,3587,2.0,21,20,2,1,1,95.23809524
2001020975,1,3600,0.0,22,22,1,0,0,100.0
2001020975,25,3600,0.0,21,18,1,1,3,85.71428571
2001020976,29,2098,0.0,17,12,3,0,5,70.58823529
2001020976,29,1502,0.0,8,8,3,2,0,100.0
2001020976,30,3583,0.0,14,14,4,0,0,100.0
2001020977,28,3597,0.0,30,26,7,3,4,86.66666667
2001020977,23,1542,0.0,8,4,0,1,4,50.0
2001020977,23,2021,0.0,15,13,5,0,2,86.66666667
2001020978,9,3600,0.0,18,16,3,0,2,88.88888889
2001020978,24,3568,0.0,18,15,4,0,3,83.33333333
2001020979,8,3566,2.0,42,40,7,0,2,95.23809524
2001020979,3,3600,0.0,24,23,0,1,1,95.83333333
2001020980,29,3600,0.0,36,34,7,0,2,94.44444444
2001020980,5,3560,0.0,19,15,2,0,4,78.94736842
2001020981,20,3895,0.0,35,32,15,3,3,91.42857143
2001020981,12,3900,0.0,28,25,9,1,3,89.28571429
2001020982,21,3600,0.0,35,33,9,0,2,94.28571429
2001020982,19,3563,0.0,18,15,4,0,3,83.33333333
2001020983,16,3542,0.0,32,30,2,0,2,93.75
2001020983,26,3600,0.0,11,10,3,0,1,90.90909091
2001020984,2,3600,2.0,28,28,2,0,0,100.0
2001020984,7,3543,0.0,27,25,2,1,2,92.59259259
2001020985,4,3900,0.0,22,21,5,0,1,95.45454545
2001020985,10,3900,0.0,23,22,2,0,1,95.65217391
2001020986,25,3600,0.0,27,25,4,3,2,92.59259259
2001020986,15,3543,0.0,33,29,3,2,4,87.87878788
2001020987,14,3895,0.0,26,22,2,0,4,84.61538462
2001020987,11,3900,0.0,42,38,9,0,4,90.47619048
2001020988,23,3600,0.0,23,23,9,1,0,100.0
2001020988,18,2400,0.0,36,32,6,0,4,88.88888889
2001020988,18,1200,0.0,9,8,2,0,1,88.88888889
2001020989,9,3701,0.0,19,16,2,0,3,84.21052632
2001020989,30,3701,0.0,32,28,3,0,4,87.5
2001020990,16,3546,0.0,24,22,3,1,2,91.66666667
2001020990,27,3600,0.0,39,38,5,0,1,97.43589744
2001020991,2,3540,0.0,22,19,5,0,3,86.36363636
2001020991,1,3600,0.0,20,18,7,0,2,90.0
2001020992,6,3600,0.0,34,33,2,0,1,97.05882353
2001020992,3,3543,0.0,24,22,2,0,2,91.66666667
2001020993,20,3900,2.0,34,31,6,0,3,91.17647059
2001020993,13,3900,0.0,49,46,2,1,3,93.87755102
2001020994,22,3759,0.0,31,27,7,0,4,87.09677419
2001020994,17,3835,0.0,38,35,4,1,3,92.10526316
2001020995,5,3509,0.0,28,24,3,0,4,85.71428571
2001020995,24,3600,0.0,31,29,3,2,2,93.5483871
2001020996,19,3593,0.0,18,18,4,0,0,100.0
2001020996,28,3580,0.0,26,25,5,2,1,96.15384615
2001020997,10,3600,0.0,20,19,6,2,1,95.0
2001020997,6,3536,0.0,27,25,7,2,2,92.59259259
2001020998,25,3900,0.0,21,18,0,0,3,85.71428571
2001020998,8,3885,0.0,42,39,3,0,3,92.85714286
2001020999,22,3600,0.0,21,20,2,1,1,95.23809524
2001020999,9,3546,0.0,17,14,4,0,3,82.35294118
2001021000,7,3598,2.0,32,31,4,1,1,96.875
2001021000,4,3522,0.0,22,20,1,0,2,90.90909091
2001021001,21,3571,0.0,27,26,3,0,1,96.2962963
2001021001,11,3600,0.0,23,23,1,0,0,100.0
2001021002,20,3512,0.0,24,21,2,0,3,87.5
2001021002,14,3600,0.0,32,30,4,0,2,93.75
2001021003,23,3600,0.0,27,26,0,0,1,96.2962963
2001021003,29,1670,0.0,12,11,0,0,1,91.66666667
2001021003,29,1930,0.0,24,20,3,0,4,83.33333333
2001021004,19,3531,0.0,22,20,0,0,2,90.90909091
2001021004,26,3600,0.0,29,28,1,2,1,96.55172414
2001021005,7,3234,0.0,17,15,5,1,2,88.23529412
2001021005,7,364,0.0,6,3,0,1,3,50.0
2001021005,13,3600,2.0,30,28,9,2,2,93.33333333
2001021006,27,3600,0.0,42,40,10,5,2,95.23809524
2001021006,18,3530,0.0,18,15,2,1,3,83.33333333
2001021007,16,3900,0.0,33,32,11,2,1,96.96969697
2001021007,24,3900,0.0,40,39,2,5,1,97.5
2001021008,15,3536,0.0,26,21,4,0,5,80.76923077
2001021008,28,3596,0.0,27,23,2,2,4,85.18518519
2001021009,17,3533,0.0,22,20,6,1,2,90.90909091
2001021009,6,3582,0.0,30,29,4,1,1,96.66666667
2001021010,25,1647,0.0,22,19,4,0,3,86.36363636
2001021010,25,2253,0.0,13,11,1,0,2,84.61538462
2001021010,10,3900,0.0,31,26,4,1,5,83.87096774
2001021011,12,3562,0.0,22,19,5,0,3,86.36363636
2001021011,8,3598,0.0,33,31,8,1,2,93.93939394
2001021012,2,3519,0.0,31,27,5,0,4,87.09677419
2001021012,9,3600,0.0,21,18,1,0,3,85.71428571
2001021013,3,3537,2.0,26,23,1,2,3,88.46153846
2001021013,1,3600,0.0,25,24,8,1,1,96.0
2001021014,21,3600,0.0,37,36,14,1,1,97.2972973
2001021014,4,3481,0.0,18,16,0,0,2,88.88888889
2001021015,23,3600,0.0,16,14,0,1,2,87.5
2001021015,11,3547,0.0,40,36,6,1,4,90.0
2001021016,20,3535,0.0,20,17,5,0,3,85.0
2001021016,29,3600,0.0,43,42,1,3,1,97.6744186
2001021017,15,3521,0.0,22,19,4,1,3,86.36363636
2001021017,22,3596,0.0,28,27,0,0,1,96.42857143
2001021018,5,2389,0.0,14,13,5,1,1,92.85714286
2001021018,5,1200,0.0,10,7,0,0,3,70.0
2001021018,26,3582,0.0,23,20,3,1,3,86.95652174
2001021019,16,3868,0.0,26,24,6,1,2,92.30769231
2001021019,28,3900,0.0,37,35,3,0,2,94.59459459
2001021020,13,3553,0.0,41,39,13,0,2,95.12195122
2001021020,9,3592,0.0,28,28,5,0,0,100.0
2001021021,17,3600,2.0,26,23,4,1,3,88.46153846
2001021021,3,3581,0.0,34,30,7,1,4,88.23529412
2001021022,7,3876,0.0,24,22,4,2,2,91.66666667
2001021022,14,3897,0.0,24,22,5,1,2,91.66666667
2001021023,21,3600,0.0,28,24,5,2,4,85.71428571
2001021023,18,3564,0.0,21,16,1,0,5,76.19047619
2001021024,27,3900,0.0,25,23,4,0,2,92.0
2001021024,30,3900,0.0,27,25,4,1,2,92.59259259
2001021025,19,3598,0.0,14,12,2,0,2,85.71428571
2001021025,24,3581,0.0,21,18,1,2,3,85.71428571
2001021026,23,3771,0.0,18,16,3,0,2,88.88888889
2001021026,1,3769,0.0,26,23,5,0,3,88.46153846
2001021027,14,3900,0.0,41,38,1,0,3,92.68292683
2001021027,4,3900,0.0,25,22,0,0,3,88.0
2001021028,8,3900,0.0,42,41,7,1,1,97.61904762
2001021028,12,3825,0.0,26,25,4,0,1,96.15384615
2001021029,5,3600,0.0,24,22,4,1,2,91.66666667
2001021029,11,3535,0.0,26,23,5,1,3,88.46153846
2001021030,25,3900,0.0,27,25,0,1,2,92.59259259
2001021030,16,3896,0.0,35,33,4,1,2,94.28571429
2001021031,20,3546,0.0,13,10,3,0,3,76.92307692
2001021031,30,3600,0.0,25,23,4,0,2,92.0
2001021032,26,3600,0.0,24,22,6,5,2,91.66666667
2001021032,28,3552,0.0,30,27,6,0,3,90.0
2001021033,27,3560,0.0,30,26,3,2,4,86.66666667
2001021033,6,3600,0.0,29,27,7,1,2,93.10344828
2001021034,9,3600,0.0,24,19,1,2,5,79.16666667
2001021034,7,3600,0.0,34,33,5,0,1,97.05882353
2001021035,2,3731,0.0,24,21,2,1,3,87.5
2001021035,10,3726,0.0,28,26,4,0,2,92.85714286
2001021036,23,3600,0.0,27,26,11,0,1,96.2962963
2001021036,3,3564,0.0,21,19,3,2,2,90.47619048
2001021037,24,3600,0.0,29,28,8,3,1,96.55172414
2001021037,17,3548,0.0,25,23,1,0,2,92.0
2001021038,18,3594,2.0,19,15,3,0,4,78.94736842
2001021038,19,3600,0.0,26,25,4,3,1,96.15384615
2001021039,15,3600,0.0,21,21,5,0,0,100.0
2001021039,21,3532,0.0,23,21,5,0,2,91.30434783
2001021040,27,3600,2.0,30,29,7,1,1,96.66666667
2001021040,5,3516,0.0,26,23,6,2,3,88.46153846
2001021041,11,2036,0.0,24,21,5,0,3,87.5
2001021041,11,1564,0.0,13,12,2,0,1,92.30769231
2001021041,14,3593,0.0,21,19,1,3,2,90.47619048
2001021042,8,3600,0.0,30,29,10,2,1,96.66666667
2001021042,13,410,0.0,3,2,0,0,1,66.66666667
2001021042,13,3190,0.0,26,23,4,2,3,88.46153846
2001021043,1,3600,2.0,22,21,8,0,1,95.45454545
2001021043,16,2246,0.0,14,13,0,1,1,92.85714286
2001021043,16,1354,0.0,15,13,0,0,2,86.66666667
2001021044,19,3498,0.0,23,20,7,0,3,86.95652174
2001021044,25,3600,0.0,25,23,3,0,2,92.0
2001021045,29,3600,0.0,25,24,4,0,1,96.0
2001021045,30,3595,0.0,22,19,4,0,3,86.36363636
2001021046,28,3565,0.0,28,26,4,1,2,92.85714286
2001021046,22,3593,0.0,25,24,7,2,1,96.0
2001021047,6,3600,0.0,26,25,8,0,1,96.15384615
2001021047,7,3557,0.0,27,25,2,1,2,92.59259259
2001021048,15,3595,0.0,22,19,0,0,3,86.36363636
2001021048,10,3544,0.0,31,27,4,0,4,87.09677419
2001021049,3,3600,0.0,19,17,3,0,2,89.47368421
2001021049,9,3600,0.0,18,13,0,1,5,72.22222222
2001021050,23,3547,2.0,33,30,9,0,3,90.90909091
2001021050,2,3600,0.0,38,36,5,3,2,94.73684211
2001021051,24,3552,0.0,23,21,1,0,2,91.30434783
2001021051,4,3591,0.0,16,15,5,0,1,93.75
2001021052,13,3545,0.0,35,32,9,0,3,91.42857143
2001021052,12,3597,0.0,16,14,1,1,2,87.5
2001021053,17,3625,0.0,22,20,5,1,2,90.90909091
2001021053,29,3625,0.0,21,18,4,1,3,85.71428571
2001021054,1,3598,0.0,27,24,3,1,3,88.88888889
2001021054,18,3542,0.0,36,32,6,1,4,88.88888889
2001021055,28,3600,0.0,25,24,7,0,1,96.0
2001021055,20,3586,0.0,28,24,2,0,4,85.71428571
2001021056,21,3600,0.0,21,18,4,0,3,85.71428571
2001021056,26,3600,0.0,27,26,7,1,1,96.2962963
2001021057,11,3600,0.0,35,33,3,1,2,94.28571429
2001021057,3,140,0.0,2,2,0,0,0,100.0
2001021057,3,3456,0.0,31,26,6,1,5,83.87096774
2001021058,8,3840,0.0,40,37,7,1,3,92.5
2001021058,14,3900,0.0,26,23,1,0,3,88.46153846
2001021059,24,3515,0.0,29,26,6,0,3,89.65517241
2001021059,19,3600,0.0,23,21,5,0,2,91.30434783
2001021060,27,3567,0.0,35,31,2,0,4,88.57142857
2001021060,25,3577,2.0,23,20,3,1,3,86.95652174
2001021061,7,3500,0.0,23,21,5,0,2,91.30434783
2001021061,10,3600,0.0,20,20,0,0,0,100.0
2001021062,11,3699,0.0,52,50,17,0,2,96.15384615
2001021062,9,3701,0.0,15,12,0,2,3,80.0
2001021063,12,3600,0.0,26,24,3,1,2,92.30769231
2001021063,1,3593,0.0,19,16,3,0,3,84.21052632
2001021064,30,3574,0.0,23,21,4,1,2,91.30434783
2001021064,2,3600,0.0,29,28,3,1,1,96.55172414
2001021065,4,3893,0.0,23,19,1,1,4,82.60869565
2001021065,5,3898,2.0,26,22,5,0,4,84.61538462
2001021066,6,3584,0.0,26,25,1,2,1,96.15384615
2001021066,13,3554,0.0,22,20,0,3,2,90.90909091
2001021067,15,3598,0.0,29,27,5,0,2,93.10344828
2001021067,29,3538,0.0,26,22,2,0,4,84.61538462
2001021068,8,658,0.0,7,4,0,1,3,57.14285714
2001021068,8,2942,0.0,19,17,3,3,2,89.47368421
2001021068,18,3600,0.0,43,42,6,0,1,97.6744186
2001021069,17,3595,2.0,31,31,8,1,0,100.0
2001021069,21,3529,2.0,26,24,5,2,2,92.30769231
2001021070,20,945,0.0,9,6,4,0,3,66.66666667
2001021070,20,2597,0.0,16,16,5,2,0,100.0
2001021070,22,3600,0.0,35,34,12,2,1,97.14285714
2001021071,28,2400,0.0,24,21,7,0,3,87.5
2001021071,28,1176,0.0,7,7,0,0,0,100.0
2001021071,26,3598,0.0,17,17,3,1,0,100.0
2001021072,7,3687,0.0,27,25,2,0,2,92.59259259
2001021072,9,3687,0.0,26,23,5,0,3,88.46153846
2001021073,15,1200,0.0,5,4,1,1,1,80.0
2001021073,15,2400,0.0,27,22,7,2,5,81.48148148
2001021073,5,3594,2.0,23,21,6,2,2,91.30434783
2001021074,6,3872,0.0,30,27,5,0,3,90.0
2001021074,14,3859,0.0,24,20,5,0,4,83.33333333
2001021075,19,3822,0.0,20,16,1,1,4,80.0
2001021075,16,3814,0.0,31,28,5,2,3,90.32258065
2001021076,24,3600,0.0,28,27,4,0,1,96.42857143
2001021076,25,3514,0.0,13,11,1,0,2,84.61538462
2001021077,22,3592,0.0,22,22,4,1,0,100.0
2001021077,23,3474,0.0,20,18,3,1,2,90.0
2001021078,26,1200,0.0,10,8,2,0,2,80.0
2001021078,26,2254,0.0,10,9,4,0,1,90.0
2001021078,27,3594,0.0,25,25,5,4,0,100.0
2001021079,13,3600,0.0,37,34,4,1,3,91.89189189
2001021079,1,3586,0.0,15,14,4,0,1,93.33333333
2001021080,3,3520,0.0,31,28,4,0,3,90.32258065
2001021080,2,3600,0.0,29,27,0,0,2,93.10344828
2001021081,10,3554,0.0,35,32,6,4,3,91.42857143
2001021081,4,3600,0.0,26,25,10,0,1,96.15384615
2001021082,17,3900,0.0,20,17,4,0,3,85.0
2001021082,18,3900,0.0,38,35,8,0,3,92.10526316
2001021083,29,3594,0.0,34,28,4,4,6,82.35294118
2001021083,20,3600,0.0,33,32,4,1,1,96.96969697
2001021084,15,3600,0.0,31,28,3,0,3,90.32258065
2001021084,7,3556,0.0,19,15,3,1,4,78.94736842
2001021085,14,2710,0.0,21,17,2,0,4,80.95238095
2001021085,14,890,0.0,7,4,0,1,3,57.14285714
2001021085,10,3596,0.0,26,24,2,1,2,92.30769231
2001021086,13,3598,0.0,33,32,4,1,1,96.96969697
2001021086,8,3529,0.0,43,41,11,3,2,95.34883721
2001021087,6,3598,2.0,31,29,7,1,2,93.5483871
2001021087,12,3527,0.0,30,27,4,0,3,90.0
2001021088,30,3600,0.0,27,26,7,0,1,96.2962963
2001021088,19,3524,0.0,17,16,3,1,1,94.11764706
2001021089,29,3600,0.0,28,25,4,1,3,89.28571429
2001021089,22,3585,0.0,28,27,7,1,1,96.42857143
2001021090,26,3600,0.0,27,23,7,0,4,85.18518519
2001021090,23,3595,0.0,18,18,6,2,0,100.0
2001021091,25,3526,0.0,30,27,7,1,3,90.0
2001021091,28,3600,0.0,38,36,7,0,2,94.73684211
2001021092,9,3600,0.0,28,27,3,1,1,96.42857143
2001021092,2,3600,4.0,35,31,5,0,4,88.57142857
2001021093,4,3600,0.0,27,25,1,0,2,92.59259259
2001021093,3,3585,0.0,32,29,3,1,3,90.625
2001021094,1,3600,0.0,21,18,0,0,3,85.71428571
2001021094,5,3547,0.0,31,27,0,0,4,87.09677419
2001021095,30,3600,0.0,24,22,4,0,2,91.66666667
2001021095,11,3555,0.0,38,35,6,1,3,92.10526316
2001021096,18,3600,0.0,31,27,8,0,4,87.09677419
2001021096,16,3600,0.0,17,16,5,0,1,94.11764706
2001021097,27,3600,0.0,27,25,0,1,2,92.59259259
2001021097,24,3528,0.0,18,14,2,0,4,77.77777778
2001021098,2,3600,0.0,32,28,7,2,4,87.5
2001021098,10,3567,0.0,22,17,3,1,5,77.27272727
2001021099,14,3563,0.0,24,22,1,1,2,91.66666667
2001021099,8,3600,0.0,33,32,5,0,1,96.96969697
2001021100,13,3600,0.0,40,37,13,1,3,92.5
2001021100,9,3595,0.0,29,25,0,1,4,86.20689655
2001021101,4,3600,10.0,29,25,6,0,4,86.20689655
2001021101,12,3600,0.0,19,18,3,3,1,94.73684211
2001021102,18,3884,0.0,40,37,11,1,3,92.5
2001021102,17,3875,0.0,24,21,6,1,3,87.5
2001021103,7,1967,0.0,19,15,3,0,4,78.94736842
2001021103,7,1633,0.0,5,5,0,0,0,100.0
2001021103,19,3600,0.0,13,12,4,0,1,92.30769231
2001021104,25,3900,0.0,33,31,2,1,2,93.93939394
2001021104,20,3900,0.0,36,34,4,0,2,94.44444444
2001021105,26,3900,0.0,22,20,2,0,2,90.90909091
2001021105,22,3896,0.0,24,22,3,1,2,91.66666667
2001021106,29,3860,0.0,39,35,9,0,4,89.74358974
2001021106,23,3844,0.0,20,17,3,2,3,85.0
2001021107,24,3832,0.0,27,26,2,0,1,96.2962963
2001021107,27,3831,0.0,28,26,0,0,2,92.85714286
2001021108,21,3600,0.0,32,30,6,0,2,93.75
2001021108,28,3539,0.0,27,24,8,0,3,88.88888889
2001021109,15,3600,0.0,27,26,2,0,1,96.2962963
2001021109,1,3583,2.0,15,13,0,0,2,86.66666667
2001021110,16,3600,0.0,16,15,1,2,1,93.75
2001021110,30,3600,2.0,22,19,9,0,3,86.36363636
2001021111,12,3600,0.0,21,21,8,2,0,100.0
2001021111,6,3547,0.0,14,13,1,1,1,92.85714286
2001021112,1,3600,0.0,33,32,6,4,1,96.96969697
2001021112,10,1149,0.0,6,5,2,1,1,83.33333333
2001021112,10,2400,0.0,25,23,2,2,2,92.0
2001021113,5,3692,0.0,35,33,11,1,2,94.28571429
2001021113,8,3692,0.0,26,25,1,5,1,96.15384615
2001021114,14,3473,0.0,36,33,8,0,3,91.66666667
2001021114,9,3600,0.0,17,16,5,0,1,94.11764706
2001021115,7,3600,0.0,29,28,0,1,1,96.55172414
2001021115,4,3508,0.0,22,19,0,1,3,86.36363636
2001021116,2,3577,2.0,30,27,4,0,3,90.0
2001021116,15,3600,0.0,13,11,2,0,2,84.61538462
2001021117,3,3600,0.0,33,31,5,1,2,93.93939394
2001021117,13,3593,0.0,39,35,5,5,4,89.74358974
2001021118,11,3590,0.0,32,28,8,1,4,87.5
2001021118,17,3600,0.0,22,21,5,1,1,95.45454545
2001021119,19,3600,0.0,24,22,3,0,2,91.66666667
2001021119,18,3545,0.0,29,25,3,3,4,86.20689655
2001021120,26,3558,0.0,26,21,3,2,5,80.76923077
2001021120,20,3600,0.0,28,25,6,0,3,89.28571429
2001021121,25,3595,0.0,25,23,4,1,2,92.0
2001021121,22,3600,0.0,19,18,4,2,1,94.73684211
2001021122,24,3593,0.0,31,27,11,1,4,87.09677419
2001021122,23,3590,0.0,17,16,2,2,1,94.11764706
2001021123,21,669,0.0,5,5,1,1,0,100.0
2001021123,21,2900,20.0,20,16,2,2,4,80.0
2001021123,27,3599,0.0,30,27,5,3,3,90.0
2001021124,29,533,0.0,8,5,2,0,3,62.5
2001021124,29,3067,0.0,23,16,0,1,7,69.56521739
2001021124,28,3600,0.0,34,32,3,1,2,94.11764706
2001021125,30,3583,0.0,25,23,4,2,2,92.0
2001021125,16,3600,0.0,19,18,4,0,1,94.73684211
2001021126,4,3522,0.0,16,14,5,0,2,87.5
2001021126,7,3600,0.0,35,34,4,1,1,97.14285714
2001021127,1,3579,0.0,21,18,0,1,3,85.71428571
2001021127,2,3600,2.0,41,39,6,2,2,95.12195122
2001021128,8,3600,0.0,28,28,5,1,0,100.0
2001021128,5,3575,0.0,24,21,3,1,3,87.5
2001021129,3,3600,0.0,30,26,5,1,4,86.66666667
2001021129,14,3532,0.0,20,15,2,1,5,75.0
2001021130,10,3810,0.0,35,31,7,1,4,88.57142857
2001021130,17,3812,0.0,26,21,1,0,5,80.76923077
2001021131,29,3518,0.0,21,18,2,0,3,85.71428571
2001021131,25,3595,0.0,18,17,2,0,1,94.44444444
2001021132,18,3600,0.0,33,28,7,1,5,84.84848485
2001021132,21,3597,0.0,23,22,4,0,1,95.65217391
2001021133,19,2400,0.0,15,11,0,1,4,73.33333333
2001021133,19,1154,0.0,6,5,2,1,1,83.33333333
2001021133,27,3600,0.0,34,31,3,0,3,91.17647059
2001021134,12,3546,0.0,21,17,4,0,4,80.95238095
2001021134,9,3600,0.0,38,35,9,0,3,92.10526316
2001021135,6,3600,0.0,28,26,3,0,2,92.85714286
2001021135,4,3530,0.0,36,32,8,2,4,88.88888889
2001021136,11,3474,0.0,27,23,8,3,4,85.18518519
2001021136,20,3596,0.0,18,16,3,0,2,88.88888889
2001021137,30,3735,0.0,32,30,2,0,2,93.75
2001021137,22,3731,0.0,28,27,3,0,1,96.42857143
2001021138,23,3876,0.0,31,27,6,1,4,87.09677419
2001021138,26,3900,0.0,35,31,10,1,4,88.57142857
2001021139,24,3600,0.0,30,27,3,1,3,90.0
2001021139,28,3599,0.0,26,25,3,0,1,96.15384615
2001021140,2,3900,0.0,35,34,9,2,1,97.14285714
2001021140,7,3895,0.0,27,26,4,0,1,96.2962963
2001021141,14,1180,0.0,6,6,0,1,0,100.0
2001021141,14,2400,0.0,19,16,2,0,3,84.21052632
2001021141,15,3600,0.0,20,19,8,0,1,95.0
2001021142,1,3598,0.0,26,24,3,0,2,92.30769231
2001021142,12,3543,0.0,27,24,1,1,3,88.88888889
2001021143,5,3554,0.0,26,23,2,0,3,88.46153846
2001021143,13,3590,0.0,33,31,10,1,2,93.93939394
2001021144,18,3591,0.0,20,19,7,0,1,95.0
2001021144,16,3528,0.0,19,16,7,1,3,84.21052632
2001021145,19,3749,0.0,24,23,7,1,1,95.83333333
2001021145,25,3749,0.0,32,30,3,0,2,93.75
2001021146,11,1200,0.0,12,11,1,0,1,91.66666667
2001021146,11,2400,0.0,37,32,2,1,5,86.48648649
2001021146,21,3600,0.0,24,24,6,4,0,100.0
2001021147,17,3900,0.0,30,29,4,1,1,96.66666667
2001021147,24,3194,0.0,18,17,4,2,1,94.44444444
2001021147,24,703,0.0,5,5,2,0,0,100.0
2001021148,2,3809,0.0,40,39,8,1,1,97.5
2001021148,6,3809,0.0,16,14,2,1,2,87.5
2001021149,3,3600,0.0,37,35,4,2,2,94.59459459
2001021149,10,3560,0.0,24,20,0,1,4,83.33333333
2001021150,8,3600,0.0,24,23,1,2,1,95.83333333
2001021150,4,3534,0.0,24,21,4,0,3,87.5
2001021151,5,3557,0.0,31,28,4,1,3,90.32258065
2001021151,14,3598,0.0,31,29,10,2,2,93.5483871
2001021152,18,3551,0.0,23,21,4,3,2,91.30434783
2001021152,29,3592,0.0,21,20,5,0,1,95.23809524
2001021153,30,3569,0.0,36,32,7,1,4,88.88888889
2001021153,20,3600,0.0,26,23,4,1,3,88.46153846
2001021154,17,3600,0.0,28,25,4,1,3,89.28571429
2001021154,26,3600,0.0,31,31,1,0,0,100.0
2001021155,27,3550,0.0,30,25,7,0,5,83.33333333
2001021155,28,3600,0.0,23,21,7,1,2,91.30434783
2001021156,13,3461,0.0,34,31,4,1,3,91.17647059
2001021156,7,3593,0.0,22,21,4,0,1,95.45454545
2001021157,9,3900,0.0,25,25,2,1,0,100.0
2001021157,15,3900,0.0,28,28,3,0,0,100.0
2001021158,1,3600,0.0,15,14,1,3,1,93.33333333
2001021158,11,3583,0.0,35,33,5,2,2,94.28571429
2001021159,16,3600,0.0,40,35,14,0,5,87.5
2001021159,19,3595,0.0,21,20,2,0,1,95.23809524
2001021160,21,3593,0.0,20,17,5,1,3,85.0
2001021160,25,3600,0.0,22,21,2,2,1,95.45454545
2001021161,30,3743,0.0,27,22,3,0,5,81.48148148
2001021161,23,3736,0.0,37,33,1,1,4,89.18918919
2001021162,22,3460,0.0,30,28,4,3,2,93.33333333
2001021162,24,3600,0.0,26,26,2,1,0,100.0
2001021163,3,3600,0.0,38,34,4,0,4,89.47368421
2001021163,6,3541,0.0,24,19,2,0,5,79.16666667
2001021164,13,3900,0.0,48,46,12,2,2,95.83333333
2001021164,10,3900,0.0,25,23,2,3,2,92.0
2001021165,29,3600,0.0,24,20,1,0,4,83.33333333
2001021165,8,3600,0.0,20,19,1,1,1,95.0
2001021166,15,3518,0.0,24,19,1,1,5,79.16666667
2001021166,2,3600,0.0,28,24,5,0,4,85.71428571
2001021167,5,3557,0.0,36,34,4,0,2,94.44444444
2001021167,4,3586,0.0,18,17,2,1,1,94.44444444
2001021168,20,3505,0.0,23,21,10,2,2,91.30434783
2001021168,20,58,0.0,0,0,0,0,0,
2001021168,18,1200,0.0,9,8,5,1,1,88.88888889
2001021168,18,2400,0.0,23,23,12,1,0,100.0
2001021169,22,3592,0.0,29,25,5,1,4,86.20689655
2001021169,26,3628,0.0,20,17,5,2,3,85.0
2001021170,17,3600,0.0,32,26,3,2,6,81.25
2001021170,28,3600,2.0,34,31,5,0,3,91.17647059
2001021171,8,3600,0.0,35,34,2,0,1,97.14285714
2001021171,9,3589,0.0,19,16,1,0,3,84.21052632
2001021172,6,3787,0.0,25,22,4,0,3,88.0
2001021172,1,3797,0.0,24,22,4,0,2,91.66666667
2001021173,11,3885,2.0,43,42,10,1,1,97.6744186
2001021173,12,3890,0.0,22,21,5,0,1,95.45454545
2001021174,7,3579,0.0,28,25,4,2,3,89.28571429
2001021174,14,3534,0.0,23,19,6,0,4,82.60869565
2001021175,20,3552,0.0,33,30,13,0,3,90.90909091
2001021175,16,3598,0.0,17,15,4,1,2,88.23529412
2001021176,21,3600,0.0,32,30,5,3,2,93.75
2001021176,19,1506,0.0,4,4,1,0,0,100.0
2001021176,19,2034,0.0,11,8,2,0,3,72.72727273
2001021177,27,3546,0.0,25,21,4,0,4,84.0
2001021177,23,3567,2.0,30,27,6,1,3,90.0
2001021178,25,3600,0.0,22,18,0,0,4,81.81818182
2001021178,24,3600,0.0,37,36,7,0,1,97.2972973
2001021179,29,2400,0.0,23,22,4,2,1,95.65217391
2001021179,29,1200,0.0,11,8,0,0,3,72.72727273
2001021179,10,3600,0.0,30,29,1,1,1,96.66666667
2001021180,12,3600,0.0,25,24,4,3,1,96.0
2001021180,2,3533,0.0,25,23,3,0,2,92.0
2001021181,5,3520,0.0,21,18,3,2,3,85.71428571
2001021181,3,3600,0.0,28,26,3,0,2,92.85714286
2001021182,13,3891,0.0,36,32,8,1,4,88.88888889
2001021182,4,3896,0.0,29,25,5,1,4,86.20689655
2001021183,28,3583,0.0,22,20,3,0,2,90.90909091
2001021183,30,3600,0.0,19,18,2,1,1,94.73684211
2001021184,25,3546,0.0,20,18,0,0,2,90.0
2001021184,26,3600,0.0,21,21,4,0,0,100.0
2001021185,14,3863,2.0,38,36,5,5,2,94.73684211
2001021185,6,3900,0.0,24,22,0,0,2,91.66666667
2001021186,9,1136,0.0,3,2,0,0,1,66.66666667
2001021186,9,2389,0.0,14,11,5,1,3,78.57142857
2001021186,8,3599,0.0,28,25,6,1,3,89.28571429
2001021187,16,3502,0.0,22,19,3,2,3,86.36363636
2001021187,15,3600,0.0,33,32,8,0,1,96.96969697
2001021188,18,3538,2.0,42,39,19,2,3,92.85714286
2001021188,19,3600,0.0,15,13,7,0,2,86.66666667
2001021189,23,3600,0.0,31,30,12,0,1,96.77419355
2001021189,21,3519,0.0,22,20,5,1,2,90.90909091
2001021190,27,3598,0.0,24,22,2,1,2,91.66666667
2001021190,20,3577,0.0,32,29,3,2,3,90.625
2001021191,4,3520,0.0,19,18,1,0,1,94.73684211
2001021191,1,3600,0.0,22,22,1,0,0,100.0
2001021192,10,3598,0.0,23,21,6,1,2,91.30434783
2001021192,3,535,0.0,2,2,1,0,0,100.0
2001021192,3,3065,0.0,24,17,1,0,7,70.83333333
2001021193,7,3900,0.0,41,37,3,0,4,90.24390244
2001021193,5,1072,0.0,9,9,0,0,0,100.0
2001021193,5,2826,0.0,28,24,0,3,4,85.71428571
2001021194,14,3539,0.0,26,22,3,1,4,84.61538462
2001021194,12,3600,0.0,30,28,3,1,2,93.33333333
2001021195,13,3900,0.0,30,26,0,0,4,86.66666667
2001021195,11,3900,0.0,48,44,4,0,4,91.66666667
2001021196,16,3900,0.0,40,37,1,2,3,92.5
2001021196,17,3900,0.0,23,20,2,0,3,86.95652174
2001021197,28,3599,0.0,29,26,6,1,3,89.65517241
2001021197,29,3600,0.0,33,28,6,0,5,84.84848485
2001021198,30,1685,0.0,15,12,4,0,3,80.0
2001021198,30,2215,0.0,13,12,5,1,1,92.30769231
2001021198,25,959,0.0,11,11,1,0,0,100.0
2001021198,25,2921,0.0,17,13,2,2,4,76.47058824
2001021199,27,3597,0.0,29,26,0,0,3,89.65517241
2001021199,22,3600,0.0,23,23,6,0,0,100.0
2001021200,6,3600,0.0,19,15,1,1,4,78.94736842
2001021200,9,3600,0.0,22,22,3,0,0,100.0
2001021201,28,3600,2.0,23,19,1,1,4,82.60869565
2001021201,19,3600,0.0,23,22,5,1,1,95.65217391
2001021202,2,3600,0.0,25,23,4,2,2,92.0
2001021202,18,3580,0.0,30,26,3,1,4,86.66666667
2001021203,26,3498,0.0,24,20,2,0,4,83.33333333
2001021203,23,3600,0.0,16,14,1,1,2,87.5
2001021204,15,3600,0.0,39,38,4,0,1,97.43589744
2001021204,7,3543,0.0,17,14,2,0,3,82.35294118
2001021205,8,3600,0.0,41,36,1,0,5,87.80487805
2001021205,1,3593,0.0,18,16,0,0,2,88.88888889
2001021206,10,3590,0.0,29,27,6,0,2,93.10344828
2001021206,5,3600,0.0,28,23,5,1,5,82.14285714
2001021207,2,3595,0.0,25,24,5,0,1,96.0
2001021207,14,3535,0.0,19,17,6,1,2,89.47368421
2001021208,12,3593,0.0,25,24,8,3,1,96.0
2001021208,13,3569,0.0,36,34,8,2,2,94.44444444
2001021209,11,3629,0.0,31,26,4,0,5,83.87096774
2001021209,29,3628,0.0,31,27,5,1,4,87.09677419
2001021210,16,3563,0.0,21,19,0,0,2,90.47619048
2001021210,25,3600,0.0,23,22,0,0,1,95.65217391
2001021211,20,3597,0.0,36,36,7,1,0,100.0
2001021211,22,3545,0.0,24,23,3,1,1,95.83333333
2001021212,30,1543,0.0,7,7,2,0,0,100.0
2001021212,30,2039,0.0,21,14,0,1,7,66.66666667
2001021212,27,2400,0.0,14,14,1,2,0,100.0
2001021212,27,1200,0.0,5,4,2,0,1,80.0
2001021213,21,3600,0.0,26,25,3,2,1,96.15384615
2001021213,24,3600,10.0,32,29,3,1,3,90.625
2001021214,5,3600,0.0,32,25,5,1,7,78.125
2001021214,6,3585,0.0,13,12,0,0,1,92.30769231
2001021215,7,3600,0.0,22,22,1,0,0,100.0
2001021215,8,3547,0.0,33,31,1,2,2,93.93939394
2001021216,10,3597,0.0,28,26,11,1,2,92.85714286
2001021216,9,3600,0.0,26,21,3,2,5,80.76923077
2001021217,3,3532,0.0,45,43,12,0,2,95.55555556
2001021217,4,3594,0.0,20,19,2,4,1,95.0
2001021218,1,3713,0.0,24,21,0,1,3,87.5
2001021218,15,3713,0.0,39,35,6,0,4,89.74358974
2001021219,17,3831,0.0,25,22,4,1,3,88.0
2001021219,19,3826,0.0,25,23,4,0,2,92.0
2001021220,23,3600,0.0,24,23,1,1,1,95.83333333
2001021220,20,3600,0.0,39,35,14,1,4,89.74358974
2001021221,26,3545,0.0,21,18,1,2,3,85.71428571
2001021221,28,3600,0.0,29,28,1,0,1,96.55172414
2001021222,4,3585,0.0,32,30,11,0,2,93.75
2001021222,2,3600,0.0,16,15,3,2,1,93.75
2001021223,12,3900,4.0,25,23,7,1,2,92.0
2001021223,11,3896,0.0,26,24,3,1,2,92.30769231
2001021224,14,3617,2.0,30,28,6,0,2,93.33333333
2001021224,13,3617,0.0,33,30,4,1,3,90.90909091
2001021225,19,3596,0.0,24,21,4,1,3,87.5
2001021225,17,3592,0.0,28,23,5,0,5,82.14285714
2001021226,29,3600,0.0,32,30,2,1,2,93.75
2001021226,16,3597,0.0,28,28,4,1,0,100.0
2001021227,22,3600,0.0,31,29,11,1,2,93.5483871
2001021227,30,3600,0.0,23,19,1,1,4,82.60869565
2001021228,25,3900,0.0,29,27,2,0,2,93.10344828
2001021228,21,3900,0.0,34,32,4,1,2,94.11764706
2001021229,18,3515,0.0,32,26,5,0,6,81.25
2001021229,27,3592,0.0,22,18,1,1,4,81.81818182
2001021230,24,3536,0.0,14,13,1,1,1,92.85714286
2001021230,26,3598,2.0,23,23,8,0,0,100.0
2002020001,3,3600,0.0,21,20,5,1,1,95.23809524
2002020001,12,3576,0.0,28,24,8,4,4,85.71428571
2002020002,25,3900,0.0,41,40,24,0,1,97.56097561
2002020002,21,3900,0.0,25,24,6,0,1,96.0
2002020003,27,3600,2.0,33,29,12,0,4,87.87878788
2002020003,26,3591,0.0,26,25,7,0,1,96.15384615
2002020004,2,1200,0.0,1,1,1,0,0,100.0
2002020004,2,2400,0.0,20,15,3,1,5,75.0
2002020004,7,3597,0.0,23,22,7,3,1,95.65217391
2002020005,1,3600,0.0,34,33,8,0,1,97.05882353
2002020005,9,3533,0.0,20,18,0,0,2,90.0
2002020006,16,3566,0.0,33,31,7,0,2,93.93939394
2002020006,29,3583,0.0,32,31,9,2,1,96.875
2002020007,10,3600,0.0,33,33,9,1,0,100.0
2002020007,5,3600,0.0,25,19,5,1,6,76.0
2002020008,14,3809,0.0,25,22,3,1,3,88.0
2002020008,13,3804,0.0,32,28,3,3,4,87.5
2002020009,24,3600,0.0,27,24,6,1,3,88.88888889
2002020009,19,3464,0.0,25,21,7,2,4,84.0
2002020010,23,3600,0.0,19,19,5,0,0,100.0
2002020010,20,3585,0.0,34,31,14,1,3,91.17647059
2002020011,4,3900,2.0,28,26,9,2,2,92.85714286
2002020011,22,3892,0.0,27,25,5,1,2,92.59259259
2002020012,17,3590,0.0,26,23,5,0,3,88.46153846
2002020012,28,1200,0.0,12,12,0,0,0,100.0
2002020012,28,2390,0.0,15,9,2,2,6,60.0
2002020013,8,3600,0.0,21,20,5,3,1,95.23809524
2002020013,3,3541,0.0,25,22,7,2,3,88.0
2002020014,11,3552,0.0,39,34,14,0,5,87.17948718
2002020014,12,3585,0.0,30,27,12,1,3,90.0
2002020015,18,3548,0.0,28,23,13,1,5,82.14285714
2002020015,15,3574,0.0,31,27,16,2,4,87.09677419
2002020016,6,3600,0.0,20,15,4,0,5,75.0
2002020016,30,3597,0.0,27,26,4,1,1,96.2962963
2002020017,24,2400,0.0,20,17,1,1,3,85.0
2002020017,24,1188,0.0,5,5,0,0,0,100.0
2002020017,25,3600,0.0,26,24,6,0,2,92.30769231
2002020018,9,3600,0.0,23,22,4,0,1,95.65217391
2002020018,10,3584,0.0,35,33,12,1,2,94.28571429
2002020019,7,3600,0.0,20,19,3,2,1,95.0
2002020019,8,3600,0.0,31,25,6,0,6,80.64516129
2002020020,15,3588,0.0,36,35,10,2,1,97.22222222
2002020020,2,3550,0.0,14,12,2,0,2,85.71428571
2002020021,13,1943,2.0,18,17,2,0,1,94.44444444
2002020021,13,1946,0.0,16,13,7,1,3,81.25
2002020021,11,3881,0.0,35,30,6,2,5,85.71428571
2002020022,29,3535,0.0,23,20,5,1,3,86.95652174
2002020022,1,3595,0.0,20,18,6,2,2,90.0
2002020023,3,3587,0.0,28,22,5,0,6,78.57142857
2002020023,5,3589,0.0,30,30,5,2,0,100.0
2002020024,12,2400,0.0,16,14,6,0,2,87.5
2002020024,12,1200,0.0,8,5,1,0,3,62.5
2002020024,14,3599,0.0,22,21,3,4,1,95.45454545
2002020025,30,3873,0.0,27,25,4,2,2,92.59259259
2002020025,19,3900,0.0,22,20,4,1,2,90.90909091
2002020026,22,3600,0.0,31,29,3,0,2,93.5483871
2002020026,18,3540,0.0,27,24,9,1,3,88.88888889
2002020027,4,3600,0.0,25,21,7,2,4,84.0
2002020027,20,3543,0.0,34,29,13,2,5,85.29411765
2002020028,28,3586,0.0,21,17,3,1,4,80.95238095
2002020028,23,3597,0.0,25,22,2,2,3,88.0
2002020029,25,3600,0.0,24,22,5,0,2,91.66666667
2002020029,27,3600,0.0,30,25,6,2,5,83.33333333
2002020030,17,3581,0.0,26,23,4,0,3,88.46153846
2002020030,26,3600,0.0,29,27,8,1,2,93.10344828
2002020031,7,3541,2.0,32,29,6,4,3,90.625
2002020031,16,3587,0.0,26,26,5,3,0,100.0
2002020032,17,3600,0.0,30,28,8,2,2,93.33333333
2002020032,24,3484,0.0,32,28,7,3,4,87.5
2002020033,27,3597,0.0,32,30,18,0,2,93.75
2002020033,29,3533,0.0,36,32,11,4,4,88.88888889
2002020034,5,3092,2.0,30,27,6,0,3,90.0
2002020034,5,508,0.0,3,2,0,1,1,66.66666667
2002020034,10,3534,0.0,22,17,3,1,5,77.27272727
2002020035,6,3600,0.0,25,24,6,0,1,96.0
2002020035,21,3598,0.0,37,35,14,1,2,94.59459459
2002020036,20,3600,0.0,25,23,8,1,2,92.0
2002020036,23,3557,0.0,32,29,10,0,3,90.625
2002020037,27,3531,0.0,29,27,8,3,2,93.10344828
2002020037,9,3600,0.0,27,26,8,1,1,96.2962963
2002020038,18,3710,2.0,30,26,7,0,4,86.66666667
2002020038,2,3710,0.0,13,10,0,0,3,76.92307692
2002020039,10,3555,0.0,28,23,0,3,5,82.14285714
2002020039,3,3600,0.0,33,29,5,0,4,87.87878788
2002020040,4,3600,0.0,28,26,6,1,2,92.85714286
2002020040,8,3600,0.0,24,18,4,2,6,75.0
2002020041,12,3829,0.0,29,27,6,2,2,93.10344828
2002020041,19,3805,0.0,24,23,4,0,1,95.83333333
2002020042,13,3475,0.0,26,23,7,0,3,88.46153846
2002020042,30,3577,0.0,31,30,5,0,1,96.77419355
2002020043,22,3596,2.0,18,15,3,1,3,83.33333333
2002020043,25,3598,0.0,21,21,11,1,0,100.0
2002020044,11,3532,0.0,38,35,9,1,3,92.10526316
2002020044,5,3600,0.0,34,32,10,0,2,94.11764706
2002020045,6,2400,0.0,16,14,2,1,2,87.5
2002020045,6,1200,0.0,10,9,1,0,1,90.0
2002020045,23,3547,0.0,29,24,7,0,5,82.75862069
2002020046,26,3593,2.0,33,31,8,0,2,93.93939394
2002020046,24,3558,0.0,37,34,3,5,3,91.89189189
2002020047,3,3885,0.0,28,24,6,1,4,85.71428571
2002020047,7,3893,0.0,36,32,7,0,4,88.88888889
2002020048,2,3900,0.0,41,38,8,1,3,92.68292683
2002020048,4,3900,0.0,26,23,5,1,3,88.46153846
2002020049,15,3600,0.0,38,37,14,0,1,97.36842105
2002020049,12,3523,0.0,27,25,5,1,2,92.59259259
2002020050,27,3589,0.0,27,22,3,0,5,81.48148148
2002020050,10,3600,0.0,30,27,12,2,3,90.0
2002020051,8,3600,0.0,32,30,3,2,2,93.75
2002020051,17,3541,0.0,14,11,1,0,3,78.57142857
2002020052,29,1653,0.0,11,7,1,0,4,63.63636364
2002020052,29,1926,0.0,22,19,6,0,3,86.36363636
2002020052,19,1147,0.0,10,10,6,1,0,100.0
2002020052,19,2453,0.0,13,12,3,0,1,92.30769231
2002020053,25,3546,0.0,23,21,7,1,2,91.30434783
2002020053,30,3593,0.0,34,33,8,0,1,97.05882353
2002020054,13,3600,0.0,42,38,17,0,4,90.47619048
2002020054,16,3600,0.0,16,15,2,3,1,93.75
2002020055,6,3900,0.0,27,24,7,1,3,88.88888889
2002020055,20,3894,0.0,19,16,2,0,3,84.21052632
2002020056,21,3600,0.0,27,26,5,0,1,96.2962963
2002020056,26,3543,0.0,31,28,11,1,3,90.32258065
2002020057,22,3557,0.0,31,27,3,1,4,87.09677419
2002020057,28,3600,0.0,25,22,5,2,3,88.0
2002020058,18,3666,0.0,26,23,5,0,3,88.46153846
2002020058,1,3645,0.0,24,22,3,1,2,91.66666667
2002020059,11,1346,2.0,9,6,1,0,3,66.66666667
2002020059,11,2246,0.0,22,17,6,0,5,77.27272727
2002020059,14,3587,0.0,26,21,1,2,5,80.76923077
2002020060,23,3897,0.0,23,21,2,2,2,91.30434783
2002020060,24,3900,0.0,26,24,5,1,2,92.30769231
2002020061,15,3525,0.0,33,30,12,0,3,90.90909091
2002020061,4,3600,2.0,24,23,4,0,1,95.83333333
2002020062,27,3590,0.0,30,28,7,1,2,93.33333333
2002020062,7,3581,0.0,28,25,6,0,3,89.28571429
2002020063,10,3900,0.0,31,29,2,1,2,93.5483871
2002020063,8,3893,0.0,34,32,4,2,2,94.11764706
2002020064,18,3900,0.0,18,16,4,2,2,88.88888889
2002020064,3,3900,0.0,26,24,3,2,2,92.30769231
2002020065,1,3600,2.0,20,17,5,0,3,85.0
2002020065,12,3600,0.0,27,26,8,0,1,96.2962963
2002020066,2,3598,0.0,23,19,4,4,4,82.60869565
2002020066,11,3548,0.0,42,37,6,1,5,88.0952381
2002020067,13,3557,0.0,21,18,3,1,3,85.71428571
2002020067,29,3598,0.0,27,26,9,0,1,96.2962963
2002020068,14,3900,0.0,29,26,6,1,3,89.65517241
2002020068,5,3895,2.0,41,38,10,2,3,92.68292683
2002020069,25,3572,2.0,26,22,13,0,4,84.61538462
2002020069,19,3600,0.0,26,23,9,4,3,88.46153846
2002020070,17,3600,0.0,22,19,6,0,3,86.36363636
2002020070,30,3600,0.0,37,32,5,2,5,86.48648649
2002020071,20,3600,0.0,35,33,6,0,2,94.28571429
2002020071,16,3596,0.0,25,20,1,1,5,80.0
2002020072,6,3598,0.0,34,31,7,6,3,91.17647059
2002020072,22,3537,0.0,25,21,8,1,4,84.0
2002020073,23,3898,0.0,16,14,2,2,2,87.5
2002020073,26,3893,0.0,19,17,7,0,2,89.47368421
2002020074,21,3598,0.0,22,21,10,0,1,95.45454545
2002020074,28,3546,0.0,38,36,16,0,2,94.73684211
2002020075,15,613,0.0,7,4,2,0,3,57.14285714
2002020075,15,2920,0.0,22,21,5,0,1,95.45454545
2002020075,25,3577,0.0,28,26,1,1,2,92.85714286
2002020076,21,3889,0.0,27,24,2,1,3,88.88888889
2002020076,24,3889,0.0,24,22,0,1,2,91.66666667
2002020077,14,3590,0.0,20,18,3,1,2,90.0
2002020077,3,1109,0.0,8,7,3,0,1,87.5
2002020077,3,2400,0.0,21,18,6,1,3,85.71428571
2002020078,6,3600,0.0,34,33,11,1,1,97.05882353
2002020078,10,3600,0.0,26,22,6,1,4,84.61538462
2002020079,11,3540,0.0,23,20,5,1,3,86.95652174
2002020079,13,3594,0.0,28,26,2,1,2,92.85714286
2002020080,20,3600,0.0,33,29,13,4,4,87.87878788
2002020080,17,3598,0.0,24,24,10,1,0,100.0
2002020081,23,3600,0.0,32,30,13,3,2,93.75
2002020081,28,1315,0.0,14,12,7,0,2,85.71428571
2002020081,28,2280,0.0,21,18,2,0,3,85.71428571
2002020082,4,3568,0.0,31,29,8,1,2,93.5483871
2002020082,7,3600,0.0,22,21,4,1,1,95.45454545
2002020083,12,3598,0.0,37,36,15,2,1,97.2972973
2002020083,2,3576,0.0,17,14,6,0,3,82.35294118
2002020084,5,3879,0.0,33,30,5,2,3,90.90909091
2002020084,8,3895,0.0,30,27,3,1,3,90.0
2002020085,27,654,0.0,4,4,0,0,0,100.0
2002020085,27,2929,0.0,27,26,12,0,1,96.2962963
2002020085,18,3518,0.0,18,16,0,0,2,88.88888889
2002020086,20,3716,0.0,21,17,5,2,4,80.95238095
2002020086,30,3718,0.0,21,18,4,0,3,85.71428571
2002020087,22,3898,0.0,39,36,11,3,3,92.30769231
2002020087,21,3896,0.0,27,24,7,1,3,88.88888889
2002020088,12,3523,0.0,24,21,7,0,3,87.5
2002020088,9,3591,0.0,21,20,1,1,1,95.23809524
2002020089,15,3600,0.0,32,31,4,2,1,96.875
2002020089,3,3592,0.0,26,24,3,1,2,92.30769231
2002020090,14,3900,0.0,26,24,7,2,2,92.30769231
2002020090,29,3900,0.0,27,25,2,4,2,92.59259259
2002020091,13,3600,0.0,31,30,7,1,1,96.77419355
2002020091,10,3536,0.0,29,26,13,1,3,89.65517241
2002020092,1,3596,0.0,25,24,3,1,1,96.0
2002020092,11,3512,0.0,27,25,6,0,2,92.59259259
2002020093,26,3900,0.0,28,25,10,4,3,89.28571429
2002020093,17,3900,0.0,31,28,6,1,3,90.32258065
2002020094,9,3900,0.0,28,26,4,2,2,92.85714286
2002020094,6,3900,0.0,32,30,5,1,2,93.75
2002020095,13,3541,0.0,36,32,10,3,4,88.88888889
2002020095,2,3590,0.0,22,19,5,1,3,86.36363636
2002020096,8,1722,0.0,14,10,0,1,4,71.42857143
2002020096,8,1878,0.0,27,25,0,1,2,92.59259259
2002020096,4,3591,0.0,20,18,5,0,2,90.0
2002020097,28,3598,0.0,21,20,5,2,1,95.23809524
2002020097,18,3546,2.0,34,32,10,1,2,94.11764706
2002020098,30,3599,0.0,26,24,7,0,2,92.30769231
2002020098,16,3535,0.0,23,20,5,0,3,86.95652174
2002020099,25,3900,0.0,42,39,4,0,3,92.85714286
2002020099,20,3899,0.0,31,28,7,0,3,90.32258065
2002020100,19,1803,0.0,10,10,0,0,0,100.0
2002020100,19,1797,0.0,12,11,1,0,1,91.66666667
2002020100,22,3525,0.0,24,22,2,0,2,91.66666667
2002020101,24,3900,0.0,32,30,11,1,2,93.75
2002020101,23,3900,0.0,17,15,6,1,2,88.23529412
2002020102,21,3597,0.0,29,27,4,1,2,93.10344828
2002020102,27,3571,0.0,30,27,5,0,3,90.0
2002020103,1,3597,0.0,24,23,4,1,1,95.83333333
2002020103,7,3538,0.0,26,24,3,1,2,92.30769231
2002020104,26,3600,0.0,20,18,2,2,2,90.0
2002020104,3,708,0.0,8,5,1,0,3,62.5
2002020104,3,2892,2.0,20,17,3,0,3,85.0
2002020105,28,3600,0.0,24,20,5,0,4,83.33333333
2002020105,29,3573,0.0,38,33,8,1,5,86.84210526
2002020106,15,3549,0.0,37,34,16,2,3,91.89189189
2002020106,14,3596,0.0,27,25,4,1,2,92.59259259
2002020107,5,3597,0.0,44,37,5,1,7,84.09090909
2002020107,17,3600,0.0,27,24,9,1,3,88.88888889
2002020108,11,3586,0.0,31,27,3,0,4,87.09677419
2002020108,6,3600,0.0,31,28,4,5,3,90.32258065
2002020109,3,3598,0.0,39,36,9,2,3,92.30769231
2002020109,10,3573,0.0,36,32,10,4,4,88.88888889
2002020110,9,3545,0.0,21,16,1,0,5,76.19047619
2002020110,8,3600,0.0,48,45,10,1,3,93.75
2002020111,4,3590,0.0,24,22,6,1,2,91.66666667
2002020111,2,2397,0.0,15,14,1,0,1,93.33333333
2002020111,2,1200,0.0,11,6,2,0,5,54.54545455
2002020112,16,3897,0.0,28,25,5,2,3,89.28571429
2002020112,12,3897,0.0,43,40,14,3,3,93.02325581
2002020113,14,3600,0.0,30,25,2,2,5,83.33333333
2002020113,1,3600,0.0,21,20,0,1,1,95.23809524
2002020114,7,3586,0.0,23,18,3,2,5,78.26086957
2002020114,5,3600,0.0,31,29,8,3,2,93.5483871
2002020115,15,3900,0.0,19,18,8,0,1,94.73684211
2002020115,13,3883,0.0,36,35,6,1,1,97.22222222
2002020116,17,3455,0.0,30,27,9,1,3,90.0
2002020116,18,3595,0.0,38,37,9,3,1,97.36842105
2002020117,24,3600,2.0,27,23,8,4,4,85.18518519
2002020117,22,2901,0.0,15,15,5,0,0,100.0
2002020117,22,692,0.0,5,2,0,0,3,40.0
2002020118,19,3862,0.0,21,18,5,0,3,85.71428571
2002020118,20,3875,0.0,31,27,1,2,4,87.09677419
2002020119,25,3600,0.0,28,27,6,1,1,96.42857143
2002020119,23,3578,0.0,29,26,6,0,3,89.65517241
2002020120,30,3600,0.0,40,39,5,2,1,97.5
2002020120,27,3600,0.0,30,24,8,2,6,80.0
2002020121,26,3526,2.0,33,28,7,0,5,84.84848485
2002020121,29,3600,0.0,25,24,6,3,1,96.0
2002020122,28,3530,2.0,21,18,4,2,3,85.71428571
2002020122,16,3600,0.0,36,34,7,5,2,94.44444444
2002020123,30,3900,0.0,45,42,6,2,3,93.33333333
2002020123,21,3895,0.0,16,13,2,1,3,81.25
2002020124,27,3740,0.0,37,34,3,4,3,91.89189189
2002020124,3,3740,0.0,31,29,8,3,2,93.5483871
2002020125,24,1200,0.0,7,6,0,0,1,85.71428571
2002020125,24,2397,0.0,12,8,0,1,4,66.66666667
2002020125,10,3600,0.0,23,21,5,1,2,91.30434783
2002020126,15,3534,0.0,24,21,8,0,3,87.5
2002020126,5,3600,0.0,42,40,16,2,2,95.23809524
2002020127,14,3600,2.0,23,22,5,0,1,95.65217391
2002020127,13,3594,0.0,38,32,11,2,6,84.21052632
2002020128,25,3634,0.0,31,28,9,0,3,90.32258065
2002020128,22,3632,0.0,28,24,2,0,4,85.71428571
2002020129,27,3591,0.0,33,31,7,4,2,93.93939394
2002020129,2,3533,0.0,21,18,6,0,3,85.71428571
2002020130,9,3583,0.0,28,26,12,1,2,92.85714286
2002020130,4,3600,0.0,30,29,4,1,1,96.66666667
2002020131,24,3900,0.0,24,22,1,1,2,91.66666667
2002020131,8,3900,0.0,33,31,5,0,2,93.93939394
2002020132,12,3598,0.0,35,34,8,1,1,97.14285714
2002020132,1,3526,0.0,11,9,0,0,2,81.81818182
2002020133,26,3583,0.0,25,25,7,1,0,100.0
2002020133,11,2806,0.0,38,34,11,3,4,89.47368421
2002020133,11,794,0.0,3,3,1,0,0,100.0
2002020134,28,3557,0.0,22,19,3,0,3,86.36363636
2002020134,17,3600,0.0,20,18,2,0,2,90.0
2002020135,21,3812,0.0,23,20,7,0,3,86.95652174
2002020135,30,3821,0.0,23,21,4,0,2,91.30434783
2002020136,29,3600,0.0,22,19,3,3,3,86.36363636
2002020136,16,3600,0.0,22,20,4,0,2,90.90909091
2002020137,7,3900,0.0,22,21,9,0,1,95.45454545
2002020137,23,3900,0.0,31,30,9,2,1,96.77419355
2002020138,5,3600,0.0,22,21,6,0,1,95.45454545
2002020138,9,3600,0.0,19,15,4,0,4,78.94736842
2002020139,6,3600,0.0,35,33,14,0,2,94.28571429
2002020139,15,2282,0.0,17,14,4,0,3,82.35294118
2002020139,15,1304,0.0,12,8,2,0,4,66.66666667
2002020140,2,3558,0.0,23,20,5,0,3,86.95652174
2002020140,12,3593,0.0,33,31,3,2,2,93.93939394
2002020141,3,3567,0.0,21,19,2,2,2,90.47619048
2002020141,14,3600,0.0,24,24,4,4,0,100.0
2002020142,18,3600,0.0,38,31,10,1,7,81.57894737
2002020142,19,3595,0.0,19,19,4,1,0,100.0
2002020143,13,3797,0.0,44,42,7,2,2,95.45454545
2002020143,25,3795,0.0,13,10,3,1,3,76.92307692
2002020144,24,3600,0.0,27,26,5,1,1,96.2962963
2002020144,6,3600,0.0,23,19,7,1,4,82.60869565
2002020145,11,3900,0.0,35,32,8,2,3,91.42857143
2002020145,10,3900,0.0,20,17,7,0,3,85.0
2002020146,27,3599,0.0,35,29,7,0,6,82.85714286
2002020146,4,3600,0.0,20,18,4,0,2,90.0
2002020147,28,3888,0.0,29,27,7,0,2,93.10344828
2002020147,30,3890,0.0,20,19,1,3,1,95.0
2002020148,26,3695,0.0,30,28,8,1,2,93.33333333
2002020148,16,3646,0.0,23,22,5,0,1,95.65217391
2002020149,7,3600,0.0,17,14,1,3,3,82.35294118
2002020149,20,3600,0.0,30,30,6,1,0,100.0
2002020150,21,3600,2.0,24,23,6,2,1,95.83333333
2002020150,23,1571,0.0,10,7,1,0,3,70.0
2002020150,23,2029,0.0,10,8,3,1,2,80.0
2002020151,14,3593,0.0,28,25,8,0,3,89.28571429
2002020151,15,3598,0.0,18,16,4,3,2,88.88888889
2002020152,8,3894,0.0,38,36,1,0,2,94.73684211
2002020152,12,3900,0.0,25,23,1,1,2,92.0
2002020153,25,3512,0.0,28,24,9,2,4,85.71428571
2002020153,29,3600,0.0,40,38,9,1,2,95.0
2002020154,7,3900,0.0,40,39,6,2,1,97.5
2002020154,22,3900,0.0,33,32,4,6,1,96.96969697
2002020155,16,3600,0.0,41,36,5,1,5,87.80487805
2002020155,1,3594,0.0,19,18,1,0,1,94.73684211
2002020156,3,3565,0.0,33,30,1,4,3,90.90909091
2002020156,6,3600,0.0,27,25,3,7,2,92.59259259
2002020157,8,3600,0.0,32,30,8,2,2,93.75
2002020157,10,3470,0.0,27,23,13,2,4,85.18518519
2002020158,17,3600,0.0,34,29,4,0,5,85.29411765
2002020158,9,3600,0.0,22,20,2,1,2,90.90909091
2002020159,19,3599,0.0,20,19,1,6,1,95.0
2002020159,2,3600,0.0,32,26,4,2,6,81.25
2002020160,15,3577,0.0,45,43,12,3,2,95.55555556
2002020160,4,3600,0.0,11,10,3,0,1,90.90909091
2002020161,14,3532,0.0,24,20,5,0,4,83.33333333
2002020161,5,3600,0.0,29,26,6,0,3,89.65517241
2002020162,11,3599,0.0,22,21,6,1,1,95.45454545
2002020162,13,3600,0.0,32,29,8,3,3,90.625
2002020163,23,3600,0.0,22,20,2,1,2,90.90909091
2002020163,30,3598,0.0,28,24,3,0,4,85.71428571
2002020164,21,3900,0.0,31,27,7,0,4,87.09677419
2002020164,20,3899,0.0,30,26,7,0,4,86.66666667
2002020165,18,3705,0.0,32,26,4,0,6,81.25
2002020165,26,3705,0.0,28,23,3,0,5,82.14285714
2002020166,19,3600,0.0,25,23,5,3,2,92.0
2002020166,3,3517,0.0,22,19,0,2,3,86.36363636
2002020167,25,3900,0.0,35,32,4,0,3,91.42857143
2002020167,17,3900,0.0,37,34,2,2,3,91.89189189
2002020168,7,3560,0.0,26,23,12,1,3,88.46153846
2002020168,29,3598,0.0,32,30,6,2,2,93.75
2002020169,18,3860,0.0,45,43,10,3,2,95.55555556
2002020169,27,3855,0.0,25,24,5,2,1,96.0
2002020170,22,3600,0.0,25,24,4,1,1,96.0
2002020170,16,3532,0.0,26,23,0,1,3,88.46153846
2002020171,28,3600,0.0,19,16,6,1,3,84.21052632
2002020171,24,3522,0.0,17,13,2,0,4,76.47058824
2002020172,20,3600,0.0,28,26,3,0,2,92.85714286
2002020172,2,3591,0.0,21,17,0,0,4,80.95238095
2002020173,23,3600,0.0,26,24,10,0,2,92.30769231
2002020173,21,3479,0.0,21,17,5,1,4,80.95238095
2002020174,30,3600,0.0,26,24,7,0,2,92.30769231
2002020174,26,3480,0.0,21,18,1,1,3,85.71428571
2002020175,22,1200,0.0,7,7,2,1,0,100.0
2002020175,22,2395,0.0,16,11,1,0,5,68.75
2002020175,3,3600,0.0,41,39,13,3,2,95.12195122
2002020176,4,3711,0.0,18,17,3,0,1,94.44444444
2002020176,12,3702,0.0,31,29,8,2,2,93.5483871
2002020177,15,3896,0.0,29,26,10,0,3,89.65517241
2002020177,29,3896,0.0,37,33,3,0,4,89.18918919
2002020178,14,3528,0.0,32,28,2,1,4,87.5
2002020178,10,3600,0.0,37,34,8,1,3,91.89189189
2002020179,19,3595,0.0,15,13,1,3,2,86.66666667
2002020179,8,3600,0.0,36,31,6,0,5,86.11111111
2002020180,20,3600,0.0,32,30,3,0,2,93.75
2002020180,1,3548,0.0,21,18,5,0,3,85.71428571
2002020181,16,3598,0.0,18,18,6,5,0,100.0
2002020181,17,3554,0.0,23,21,5,0,2,91.30434783
2002020182,26,3600,0.0,32,27,10,0,5,84.375
2002020182,28,3600,0.0,29,27,7,1,2,93.10344828
2002020183,5,3649,0.0,24,20,0,1,4,83.33333333
2002020183,13,3721,0.0,29,26,2,0,3,89.65517241
2002020184,23,2392,0.0,21,17,1,1,4,80.95238095
2002020184,23,1197,0.0,3,3,0,0,0,100.0
2002020184,25,3600,0.0,26,26,11,0,0,100.0
2002020185,9,3600,0.0,38,36,4,1,2,94.73684211
2002020185,21,3548,0.0,33,29,5,1,4,87.87878788
2002020186,18,3541,0.0,25,23,5,0,2,92.0
2002020186,24,3600,0.0,35,34,11,3,1,97.14285714
2002020187,20,3651,0.0,35,34,11,0,1,97.14285714
2002020187,3,3651,0.0,26,26,2,3,0,100.0
2002020188,1,3600,0.0,23,23,0,0,0,100.0
2002020188,4,3559,0.0,27,26,1,1,1,96.2962963
2002020189,13,3830,0.0,32,30,11,1,2,93.75
2002020189,15,3836,0.0,33,32,6,0,1,96.96969697
2002020190,7,3598,0.0,21,19,2,1,2,90.47619048
2002020190,12,3600,0.0,26,26,3,3,0,100.0
2002020191,2,3539,0.0,20,18,4,0,2,90.0
2002020191,8,3600,0.0,42,42,13,0,0,100.0
2002020192,6,3706,0.0,28,26,5,2,2,92.85714286
2002020192,17,3721,0.0,34,33,11,4,1,97.05882353
2002020193,29,3600,0.0,28,26,9,1,2,92.85714286
2002020193,19,3513,0.0,30,26,7,1,4,86.66666667
2002020194,11,1463,0.0,13,11,0,0,2,84.61538462
2002020194,11,2137,0.0,17,14,5,0,3,82.35294118
2002020194,16,3600,0.0,17,17,0,3,0,100.0
2002020195,30,1200,0.0,14,11,0,0,3,78.57142857
2002020195,30,2400,0.0,18,17,8,1,1,94.44444444
2002020195,27,3600,0.0,29,28,6,0,1,96.55172414
2002020196,18,3900,0.0,31,29,7,1,2,93.5483871
2002020196,28,3891,0.0,29,27,4,0,2,93.10344828
2002020197,26,3600,2.0,30,28,6,0,2,93.33333333
2002020197,9,3533,0.0,20,17,4,1,3,85.0
2002020198,22,3546,0.0,22,19,2,4,3,86.36363636
2002020198,2,3600,0.0,33,31,5,1,2,93.93939394
2002020199,5,3575,0.0,21,18,2,2,3,85.71428571
2002020199,14,3600,0.0,16,15,4,0,1,93.75
2002020200,10,3541,0.0,23,21,2,1,2,91.30434783
2002020200,25,3600,0.0,23,22,1,2,1,95.65217391
2002020201,24,3619,2.0,30,28,7,0,2,93.33333333
2002020201,21,3620,0.0,30,27,9,1,3,90.0
2002020202,9,2399,0.0,19,16,7,2,3,84.21052632
2002020202,9,1200,0.0,18,14,4,0,4,77.77777778
2002020202,6,3597,0.0,23,22,5,8,1,95.65217391
2002020203,11,3600,0.0,28,24,0,1,4,85.71428571
2002020203,7,1574,0.0,7,6,1,0,1,85.71428571
2002020203,7,1955,0.0,12,8,1,0,4,66.66666667
2002020204,26,3487,0.0,20,17,2,0,3,85.0
2002020204,8,3600,0.0,28,27,3,0,1,96.42857143
2002020205,4,1602,0.0,13,10,1,0,3,76.92307692
2002020205,4,1995,0.0,13,12,7,0,1,92.30769231
2002020205,15,3600,0.0,44,43,9,2,1,97.72727273
2002020206,5,3579,0.0,31,28,9,0,3,90.32258065
2002020206,12,3600,0.0,26,24,6,1,2,92.30769231
2002020207,3,3600,0.0,25,19,3,0,6,76.0
2002020207,29,3600,0.0,34,31,8,1,3,91.17647059
2002020208,10,3600,0.0,23,17,9,0,6,73.91304348
2002020208,19,3567,0.0,21,18,2,3,3,85.71428571
2002020209,22,3600,0.0,39,36,10,1,3,92.30769231
2002020209,1,3565,0.0,20,15,2,0,5,75.0
2002020210,16,3756,0.0,39,37,13,2,2,94.87179487
2002020210,14,3750,0.0,18,15,1,0,3,83.33333333
2002020211,20,3568,0.0,23,21,9,1,2,91.30434783
2002020211,13,3600,0.0,28,28,6,1,0,100.0
2002020212,23,3600,0.0,37,35,3,3,2,94.59459459
2002020212,27,3586,0.0,31,27,3,0,4,87.09677419
2002020213,30,3588,0.0,37,35,10,0,2,94.59459459
2002020213,28,3536,0.0,33,29,11,2,4,87.87878788
2002020214,25,3556,0.0,25,22,5,0,3,88.0
2002020214,2,3593,0.0,40,38,4,4,2,95.0
2002020215,30,3562,0.0,37,36,1,0,1,97.2972973
2002020215,24,3600,0.0,26,26,2,2,0,100.0
2002020216,18,3600,0.0,36,33,10,2,3,91.66666667
2002020216,21,3515,0.0,28,24,3,2,4,85.71428571
2002020217,22,3585,0.0,31,25,6,2,6,80.64516129
2002020217,6,3600,0.0,21,20,0,2,1,95.23809524
2002020218,20,3526,0.0,25,23,6,2,2,92.0
2002020218,11,3590,0.0,32,31,6,4,1,96.875
2002020219,27,1217,0.0,13,9,5,0,4,69.23076923
2002020219,27,2213,0.0,13,13,4,0,0,100.0
2002020219,14,3596,0.0,36,34,5,1,2,94.44444444
2002020220,16,3896,0.0,32,30,6,0,2,93.75
2002020220,13,3894,0.0,34,32,12,1,2,94.11764706
2002020221,3,3596,0.0,37,33,5,3,4,89.18918919
2002020221,28,3532,0.0,27,22,12,0,5,81.48148148
2002020222,6,3600,0.0,37,34,14,3,3,91.89189189
2002020222,7,1718,0.0,14,10,0,3,4,71.42857143
2002020222,7,1829,0.0,6,6,2,0,0,100.0
2002020223,9,3599,0.0,32,29,5,4,3,90.625
2002020223,2,3535,0.0,26,22,5,0,4,84.61538462
2002020224,27,3520,0.0,28,25,7,1,3,89.28571429
2002020224,12,3589,0.0,29,27,3,0,2,93.10344828
2002020225,26,2400,0.0,18,15,1,0,3,83.33333333
2002020225,26,1400,0.0,8,7,2,0,1,87.5
2002020225,10,3797,0.0,27,24,1,1,3,88.88888889
2002020226,25,3600,0.0,23,21,2,0,2,91.30434783
2002020226,8,3570,2.0,32,29,11,0,3,90.625
2002020227,24,3780,0.0,32,29,2,5,3,90.625
2002020227,1,3784,0.0,35,33,3,1,2,94.28571429
2002020228,18,3600,0.0,38,34,4,2,4,89.47368421
2002020228,17,3600,0.0,23,22,7,0,1,95.65217391
2002020229,22,3600,0.0,23,21,8,3,2,91.30434783
2002020229,30,3578,0.0,24,21,4,3,3,87.5
2002020230,29,3520,0.0,51,46,17,1,5,90.19607843
2002020230,21,3581,0.0,35,31,6,1,4,88.57142857
2002020231,19,3600,0.0,35,29,8,2,6,82.85714286
2002020231,23,3600,12.0,28,25,4,2,3,89.28571429
2002020232,25,3596,0.0,24,23,1,4,1,95.83333333
2002020232,15,3600,0.0,35,29,4,0,6,82.85714286
2002020233,28,3739,0.0,33,30,2,2,3,90.90909091
2002020233,11,3739,0.0,24,22,1,1,2,91.66666667
2002020234,13,3900,0.0,30,29,6,1,1,96.66666667
2002020234,4,3892,0.0,29,28,2,1,1,96.55172414
2002020235,2,2069,0.0,12,12,0,0,0,100.0
2002020235,2,1474,0.0,13,10,3,3,3,76.92307692
2002020235,6,3565,0.0,31,30,6,0,1,96.77419355
2002020236,13,3780,2.0,34,31,3,0,3,91.17647059
2002020236,9,3780,0.0,26,24,3,0,2,92.30769231
2002020237,24,3600,0.0,28,26,6,0,2,92.85714286
2002020237,29,3576,0.0,44,41,4,2,3,93.18181818
2002020238,21,3588,0.0,24,23,7,0,1,95.83333333
2002020238,18,3526,0.0,24,21,7,1,3,87.5
2002020239,5,3900,0.0,31,30,10,0,1,96.77419355
2002020239,30,3900,0.0,24,23,2,2,1,95.83333333
2002020240,3,3600,0.0,36,35,4,1,1,97.22222222
2002020240,20,3536,0.0,30,28,7,1,2,93.33333333
2002020241,26,3538,0.0,15,12,1,2,3,80.0
2002020241,23,3585,0.0,21,19,5,0,2,90.47619048
2002020242,10,3600,0.0,37,35,13,1,2,94.59459459
2002020242,7,3564,0.0,28,25,7,1,3,89.28571429
2002020243,4,3900,0.0,24,23,0,1,1,95.83333333
2002020243,12,3900,0.0,28,27,1,1,1,96.42857143
2002020244,8,3597,0.0,44,39,7,1,5,88.63636364
2002020244,1,3600,0.0,21,20,7,1,1,95.23809524
2002020245,27,3600,0.0,25,24,4,1,1,96.0
2002020245,11,1200,0.0,17,17,8,0,0,100.0
2002020245,11,2400,0.0,15,10,2,0,5,66.66666667
2002020246,28,3488,0.0,27,23,6,1,4,85.18518519
2002020246,14,3598,0.0,29,27,9,3,2,93.10344828
2002020247,24,3877,0.0,45,43,6,1,2,95.55555556
2002020247,17,3879,0.0,26,25,4,1,1,96.15384615
2002020248,15,3900,0.0,38,36,5,0,2,94.73684211
2002020248,16,3882,0.0,16,14,0,0,2,87.5
2002020249,21,3524,0.0,22,18,1,0,4,81.81818182
2002020249,25,3600,2.0,21,19,7,0,2,90.47619048
2002020250,19,3597,0.0,25,20,6,3,5,80.0
2002020250,22,3598,0.0,29,29,8,1,0,100.0
2002020251,17,3600,0.0,31,30,14,0,1,96.77419355
2002020251,10,3587,0.0,32,30,5,1,2,93.75
2002020252,1,3490,0.0,22,19,4,0,3,86.36363636
2002020252,8,3600,0.0,24,23,4,1,1,95.83333333
2002020253,7,3600,2.0,23,19,4,0,4,82.60869565
2002020253,9,3600,0.0,26,25,3,2,1,96.15384615
2002020254,6,3900,0.0,48,46,7,0,2,95.83333333
2002020254,4,3893,0.0,34,32,1,1,2,94.11764706
2002020255,2,3600,2.0,35,33,5,3,2,94.28571429
2002020255,5,3538,2.0,27,24,5,0,3,88.88888889
2002020256,28,3597,0.0,34,31,1,1,3,91.17647059
2002020256,13,1769,0.0,12,8,3,0,4,66.66666667
2002020256,13,1827,0.0,15,12,0,0,3,80.0
2002020257,29,3900,0.0,34,33,0,0,1,97.05882353
2002020257,18,3899,0.0,25,24,1,1,1,96.0
2002020258,15,3558,0.0,31,30,9,0,1,96.77419355
2002020258,30,3594,0.0,17,17,2,0,0,100.0
2002020259,26,3596,0.0,18,17,4,1,1,94.44444444
2002020259,22,3518,0.0,27,24,4,0,3,88.88888889
2002020260,19,3600,0.0,23,23,4,2,0,100.0
2002020260,20,3531,0.0,24,23,6,0,1,95.83333333
2002020261,3,3511,0.0,27,25,1,0,2,92.59259259
2002020261,23,3600,0.0,20,19,5,2,1,95.0
2002020262,14,3825,0.0,36,35,8,2,1,97.22222222
2002020262,12,3821,0.0,31,29,10,2,2,93.5483871
2002020263,24,3600,0.0,28,27,9,1,1,96.42857143
2002020263,11,2190,0.0,20,16,1,1,4,80.0
2002020263,11,1406,0.0,13,12,1,4,1,92.30769231
2002020264,29,3799,0.0,42,39,8,0,3,92.85714286
2002020264,25,3795,0.0,15,13,2,0,2,86.66666667
2002020265,21,3895,0.0,31,27,6,1,4,87.09677419
2002020265,27,3900,0.0,28,24,8,1,4,85.71428571
2002020266,18,1693,0.0,7,6,2,0,1,85.71428571
2002020266,18,1810,0.0,12,9,1,0,3,75.0
2002020266,16,3600,0.0,30,28,5,0,2,93.33333333
2002020267,5,3657,0.0,25,20,1,2,5,80.0
2002020267,8,3672,0.0,33,29,6,1,4,87.87878788
2002020268,24,3656,0.0,26,23,3,1,3,88.46153846
2002020268,3,3657,0.0,34,32,6,0,2,94.11764706
2002020269,28,3597,0.0,48,46,17,4,2,95.83333333
2002020269,15,3536,0.0,29,26,8,0,3,89.65517241
2002020270,9,3900,0.0,41,37,11,1,4,90.24390244
2002020270,12,3890,0.0,36,32,10,0,4,88.88888889
2002020271,4,3600,2.0,19,17,6,0,2,89.47368421
2002020271,14,3535,0.0,32,29,4,3,3,90.625
2002020272,6,3542,0.0,27,25,4,3,2,92.59259259
2002020272,10,3600,0.0,29,29,5,1,0,100.0
2002020273,7,3680,0.0,25,21,1,0,4,84.0
2002020273,1,3683,2.0,34,31,7,0,3,91.17647059
2002020274,13,3803,0.0,39,35,11,0,4,89.74358974
2002020274,11,3796,0.0,15,12,1,3,3,80.0
2002020275,26,3898,2.0,21,19,6,0,2,90.47619048
2002020275,30,3890,2.0,35,33,2,4,2,94.28571429
2002020276,17,3591,0.0,29,29,3,1,0,100.0
2002020276,20,3600,0.0,35,30,9,0,5,85.71428571
2002020277,16,3542,0.0,20,17,3,1,3,85.0
2002020277,22,3600,0.0,29,28,4,1,1,96.55172414
2002020278,19,3562,0.0,20,17,4,1,3,85.0
2002020278,29,3595,0.0,28,26,1,2,2,92.85714286
2002020279,8,3745,0.0,25,23,1,0,2,92.0
2002020279,5,3737,0.0,35,32,2,0,3,91.42857143
2002020280,2,3899,0.0,24,21,6,0,3,87.5
2002020280,13,3900,0.0,42,39,6,2,3,92.85714286
2002020281,25,3900,0.0,30,28,3,2,2,93.33333333
2002020281,27,3900,0.0,38,36,8,3,2,94.73684211
2002020282,16,3589,0.0,35,30,7,1,5,85.71428571
2002020282,23,3595,0.0,22,19,2,1,3,86.36363636
2002020283,12,3598,0.0,32,29,5,3,3,90.625
2002020283,6,3586,0.0,24,23,7,3,1,95.83333333
2002020284,8,3586,0.0,37,34,2,1,3,91.89189189
2002020284,9,3600,0.0,30,28,4,0,2,93.33333333
2002020285,30,3600,0.0,24,21,2,1,3,87.5
2002020285,15,3556,0.0,35,31,7,0,4,88.57142857
2002020286,2,3431,12.0,30,29,6,2,1,96.66666667
2002020286,2,165,0.0,4,3,2,0,1,75.0
2002020286,14,2393,2.0,32,26,6,0,6,81.25
2002020286,14,1200,2.0,6,5,0,0,1,83.33333333
2002020287,3,3892,0.0,35,31,0,1,4,88.57142857
2002020287,1,3854,0.0,27,23,3,0,4,85.18518519
2002020288,28,3896,0.0,34,32,7,4,2,94.11764706
2002020288,4,3900,0.0,29,27,7,3,2,93.10344828
2002020289,26,3662,0.0,37,34,7,0,3,91.89189189
2002020289,19,3611,0.0,12,10,2,1,2,83.33333333
2002020290,18,3900,0.0,32,31,4,1,1,96.875
2002020290,21,3891,0.0,30,29,5,2,1,96.66666667
2002020291,22,3600,0.0,27,26,8,0,1,96.2962963
2002020291,20,3539,0.0,25,23,3,3,2,92.0
2002020292,29,3531,0.0,33,28,9,3,5,84.84848485
2002020292,7,3597,0.0,21,17,5,0,4,80.95238095
2002020293,5,3600,0.0,37,36,5,0,1,97.2972973
2002020293,11,3557,0.0,22,20,1,4,2,90.90909091
2002020294,13,3900,0.0,40,37,8,0,3,92.5
2002020294,27,3900,0.0,39,36,8,0,3,92.30769231
2002020295,17,1741,0.0,18,14,6,0,4,77.77777778
2002020295,17,1859,0.0,11,11,2,2,0,100.0
2002020295,23,3596,2.0,23,22,5,1,1,95.65217391
2002020296,25,3600,0.0,31,31,3,0,0,100.0
2002020296,24,2817,0.0,27,23,1,1,4,85.18518519
2002020296,24,783,0.0,5,5,0,1,0,100.0
2002020297,2,3600,0.0,26,25,4,1,1,96.15384615
2002020297,3,3491,0.0,29,26,2,0,3,89.65517241
2002020298,18,2600,0.0,17,13,4,3,4,76.47058824
2002020298,18,909,0.0,6,6,0,0,0,100.0
2002020298,30,3600,0.0,34,32,9,0,2,94.11764706
2002020299,7,3600,0.0,30,26,3,1,4,86.66666667
2002020299,6,3600,0.0,23,22,3,3,1,95.65217391
2002020300,4,2509,0.0,13,9,1,0,4,69.23076923
2002020300,4,1085,0.0,3,1,0,0,2,33.33333333
2002020300,10,3600,0.0,25,25,5,1,0,100.0
2002020301,12,3597,0.0,35,32,8,0,3,91.42857143
2002020301,8,3587,0.0,31,24,4,0,7,77.41935484
2002020302,29,3600,0.0,30,25,2,0,5,83.33333333
2002020302,9,3600,0.0,39,37,3,5,2,94.87179487
2002020303,11,3556,0.0,29,24,0,3,5,82.75862069
2002020303,15,3552,0.0,27,24,5,1,3,88.88888889
2002020304,14,3600,0.0,33,32,1,0,1,96.96969697
2002020304,1,3545,0.0,23,20,0,0,3,86.95652174
2002020305,28,1999,0.0,21,18,1,0,3,85.71428571
2002020305,28,1601,0.0,3,2,1,0,1,66.66666667
2002020305,5,3600,0.0,25,24,0,1,1,96.0
2002020306,21,3600,0.0,20,19,1,0,1,95.0
2002020306,19,3561,0.0,30,27,7,0,3,90.0
2002020307,16,3515,0.0,19,16,3,0,3,84.21052632
2002020307,20,3600,0.0,33,32,7,1,1,96.96969697
2002020308,17,3900,0.0,27,26,5,0,1,96.2962963
2002020308,22,3900,0.0,37,36,5,6,1,97.2972973
2002020309,25,3553,0.0,36,35,9,1,1,97.22222222
2002020309,26,3600,0.0,29,29,4,2,0,100.0
2002020310,13,653,0.0,9,7,0,0,2,77.77777778
2002020310,13,3207,0.0,27,25,6,0,2,92.59259259
2002020310,24,3900,0.0,24,20,4,0,4,83.33333333
2002020311,10,3550,0.0,31,29,11,2,2,93.5483871
2002020311,9,3600,0.0,22,22,8,2,0,100.0
2002020312,12,3479,0.0,30,27,7,1,3,90.0
2002020312,3,3600,0.0,31,30,8,0,1,96.77419355
2002020313,22,3688,0.0,34,30,1,0,4,88.23529412
2002020313,17,3688,0.0,35,30,3,1,5,85.71428571
2002020314,28,3600,0.0,33,32,8,2,1,96.96969697
2002020314,19,1358,0.0,6,6,3,0,0,100.0
2002020314,19,2065,0.0,14,11,2,0,3,78.57142857
2002020315,23,3600,0.0,28,27,6,0,1,96.42857143
2002020315,30,3553,0.0,17,15,4,2,2,88.23529412
2002020316,27,3580,0.0,37,32,11,0,5,86.48648649
2002020316,25,3596,0.0,20,19,2,3,1,95.0
2002020317,16,3568,0.0,24,23,2,1,1,95.83333333
2002020317,21,3600,0.0,26,26,3,1,0,100.0
2002020318,20,2385,0.0,17,13,5,1,4,76.47058824
2002020318,20,1200,0.0,13,10,2,0,3,76.92307692
2002020318,6,3600,0.0,31,29,11,1,2,93.5483871
2002020319,15,3556,0.0,34,29,7,1,5,85.29411765
2002020319,10,3595,0.0,26,22,8,2,4,84.61538462
2002020320,11,3571,0.0,27,24,0,1,3,88.88888889
2002020320,8,3600,0.0,27,25,1,1,2,92.59259259
2002020321,14,3900,2.0,23,22,4,3,1,95.65217391
2002020321,7,3900,0.0,24,23,6,0,1,95.83333333
2002020322,9,3900,0.0,28,26,5,2,2,92.85714286
2002020322,2,3887,0.0,35,33,9,0,2,94.28571429
2002020323,20,3515,0.0,32,28,8,3,4,87.5
2002020323,15,3591,0.0,34,32,10,0,2,94.11764706
2002020324,23,3600,0.0,34,32,8,0,2,94.11764706
2002020324,12,3512,0.0,24,21,4,0,3,87.5
2002020325,22,3600,0.0,16,15,0,1,1,93.75
2002020325,29,3540,0.0,19,16,4,0,3,84.21052632
2002020326,4,1487,0.0,13,9,4,0,4,69.23076923
2002020326,4,2113,0.0,8,5,2,0,3,62.5
2002020326,5,3600,0.0,43,41,3,0,2,95.34883721
2002020327,1,3715,0.0,25,22,2,1,3,88.0
2002020327,17,3715,0.0,27,25,0,1,2,92.59259259
2002020328,28,3571,0.0,45,41,10,0,4,91.11111111
2002020328,18,3600,0.0,24,22,1,3,2,91.66666667
2002020329,30,3593,0.0,43,38,16,1,5,88.37209302
2002020329,25,3593,2.0,18,18,1,3,0,100.0
2002020330,19,3900,0.0,31,27,7,0,4,87.09677419
2002020330,21,3898,0.0,30,26,7,1,4,86.66666667
2002020331,27,3860,0.0,35,33,8,0,2,94.28571429
2002020331,24,3900,0.0,28,26,2,1,2,92.85714286
2002020332,13,3598,0.0,34,32,2,2,2,94.11764706
2002020332,26,3566,0.0,26,22,4,0,4,84.61538462
2002020333,3,3600,0.0,25,18,0,0,7,72.0
2002020333,11,3600,0.0,26,22,0,1,4,84.61538462
2002020334,16,3600,0.0,36,34,5,1,2,94.44444444
2002020334,27,3505,0.0,18,14,0,0,4,77.77777778
2002020335,8,3548,0.0,42,38,4,2,4,90.47619048
2002020335,6,3598,0.0,26,24,10,0,2,92.30769231
2002020336,10,3587,0.0,21,21,5,1,0,100.0
2002020336,4,3581,0.0,20,18,6,0,2,90.0
2002020337,21,3900,0.0,29,27,5,0,2,93.10344828
2002020337,30,3900,0.0,26,24,3,0,2,92.30769231
2002020338,26,3900,0.0,25,23,5,1,2,92.0
2002020338,24,3897,0.0,24,22,2,1,2,91.66666667
2002020339,5,3600,0.0,44,43,12,2,1,97.72727273
2002020339,7,3522,0.0,22,19,5,0,3,86.36363636
2002020340,29,3600,0.0,31,29,4,0,2,93.5483871
2002020340,2,2791,0.0,21,20,5,3,1,95.23809524
2002020340,2,809,0.0,7,4,0,0,3,57.14285714
2002020341,9,3600,0.0,23,21,2,1,2,91.30434783
2002020341,15,3600,0.0,34,28,4,0,6,82.35294118
2002020342,17,3498,2.0,41,35,10,1,6,85.36585366
2002020342,12,889,0.0,8,6,0,4,2,75.0
2002020342,12,2711,0.0,20,18,3,0,2,90.0
2002020343,23,3600,0.0,35,32,1,0,3,91.42857143
2002020343,14,3556,0.0,32,28,1,1,4,87.5
2002020344,20,462,0.0,4,3,0,0,1,75.0
2002020344,20,3138,0.0,21,15,1,0,6,71.42857143
2002020344,19,2400,0.0,15,14,1,1,1,93.33333333
2002020344,19,1200,0.0,10,9,1,0,1,90.0
2002020345,1,3600,0.0,29,28,0,1,1,96.55172414
2002020345,18,3523,0.0,15,13,1,0,2,86.66666667
2002020346,3,3900,0.0,23,20,1,0,3,86.95652174
2002020346,25,3900,0.0,26,23,2,2,3,88.46153846
2002020347,7,3559,0.0,26,23,1,0,3,88.46153846
2002020347,10,3600,0.0,20,19,0,1,1,95.0
2002020348,4,3893,0.0,21,20,2,0,1,95.23809524
2002020348,8,3888,0.0,39,37,5,0,2,94.87179487
2002020349,2,3596,2.0,30,27,11,0,3,90.0
2002020349,9,3600,0.0,24,22,4,2,2,91.66666667
2002020350,12,3598,0.0,27,25,6,0,2,92.59259259
2002020350,29,3577,0.0,41,38,9,2,3,92.68292683
2002020351,6,3593,0.0,26,24,3,0,2,92.30769231
2002020351,5,3531,0.0,28,25,2,2,3,89.28571429
2002020352,23,3600,0.0,31,29,3,2,2,93.5483871
2002020352,13,2400,0.0,18,16,4,1,2,88.88888889
2002020352,13,1200,0.0,10,7,1,0,3,70.0
2002020353,1,3888,0.0,18,14,0,1,4,77.77777778
2002020353,19,3888,0.0,33,28,3,0,5,84.84848485
2002020354,25,1634,0.0,15,11,5,0,4,73.33333333
2002020354,25,1966,0.0,14,13,11,0,1,92.85714286
2002020354,18,3598,0.0,32,30,3,1,2,93.75
2002020355,21,3563,0.0,18,17,6,0,1,94.44444444
2002020355,22,3600,0.0,22,22,5,1,0,100.0
2002020356,16,1614,0.0,4,4,0,0,0,100.0
2002020356,16,1984,0.0,23,19,5,0,4,82.60869565
2002020356,26,3600,0.0,13,12,4,0,1,92.30769231
2002020357,27,3600,0.0,28,26,9,1,2,92.85714286
2002020357,28,3525,0.0,32,29,6,2,3,90.625
2002020358,14,3573,0.0,29,25,1,2,4,86.20689655
2002020358,3,3600,0.0,26,23,2,0,3,88.46153846
2002020359,15,3569,0.0,20,15,2,0,5,75.0
2002020359,11,3600,0.0,29,25,1,0,4,86.20689655
2002020360,20,3522,0.0,17,14,2,0,3,82.35294118
2002020360,17,3600,0.0,33,31,9,3,2,93.93939394
2002020361,16,3551,0.0,26,23,2,0,3,88.46153846
2002020361,24,3600,0.0,29,27,2,1,2,93.10344828
2002020362,1,3771,0.0,26,26,2,1,0,100.0
2002020362,4,3771,0.0,26,25,3,1,1,96.15384615
2002020363,19,3600,0.0,33,33,0,0,0,100.0
2002020363,6,3600,0.0,23,19,0,1,4,82.60869565
2002020364,23,3554,0.0,36,34,3,3,2,94.44444444
2002020364,2,3600,2.0,26,25,4,1,1,96.15384615
2002020365,29,3600,0.0,35,30,4,1,5,85.71428571
2002020365,3,3594,0.0,31,28,2,3,3,90.32258065
2002020366,14,3828,0.0,48,44,7,1,4,91.66666667
2002020366,10,3828,0.0,28,25,4,2,3,89.28571429
2002020367,15,3600,0.0,17,16,3,0,1,94.11764706
2002020367,5,3600,0.0,32,28,3,1,4,87.5
2002020368,24,3553,0.0,27,25,7,1,2,92.59259259
2002020368,17,3600,0.0,30,29,7,0,1,96.66666667
2002020369,12,3600,0.0,25,24,9,0,1,96.0
2002020369,18,3536,0.0,35,33,5,1,2,94.28571429
2002020370,20,3600,2.0,31,30,5,0,1,96.77419355
2002020370,21,3589,0.0,32,30,2,1,2,93.75
2002020371,30,3689,0.0,27,25,0,0,2,92.59259259
2002020371,22,3678,0.0,31,30,2,0,1,96.77419355
2002020372,28,3857,0.0,31,29,8,1,2,93.5483871
2002020372,27,3844,0.0,30,27,5,1,3,90.0
2002020373,24,3600,0.0,36,32,6,3,4,88.88888889
2002020373,7,3590,0.0,22,22,3,2,0,100.0
2002020374,23,3656,0.0,26,24,6,0,2,92.30769231
2002020374,1,3639,0.0,28,25,0,0,3,89.28571429
2002020375,12,3554,0.0,22,18,3,0,4,81.81818182
2002020375,13,3600,0.0,33,31,5,0,2,93.93939394
2002020376,9,3559,0.0,18,17,1,0,1,94.44444444
2002020376,16,3600,0.0,28,28,9,1,0,100.0
2002020377,8,3600,0.0,34,29,3,2,5,85.29411765
2002020377,25,3600,0.0,26,25,6,1,1,96.15384615
2002020378,11,3711,0.0,40,36,4,1,4,90.0
2002020378,6,3713,0.0,33,30,7,2,3,90.90909091
2002020379,22,3512,0.0,21,18,3,1,3,85.71428571
2002020379,14,3599,0.0,27,25,4,0,2,92.59259259
2002020380,3,3863,0.0,35,32,6,0,3,91.42857143
2002020380,4,3863,0.0,26,24,4,0,2,92.30769231
2002020381,9,3898,0.0,29,27,3,3,2,93.10344828
2002020381,19,3900,0.0,32,30,9,1,2,93.75
2002020382,17,3600,0.0,30,27,10,1,3,90.0
2002020382,27,3556,0.0,23,19,5,1,4,82.60869565
2002020383,30,3900,0.0,20,19,0,2,1,95.0
2002020383,20,3900,0.0,35,34,17,0,1,97.14285714
2002020384,18,3568,0.0,21,19,4,4,2,90.47619048
2002020384,26,3522,0.0,19,16,6,0,3,84.21052632
2002020385,10,3507,0.0,37,33,10,3,4,89.18918919
2002020385,2,3600,0.0,15,13,2,0,2,86.66666667
2002020386,7,3597,2.0,33,32,7,2,1,96.96969697
2002020386,3,3454,0.0,25,22,8,0,3,88.0
2002020387,11,3744,0.0,30,23,7,0,7,76.66666667
2002020387,15,3683,0.0,34,28,6,2,6,82.35294118
2002020388,13,3600,0.0,40,40,7,1,0,100.0
2002020388,12,3564,0.0,24,23,7,0,1,95.83333333
2002020389,5,3569,0.0,30,28,2,0,2,93.33333333
2002020389,1,3600,0.0,21,20,0,0,1,95.23809524
2002020390,24,3600,0.0,20,17,1,1,3,85.0
2002020390,16,3546,0.0,26,22,2,0,4,84.61538462
2002020391,17,3884,0.0,32,29,4,0,3,90.625
2002020391,25,3870,0.0,29,26,4,5,3,89.65517241
2002020392,8,3712,0.0,44,37,9,1,7,84.09090909
2002020392,21,3690,2.0,23,17,2,0,6,73.91304348
2002020393,29,3522,0.0,23,20,2,2,3,86.95652174
2002020393,28,3600,0.0,30,28,12,2,2,93.33333333
2002020394,14,3791,0.0,34,31,2,0,3,91.17647059
2002020394,6,3791,0.0,22,20,1,2,2,90.90909091
2002020395,19,3597,0.0,25,24,9,0,1,96.0
2002020395,4,3552,0.0,16,14,1,1,2,87.5
2002020396,15,3600,0.0,44,40,5,0,4,90.90909091
2002020396,7,3600,0.0,25,22,4,2,3,88.0
2002020397,1,3534,0.0,14,13,2,2,1,92.85714286
2002020397,10,3600,0.0,38,38,13,0,0,100.0
2002020398,12,3600,0.0,36,31,14,3,5,86.11111111
2002020398,9,3590,0.0,21,19,3,1,2,90.47619048
2002020399,2,3600,0.0,22,19,5,0,3,86.36363636
2002020399,5,3600,0.0,26,20,9,1,6,76.92307692
2002020400,22,3597,0.0,22,22,6,0,0,100.0
2002020400,13,3052,0.0,22,19,2,2,3,86.36363636
2002020400,13,548,0.0,7,6,0,0,1,85.71428571
2002020401,30,3600,0.0,34,32,5,3,2,94.11764706
2002020401,23,3588,0.0,23,19,3,2,4,82.60869565
2002020402,8,3600,0.0,31,29,7,0,2,93.5483871
2002020402,27,2272,0.0,21,20,1,0,1,95.23809524
2002020402,27,1200,0.0,10,7,3,0,3,70.0
2002020403,29,3600,0.0,30,28,5,3,2,93.33333333
2002020403,26,3554,0.0,24,21,2,0,3,87.5
2002020404,18,3600,0.0,30,28,11,0,2,93.33333333
2002020404,28,3558,0.0,21,18,5,1,3,85.71428571
2002020405,6,3600,0.0,24,23,5,0,1,95.83333333
2002020405,3,3592,0.0,35,31,3,2,4,88.57142857
2002020406,22,3600,0.0,15,15,1,0,0,100.0
2002020406,11,3600,0.0,21,18,0,0,3,85.71428571
2002020407,19,3719,0.0,30,26,8,0,4,86.66666667
2002020407,17,3709,0.0,26,23,4,3,3,88.46153846
2002020408,14,3555,0.0,37,35,6,1,2,94.59459459
2002020408,16,3599,2.0,21,20,0,0,1,95.23809524
2002020409,18,3600,0.0,30,27,3,1,3,90.0
2002020409,24,3600,0.0,20,20,5,0,0,100.0
2002020410,29,3886,0.0,41,38,9,4,3,92.68292683
2002020410,27,3885,0.0,22,19,2,1,3,86.36363636
2002020411,20,3600,0.0,30,29,6,2,1,96.66666667
2002020411,23,3560,0.0,15,13,5,1,2,86.66666667
2002020412,8,3600,0.0,33,31,6,2,2,93.93939394
2002020412,6,3515,0.0,27,23,0,4,4,85.18518519
2002020413,9,3600,0.0,28,26,1,2,2,92.85714286
2002020413,7,3542,0.0,30,26,1,0,4,86.66666667
2002020414,16,3600,0.0,31,29,4,1,2,93.5483871
2002020414,2,3560,0.0,34,31,5,0,3,91.17647059
2002020415,5,3579,0.0,22,19,5,2,3,86.36363636
2002020415,10,3600,0.0,16,14,3,0,2,87.5
2002020416,19,3546,0.0,28,26,3,3,2,92.85714286
2002020416,1,3600,0.0,28,28,2,1,0,100.0
2002020417,4,3595,0.0,26,24,8,1,2,92.30769231
2002020417,13,3587,0.0,35,30,7,0,5,85.71428571
2002020418,26,3600,0.0,19,19,5,0,0,100.0
2002020418,18,1125,0.0,5,5,0,0,0,100.0
2002020418,18,2397,0.0,21,18,9,1,3,85.71428571
2002020419,14,2005,0.0,15,11,0,0,4,73.33333333
2002020419,14,1579,0.0,8,8,0,0,0,100.0
2002020419,30,3594,4.0,35,32,2,3,3,91.42857143
2002020420,16,3600,0.0,49,46,13,1,3,93.87755102
2002020420,3,2338,0.0,18,16,2,0,2,88.88888889
2002020420,3,1200,0.0,8,6,1,0,2,75.0
2002020421,26,3591,0.0,35,35,5,3,0,100.0
2002020421,25,1788,0.0,10,10,2,1,0,100.0
2002020421,25,1812,0.0,8,5,1,1,3,62.5
2002020422,12,3596,0.0,31,27,3,2,4,87.09677419
2002020422,22,3567,0.0,37,36,7,4,1,97.2972973
2002020423,11,3572,0.0,28,24,2,0,4,85.71428571
2002020423,27,3600,0.0,18,16,1,1,2,88.88888889
2002020424,21,3475,0.0,28,25,8,0,3,89.28571429
2002020424,23,3598,0.0,27,26,7,2,1,96.2962963
2002020425,15,3538,0.0,29,27,4,4,2,93.10344828
2002020425,24,3600,0.0,26,26,5,0,0,100.0
2002020426,9,3598,0.0,31,29,9,2,2,93.5483871
2002020426,6,3600,0.0,28,23,4,2,5,82.14285714
2002020427,10,3535,0.0,31,29,3,4,2,93.5483871
2002020427,4,3600,0.0,19,18,3,0,1,94.73684211
2002020428,1,3564,0.0,28,25,2,0,3,89.28571429
2002020428,29,3590,0.0,42,40,5,2,2,95.23809524
2002020429,14,3600,0.0,20,18,6,1,2,90.0
2002020429,8,3528,0.0,34,31,7,2,3,91.17647059
2002020430,30,3597,0.0,38,36,0,0,2,94.73684211
2002020430,17,3533,0.0,23,20,2,0,3,86.95652174
2002020431,19,3894,0.0,37,35,7,1,2,94.59459459
2002020431,18,3900,0.0,24,22,3,1,2,91.66666667
2002020432,12,3588,2.0,35,32,5,0,3,91.42857143
2002020432,20,3550,0.0,23,19,2,1,4,82.60869565
2002020433,5,3600,0.0,34,29,7,4,5,85.29411765
2002020433,28,3591,0.0,24,22,7,1,2,91.66666667
2002020434,16,3894,0.0,27,26,6,2,1,96.2962963
2002020434,7,3840,0.0,27,26,6,1,1,96.2962963
2002020435,2,3897,0.0,28,25,2,1,3,89.28571429
2002020435,13,3900,0.0,41,38,5,3,3,92.68292683
2002020436,11,3569,0.0,39,37,1,0,2,94.87179487
2002020436,25,3600,0.0,22,21,5,0,1,95.45454545
2002020437,21,3799,0.0,27,23,5,2,4,85.18518519
2002020437,22,3799,0.0,24,21,4,1,3,87.5
2002020438,15,3600,0.0,33,30,14,1,3,90.90909091
2002020438,27,3506,0.0,19,15,6,1,4,78.94736842
2002020439,3,3590,0.0,25,21,4,1,4,84.0
2002020439,10,3600,2.0,36,35,12,3,1,97.22222222
2002020440,6,3571,2.0,25,21,6,1,4,84.0
2002020440,8,3595,0.0,27,25,3,1,2,92.59259259
2002020441,1,3790,0.0,29,25,4,0,4,86.20689655
2002020441,9,3790,0.0,28,25,4,5,3,89.28571429
2002020442,7,3544,0.0,33,31,3,0,2,93.93939394
2002020442,4,3600,0.0,15,15,0,0,0,100.0
2002020443,2,3560,0.0,24,20,3,1,4,83.33333333
2002020443,14,3600,0.0,27,24,3,3,3,88.88888889
2002020444,29,3515,0.0,34,28,0,3,6,82.35294118
2002020444,17,3600,0.0,22,18,8,0,4,81.81818182
2002020445,11,3600,0.0,29,25,2,1,4,86.20689655
2002020445,19,3591,0.0,32,32,2,2,0,100.0
2002020446,30,3600,0.0,37,34,9,0,3,91.89189189
2002020446,18,3590,2.0,19,18,2,1,1,94.73684211
2002020447,21,3600,0.0,28,27,4,0,1,96.42857143
2002020447,20,3505,0.0,25,22,3,0,3,88.0
2002020448,23,3600,2.0,26,23,6,1,3,88.46153846
2002020448,22,3600,2.0,29,23,6,1,6,79.31034483
2002020449,5,3862,0.0,33,30,4,0,3,90.90909091
2002020449,26,3862,0.0,17,15,4,1,2,88.23529412
2002020450,15,3459,0.0,35,33,11,0,2,94.28571429
2002020450,28,3595,0.0,34,34,9,2,0,100.0
2002020451,12,3526,0.0,15,13,7,1,2,86.66666667
2002020451,30,3600,0.0,34,33,5,1,1,97.05882353
2002020452,26,3526,2.0,24,22,11,1,2,91.66666667
2002020452,27,3598,0.0,23,22,6,1,1,95.65217391
2002020453,25,3594,0.0,17,17,2,0,0,100.0
2002020453,16,3600,0.0,28,23,7,0,5,82.14285714
2002020454,5,3600,0.0,47,42,9,2,5,89.36170213
2002020454,24,3600,0.0,19,19,2,0,0,100.0
2002020455,20,3900,0.0,33,30,3,2,3,90.90909091
2002020455,23,3892,0.0,33,30,6,2,3,90.90909091
2002020456,8,3600,0.0,32,30,7,0,2,93.75
2002020456,9,3583,0.0,21,18,2,1,3,85.71428571
2002020457,28,3744,0.0,29,27,5,2,2,93.10344828
2002020457,3,3745,0.0,26,25,2,0,1,96.15384615
2002020458,10,3529,0.0,21,20,3,2,1,95.23809524
2002020458,11,3600,0.0,30,30,8,2,0,100.0
2002020459,15,3894,0.0,37,35,3,3,2,94.59459459
2002020459,21,3894,0.0,25,23,6,0,2,92.0
2002020460,17,1188,0.0,11,9,0,1,2,81.81818182
2002020460,17,2695,0.0,21,21,4,0,0,100.0
2002020460,2,3900,0.0,36,34,3,1,2,94.44444444
2002020461,25,3900,2.0,36,34,3,1,2,94.44444444
2002020461,4,3898,0.0,42,40,1,1,2,95.23809524
2002020462,28,3595,0.0,24,23,4,0,1,95.83333333
2002020462,8,3528,0.0,24,21,1,0,3,87.5
2002020463,20,3600,0.0,23,23,8,2,0,100.0
2002020463,18,3600,0.0,23,20,3,1,3,86.95652174
2002020464,22,3883,0.0,22,18,4,0,4,81.81818182
2002020464,30,3883,0.0,34,31,3,1,3,91.17647059
2002020465,23,3600,0.0,26,23,1,0,3,88.46153846
2002020465,16,3600,0.0,30,28,6,3,2,93.33333333
2002020466,5,3600,0.0,30,25,6,1,5,83.33333333
2002020466,27,3600,0.0,23,21,2,1,2,91.30434783
2002020467,19,3537,0.0,28,23,6,0,5,82.14285714
2002020467,26,3600,0.0,36,34,7,1,2,94.44444444
2002020468,6,3600,0.0,25,21,4,1,4,84.0
2002020468,7,3587,0.0,29,27,2,1,2,93.10344828
2002020469,14,3900,0.0,28,27,8,1,1,96.42857143
2002020469,12,3900,0.0,22,21,2,0,1,95.45454545
2002020470,9,3600,0.0,27,27,5,0,0,100.0
2002020470,1,3576,0.0,25,23,9,1,2,92.0
2002020471,4,3600,2.0,24,23,9,0,1,95.83333333
2002020471,11,3539,0.0,24,21,1,0,3,87.5
2002020472,10,3900,0.0,32,30,4,1,2,93.75
2002020472,13,3888,0.0,31,29,5,3,2,93.5483871
2002020473,19,3532,0.0,16,12,2,0,4,75.0
2002020473,24,3600,0.0,46,44,8,4,2,95.65217391
2002020474,28,1460,0.0,9,5,0,0,4,55.55555556
2002020474,28,2140,0.0,14,9,2,1,5,64.28571429
2002020474,9,3595,0.0,33,30,3,2,3,90.90909091
2002020475,8,3600,0.0,42,41,10,5,1,97.61904762
2002020475,3,3577,0.0,23,20,5,0,3,86.95652174
2002020476,10,3600,0.0,30,29,6,0,1,96.66666667
2002020476,14,3516,0.0,19,17,4,1,2,89.47368421
2002020477,20,3598,0.0,27,24,4,1,3,88.88888889
2002020477,29,3600,0.0,29,29,6,0,0,100.0
2002020478,1,3600,0.0,16,15,1,1,1,93.75
2002020478,5,3500,0.0,34,31,7,0,3,91.17647059
2002020479,6,3537,0.0,18,13,3,0,5,72.22222222
2002020479,15,3594,0.0,39,36,13,1,3,92.30769231
2002020480,25,3900,0.0,30,29,0,0,1,96.66666667
2002020480,17,3894,0.0,31,30,5,0,1,96.77419355
2002020481,23,3600,0.0,31,30,9,0,1,96.77419355
2002020481,18,3528,0.0,28,26,2,2,2,92.85714286
2002020482,2,3600,0.0,17,15,4,1,2,88.23529412
2002020482,30,3576,0.0,31,28,8,0,3,90.32258065
2002020483,22,3512,0.0,29,27,2,0,2,93.10344828
2002020483,21,3600,0.0,32,31,3,1,1,96.875
2002020484,24,3537,0.0,36,31,9,0,5,86.11111111
2002020484,26,3600,0.0,22,18,6,1,4,81.81818182
2002020485,13,3600,0.0,30,30,7,1,0,100.0
2002020485,7,3520,0.0,30,28,5,0,2,93.33333333
2002020486,12,3815,2.0,34,32,5,0,2,94.11764706
2002020486,11,3832,0.0,40,37,5,1,3,92.5
2002020487,29,3549,0.0,30,27,8,0,3,90.0
2002020487,16,3600,0.0,29,28,13,1,1,96.55172414
2002020488,19,3877,0.0,18,15,1,1,3,83.33333333
2002020488,27,3900,0.0,42,39,9,2,3,92.85714286
2002020489,25,3600,2.0,32,27,4,1,5,84.375
2002020489,1,3600,0.0,25,22,3,0,3,88.0
2002020490,9,3600,0.0,28,27,0,2,1,96.42857143
2002020490,4,3546,0.0,20,18,3,0,2,90.0
2002020491,13,3875,0.0,43,40,7,3,3,93.02325581
2002020491,6,3900,0.0,33,30,7,2,3,90.90909091
2002020492,28,3900,0.0,26,23,1,2,3,88.46153846
2002020492,10,3900,0.0,29,26,5,0,3,89.65517241
2002020493,7,2374,0.0,10,6,2,0,4,60.0
2002020493,7,1200,2.0,6,4,0,0,2,66.66666667
2002020493,8,3600,0.0,38,36,9,1,2,94.73684211
2002020494,15,3589,0.0,18,17,2,0,1,94.44444444
2002020494,2,3548,0.0,33,31,4,1,2,93.93939394
2002020495,20,3493,0.0,20,18,5,0,2,90.0
2002020495,5,3600,0.0,23,23,5,0,0,100.0
2002020496,18,3900,0.0,40,38,4,2,2,95.0
2002020496,14,3896,0.0,26,24,3,1,2,92.30769231
2002020497,3,3538,0.0,32,29,5,2,3,90.625
2002020497,17,3600,0.0,31,29,8,2,2,93.5483871
2002020498,30,3595,0.0,27,23,3,3,4,85.18518519
2002020498,21,3600,0.0,47,45,14,0,2,95.74468085
2002020499,22,3731,0.0,32,28,6,2,4,87.5
2002020499,23,3716,0.0,30,27,4,2,3,90.0
2002020500,25,3493,0.0,26,25,2,0,1,96.15384615
2002020500,12,3600,0.0,28,28,3,0,0,100.0
2002020501,26,3600,0.0,20,17,1,1,3,85.0
2002020501,16,3600,2.0,25,24,4,0,1,96.0
2002020502,27,771,0.0,8,5,0,0,3,62.5
2002020502,27,2829,0.0,21,20,4,0,1,95.23809524
2002020502,24,3597,0.0,24,24,0,3,0,100.0
2002020503,28,3544,0.0,37,33,4,2,4,89.18918919
2002020503,6,3600,0.0,27,25,4,0,2,92.59259259
2002020504,4,3900,0.0,28,26,6,2,2,92.85714286
2002020504,9,3896,0.0,30,28,4,2,2,93.33333333
2002020505,8,3567,0.0,35,33,0,0,2,94.28571429
2002020505,2,3600,0.0,13,12,1,0,1,92.30769231
2002020506,1,3900,2.0,28,26,6,0,2,92.85714286
2002020506,3,3896,0.0,42,40,7,1,2,95.23809524
2002020507,14,3452,0.0,24,22,1,2,2,91.66666667
2002020507,15,3599,0.0,40,40,11,1,0,100.0
2002020508,17,3600,0.0,33,33,7,1,0,100.0
2002020508,29,3549,0.0,28,27,3,1,1,96.42857143
2002020509,11,3600,0.0,27,22,4,0,5,81.48148148
2002020509,10,3600,0.0,21,20,8,1,1,95.23809524
2002020510,7,3600,0.0,28,23,4,1,5,82.14285714
2002020510,5,3598,0.0,19,17,2,0,2,89.47368421
2002020511,18,3648,0.0,30,28,3,1,2,93.33333333
2002020511,13,3648,0.0,27,24,3,0,3,88.88888889
2002020512,26,3600,0.0,28,23,4,1,5,82.14285714
2002020512,19,3595,0.0,30,30,8,1,0,100.0
2002020513,20,3596,0.0,19,17,3,1,2,89.47368421
2002020513,30,3568,0.0,28,25,6,0,3,89.28571429
2002020514,23,1347,0.0,14,13,2,4,1,92.85714286
2002020514,23,2158,0.0,23,19,5,1,4,82.60869565
2002020514,21,3585,0.0,36,33,10,0,3,91.66666667
2002020515,9,3600,0.0,22,20,3,0,2,90.90909091
2002020515,7,3530,0.0,23,20,3,1,3,86.95652174
2002020516,5,2271,0.0,12,11,1,0,1,91.66666667
2002020516,5,1317,0.0,12,12,2,2,0,100.0
2002020516,3,1991,0.0,15,10,1,0,5,66.66666667
2002020516,3,1609,0.0,7,6,1,0,1,85.71428571
2002020517,29,3575,0.0,34,31,3,2,3,91.17647059
2002020517,17,3600,0.0,26,24,9,1,2,92.30769231
2002020518,21,3495,0.0,15,12,3,0,3,80.0
2002020518,19,3600,0.0,20,18,3,0,2,90.0
2002020519,25,3514,0.0,33,30,3,1,3,90.90909091
2002020519,18,3600,0.0,21,20,3,0,1,95.23809524
2002020520,30,3900,0.0,24,22,3,1,2,91.66666667
2002020520,16,3897,0.0,26,24,4,0,2,92.30769231
2002020521,23,3596,0.0,26,24,4,2,2,92.30769231
2002020521,22,3530,0.0,18,15,2,1,3,83.33333333
2002020522,27,3794,0.0,28,24,3,0,4,85.71428571
2002020522,26,3794,0.0,36,33,3,1,3,91.66666667
2002020523,24,3600,0.0,28,24,5,1,4,85.71428571
2002020523,28,3600,0.0,21,20,4,0,1,95.23809524
2002020524,8,3650,0.0,39,36,6,2,3,92.30769231
2002020524,9,3639,0.0,12,10,1,0,2,83.33333333
2002020525,1,3548,0.0,17,14,3,1,3,82.35294118
2002020525,15,3600,0.0,31,29,5,0,2,93.5483871
2002020526,11,3600,0.0,38,35,1,0,3,92.10526316
2002020526,12,3546,0.0,28,23,0,1,5,82.14285714
2002020527,6,3600,0.0,26,21,2,0,5,80.76923077
2002020527,14,3600,0.0,34,32,1,0,2,94.11764706
2002020528,25,3600,0.0,23,23,6,0,0,100.0
2002020528,13,3599,0.0,29,25,1,0,4,86.20689655
2002020529,4,3698,0.0,35,34,2,0,1,97.14285714
2002020529,21,3698,2.0,28,26,4,0,2,92.85714286
2002020530,10,3600,0.0,27,24,6,2,3,88.88888889
2002020530,20,3536,0.0,26,22,3,1,4,84.61538462
2002020531,30,3600,0.0,40,37,4,2,3,92.5
2002020531,7,3533,0.0,28,25,3,1,3,89.28571429
2002020532,12,3594,0.0,29,26,10,4,3,89.65517241
2002020532,2,3600,0.0,25,25,9,1,0,100.0
2002020533,8,3574,0.0,29,26,1,0,3,89.65517241
2002020533,5,3600,0.0,22,20,3,1,2,90.90909091
2002020534,6,3577,0.0,29,29,4,0,0,100.0
2002020534,11,3565,0.0,35,34,1,2,1,97.14285714
2002020535,19,3600,0.0,27,26,5,0,1,96.2962963
2002020535,29,3600,0.0,32,26,6,2,6,81.25
2002020536,15,3850,0.0,40,38,16,1,2,95.0
2002020536,1,3850,0.0,15,14,2,1,1,93.33333333
2002020537,3,3652,0.0,20,19,4,0,1,95.0
2002020537,13,3656,0.0,37,35,10,0,2,94.59459459
2002020538,17,1573,0.0,13,12,5,0,1,92.30769231
2002020538,17,2027,0.0,22,21,3,4,1,95.45454545
2002020538,18,1885,0.0,12,11,3,0,1,91.66666667
2002020538,18,1652,0.0,11,8,1,0,3,72.72727273
2002020539,4,3578,0.0,33,29,11,3,4,87.87878788
2002020539,27,3600,0.0,23,23,5,1,0,100.0
2002020540,10,3875,0.0,36,33,4,0,3,91.66666667
2002020540,22,3853,0.0,24,22,1,0,2,91.66666667
2002020541,24,1200,0.0,9,6,3,0,3,66.66666667
2002020541,24,2400,0.0,20,16,4,0,4,80.0
2002020541,23,3600,0.0,25,22,3,1,3,88.0
2002020542,16,3900,0.0,27,24,0,2,3,88.88888889
2002020542,28,3900,0.0,35,32,3,0,3,91.42857143
2002020543,3,3442,0.0,43,38,15,1,5,88.37209302
2002020543,14,3600,0.0,31,28,4,3,3,90.32258065
2002020544,26,3600,0.0,29,23,3,0,6,79.31034483
2002020544,21,3600,0.0,29,28,6,0,1,96.55172414
2002020545,29,3600,0.0,38,33,4,0,5,86.84210526
2002020545,19,3587,0.0,26,24,3,3,2,92.30769231
2002020546,24,3552,0.0,32,28,2,1,4,87.5
2002020546,20,3600,0.0,30,28,3,0,2,93.33333333
2002020547,17,3876,0.0,28,26,10,1,2,92.85714286
2002020547,25,3898,0.0,29,27,5,4,2,93.10344828
2002020548,1,3600,0.0,33,33,1,1,0,100.0
2002020548,6,3585,0.0,27,26,2,0,1,96.2962963
2002020549,13,3843,0.0,35,33,9,0,2,94.28571429
2002020549,2,3843,2.0,25,24,0,0,1,96.0
2002020550,7,3530,0.0,28,24,3,0,4,85.71428571
2002020550,15,3600,0.0,21,18,3,0,3,85.71428571
2002020551,11,3880,0.0,37,35,14,0,2,94.59459459
2002020551,5,3867,0.0,26,23,3,2,3,88.46153846
2002020552,9,3534,0.0,30,27,6,0,3,90.0
2002020552,18,3600,0.0,32,30,8,0,2,93.75
2002020553,22,3868,0.0,39,35,2,1,4,89.74358974
2002020553,27,3871,0.0,34,31,3,0,3,91.17647059
2002020554,16,3600,0.0,33,33,5,0,0,100.0
2002020554,26,2557,0.0,8,6,0,0,2,75.0
2002020554,26,925,0.0,6,6,0,0,0,100.0
2002020555,4,3529,0.0,23,21,6,3,2,91.30434783
2002020555,28,3600,0.0,25,24,8,1,1,96.0
2002020556,24,3600,0.0,23,19,0,1,4,82.60869565
2002020556,30,3596,0.0,21,20,1,0,1,95.23809524
2002020557,2,3679,2.0,38,38,4,1,0,100.0
2002020557,7,3696,0.0,26,25,6,1,1,96.15384615
2002020558,3,3600,0.0,30,30,5,2,0,100.0
2002020558,12,3506,0.0,22,20,6,1,2,90.90909091
2002020559,9,3600,0.0,26,23,1,2,3,88.46153846
2002020559,14,1319,0.0,16,13,0,0,3,81.25
2002020559,14,2281,0.0,14,11,0,0,3,78.57142857
2002020560,19,2519,0.0,16,12,1,0,4,75.0
2002020560,19,1081,0.0,6,5,1,0,1,83.33333333
2002020560,17,3598,0.0,30,29,7,1,1,96.66666667
2002020561,5,3514,2.0,33,29,9,3,4,87.87878788
2002020561,29,3600,0.0,32,30,11,2,2,93.75
2002020562,8,3900,0.0,31,30,1,1,1,96.77419355
2002020562,20,3900,0.0,24,23,3,0,1,95.83333333
2002020563,22,3533,0.0,27,25,5,3,2,92.59259259
2002020563,25,3577,0.0,25,24,4,0,1,96.0
2002020564,10,3600,0.0,25,22,3,3,3,88.0
2002020564,23,3521,0.0,18,14,2,0,4,77.77777778
2002020565,13,3600,0.0,27,26,12,1,1,96.2962963
2002020565,1,3529,0.0,14,12,2,3,2,85.71428571
2002020566,27,3680,0.0,32,31,4,0,1,96.875
2002020566,15,3680,0.0,14,12,1,0,2,85.71428571
2002020567,21,2400,2.0,24,22,2,0,2,91.66666667
2002020567,21,1200,0.0,11,10,3,0,1,90.90909091
2002020567,18,793,0.0,9,5,1,0,4,55.55555556
2002020567,18,2801,0.0,13,10,1,1,3,76.92307692
2002020568,11,2877,0.0,23,19,4,1,4,82.60869565
2002020568,11,723,0.0,7,3,0,0,4,42.85714286
2002020568,9,787,0.0,5,5,0,1,0,100.0
2002020568,9,2813,0.0,15,14,2,1,1,93.33333333
2002020569,16,3600,0.0,29,28,4,0,1,96.55172414
2002020569,19,686,0.0,4,2,0,0,2,50.0
2002020569,19,2914,0.0,21,19,3,1,2,90.47619048
2002020570,13,3598,0.0,28,27,1,0,1,96.42857143
2002020570,21,3578,0.0,16,13,0,0,3,81.25
2002020571,14,3520,0.0,31,28,5,0,3,90.32258065
2002020571,20,3589,0.0,26,25,5,0,1,96.15384615
2002020572,30,3856,0.0,28,27,2,0,1,96.42857143
2002020572,22,3856,0.0,32,30,1,0,2,93.75
2002020573,8,3529,0.0,35,32,6,1,3,91.42857143
2002020573,23,3595,2.0,19,17,2,0,2,89.47368421
2002020574,4,3600,0.0,19,18,8,0,1,94.73684211
2002020574,26,3598,0.0,27,23,6,1,4,85.18518519
2002020575,25,3600,0.0,24,23,2,0,1,95.83333333
2002020575,28,3582,0.0,23,20,1,1,3,86.95652174
2002020576,12,3600,0.0,34,28,13,1,6,82.35294118
2002020576,7,3596,0.0,28,25,4,0,3,89.28571429
2002020577,6,3597,0.0,35,27,11,2,8,77.14285714
2002020577,2,3600,0.0,43,39,10,3,4,90.69767442
2002020578,29,3880,0.0,32,30,2,2,2,93.75
2002020578,15,3900,0.0,28,26,7,0,2,92.85714286
2002020579,10,3540,0.0,25,23,3,2,2,92.0
2002020579,1,3590,0.0,17,17,2,1,0,100.0
2002020580,5,3600,0.0,24,23,0,1,1,95.83333333
2002020580,11,3558,0.0,27,24,5,0,3,88.88888889
2002020581,27,3600,0.0,41,40,2,2,1,97.56097561
2002020581,17,3597,0.0,27,23,3,2,4,85.18518519
2002020582,4,3600,0.0,28,28,7,0,0,100.0
2002020582,24,3503,0.0,25,24,3,3,1,96.0
2002020583,12,3598,2.0,34,32,13,4,2,94.11764706
2002020583,6,3547,2.0,41,37,13,1,4,90.24390244
2002020584,1,3529,0.0,19,17,1,2,2,89.47368421
2002020584,10,3600,0.0,51,50,13,3,1,98.03921569
2002020585,7,3859,0.0,33,32,5,1,1,96.96969697
2002020585,9,3853,0.0,21,19,1,1,2,90.47619048
2002020586,15,3900,0.0,30,28,2,1,2,93.33333333
2002020586,3,3897,0.0,32,30,10,0,2,93.75
2002020587,27,3473,0.0,25,23,6,0,2,92.0
2002020587,29,3600,0.0,23,23,4,3,0,100.0
2002020588,2,2438,0.0,16,15,1,1,1,93.75
2002020588,2,1200,0.0,10,8,0,0,2,80.0
2002020588,5,3642,2.0,28,26,1,0,2,92.85714286
2002020589,14,2528,0.0,18,14,2,0,4,77.77777778
2002020589,14,1072,0.0,4,3,0,1,1,75.0
2002020589,19,3600,0.0,27,26,6,2,1,96.2962963
2002020590,16,3900,0.0,35,32,1,2,3,91.42857143
2002020590,18,3900,0.0,35,32,1,0,3,91.42857143
2002020591,30,3588,0.0,31,28,4,3,3,90.32258065
2002020591,20,3587,2.0,24,22,4,0,2,91.66666667
2002020592,8,3810,0.0,28,23,5,4,5,82.14285714
2002020592,22,3835,0.0,35,31,6,0,4,88.57142857
2002020593,13,3564,0.0,31,28,11,0,3,90.32258065
2002020593,23,3600,0.0,21,19,0,1,2,90.47619048
2002020594,25,3600,0.0,19,17,0,0,2,89.47368421
2002020594,26,3532,0.0,29,26,2,2,3,89.65517241
2002020595,21,3600,0.0,41,40,5,1,1,97.56097561
2002020595,28,1200,0.0,8,5,0,0,3,62.5
2002020595,28,2400,0.0,11,8,3,1,3,72.72727273
2002020596,4,3600,0.0,22,18,4,0,4,81.81818182
2002020596,11,3528,0.0,40,35,2,1,5,87.5
2002020597,17,3587,0.0,24,21,5,0,3,87.5
2002020597,16,3671,0.0,32,28,3,1,4,87.5
2002020598,25,3900,0.0,33,32,0,1,1,96.96969697
2002020598,24,3900,0.0,27,26,2,0,1,96.2962963
2002020599,18,3600,0.0,22,21,4,1,1,95.45454545
2002020599,29,3597,0.0,34,29,6,1,5,85.29411765
2002020600,9,3598,2.0,19,17,2,0,2,89.47368421
2002020600,3,3600,0.0,36,31,9,0,5,86.11111111
2002020601,26,3600,0.0,28,26,7,0,2,92.85714286
2002020601,30,1803,0.0,8,6,1,0,2,75.0
2002020601,30,1742,0.0,6,5,0,1,1,83.33333333
2002020602,22,3900,0.0,46,41,6,0,5,89.13043478
2002020602,28,3900,0.0,32,27,3,4,5,84.375
2002020603,5,3600,2.0,41,35,1,0,6,85.36585366
2002020603,2,3600,2.0,31,28,9,0,3,90.32258065
2002020604,7,3562,0.0,24,21,2,0,3,87.5
2002020604,4,3600,0.0,23,21,2,2,2,91.30434783
2002020605,17,3531,0.0,32,31,5,0,1,96.875
2002020605,14,3600,0.0,30,30,1,0,0,100.0
2002020606,6,3600,0.0,35,30,5,0,5,85.71428571
2002020606,10,3600,0.0,42,40,2,2,2,95.23809524
2002020607,8,3557,0.0,36,33,3,2,3,91.66666667
2002020607,1,3600,0.0,22,20,2,0,2,90.90909091
2002020608,12,3900,0.0,31,28,6,1,3,90.32258065
2002020608,11,3900,0.0,39,36,2,4,3,92.30769231
2002020609,19,3880,0.0,23,21,3,3,2,91.30434783
2002020609,18,3884,2.0,31,30,8,1,1,96.77419355
2002020610,26,731,0.0,7,4,1,0,3,57.14285714
2002020610,26,2869,0.0,16,12,0,0,4,75.0
2002020610,25,3600,0.0,23,19,0,1,4,82.60869565
2002020611,20,3596,0.0,33,31,9,0,2,93.93939394
2002020611,21,3480,0.0,17,13,4,2,4,76.47058824
2002020612,17,3694,0.0,29,28,4,1,1,96.55172414
2002020612,13,3694,0.0,32,30,9,0,2,93.75
2002020613,12,1200,0.0,4,3,0,0,1,75.0
2002020613,12,2400,0.0,20,16,7,1,4,80.0
2002020613,3,3600,0.0,31,30,12,3,1,96.77419355
2002020614,29,3600,0.0,19,18,5,0,1,94.73684211
2002020614,30,3572,0.0,26,24,5,1,2,92.30769231
2002020615,27,3900,0.0,40,40,11,1,0,100.0
2002020615,16,3900,0.0,31,31,3,2,0,100.0
2002020616,9,2972,0.0,25,19,9,0,6,76.0
2002020616,9,586,0.0,4,4,3,1,0,100.0
2002020616,23,3596,0.0,27,23,4,3,4,85.18518519
2002020617,22,3600,0.0,32,32,1,0,0,100.0
2002020617,24,3541,0.0,21,20,2,0,1,95.23809524
2002020618,4,3600,0.0,24,24,5,0,0,100.0
2002020618,2,3600,0.0,20,16,1,4,4,80.0
2002020619,11,3884,0.0,32,30,4,1,2,93.75
2002020619,14,3873,0.0,39,36,6,3,3,92.30769231
2002020620,3,3558,0.0,33,30,8,1,3,90.90909091
2002020620,8,3597,0.0,30,28,2,2,2,93.33333333
2002020621,10,3600,0.0,25,23,7,0,2,92.0
2002020621,5,3569,0.0,21,18,4,1,3,85.71428571
2002020622,16,3883,0.0,24,20,4,0,4,83.33333333
2002020622,25,3883,0.0,24,21,4,0,3,87.5
2002020623,24,3600,0.0,39,36,5,0,3,92.30769231
2002020623,21,3583,0.0,26,22,1,0,4,84.61538462
2002020624,9,3600,0.0,21,21,7,2,0,100.0
2002020624,20,3535,0.0,23,22,4,1,1,95.65217391
2002020625,22,3600,0.0,29,25,4,0,4,86.20689655
2002020625,26,3490,0.0,31,26,10,0,5,83.87096774
2002020625,26,22,0.0,0,0,0,0,0,
2002020626,19,3595,0.0,22,21,3,2,1,95.45454545
2002020626,28,3520,0.0,30,27,7,0,3,90.0
2002020627,6,3555,0.0,29,26,2,1,3,89.65517241
2002020627,7,3582,0.0,23,21,0,0,2,91.30434783
2002020628,15,3600,0.0,25,24,3,1,1,96.0
2002020628,12,3600,0.0,31,27,3,0,4,87.09677419
2002020629,1,3600,0.0,28,27,11,0,1,96.42857143
2002020629,13,3533,0.0,36,34,2,2,2,94.44444444
2002020630,27,3541,0.0,43,41,13,1,2,95.34883721
2002020630,30,3578,0.0,30,29,7,1,1,96.66666667
2002020631,29,3600,0.0,29,27,3,0,2,93.10344828
2002020631,23,3526,0.0,24,21,3,2,3,87.5
2002020632,17,3528,0.0,29,26,1,0,3,89.65517241
2002020632,4,3595,0.0,23,21,1,0,2,91.30434783
2002020633,3,3600,0.0,28,27,5,0,1,96.42857143
2002020633,5,2302,0.0,18,18,2,1,0,100.0
2002020633,5,1200,0.0,11,8,0,0,3,72.72727273
2002020634,21,1174,0.0,6,5,3,1,1,83.33333333
2002020634,21,2400,0.0,17,13,1,0,4,76.47058824
2002020634,25,3600,0.0,33,30,3,1,3,90.90909091
2002020635,10,3563,0.0,32,27,8,2,5,84.375
2002020635,6,3600,0.0,20,18,6,2,2,90.0
2002020636,7,3598,0.0,27,25,6,0,2,92.59259259
2002020636,8,3551,0.0,32,29,4,1,3,90.625
2002020637,11,2400,0.0,28,23,3,2,5,82.14285714
2002020637,11,1200,0.0,6,4,0,0,2,66.66666667
2002020637,2,3584,0.0,32,29,6,2,3,90.625
2002020638,13,1178,0.0,14,10,2,0,4,71.42857143
2002020638,13,2417,0.0,26,18,8,0,8,69.23076923
2002020638,15,3600,0.0,26,24,6,0,2,92.30769231
2002020639,1,3900,0.0,25,22,3,1,3,88.0
2002020639,14,2893,0.0,29,26,3,1,3,89.65517241
2002020639,14,1007,0.0,3,3,0,0,0,100.0
2002020640,27,3637,0.0,23,19,1,1,4,82.60869565
2002020640,18,3637,0.0,33,30,3,3,3,90.90909091
2002020641,29,3594,0.0,30,28,7,0,2,93.33333333
2002020641,20,2400,0.0,12,8,2,0,4,66.66666667
2002020641,20,1200,0.0,13,10,1,0,3,76.92307692
2002020642,9,3600,0.0,20,20,1,2,0,100.0
2002020642,22,3534,0.0,16,14,3,1,2,87.5
2002020643,19,3600,0.0,22,21,2,0,1,95.45454545
2002020643,26,3543,0.0,28,26,3,1,2,92.85714286
2002020644,23,3485,0.0,24,22,6,1,2,91.66666667
2002020644,28,3600,0.0,29,29,9,2,0,100.0
2002020645,21,3685,0.0,32,30,6,0,2,93.75
2002020645,12,3724,0.0,33,30,10,0,3,90.90909091
2002020646,18,3493,0.0,20,18,1,0,2,90.0
2002020646,16,3600,0.0,17,17,5,0,0,100.0
2002020647,19,3528,0.0,21,19,5,1,2,90.47619048
2002020647,24,3600,0.0,19,18,2,0,1,94.73684211
2002020648,5,3600,0.0,32,31,0,0,1,96.875
2002020648,6,3527,0.0,20,18,2,0,2,90.0
2002020649,20,3572,0.0,28,24,4,0,4,85.71428571
2002020649,8,3592,0.0,28,26,5,0,2,92.85714286
2002020650,10,3600,0.0,35,30,4,1,5,85.71428571
2002020650,3,3600,0.0,24,23,6,0,1,95.83333333
2002020651,11,2225,0.0,27,24,3,1,3,88.88888889
2002020651,11,1375,0.0,15,14,3,0,1,93.33333333
2002020651,4,2822,0.0,17,13,3,1,4,76.47058824
2002020651,4,772,0.0,5,2,0,0,3,40.0
2002020652,2,3863,0.0,30,26,10,1,4,86.66666667
2002020652,15,3860,0.0,35,32,7,0,3,91.42857143
2002020653,13,3600,0.0,41,35,10,2,6,85.36585366
2002020653,1,3588,0.0,12,10,1,0,2,83.33333333
2002020654,16,3647,0.0,33,28,6,1,5,84.84848485
2002020654,17,3647,0.0,38,34,5,2,4,89.47368421
2002020655,29,2782,0.0,33,26,5,0,7,78.78787879
2002020655,29,747,0.0,6,6,0,0,0,100.0
2002020655,22,3600,0.0,16,11,1,0,5,68.75
2002020656,28,3829,0.0,34,31,11,1,3,91.17647059
2002020656,26,3830,0.0,19,17,4,0,2,89.47368421
2002020657,14,3022,2.0,26,19,3,1,7,73.07692308
2002020657,14,578,0.0,2,2,0,0,0,100.0
2002020657,9,3600,0.0,17,17,3,0,0,100.0
2002020658,20,3510,0.0,22,19,5,0,3,86.36363636
2002020658,10,3600,0.0,33,31,4,0,2,93.93939394
2002020659,7,3600,0.0,22,22,3,2,0,100.0
2002020659,30,3583,0.0,27,26,1,0,1,96.2962963
2002020660,19,3600,0.0,26,25,9,0,1,96.15384615
2002020660,27,3550,0.0,22,20,2,2,2,90.90909091
2002020661,18,3537,0.0,27,23,5,0,4,85.18518519
2002020661,23,3574,0.0,27,24,2,0,3,88.88888889
2002020662,3,3718,0.0,25,24,3,1,1,96.0
2002020662,15,3718,0.0,36,34,2,2,2,94.44444444
2002020663,5,3600,0.0,26,26,3,1,0,100.0
2002020663,12,3539,0.0,30,29,5,0,1,96.66666667
2002020664,24,3600,0.0,30,27,7,0,3,90.0
2002020664,29,3540,0.0,32,28,5,3,4,87.5
2002020665,2,3600,0.0,29,24,3,0,5,82.75862069
2002020665,1,3600,0.0,27,27,1,0,0,100.0
2002020666,8,3529,0.0,33,32,4,1,1,96.96969697
2002020666,11,3600,0.0,22,22,2,0,0,100.0
2002020667,6,3600,0.0,25,22,3,0,3,88.0
2002020667,13,3600,0.0,27,27,4,1,0,100.0
2002020668,17,3600,0.0,30,26,7,0,4,86.66666667
2002020668,16,3600,0.0,27,26,7,2,1,96.2962963
2002020669,24,3582,0.0,25,23,4,3,2,92.0
2002020669,9,3598,0.0,24,23,4,0,1,95.83333333
2002020670,8,3531,0.0,40,37,3,2,3,92.5
2002020670,4,3600,0.0,17,16,0,0,1,94.11764706
2002020671,2,3719,2.0,29,27,5,4,2,93.10344828
2002020671,19,3707,0.0,25,22,9,0,3,88.0
2002020672,23,3588,0.0,23,19,2,0,4,82.60869565
2002020672,30,3588,0.0,30,28,0,0,2,93.33333333
2002020673,17,3600,0.0,38,36,4,0,2,94.73684211
2002020673,21,3571,0.0,22,19,2,2,3,86.36363636
2002020674,18,2,0.0,0,0,0,0,0,
2002020674,18,3896,14.0,22,20,4,3,2,90.90909091
2002020674,20,3898,14.0,31,29,13,1,2,93.5483871
2002020675,26,3439,0.0,26,24,7,2,2,92.30769231
2002020675,22,3600,0.0,22,22,3,2,0,100.0
2002020676,7,3889,0.0,33,31,8,1,2,93.93939394
2002020676,28,3900,0.0,25,23,2,2,2,92.0
2002020677,10,3600,0.0,25,24,5,0,1,96.0
2002020677,15,3551,0.0,22,19,7,1,3,86.36363636
2002020678,1,3600,0.0,35,34,3,2,1,97.14285714
2002020678,12,3534,0.0,27,25,5,1,2,92.59259259
2002020679,6,3553,0.0,24,21,2,1,3,87.5
2002020679,11,3600,2.0,27,26,5,0,1,96.2962963
2002020680,5,3600,0.0,31,29,10,3,2,93.5483871
2002020680,14,3517,0.0,21,18,3,0,3,85.71428571
2002020681,23,3600,0.0,23,21,5,0,2,91.30434783
2002020681,16,3578,0.0,26,23,9,0,3,88.46153846
2002020682,14,3530,0.0,24,21,1,0,3,87.5
2002020682,4,3594,0.0,14,12,0,1,2,85.71428571
2002020683,29,3600,0.0,45,38,9,3,7,84.44444444
2002020683,6,3600,0.0,24,22,4,2,2,91.66666667
2002020684,10,926,0.0,10,9,0,0,1,90.0
2002020684,10,2730,0.0,29,28,9,1,1,96.55172414
2002020684,8,3655,0.0,27,24,6,3,3,88.88888889
2002020685,15,3590,0.0,30,26,1,1,4,86.66666667
2002020685,9,3600,0.0,18,16,4,1,2,88.88888889
2002020686,12,3558,0.0,31,27,7,3,4,87.09677419
2002020686,1,3600,0.0,20,18,4,2,2,90.0
2002020687,5,3563,0.0,32,29,3,0,3,90.625
2002020687,13,3600,0.0,35,35,7,2,0,100.0
2002020688,16,3551,0.0,32,29,2,3,3,90.625
2002020688,19,3600,0.0,34,32,3,1,2,94.11764706
2002020689,24,3597,0.0,33,33,9,0,0,100.0
2002020689,30,3556,0.0,13,12,2,0,1,92.30769231
2002020690,18,3804,0.0,24,22,3,0,2,91.66666667
2002020690,22,3815,0.0,26,23,3,0,3,88.46153846
2002020691,7,3598,0.0,30,30,6,1,0,100.0
2002020691,27,3538,0.0,23,22,3,4,1,95.65217391
2002020692,26,3762,0.0,27,25,6,1,2,92.59259259
2002020692,20,3758,0.0,19,18,1,0,1,94.73684211
2002020693,25,3600,0.0,32,31,0,0,1,96.875
2002020693,28,3472,0.0,27,24,1,0,3,88.88888889
2002020694,2,3600,0.0,26,25,7,3,1,96.15384615
2002020694,11,3582,0.0,27,23,3,0,4,85.18518519
2002020695,4,3600,0.0,33,31,5,0,2,93.93939394
2002020695,3,3548,0.0,26,23,2,0,3,88.46153846
2002020696,23,3595,2.0,31,30,4,1,1,96.77419355
2002020696,17,3600,0.0,34,30,11,1,4,88.23529412
2002020697,15,3899,0.0,41,38,12,1,3,92.68292683
2002020697,6,3900,0.0,29,26,8,2,3,89.65517241
2002020698,30,3773,0.0,31,30,7,1,1,96.77419355
2002020698,24,3773,0.0,25,23,6,0,2,92.0
2002020699,8,3600,0.0,33,31,1,1,2,93.93939394
2002020699,13,3528,0.0,34,31,4,0,3,91.17647059
2002020700,19,3598,0.0,30,27,6,0,3,90.0
2002020700,12,2395,0.0,19,16,2,0,3,84.21052632
2002020700,12,1175,0.0,7,6,1,0,1,85.71428571
2002020701,9,1198,0.0,6,4,1,0,2,66.66666667
2002020701,9,2400,0.0,24,20,2,2,4,83.33333333
2002020701,14,3600,0.0,24,22,3,2,2,91.66666667
2002020702,16,2400,0.0,17,15,3,2,2,88.23529412
2002020702,16,1200,0.0,9,6,0,0,3,66.66666667
2002020702,29,3598,0.0,38,37,3,2,1,97.36842105
2002020703,25,3900,0.0,35,34,0,0,1,97.14285714
2002020703,21,3900,0.0,30,29,3,0,1,96.66666667
2002020704,22,1183,0.0,7,7,0,1,0,100.0
2002020704,22,2400,0.0,16,12,3,1,4,75.0
2002020704,20,3600,0.0,27,24,1,2,3,88.88888889
2002020705,28,3512,0.0,25,22,4,1,3,88.0
2002020705,27,3598,0.0,27,26,4,0,1,96.2962963
2002020706,5,3900,0.0,34,34,1,0,0,100.0
2002020706,7,3896,0.0,23,23,3,0,0,100.0
2002020707,3,3600,0.0,31,31,2,1,0,100.0
2002020707,2,827,0.0,4,2,1,0,2,50.0
2002020707,2,2773,0.0,25,22,0,0,3,88.0
2002020708,4,3600,0.0,23,22,2,1,1,95.65217391
2002020708,10,3551,0.0,26,23,4,1,3,88.46153846
2002020709,19,267,0.0,3,1,0,0,2,33.33333333
2002020709,19,3333,0.0,27,21,4,2,6,77.77777778
2002020709,11,3600,0.0,26,22,1,2,4,84.61538462
2002020710,23,3507,0.0,25,22,7,0,3,88.0
2002020710,18,3600,0.0,33,31,1,1,2,93.93939394
2002020711,12,3549,0.0,26,22,3,0,4,84.61538462
2002020711,15,3600,0.0,38,35,6,1,3,92.10526316
2002020712,8,3900,0.0,36,34,5,0,2,94.44444444
2002020712,14,3882,0.0,28,26,4,2,2,92.85714286
2002020713,9,3600,0.0,17,16,0,0,1,94.11764706
2002020713,13,3572,0.0,17,15,4,2,2,88.23529412
2002020714,29,3600,0.0,26,22,5,1,4,84.61538462
2002020714,25,3600,0.0,19,17,0,0,2,89.47368421
2002020715,17,3697,0.0,21,17,2,0,4,80.95238095
2002020715,22,3702,0.0,39,36,5,0,3,92.30769231
2002020716,26,1200,0.0,10,7,4,0,3,70.0
2002020716,26,2314,0.0,18,15,1,0,3,83.33333333
2002020716,24,3593,0.0,22,17,4,0,5,77.27272727
2002020717,1,3835,2.0,36,32,6,0,4,88.88888889
2002020717,28,3868,0.0,36,31,4,1,5,86.11111111
2002020718,9,3900,0.0,33,30,9,1,3,90.90909091
2002020718,11,3900,0.0,28,25,5,1,3,89.28571429
2002020719,6,3600,0.0,36,35,9,2,1,97.22222222
2002020719,5,3600,0.0,30,26,4,3,4,86.66666667
2002020720,19,3900,0.0,25,22,5,2,3,88.0
2002020720,16,3897,0.0,33,30,7,0,3,90.90909091
2002020721,3,3597,0.0,30,28,5,1,2,93.33333333
2002020721,18,3442,0.0,23,19,4,1,4,82.60869565
2002020722,29,3096,0.0,36,31,9,0,5,86.11111111
2002020722,29,504,0.0,1,1,0,0,0,100.0
2002020722,21,3579,0.0,18,18,8,0,0,100.0
2002020723,27,3595,2.0,40,39,12,0,1,97.5
2002020723,20,2143,0.0,18,14,2,0,4,77.77777778
2002020723,20,1457,0.0,8,5,1,0,3,62.5
2002020724,30,3600,0.0,32,31,7,0,1,96.875
2002020724,26,3469,0.0,21,19,2,0,2,90.47619048
2002020725,10,676,0.0,2,2,0,0,0,100.0
2002020725,10,2924,0.0,20,16,6,0,4,80.0
2002020725,7,3587,2.0,27,27,5,3,0,100.0
2002020726,2,3594,2.0,37,36,6,1,1,97.2972973
2002020726,4,3522,0.0,20,17,2,1,3,85.0
2002020727,13,2400,0.0,39,36,7,0,3,92.30769231
2002020727,13,1178,0.0,5,5,2,0,0,100.0
2002020727,12,3593,0.0,21,20,2,0,1,95.23809524
2002020728,14,3600,0.0,26,25,1,3,1,96.15384615
2002020728,25,1200,0.0,6,3,0,0,3,50.0
2002020728,25,2400,2.0,16,15,6,0,1,93.75
2002020729,27,3600,0.0,39,38,6,1,1,97.43589744
2002020729,22,3586,0.0,21,16,3,1,5,76.19047619
2002020730,17,3600,0.0,29,27,10,3,2,93.10344828
2002020730,23,3600,0.0,24,19,1,0,5,79.16666667
2002020731,1,3600,0.0,20,19,3,0,1,95.0
2002020731,24,3537,0.0,28,26,2,2,2,92.85714286
2002020732,11,3600,0.0,24,23,2,2,1,95.83333333
2002020732,3,3563,0.0,27,24,8,0,3,88.88888889
2002020733,15,3898,0.0,30,29,5,0,1,96.66666667
2002020733,8,3900,0.0,35,34,3,0,1,97.14285714
2002020734,16,2078,0.0,19,17,4,1,2,89.47368421
2002020734,16,1460,0.0,11,8,0,1,3,72.72727273
2002020734,5,3594,0.0,26,23,4,1,3,88.46153846
2002020735,4,3629,0.0,27,26,0,1,1,96.2962963
2002020735,6,3631,0.0,24,24,3,0,0,100.0
2002020736,21,3600,0.0,20,20,6,0,0,100.0
2002020736,10,3600,0.0,20,17,6,0,3,85.0
2002020737,7,3742,0.0,32,28,5,0,4,87.5
2002020737,9,3735,0.0,24,21,1,0,3,87.5
2002020738,2,3540,0.0,25,22,3,1,3,88.0
2002020738,29,3600,0.0,30,29,0,0,1,96.66666667
2002020739,12,3818,0.0,22,19,3,2,3,86.36363636
2002020739,13,3820,0.0,41,39,13,1,2,95.12195122
2002020740,25,3600,0.0,33,31,3,0,2,93.93939394
2002020740,19,3600,0.0,21,17,4,1,4,80.95238095
2002020741,14,3493,0.0,21,18,3,2,3,85.71428571
2002020741,18,3600,0.0,24,22,4,3,2,91.66666667
2002020742,17,3525,0.0,28,25,6,0,3,89.28571429
2002020742,20,3600,0.0,28,27,5,1,1,96.42857143
2002020743,1,3827,0.0,32,30,7,0,2,93.75
2002020743,26,3830,0.0,35,34,0,1,1,97.14285714
2002020744,30,3600,0.0,42,38,11,0,4,90.47619048
2002020744,28,3600,2.0,33,32,4,5,1,96.96969697
2002020745,3,1392,0.0,16,13,3,0,3,81.25
2002020745,3,2208,0.0,18,14,2,1,4,77.77777778
2002020745,15,3600,0.0,29,27,6,0,2,93.10344828
2002020746,16,3575,0.0,31,27,7,0,4,87.09677419
2002020746,8,3600,0.0,19,16,1,0,3,84.21052632
2002020747,27,3547,0.0,23,22,4,2,1,95.65217391
2002020747,23,3600,0.0,20,20,5,0,0,100.0
2002020748,18,3600,0.0,21,20,2,0,1,95.23809524
2002020748,7,3600,0.0,27,22,1,0,5,81.48148148
2002020749,9,3589,0.0,32,28,9,0,4,87.5
2002020749,25,3595,0.0,15,12,4,0,3,80.0
2002020750,28,3600,0.0,32,32,1,0,0,100.0
2002020750,26,3400,0.0,19,16,1,0,3,84.21052632
2002020751,18,3526,0.0,25,23,4,1,2,92.0
2002020751,6,3600,0.0,19,18,1,0,1,94.73684211
2002020752,5,3599,0.0,29,24,2,1,5,82.75862069
2002020752,2,3600,0.0,26,24,13,0,2,92.30769231
2002020753,14,3600,0.0,34,34,1,0,0,100.0
2002020753,4,3600,0.0,22,19,3,0,3,86.36363636
2002020754,19,3592,0.0,22,19,3,0,3,86.36363636
2002020754,15,3569,0.0,30,26,5,1,4,86.66666667
2002020755,21,3900,0.0,19,17,4,0,2,89.47368421
2002020755,29,3900,0.0,36,34,7,0,2,94.44444444
2002020756,13,3600,0.0,35,29,7,0,6,82.85714286
2002020756,8,3600,0.0,38,35,8,2,3,92.10526316
2002020757,17,3536,0.0,29,28,10,0,1,96.55172414
2002020757,1,3600,0.0,16,16,0,1,0,100.0
2002020758,3,3576,0.0,27,22,7,1,5,81.48148148
2002020758,11,3596,0.0,39,37,6,5,2,94.87179487
2002020759,20,3539,0.0,23,19,6,0,4,82.60869565
2002020759,27,3600,0.0,30,27,3,1,3,90.0
2002020760,30,3900,0.0,22,20,2,0,2,90.90909091
2002020760,23,3885,0.0,24,22,1,0,2,91.66666667
2002020761,26,784,0.0,11,8,3,0,3,72.72727273
2002020761,26,2669,0.0,14,14,1,0,0,100.0
2002020761,28,3589,0.0,29,28,4,1,1,96.55172414
2002020762,10,3600,0.0,27,25,5,0,2,92.59259259
2002020762,12,3568,0.0,22,19,3,1,3,86.36363636
2002020763,20,3581,0.0,25,22,1,0,3,88.0
2002020763,25,3600,0.0,29,28,3,0,1,96.55172414
2002020764,30,3600,0.0,28,23,0,1,5,82.14285714
2002020764,22,3600,0.0,29,28,6,2,1,96.55172414
2002020765,9,3527,0.0,28,25,3,0,3,89.28571429
2002020765,24,3600,0.0,27,25,2,1,2,92.59259259
2002020766,8,3593,0.0,30,28,4,1,2,93.33333333
2002020766,2,3600,0.0,23,22,1,0,1,95.65217391
2002020767,5,3554,0.0,28,26,4,1,2,92.85714286
2002020767,15,3600,0.0,24,23,8,1,1,95.83333333
2002020768,12,3522,0.0,31,28,9,0,3,90.32258065
2002020768,14,3600,0.0,25,24,1,0,1,96.0
2002020769,18,3516,0.0,19,17,2,0,2,89.47368421
2002020769,29,3600,0.0,34,33,6,0,1,97.05882353
2002020770,4,1200,0.0,11,8,0,0,3,72.72727273
2002020770,4,2400,0.0,19,17,2,0,2,89.47368421
2002020770,1,3600,0.0,23,22,0,0,1,95.65217391
2002020771,10,3600,0.0,27,25,10,2,2,92.59259259
2002020771,11,3457,0.0,32,27,8,2,5,84.375
2002020772,13,3900,0.0,35,33,5,2,2,94.28571429
2002020772,17,3900,0.0,37,35,10,1,2,94.59459459
2002020773,16,3600,0.0,45,44,12,4,1,97.77777778
2002020773,6,3551,0.0,20,17,6,0,3,85.0
2002020774,21,3749,0.0,41,38,4,1,3,92.68292683
2002020774,3,3749,0.0,29,25,3,0,4,86.20689655
2002020775,7,3806,0.0,32,30,2,0,2,93.75
2002020775,19,3806,0.0,17,16,0,0,1,94.11764706
2002020776,22,3900,0.0,28,25,6,1,3,89.28571429
2002020776,23,3888,0.0,32,29,4,3,3,90.625
2002020777,9,3570,0.0,24,21,3,0,3,87.5
2002020777,26,3598,0.0,18,18,2,0,0,100.0
2002020778,24,3600,0.0,35,32,10,0,3,91.42857143
2002020778,28,3517,0.0,22,18,1,2,4,81.81818182
2002020779,21,3857,0.0,30,28,5,3,2,93.33333333
2002020779,6,3857,0.0,21,18,2,4,3,85.71428571
2002020780,4,3598,0.0,29,28,3,1,1,96.55172414
2002020780,2,3535,0.0,32,30,1,1,2,93.75
2002020781,15,3600,0.0,28,27,10,3,1,96.42857143
2002020781,14,1894,0.0,12,11,1,0,1,91.66666667
2002020781,14,1706,0.0,11,7,3,1,4,63.63636364
2002020782,11,3600,0.0,32,29,3,0,3,90.625
2002020782,8,3532,0.0,21,17,2,2,4,80.95238095
2002020783,7,3600,0.0,30,26,4,3,4,86.66666667
2002020783,1,3594,0.0,20,19,2,1,1,95.0
2002020784,23,3600,0.0,32,30,13,0,2,93.75
2002020784,5,3530,0.0,39,36,6,2,3,92.30769231
2002020785,18,3900,0.0,34,29,10,0,5,85.29411765
2002020785,17,3896,0.0,28,23,7,1,5,82.14285714
2002020786,24,3595,0.0,25,23,2,2,2,92.0
2002020786,20,3548,0.0,26,23,3,0,3,88.46153846
2002020787,9,3600,0.0,29,26,4,1,3,89.65517241
2002020787,3,3576,0.0,22,18,5,0,4,81.81818182
2002020788,1,3600,0.0,28,27,2,0,1,96.42857143
2002020788,15,3527,0.0,38,35,8,1,3,92.10526316
2002020789,23,3899,0.0,28,24,5,3,4,85.71428571
2002020789,29,3899,0.0,40,36,7,3,4,90.0
2002020790,10,3600,2.0,33,33,5,2,0,100.0
2002020790,13,1306,0.0,16,13,0,0,3,81.25
2002020790,13,2287,0.0,11,8,5,1,3,72.72727273
2002020791,16,3546,0.0,25,23,5,0,2,92.0
2002020791,30,3600,0.0,22,21,1,0,1,95.45454545
2002020792,19,3900,2.0,29,27,7,5,2,93.10344828
2002020792,25,3872,0.0,24,22,9,2,2,91.66666667
2002020793,24,3584,0.0,24,22,2,2,2,91.66666667
2002020793,22,3577,0.0,26,25,4,2,1,96.15384615
2002020794,12,3600,0.0,30,24,7,0,6,80.0
2002020794,28,3600,0.0,29,27,8,0,2,93.10344828
2002020795,27,3528,0.0,29,25,1,1,4,86.20689655
2002020795,26,3600,0.0,34,31,5,3,3,91.17647059
2002020796,8,3565,0.0,40,35,8,2,5,87.5
2002020796,6,3592,0.0,31,28,5,1,3,90.32258065
2002020797,4,3900,0.0,45,43,10,1,2,95.55555556
2002020797,9,3894,0.0,30,28,9,0,2,93.33333333
2002020798,10,3829,0.0,36,34,11,0,2,94.44444444
2002020798,14,3829,0.0,24,21,3,2,3,87.5
2002020799,13,3595,2.0,28,28,9,0,0,100.0
2002020799,5,3596,2.0,47,41,19,0,6,87.23404255
2002020800,21,3600,0.0,28,28,3,1,0,100.0
2002020800,17,3540,0.0,21,20,4,0,1,95.23809524
2002020801,3,3900,0.0,25,21,3,0,4,84.0
2002020801,19,487,0.0,9,7,3,0,2,77.77777778
2002020801,19,3413,0.0,18,16,5,0,2,88.88888889
2002020802,16,3900,0.0,27,25,2,1,2,92.59259259
2002020802,20,3900,0.0,32,30,9,0,2,93.75
2002020803,23,3600,0.0,36,34,6,1,2,94.44444444
2002020803,7,3544,0.0,30,26,3,1,4,86.66666667
2002020804,2,3512,0.0,23,21,1,0,2,91.30434783
2002020804,15,3590,0.0,20,20,2,0,0,100.0
2002020805,11,3595,0.0,28,26,7,1,2,92.85714286
2002020805,1,3553,0.0,19,15,2,0,4,78.94736842
2002020806,28,3518,0.0,23,19,3,0,4,82.60869565
2002020806,30,3597,0.0,24,21,1,1,3,87.5
2002020807,20,3600,0.0,30,27,2,1,3,90.0
2002020807,22,3551,0.0,24,20,2,2,4,83.33333333
2002020808,27,3548,0.0,34,31,8,0,3,91.17647059
2002020808,24,3600,4.0,33,31,2,2,2,93.93939394
2002020809,12,2393,0.0,34,27,10,1,7,79.41176471
2002020809,12,1200,0.0,4,3,1,0,1,75.0
2002020809,26,3600,0.0,21,19,3,1,2,90.47619048
2002020810,5,3600,2.0,28,26,2,1,2,92.85714286
2002020810,6,3597,0.0,33,28,5,1,5,84.84848485
2002020811,3,3511,0.0,19,17,2,2,2,89.47368421
2002020811,4,3585,0.0,27,26,5,2,1,96.2962963
2002020812,17,3586,0.0,35,31,6,2,4,88.57142857
2002020812,21,3600,0.0,34,31,6,1,3,91.17647059
2002020813,8,3548,0.0,38,35,5,3,3,92.10526316
2002020813,10,3590,0.0,33,32,7,0,1,96.96969697
2002020814,11,3531,0.0,32,30,6,3,2,93.75
2002020814,9,3582,0.0,25,24,8,0,1,96.0
2002020815,7,3555,0.0,27,25,1,15,2,92.59259259
2002020815,2,3598,0.0,29,28,11,2,1,96.55172414
2002020816,14,3900,0.0,26,22,4,1,4,84.61538462
2002020816,13,1702,0.0,11,8,0,0,3,72.72727273
2002020816,13,2156,0.0,13,12,4,0,1,92.30769231
2002020817,28,3548,0.0,25,22,5,0,3,88.0
2002020817,19,3600,0.0,17,16,7,0,1,94.11764706
2002020818,29,3557,0.0,39,36,8,4,3,92.30769231
2002020818,18,3597,0.0,17,15,4,0,2,88.23529412
2002020819,25,3366,0.0,19,18,4,0,1,94.73684211
2002020819,25,223,0.0,0,0,0,0,0,
2002020819,27,3574,0.0,27,25,1,2,2,92.59259259
2002020820,16,3600,0.0,29,29,10,0,0,100.0
2002020820,22,3591,0.0,33,30,2,3,3,90.90909091
2002020821,30,3578,0.0,31,28,5,2,3,90.32258065
2002020821,1,3600,0.0,21,19,3,0,2,90.47619048
2002020822,8,3597,0.0,25,25,4,0,0,100.0
2002020822,15,3531,0.0,24,22,0,0,2,91.66666667
2002020823,26,3476,0.0,30,27,11,1,3,90.0
2002020823,25,3600,0.0,25,24,5,5,1,96.0
2002020824,12,3598,0.0,22,20,6,2,2,90.90909091
2002020824,24,3599,0.0,29,28,6,2,1,96.55172414
2002020825,20,3547,0.0,25,21,1,0,4,84.0
2002020825,21,3600,0.0,40,38,6,0,2,95.0
2002020826,30,3600,0.0,30,30,2,0,0,100.0
2002020826,4,3552,0.0,19,18,1,0,1,94.73684211
2002020827,28,3553,0.0,26,21,2,1,5,80.76923077
2002020827,17,3574,0.0,30,26,3,0,4,86.66666667
2002020828,16,3561,0.0,31,29,0,0,2,93.5483871
2002020828,23,3600,0.0,23,22,1,2,1,95.65217391
2002020829,19,3590,0.0,29,27,7,1,2,93.10344828
2002020829,7,3544,0.0,25,22,1,1,3,88.0
2002020830,14,3584,0.0,33,27,8,2,6,81.81818182
2002020830,2,3594,0.0,42,40,15,0,2,95.23809524
2002020831,22,3600,0.0,34,30,5,0,4,88.23529412
2002020831,10,3525,2.0,34,29,6,3,5,85.29411765
2002020832,6,3546,0.0,32,29,2,1,3,90.625
2002020832,8,3590,0.0,43,42,5,0,1,97.6744186
2002020833,26,3587,0.0,38,36,12,0,2,94.73684211
2002020833,18,3549,0.0,22,19,4,0,3,86.36363636
2002020834,12,3899,0.0,33,31,4,0,2,93.93939394
2002020834,25,1499,0.0,6,6,0,0,0,100.0
2002020834,25,2400,0.0,13,12,0,0,1,92.30769231
2002020835,1,3551,0.0,18,15,2,0,3,83.33333333
2002020835,21,3600,0.0,33,32,9,1,1,96.96969697
2002020836,28,3526,0.0,28,27,7,0,1,96.42857143
2002020836,29,3600,0.0,38,38,10,1,0,100.0
2002020837,9,3600,0.0,20,20,3,0,0,100.0
2002020837,5,3600,0.0,25,22,2,0,3,88.0
2002020838,15,3600,0.0,27,26,7,0,1,96.2962963
2002020838,11,1200,0.0,13,8,2,1,5,61.53846154
2002020838,11,2400,0.0,16,16,0,1,0,100.0
2002020839,3,3600,0.0,28,27,7,2,1,96.42857143
2002020839,13,3550,0.0,25,23,8,1,2,92.0
2002020840,4,3471,0.0,22,20,2,0,2,90.90909091
2002020840,30,3563,0.0,31,31,0,2,0,100.0
2002020841,10,3594,0.0,33,32,6,4,1,96.96969697
2002020841,16,3507,0.0,28,25,4,1,3,89.28571429
2002020842,1,3600,0.0,18,18,0,4,0,100.0
2002020842,27,3600,0.0,38,35,2,3,3,92.10526316
2002020843,20,3546,0.0,24,20,8,1,4,83.33333333
2002020843,24,3610,0.0,33,30,6,2,3,90.90909091
2002020844,22,3499,0.0,26,24,6,2,2,92.30769231
2002020844,9,3600,0.0,24,24,4,1,0,100.0
2002020845,29,3624,0.0,39,38,12,0,1,97.43589744
2002020845,8,3628,0.0,26,24,5,0,2,92.30769231
2002020846,7,3499,0.0,24,20,4,0,4,83.33333333
2002020846,17,3600,0.0,33,31,1,1,2,93.93939394
2002020847,4,3722,0.0,21,18,1,1,3,85.71428571
2002020847,19,3722,0.0,24,20,2,0,4,83.33333333
2002020848,2,3511,0.0,32,30,11,0,2,93.75
2002020848,18,3600,0.0,36,36,7,1,0,100.0
2002020849,21,3716,0.0,27,25,10,0,2,92.59259259
2002020849,23,3718,0.0,22,21,7,3,1,95.45454545
2002020850,20,3600,4.0,27,23,9,1,4,85.18518519
2002020850,26,3600,0.0,13,11,2,3,2,84.61538462
2002020851,5,3542,2.0,25,24,6,0,1,96.0
2002020851,3,3600,0.0,26,26,8,1,0,100.0
2002020852,15,3538,0.0,21,19,4,0,2,90.47619048
2002020852,12,3600,0.0,31,30,2,0,1,96.77419355
2002020853,14,3900,0.0,35,33,3,1,2,94.28571429
2002020853,11,3900,0.0,30,28,3,1,2,93.33333333
2002020854,6,3627,0.0,36,31,3,1,5,86.11111111
2002020854,13,3624,0.0,41,35,5,0,6,85.36585366
2002020855,27,1990,0.0,11,11,2,0,0,100.0
2002020855,27,1610,0.0,17,15,3,0,2,88.23529412
2002020855,30,3593,0.0,27,24,4,1,3,88.88888889
2002020856,28,3569,0.0,25,23,7,0,2,92.0
2002020856,16,3536,0.0,33,29,11,3,4,87.87878788
2002020857,24,3600,0.0,28,26,6,2,2,92.85714286
2002020857,25,3517,0.0,19,15,1,0,4,78.94736842
2002020858,22,3530,0.0,18,15,3,1,3,83.33333333
2002020858,8,3573,0.0,29,27,4,0,2,93.10344828
2002020859,2,3600,0.0,33,31,8,1,2,93.93939394
2002020859,26,3521,0.0,16,13,0,0,3,81.25
2002020860,3,1330,0.0,10,6,1,1,4,60.0
2002020860,3,2235,0.0,22,21,4,3,1,95.45454545
2002020860,7,3600,0.0,52,48,9,2,4,92.30769231
2002020861,9,3558,0.0,25,23,5,4,2,92.0
2002020861,10,3600,0.0,32,31,3,0,1,96.875
2002020862,12,3900,0.0,44,42,3,2,2,95.45454545
2002020862,4,3900,0.0,24,22,7,1,2,91.66666667
2002020863,17,3600,0.0,28,26,10,0,2,92.85714286
2002020863,11,2945,0.0,28,23,2,0,5,82.14285714
2002020863,11,655,0.0,6,5,0,0,1,83.33333333
2002020864,16,3600,0.0,31,30,5,2,1,96.77419355
2002020864,29,1951,0.0,19,14,4,0,5,73.68421053
2002020864,29,1649,0.0,12,10,2,1,2,83.33333333
2002020865,5,3600,2.0,40,39,6,2,1,97.5
2002020865,1,1200,0.0,11,7,1,0,4,63.63636364
2002020865,1,2400,0.0,6,6,0,0,0,100.0
2002020866,6,3543,2.0,33,29,7,0,4,87.87878788
2002020866,14,3600,0.0,32,30,2,3,2,93.75
2002020867,15,3599,0.0,17,16,5,0,1,94.11764706
2002020867,13,3569,0.0,30,28,8,2,2,93.33333333
2002020868,27,3600,0.0,32,29,8,3,3,90.625
2002020868,19,1372,0.0,15,12,1,0,3,80.0
2002020868,19,2173,0.0,9,8,0,1,1,88.88888889
2002020869,24,3563,0.0,29,27,9,1,2,93.10344828
2002020869,18,3600,0.0,33,32,5,1,1,96.96969697
2002020870,30,3570,0.0,22,19,1,0,3,86.36363636
2002020870,21,3600,0.0,36,34,11,0,2,94.44444444
2002020871,23,3899,0.0,39,37,7,0,2,94.87179487
2002020871,20,3900,0.0,32,30,2,0,2,93.75
2002020872,28,3572,0.0,24,21,3,3,3,87.5
2002020872,25,3600,0.0,20,19,3,2,1,95.0
2002020873,7,3830,0.0,30,26,8,0,4,86.66666667
2002020873,11,3827,0.0,27,24,3,1,3,88.88888889
2002020874,20,3600,0.0,28,23,8,0,5,82.14285714
2002020874,19,3600,0.0,20,17,5,1,3,85.0
2002020875,3,3507,0.0,29,26,1,1,3,89.65517241
2002020875,9,3600,0.0,28,26,6,0,2,92.85714286
2002020876,15,29,0.0,0,0,0,0,0,
2002020876,15,3515,0.0,30,27,9,1,3,90.0
2002020876,14,3591,0.0,15,14,1,1,1,93.33333333
2002020877,6,1881,0.0,8,7,0,1,1,87.5
2002020877,6,1708,2.0,24,20,0,0,4,83.33333333
2002020877,18,3600,0.0,41,40,13,1,1,97.56097561
2002020878,21,3597,2.0,31,27,4,0,4,87.09677419
2002020878,16,3533,0.0,21,16,1,0,5,76.19047619
2002020879,28,3524,0.0,28,25,0,2,3,89.28571429
2002020879,26,3600,0.0,26,24,5,0,2,92.30769231
2002020880,2,3900,0.0,31,29,4,0,2,93.5483871
2002020880,24,3895,0.0,33,31,5,1,2,93.93939394
2002020881,1,3900,0.0,26,24,1,0,2,92.30769231
2002020881,4,3891,0.0,36,34,8,2,2,94.44444444
2002020882,12,3525,0.0,47,43,4,0,4,91.4893617
2002020882,10,3595,0.0,24,21,9,1,3,87.5
2002020883,13,3587,0.0,24,24,4,2,0,100.0
2002020883,8,3600,0.0,30,27,1,1,3,90.0
2002020884,22,3692,0.0,22,18,4,1,4,81.81818182
2002020884,5,3695,2.0,36,33,4,1,3,91.66666667
2002020885,23,2615,0.0,26,23,2,1,3,88.46153846
2002020885,23,1122,0.0,4,4,0,0,0,100.0
2002020885,17,3774,0.0,37,33,5,2,4,89.18918919
2002020886,29,3600,2.0,35,30,8,2,5,85.71428571
2002020886,27,3599,0.0,16,14,6,0,2,87.5
2002020887,8,3829,0.0,30,28,0,0,2,93.33333333
2002020887,7,3829,0.0,26,25,2,0,1,96.15384615
2002020888,6,3885,0.0,28,27,3,0,1,96.42857143
2002020888,12,3900,0.0,27,26,2,0,1,96.2962963
2002020889,11,3531,0.0,36,34,4,1,2,94.44444444
2002020889,14,3597,0.0,27,27,6,1,0,100.0
2002020890,9,3600,0.0,22,19,4,1,3,86.36363636
2002020890,1,3586,0.0,19,15,3,0,4,78.94736842
2002020891,3,3600,0.0,29,27,9,0,2,93.10344828
2002020891,30,3595,0.0,19,15,0,0,4,78.94736842
2002020892,20,3896,2.0,39,38,7,1,1,97.43589744
2002020892,25,3888,0.0,27,26,4,1,1,96.2962963
2002020893,29,3578,0.0,22,21,3,0,1,95.45454545
2002020893,24,3600,0.0,26,26,4,1,0,100.0
2002020894,2,3600,0.0,29,29,5,1,0,100.0
2002020894,28,3596,0.0,33,30,7,2,3,90.90909091
2002020895,13,3600,0.0,31,28,11,0,3,90.32258065
2002020895,9,3570,0.0,27,23,8,1,4,85.18518519
2002020896,10,3600,0.0,27,25,6,0,2,92.59259259
2002020896,15,3586,0.0,22,16,4,2,6,72.72727273
2002020897,22,1830,0.0,18,16,1,3,2,88.88888889
2002020897,22,1770,0.0,20,16,4,3,4,80.0
2002020897,17,3580,0.0,35,33,9,1,2,94.28571429
2002020898,26,2400,0.0,22,20,1,2,2,90.90909091
2002020898,26,917,0.0,12,10,4,0,2,83.33333333
2002020898,4,3600,0.0,28,28,8,1,0,100.0
2002020899,21,3596,0.0,28,26,5,0,2,92.85714286
2002020899,5,3600,0.0,30,25,5,1,5,83.33333333
2002020900,23,3594,0.0,24,22,8,1,2,91.66666667
2002020900,19,2215,0.0,9,8,2,1,1,88.88888889
2002020900,19,1336,0.0,5,2,0,0,3,40.0
2002020901,20,3597,0.0,31,27,0,1,4,87.09677419
2002020901,18,3600,0.0,39,38,8,1,1,97.43589744
2002020902,27,3600,0.0,26,25,3,0,1,96.15384615
2002020902,16,3539,0.0,26,24,0,1,2,92.30769231
2002020903,26,3600,0.0,32,31,3,0,1,96.875
2002020903,7,3595,0.0,41,37,0,2,4,90.24390244
2002020904,21,3589,0.0,23,20,6,1,3,86.95652174
2002020904,2,3600,0.0,26,25,4,3,1,96.15384615
2002020905,14,3900,0.0,25,23,0,0,2,92.0
2002020905,12,3886,0.0,36,34,5,1,2,94.44444444
2002020906,6,3515,0.0,30,27,1,0,3,90.0
2002020906,1,3600,2.0,32,30,4,1,2,93.75
2002020907,27,3900,0.0,33,31,4,0,2,93.93939394
2002020907,25,3895,0.0,24,22,0,0,2,91.66666667
2002020908,3,3600,0.0,34,32,8,0,2,94.11764706
2002020908,24,3591,0.0,31,25,9,1,6,80.64516129
2002020909,29,3600,2.0,37,31,8,1,6,83.78378378
2002020909,28,3594,2.0,29,29,5,1,0,100.0
2002020910,19,3873,0.0,25,23,3,0,2,92.0
2002020910,5,3873,0.0,25,24,1,0,1,96.0
2002020911,10,3596,0.0,22,19,2,1,3,86.36363636
2002020911,8,3576,0.0,25,21,8,1,4,84.0
2002020912,18,3588,0.0,29,25,2,1,4,86.20689655
2002020912,9,3593,0.0,18,18,4,1,0,100.0
2002020913,13,3600,0.0,46,44,11,0,2,95.65217391
2002020913,4,3502,0.0,28,25,0,3,3,89.28571429
2002020914,17,3600,0.0,18,17,4,1,1,94.44444444
2002020914,15,3584,0.0,33,28,3,1,5,84.84848485
2002020915,23,3682,0.0,25,23,1,3,2,92.0
2002020915,22,3646,0.0,27,24,3,1,3,88.88888889
2002020916,6,3755,0.0,29,25,9,0,4,86.20689655
2002020916,6,135,0.0,1,1,0,0,0,100.0
2002020916,2,3880,2.0,31,27,1,0,4,87.09677419
2002020917,24,3600,0.0,28,28,8,0,0,100.0
2002020917,12,3600,0.0,22,18,3,0,4,81.81818182
2002020918,19,3600,0.0,19,16,7,0,3,84.21052632
2002020918,30,3600,0.0,22,21,4,0,1,95.45454545
2002020919,1,3600,0.0,22,19,0,1,3,86.36363636
2002020919,5,3542,0.0,35,31,5,0,4,88.57142857
2002020920,3,3600,0.0,24,20,5,3,4,83.33333333
2002020920,21,3598,0.0,38,37,7,0,1,97.36842105
2002020921,7,3600,2.0,31,30,5,0,1,96.77419355
2002020921,14,3528,5.0,24,21,2,0,3,87.5
2002020922,20,3600,0.0,34,32,10,2,2,94.11764706
2002020922,27,3531,0.0,32,29,5,3,3,90.625
2002020923,18,3600,0.0,23,21,0,5,2,91.30434783
2002020923,10,3600,12.0,29,24,8,0,5,82.75862069
2002020924,25,3596,0.0,20,20,0,2,0,100.0
2002020924,16,3600,0.0,20,17,0,1,3,85.0
2002020925,11,3900,0.0,25,22,4,0,3,88.0
2002020925,22,3888,0.0,32,29,9,2,3,90.625
2002020926,29,3586,0.0,33,26,5,2,7,78.78787879
2002020926,23,3600,0.0,26,24,6,1,2,92.30769231
2002020927,8,3600,0.0,18,14,2,0,4,77.77777778
2002020927,15,3600,0.0,26,25,4,0,1,96.15384615
2002020928,7,3900,0.0,31,29,2,0,2,93.5483871
2002020928,13,3900,0.0,25,23,10,0,2,92.0
2002020929,26,3520,0.0,31,26,3,0,5,83.87096774
2002020929,17,3600,0.0,30,26,2,1,4,86.66666667
2002020930,20,3600,0.0,30,25,6,0,5,83.33333333
2002020930,28,3594,0.0,34,32,3,1,2,94.11764706
2002020931,25,3895,0.0,34,29,1,1,5,85.29411765
2002020931,6,3900,0.0,44,39,11,0,5,88.63636364
2002020932,30,3600,0.0,28,28,3,1,0,100.0
2002020932,9,3600,0.0,19,16,0,0,3,84.21052632
2002020933,24,3488,0.0,26,24,2,1,2,92.30769231
2002020933,14,3590,0.0,24,24,2,0,0,100.0
2002020934,2,3600,0.0,28,23,1,2,5,82.14285714
2002020934,10,3600,0.0,31,29,3,3,2,93.5483871
2002020935,3,3898,0.0,36,33,7,1,3,91.66666667
2002020935,1,3900,0.0,26,23,2,4,3,88.46153846
2002020936,26,923,0.0,8,6,0,0,2,75.0
2002020936,26,2660,0.0,17,16,1,0,1,94.11764706
2002020936,5,3490,2.0,29,24,3,0,5,82.75862069
2002020937,29,3600,0.0,27,22,5,1,5,81.48148148
2002020937,18,3598,0.0,19,19,3,0,0,100.0
2002020938,4,3600,0.0,25,25,1,0,0,100.0
2002020938,16,3495,0.0,28,26,2,1,2,92.85714286
2002020939,22,1132,0.0,5,5,0,1,0,100.0
2002020939,22,2396,0.0,14,10,1,1,4,71.42857143
2002020939,21,3600,0.0,24,22,6,0,2,91.66666667
2002020940,11,3555,0.0,31,23,7,3,8,74.19354839
2002020940,23,3592,0.0,23,23,8,0,0,100.0
2002020941,7,3531,0.0,31,28,3,0,3,90.32258065
2002020941,15,3589,0.0,37,35,7,3,2,94.59459459
2002020942,24,3596,0.0,32,31,1,0,1,96.875
2002020942,13,3523,0.0,29,27,3,0,2,93.10344828
2002020943,12,3532,0.0,19,15,4,0,4,78.94736842
2002020943,27,3600,0.0,36,34,7,1,2,94.44444444
2002020944,25,3680,0.0,23,20,1,1,3,86.95652174
2002020944,9,3665,0.0,23,21,3,0,2,91.30434783
2002020945,1,3900,0.0,22,19,8,0,3,86.36363636
2002020945,2,3900,0.0,33,30,4,2,3,90.90909091
2002020946,13,3591,0.0,38,36,4,0,2,94.73684211
2002020946,14,3593,0.0,36,35,4,2,1,97.22222222
2002020947,26,3516,0.0,28,26,1,0,2,92.85714286
2002020947,29,3600,0.0,34,33,1,0,1,97.05882353
2002020948,30,3600,0.0,35,32,7,1,3,91.42857143
2002020948,8,3559,0.0,44,39,10,2,5,88.63636364
2002020949,10,3600,2.0,31,24,6,4,7,77.41935484
2002020949,17,3592,2.0,29,27,7,1,2,93.10344828
2002020950,6,3596,0.0,47,43,12,1,4,91.4893617
2002020950,3,3600,0.0,38,37,2,1,1,97.36842105
2002020951,16,3600,0.0,24,19,4,0,5,79.16666667
2002020951,4,3590,0.0,27,25,1,1,2,92.59259259
2002020952,22,3563,0.0,30,27,3,1,3,90.0
2002020952,19,3600,0.0,22,21,3,1,1,95.45454545
2002020953,5,3592,0.0,36,30,9,1,6,83.33333333
2002020953,18,3594,0.0,22,22,5,0,0,100.0
2002020954,11,3672,0.0,31,28,6,2,3,90.32258065
2002020954,21,3672,0.0,30,26,7,0,4,86.66666667
2002020955,28,3589,0.0,25,23,5,0,2,92.0
2002020955,23,3518,0.0,29,26,13,2,3,89.65517241
2002020956,25,3546,0.0,20,15,1,1,5,75.0
2002020956,7,3597,0.0,34,31,7,1,3,91.17647059
2002020957,24,3582,0.0,27,25,3,3,2,92.59259259
2002020957,27,3600,0.0,33,32,12,1,1,96.96969697
2002020958,4,3621,2.0,26,24,0,0,2,92.30769231
2002020958,6,3638,0.0,32,29,4,1,3,90.625
2002020959,16,3769,0.0,33,28,8,0,5,84.84848485
2002020959,18,3765,0.0,31,27,2,0,4,87.09677419
2002020960,5,3600,0.0,26,22,2,0,4,84.61538462
2002020960,21,3594,0.0,23,22,7,2,1,95.65217391
2002020961,11,3600,0.0,24,20,8,0,4,83.33333333
2002020961,26,3600,0.0,19,18,4,1,1,94.73684211
2002020962,12,3600,0.0,30,26,8,3,4,86.66666667
2002020962,10,3600,0.0,21,20,5,2,1,95.23809524
2002020963,23,3895,0.0,21,20,3,1,1,95.23809524
2002020963,8,3900,0.0,38,37,6,0,1,97.36842105
2002020964,14,3600,0.0,31,30,1,1,1,96.77419355
2002020964,9,3534,0.0,26,24,1,0,2,92.30769231
2002020965,7,3761,0.0,33,31,1,1,2,93.93939394
2002020965,2,3762,0.0,37,36,2,0,1,97.2972973
2002020966,13,3576,0.0,47,42,14,5,5,89.36170213
2002020966,3,3600,0.0,34,32,3,2,2,94.11764706
2002020967,22,3900,0.0,27,24,7,0,3,88.88888889
2002020967,29,3900,0.0,27,24,1,1,3,88.88888889
2002020968,15,3770,0.0,26,24,2,1,2,92.30769231
2002020968,1,3751,0.0,29,28,4,2,1,96.55172414
2002020969,30,3600,0.0,15,13,3,2,2,86.66666667
2002020969,19,3592,0.0,27,27,7,0,0,100.0
2002020970,28,3540,0.0,37,33,1,4,4,89.18918919
2002020970,20,3600,0.0,18,15,4,0,3,83.33333333
2002020971,5,3574,0.0,26,24,5,0,2,92.30769231
2002020971,25,3574,0.0,20,19,4,0,1,95.0
2002020972,27,3600,0.0,33,28,3,1,5,84.84848485
2002020972,17,3589,0.0,24,22,4,2,2,91.66666667
2002020973,12,3530,0.0,29,27,10,2,2,93.10344828
2002020973,15,3593,0.0,21,21,1,1,0,100.0
2002020974,21,3818,0.0,41,39,12,1,2,95.12195122
2002020974,16,3748,0.0,29,26,8,1,3,89.65517241
2002020975,11,3600,0.0,30,29,0,2,1,96.66666667
2002020975,24,3563,0.0,23,21,3,1,2,91.30434783
2002020976,23,3600,0.0,41,37,8,1,4,90.24390244
2002020976,6,3545,0.0,31,26,3,0,5,83.87096774
2002020977,17,3593,0.0,31,29,9,2,2,93.5483871
2002020977,29,3556,0.0,23,20,2,0,3,86.95652174
2002020978,13,3600,0.0,32,31,9,3,1,96.875
2002020978,10,3536,0.0,32,30,11,0,2,93.75
2002020979,2,3900,0.0,35,34,6,0,1,97.14285714
2002020979,3,3900,0.0,37,36,3,4,1,97.2972973
2002020980,15,3600,0.0,36,35,4,0,1,97.22222222
2002020980,7,3531,0.0,23,21,2,2,2,91.30434783
2002020981,10,3597,0.0,42,38,14,0,4,90.47619048
2002020981,9,3593,2.0,17,16,1,0,1,94.11764706
2002020982,14,3600,0.0,26,25,7,1,1,96.15384615
2002020982,2,1200,0.0,7,4,0,0,3,57.14285714
2002020982,2,2314,0.0,20,20,1,0,0,100.0
2002020983,23,169,0.0,3,1,0,0,2,33.33333333
2002020983,23,3396,0.0,21,20,6,0,1,95.23809524
2002020983,4,3600,0.0,41,41,4,1,0,100.0
2002020984,6,3600,0.0,34,32,10,0,2,94.11764706
2002020984,12,3501,0.0,30,26,4,1,4,86.66666667
2002020985,27,3600,0.0,34,33,9,0,1,97.05882353
2002020985,5,3589,0.0,28,25,3,0,3,89.28571429
2002020986,18,3698,0.0,12,10,4,0,2,83.33333333
2002020986,19,3705,0.0,19,18,5,1,1,94.73684211
2002020987,1,3532,0.0,24,21,2,1,3,87.5
2002020987,30,3600,0.0,31,29,5,0,2,93.5483871
2002020988,28,3544,0.0,37,35,10,4,2,94.59459459
2002020988,22,3592,0.0,27,26,6,1,1,96.2962963
2002020989,24,3600,0.0,21,20,2,1,1,95.23809524
2002020989,26,3476,0.0,25,23,4,0,2,92.0
2002020989,26,8,0.0,0,0,0,0,0,
2002020990,21,3597,0.0,31,30,5,1,1,96.77419355
2002020990,13,3563,0.0,24,21,0,1,3,87.5
2002020991,14,3513,2.0,22,19,3,3,3,86.36363636
2002020991,17,3600,0.0,35,33,14,3,2,94.28571429
2002020992,1,3714,0.0,32,27,5,1,5,84.375
2002020992,20,3698,0.0,26,22,2,2,4,84.61538462
2002020993,16,3600,0.0,28,21,1,0,7,75.0
2002020993,25,3597,0.0,25,21,2,0,4,84.0
2002020994,8,3528,0.0,23,20,1,1,3,86.95652174
2002020994,24,3600,0.0,25,24,3,0,1,96.0
2002020995,10,3517,0.0,25,22,1,2,3,88.0
2002020995,7,3600,0.0,33,31,6,0,2,93.93939394
2002020996,11,3882,2.0,37,33,5,2,4,89.18918919
2002020996,15,3895,0.0,21,17,1,0,4,80.95238095
2002020997,23,2049,0.0,23,19,6,0,4,82.60869565
2002020997,23,1673,0.0,13,12,3,0,1,92.30769231
2002020997,29,3722,0.0,31,27,1,3,4,87.09677419
2002020998,12,3597,0.0,21,21,5,4,0,100.0
2002020998,5,1200,0.0,9,8,4,0,1,88.88888889
2002020998,5,2400,0.0,16,13,2,0,3,81.25
2002020999,2,3559,2.0,33,30,6,1,3,90.90909091
2002020999,6,3600,0.0,22,21,1,0,1,95.45454545
2002021000,27,3578,0.0,29,24,3,1,5,82.75862069
2002021000,19,3600,0.0,19,16,5,1,3,84.21052632
2002021001,30,3900,0.0,31,29,7,3,2,93.5483871
2002021001,18,3894,2.0,38,36,6,4,2,94.73684211
2002021002,22,3572,0.0,22,21,4,0,1,95.45454545
2002021002,26,3524,0.0,35,33,5,0,2,94.28571429
2002021003,8,3838,0.0,32,28,2,2,4,87.5
2002021003,28,3838,0.0,36,33,11,0,3,91.66666667
2002021004,4,546,0.0,9,6,1,0,3,66.66666667
2002021004,4,3054,0.0,25,23,0,2,2,92.0
2002021004,3,3600,0.0,35,34,0,0,1,97.14285714
2002021005,30,3581,0.0,25,24,3,2,1,96.0
2002021005,12,3596,0.0,22,22,4,1,0,100.0
2002021006,13,3600,0.0,41,40,5,1,1,97.56097561
2002021006,11,3547,0.0,27,25,4,4,2,92.59259259
2002021007,21,3530,0.0,35,31,9,0,4,88.57142857
2002021007,14,3590,0.0,25,22,2,0,3,88.0
2002021008,19,2118,0.0,19,15,0,0,4,78.94736842
2002021008,19,1482,0.0,10,7,1,0,3,70.0
2002021008,17,3600,0.0,31,29,0,0,2,93.5483871
2002021009,20,3592,0.0,30,30,9,1,0,100.0
2002021009,16,3556,0.0,29,28,5,1,1,96.55172414
2002021010,18,3600,2.0,29,28,1,4,1,96.55172414
2002021010,25,3523,0.0,19,17,4,0,2,89.47368421
2002021011,22,3600,0.0,28,27,4,1,1,96.42857143
2002021011,24,3566,0.0,22,19,2,1,3,86.36363636
2002021012,15,3127,0.0,28,26,2,0,2,92.85714286
2002021012,15,604,0.0,6,3,1,0,3,50.0
2002021012,6,3735,0.0,26,22,5,1,4,84.61538462
2002021013,23,3873,0.0,19,16,1,0,3,84.21052632
2002021013,10,3900,2.0,33,30,4,0,3,90.90909091
2002021014,1,3599,0.0,40,38,1,0,2,95.0
2002021014,2,3534,0.0,18,15,0,0,3,83.33333333
2002021015,21,3626,0.0,29,28,7,1,1,96.55172414
2002021015,4,3615,0.0,30,28,7,2,2,93.33333333
2002021016,20,3892,0.0,28,26,5,0,2,92.85714286
2002021016,29,3892,0.0,29,26,2,5,3,89.65517241
2002021017,9,3600,2.0,35,34,5,2,1,97.14285714
2002021017,5,3600,0.0,31,26,7,0,5,83.87096774
2002021018,7,3600,0.0,29,29,9,0,0,100.0
2002021018,13,3596,0.0,25,21,9,0,4,84.0
2002021019,28,3531,0.0,30,25,2,2,5,83.33333333
2002021019,27,3599,0.0,20,16,4,1,4,80.0
2002021020,8,3566,0.0,30,28,4,1,2,93.33333333
2002021020,26,3590,0.0,28,27,2,0,1,96.42857143
2002021021,30,1577,0.0,5,5,0,0,0,100.0
2002021021,30,2023,0.0,15,11,2,1,4,73.33333333
2002021021,11,3600,0.0,32,26,4,3,6,81.25
2002021022,6,3599,4.0,33,25,1,2,8,75.75757576
2002021022,16,3600,0.0,34,29,4,0,5,85.29411765
2002021023,7,3900,0.0,28,27,1,0,1,96.42857143
2002021023,14,3886,2.0,27,26,4,2,1,96.2962963
2002021024,17,2400,0.0,23,19,7,2,4,82.60869565
2002021024,17,1200,0.0,5,5,0,0,0,100.0
2002021024,24,3595,0.0,40,39,4,9,1,97.5
2002021025,5,3588,0.0,25,21,3,0,4,84.0
2002021025,9,3600,0.0,21,19,5,0,2,90.47619048
2002021026,28,3598,0.0,24,21,6,0,3,87.5
2002021026,25,3596,0.0,23,23,11,0,0,100.0
2002021027,13,3591,0.0,41,40,18,1,1,97.56097561
2002021027,3,3584,0.0,32,30,5,1,2,93.75
2002021028,4,3621,0.0,30,28,1,0,2,93.33333333
2002021028,15,3613,0.0,18,17,4,0,1,94.44444444
2002021029,29,1020,0.0,9,6,0,0,3,66.66666667
2002021029,29,2529,0.0,15,12,4,1,3,80.0
2002021029,12,3600,0.0,40,35,4,2,5,87.5
2002021030,8,3600,0.0,38,37,5,2,1,97.36842105
2002021030,18,3591,0.0,27,25,1,1,2,92.59259259
2002021031,27,3888,0.0,36,34,9,0,2,94.44444444
2002021031,21,3895,10.0,25,23,2,0,2,92.0
2002021032,10,3600,0.0,28,26,9,0,2,92.85714286
2002021032,22,3524,0.0,18,15,0,1,3,83.33333333
2002021033,17,3600,0.0,29,27,2,0,2,93.10344828
2002021033,26,1851,0.0,13,10,2,0,3,76.92307692
2002021033,26,1684,0.0,5,5,0,0,0,100.0
2002021034,6,3628,0.0,25,21,2,0,4,84.0
2002021034,9,3628,0.0,25,22,1,0,3,88.0
2002021035,25,3590,0.0,25,25,6,0,0,100.0
2002021035,29,3537,0.0,36,34,6,1,2,94.44444444
2002021036,11,3600,0.0,25,23,3,0,2,92.0
2002021036,1,3526,0.0,20,17,4,0,3,85.0
2002021037,22,3598,0.0,22,20,1,0,2,90.90909091
2002021037,20,3586,0.0,29,25,9,0,4,86.20689655
2002021038,2,3526,0.0,24,20,2,0,4,83.33333333
2002021038,23,3598,0.0,31,28,5,3,3,90.32258065
2002021039,19,3600,0.0,21,19,2,1,2,90.47619048
2002021039,28,3542,0.0,28,24,0,1,4,85.71428571
2002021040,12,3787,0.0,34,32,3,1,2,94.11764706
2002021040,7,3820,0.0,34,31,3,1,3,91.17647059
2002021041,26,3541,2.0,26,23,9,0,3,88.46153846
2002021041,14,3600,0.0,28,26,3,3,2,92.85714286
2002021042,18,3896,0.0,32,30,11,0,2,93.75
2002021042,5,3898,0.0,32,30,10,0,2,93.75
2002021043,8,3600,0.0,32,32,4,0,0,100.0
2002021043,13,3600,0.0,31,27,1,1,4,87.09677419
2002021044,25,2317,0.0,9,9,1,0,0,100.0
2002021044,25,1200,0.0,10,6,1,0,4,60.0
2002021044,30,3600,2.0,33,31,7,0,2,93.93939394
2002021045,17,3600,0.0,29,27,3,0,2,93.10344828
2002021045,27,3523,0.0,22,19,1,0,3,86.36363636
2002021046,16,3566,0.0,27,23,3,0,4,85.18518519
2002021046,24,3600,0.0,37,35,2,1,2,94.59459459
2002021047,1,1800,0.0,20,16,1,0,4,80.0
2002021047,1,1760,0.0,8,8,1,0,0,100.0
2002021047,6,3600,0.0,30,27,1,3,3,90.0
2002021048,3,3694,0.0,34,31,3,0,3,91.17647059
2002021048,9,3678,0.0,20,18,1,1,2,90.0
2002021049,12,3553,0.0,37,32,4,1,5,86.48648649
2002021049,4,3588,0.0,15,12,3,1,3,80.0
2002021050,21,3591,0.0,21,20,1,1,1,95.23809524
2002021050,29,3600,0.0,31,26,8,0,5,83.87096774
2002021051,8,3600,0.0,28,26,1,1,2,92.85714286
2002021051,11,3530,0.0,30,27,3,1,3,90.0
2002021052,10,3870,0.0,38,34,6,2,4,89.47368421
2002021052,20,3870,0.0,23,20,1,0,3,86.95652174
2002021053,2,3597,0.0,24,22,4,0,2,91.66666667
2002021053,22,3527,0.0,32,28,6,1,4,87.5
2002021054,19,3900,0.0,20,16,1,0,4,80.0
2002021054,23,3896,0.0,33,29,3,0,4,87.87878788
2002021055,14,3600,0.0,28,26,3,0,2,92.85714286
2002021055,7,3549,0.0,32,29,3,1,3,90.625
2002021056,26,3600,0.0,22,21,5,0,1,95.45454545
2002021056,15,3529,0.0,32,29,7,2,3,90.625
2002021057,18,3556,0.0,17,15,1,0,2,88.23529412
2002021057,30,3600,0.0,23,22,0,1,1,95.65217391
2002021058,16,3600,0.0,21,21,7,2,0,100.0
2002021058,27,3529,0.0,28,25,6,2,3,89.28571429
2002021059,13,3594,0.0,32,29,6,5,3,90.625
2002021059,6,3600,0.0,25,24,3,1,1,96.0
2002021060,3,3584,0.0,38,35,9,1,3,92.10526316
2002021060,1,3600,0.0,17,16,2,0,1,94.11764706
2002021061,4,3600,0.0,14,13,1,0,1,92.85714286
2002021061,5,3600,0.0,34,30,4,2,4,88.23529412
2002021062,21,3532,0.0,38,33,3,1,5,86.84210526
2002021062,17,3600,0.0,24,21,0,0,3,87.5
2002021063,14,3600,0.0,24,23,1,0,1,95.83333333
2002021063,8,3524,0.0,24,22,1,0,2,91.66666667
2002021064,2,3598,0.0,33,31,8,2,2,93.93939394
2002021064,9,952,0.0,8,7,1,0,1,87.5
2002021064,9,2648,0.0,16,12,6,1,4,75.0
2002021065,26,3897,0.0,30,30,3,0,0,100.0
2002021065,12,3900,0.0,23,23,2,0,0,100.0
2002021066,7,3598,0.0,23,19,4,1,4,82.60869565
2002021066,11,3600,0.0,39,36,8,1,3,92.30769231
2002021067,30,1200,0.0,12,7,0,1,5,58.33333333
2002021067,30,2400,0.0,20,20,1,0,0,100.0
2002021067,29,3600,0.0,24,24,9,1,0,100.0
2002021068,10,3600,0.0,23,23,7,0,0,100.0
2002021068,23,3537,0.0,23,22,0,1,1,95.65217391
2002021069,19,3600,0.0,35,35,1,0,0,100.0
2002021069,18,3555,0.0,33,32,4,1,1,96.96969697
2002021070,24,361,0.0,6,4,3,0,2,66.66666667
2002021070,24,3190,0.0,17,16,3,0,1,94.11764706
2002021070,27,3600,0.0,28,26,6,0,2,92.85714286
2002021071,25,3527,0.0,30,26,9,0,4,86.66666667
2002021071,22,3595,0.0,27,24,5,3,3,88.88888889
2002021072,20,3540,0.0,28,25,10,0,3,89.28571429
2002021072,28,3585,0.0,34,32,4,2,2,94.11764706
2002021073,13,3600,0.0,33,31,9,0,2,93.93939394
2002021073,5,3590,0.0,29,25,4,0,4,86.20689655
2002021074,21,3532,0.0,28,26,3,0,2,92.85714286
2002021074,15,3600,0.0,22,21,4,0,1,95.45454545
2002021075,9,2692,0.0,13,8,2,0,5,61.53846154
2002021075,9,898,0.0,7,6,0,0,1,85.71428571
2002021075,17,3600,0.0,43,41,5,0,2,95.34883721
2002021076,20,3900,0.0,29,27,5,2,2,93.10344828
2002021076,24,3877,0.0,39,37,7,2,2,94.87179487
2002021077,4,3594,0.0,29,27,3,1,2,93.10344828
2002021077,1,3512,0.0,20,16,1,0,4,80.0
2002021078,2,3533,0.0,39,38,10,0,1,97.43589744
2002021078,3,3586,0.0,17,17,9,0,0,100.0
2002021079,30,3897,0.0,32,29,1,0,3,90.625
2002021079,14,3900,0.0,20,17,1,0,3,85.0
2002021080,29,3587,0.0,31,28,10,0,3,90.32258065
2002021080,11,3579,0.0,29,27,10,0,2,93.10344828
2002021081,22,3595,0.0,30,27,12,3,3,90.0
2002021081,18,3535,0.0,22,18,5,0,4,81.81818182
2002021082,23,3596,0.0,28,26,6,0,2,92.85714286
2002021082,25,3569,0.0,24,20,4,1,4,83.33333333
2002021083,16,3686,0.0,37,35,7,0,2,94.59459459
2002021083,28,3686,0.0,26,23,1,0,3,88.46153846
2002021084,4,3600,0.0,23,18,0,0,5,78.26086957
2002021084,7,3600,0.0,32,30,2,0,2,93.75
2002021085,9,3600,0.0,25,20,6,1,5,80.0
2002021085,12,3585,0.0,24,18,0,4,6,75.0
2002021086,2,3900,0.0,31,28,7,0,3,90.32258065
2002021086,10,3898,0.0,22,19,2,1,3,86.36363636
2002021087,1,3600,0.0,25,25,4,1,0,100.0
2002021087,8,3537,0.0,29,28,4,3,1,96.55172414
2002021088,17,3596,0.0,27,26,5,0,1,96.2962963
2002021088,5,3600,0.0,27,22,0,2,5,81.48148148
2002021089,23,3572,2.0,34,29,6,0,5,85.29411765
2002021089,19,3595,0.0,25,21,5,2,4,84.0
2002021090,6,3535,0.0,28,26,8,0,2,92.85714286
2002021090,27,3587,2.0,29,28,4,1,1,96.55172414
2002021091,20,3600,0.0,27,26,7,1,1,96.2962963
2002021091,26,3542,0.0,32,28,4,2,4,87.5
2002021092,7,3568,0.0,36,33,9,3,3,91.66666667
2002021092,3,3600,0.0,27,27,5,0,0,100.0
2002021093,25,3732,0.0,26,22,4,0,4,84.61538462
2002021093,11,3716,0.0,40,35,7,1,5,87.5
2002021094,30,3600,0.0,32,31,2,1,1,96.875
2002021094,13,928,0.0,6,4,0,0,2,66.66666667
2002021094,13,2662,0.0,20,19,3,0,1,95.0
2002021095,24,3600,0.0,42,39,7,0,3,92.85714286
2002021095,16,3534,0.0,32,28,3,0,4,87.5
2002021096,28,671,0.0,4,4,0,0,0,100.0
2002021096,28,2863,0.0,20,18,1,2,2,90.0
2002021096,21,3583,0.0,29,29,10,2,0,100.0
2002021097,10,3848,0.0,32,28,10,1,4,87.5
2002021097,29,3854,0.0,32,29,4,6,3,90.625
2002021098,2,3600,0.0,35,32,9,2,3,91.42857143
2002021098,8,3511,2.0,38,33,9,2,5,86.84210526
2002021099,5,3600,0.0,32,28,9,0,4,87.5
2002021099,4,3600,0.0,23,21,3,0,2,91.30434783
2002021100,24,3742,0.0,34,31,3,0,3,91.17647059
2002021100,19,3742,0.0,26,24,8,0,2,92.30769231
2002021101,15,3600,0.0,25,24,7,2,1,96.0
2002021101,20,418,0.0,3,2,0,0,1,66.66666667
2002021101,20,3181,0.0,16,13,4,0,3,81.25
2002021102,22,3771,0.0,25,22,4,0,3,88.0
2002021102,27,1625,0.0,10,9,1,0,1,90.0
2002021102,27,2148,0.0,12,11,2,0,1,91.66666667
2002021103,18,3067,0.0,27,23,1,0,4,85.18518519
2002021103,18,533,0.0,5,2,0,0,3,40.0
2002021103,23,3596,2.0,23,20,3,1,3,86.95652174
2002021104,14,3900,0.0,39,37,7,0,2,94.87179487
2002021104,26,3900,0.0,26,24,3,0,2,92.30769231
2002021105,5,3545,0.0,42,39,3,1,3,92.85714286
2002021105,1,3600,0.0,24,23,4,0,1,95.83333333
2002021106,9,3600,0.0,15,14,3,1,1,93.33333333
2002021106,11,3600,0.0,40,35,5,0,5,87.5
2002021107,30,3690,0.0,36,34,2,1,2,94.44444444
2002021107,25,3690,0.0,21,18,2,3,3,85.71428571
2002021108,6,3558,0.0,18,15,6,1,3,83.33333333
2002021108,28,3591,0.0,30,28,5,2,2,93.33333333
2002021109,3,1200,0.0,7,6,1,0,1,85.71428571
2002021109,3,2400,0.0,28,28,6,0,0,100.0
2002021109,4,3543,2.0,19,17,5,0,2,89.47368421
2002021110,17,3600,0.0,26,24,10,0,2,92.30769231
2002021110,19,3579,0.0,21,18,3,0,3,85.71428571
2002021111,16,1840,0.0,22,17,3,2,5,77.27272727
2002021111,16,1760,0.0,6,3,0,0,3,50.0
2002021111,21,1200,0.0,14,14,2,0,0,100.0
2002021111,21,2400,0.0,23,22,3,0,1,95.65217391
2002021112,7,3635,0.0,19,16,1,1,3,84.21052632
2002021112,10,3636,2.0,27,25,5,2,2,92.59259259
2002021113,12,3534,0.0,22,18,2,2,4,81.81818182
2002021113,8,3599,0.0,37,34,5,1,3,91.89189189
2002021114,1,3586,0.0,20,18,0,0,2,90.0
2002021114,2,3534,0.0,26,23,9,1,3,88.46153846
2002021115,11,3600,0.0,38,36,6,0,2,94.73684211
2002021115,29,3531,2.0,26,23,2,0,3,88.46153846
2002021116,9,3597,0.0,25,24,3,0,1,96.0
2002021116,13,3585,0.0,36,34,5,0,2,94.44444444
2002021117,18,3880,0.0,31,30,4,2,1,96.77419355
2002021117,20,3900,0.0,23,22,3,0,1,95.65217391
2002021118,14,3600,0.0,21,21,12,0,0,100.0
2002021118,27,3595,0.0,24,20,2,8,4,83.33333333
2002021119,15,3578,0.0,35,30,3,0,5,85.71428571
2002021119,22,3600,0.0,32,29,3,2,3,90.625
2002021120,6,3725,0.0,33,30,5,0,3,90.90909091
2002021120,26,3718,0.0,24,20,3,0,4,83.33333333
2002021121,24,3693,0.0,24,22,8,1,2,91.66666667
2002021121,28,3693,0.0,24,21,4,1,3,87.5
2002021122,19,3600,0.0,34,31,4,1,3,91.17647059
2002021122,25,3575,0.0,13,12,1,1,1,92.30769231
2002021123,5,3900,0.0,34,33,3,3,1,97.05882353
2002021123,16,3900,0.0,28,27,6,1,1,96.42857143
2002021124,17,3585,2.0,20,17,12,0,3,85.0
2002021124,30,3600,0.0,33,33,8,1,0,100.0
2002021125,18,3728,0.0,18,15,4,2,3,83.33333333
2002021125,22,3725,0.0,34,32,11,1,2,94.11764706
2002021126,15,1200,0.0,9,6,6,0,3,66.66666667
2002021126,15,2397,0.0,23,20,4,0,3,86.95652174
2002021126,23,3583,0.0,14,14,0,1,0,100.0
2002021127,10,3554,0.0,33,30,6,2,3,90.90909091
2002021127,6,3600,0.0,26,24,4,2,2,92.30769231
2002021128,21,3855,0.0,35,31,11,3,4,88.57142857
2002021128,7,3855,0.0,36,33,8,3,3,91.66666667
2002021129,11,3600,0.0,36,30,2,0,6,83.33333333
2002021129,4,3568,0.0,18,16,2,0,2,88.88888889
2002021130,1,3586,0.0,20,19,0,0,1,95.0
2002021130,13,3600,0.0,37,33,4,0,4,89.18918919
2002021131,27,3550,0.0,34,33,8,1,1,97.05882353
2002021131,20,3600,4.0,15,15,2,2,0,100.0
2002021132,29,2135,0.0,16,12,4,1,4,75.0
2002021132,29,1465,0.0,10,9,0,0,1,90.0
2002021132,24,3595,0.0,29,29,1,1,0,100.0
2002021133,14,3600,0.0,35,34,1,0,1,97.14285714
2002021133,28,3598,4.0,42,38,5,1,4,90.47619048
2002021134,21,3861,0.0,39,37,10,0,2,94.87179487
2002021134,9,3900,0.0,20,18,1,1,2,90.0
2002021135,10,3900,0.0,31,28,4,0,3,90.32258065
2002021135,12,3873,0.0,22,19,1,1,3,86.36363636
2002021136,15,3789,0.0,26,23,1,1,3,88.46153846
2002021136,8,3781,2.0,31,27,6,2,4,87.09677419
2002021137,30,3600,2.0,33,29,8,0,4,87.87878788
2002021137,17,3594,0.0,18,18,2,0,0,100.0
2002021138,4,3853,2.0,21,20,2,0,1,95.23809524
2002021138,18,3900,0.0,43,42,9,0,1,97.6744186
2002021139,2,3600,0.0,23,21,2,0,2,91.30434783
2002021139,16,1409,0.0,17,12,1,0,5,70.58823529
2002021139,16,2175,2.0,12,8,1,0,4,66.66666667
2002021140,25,3600,2.0,30,27,3,1,3,90.0
2002021140,23,3563,0.0,34,30,7,1,4,88.23529412
2002021141,29,3850,0.0,34,33,11,2,1,97.05882353
2002021141,26,3755,0.0,22,21,10,2,1,95.45454545
2002021142,13,3396,0.0,26,24,5,1,2,92.30769231
2002021142,13,144,0.0,0,0,0,0,0,
2002021142,7,3600,0.0,30,29,3,2,1,96.66666667
2002021143,5,3600,0.0,34,33,2,0,1,97.05882353
2002021143,3,3527,0.0,23,20,1,0,3,86.95652174
2002021144,12,3597,0.0,18,13,3,0,5,72.22222222
2002021144,11,3600,0.0,30,29,8,0,1,96.66666667
2002021145,19,3600,0.0,31,31,5,0,0,100.0
2002021145,30,3562,0.0,27,26,0,2,1,96.2962963
2002021146,27,3526,0.0,26,22,8,1,4,84.61538462
2002021146,22,3598,0.0,34,31,8,0,3,91.17647059
2002021147,28,3724,0.0,30,27,3,0,3,90.0
2002021147,24,3724,0.0,29,27,0,2,2,93.10344828
2002021148,1,3900,0.0,34,32,5,0,2,94.11764706
2002021148,14,3900,0.0,30,28,4,0,2,93.33333333
2002021149,6,3900,0.0,26,24,2,0,2,92.30769231
2002021149,4,3898,0.0,28,26,1,1,2,92.85714286
2002021150,13,3600,0.0,26,24,1,3,2,92.30769231
2002021150,19,3600,0.0,28,27,6,0,1,96.42857143
2002021151,26,2162,0.0,13,13,0,0,0,100.0
2002021151,26,1370,0.0,9,6,1,0,3,66.66666667
2002021151,21,3600,0.0,26,26,10,0,0,100.0
2002021152,18,3580,0.0,26,22,1,2,4,84.61538462
2002021152,16,3600,2.0,23,22,12,0,1,95.65217391
2002021153,25,3771,0.0,28,26,0,1,2,92.85714286
2002021153,20,3771,0.0,25,24,1,1,1,96.0
2002021154,27,3595,0.0,36,31,7,0,5,86.11111111
2002021154,23,3600,0.0,25,24,1,2,1,96.0
2002021155,17,3544,0.0,16,14,3,1,2,87.5
2002021155,28,3600,0.0,25,25,5,3,0,100.0
2002021156,8,3579,0.0,31,27,3,1,4,87.09677419
2002021156,7,3583,0.0,27,26,2,2,1,96.2962963
2002021157,15,3595,0.0,32,30,5,0,2,93.75
2002021157,9,3529,0.0,18,15,3,0,3,83.33333333
2002021158,10,3600,0.0,39,37,8,1,2,94.87179487
2002021158,2,3543,0.0,21,17,2,1,4,80.95238095
2002021159,1,3900,0.0,18,17,5,0,1,94.44444444
2002021159,11,3900,0.0,44,43,6,2,1,97.72727273
2002021160,16,3674,0.0,33,29,1,0,4,87.87878788
2002021160,30,3653,0.0,25,22,2,0,3,88.0
2002021161,29,3600,0.0,36,32,7,1,4,88.88888889
2002021161,22,3595,2.0,26,26,4,2,0,100.0
2002021162,5,3600,0.0,36,33,1,1,3,91.66666667
2002021162,4,3598,0.0,20,20,3,0,0,100.0
2002021163,3,3600,0.0,32,31,2,3,1,96.875
2002021163,6,3587,0.0,24,21,3,0,3,87.5
2002021164,17,3600,0.0,24,22,8,2,2,91.66666667
2002021164,19,3600,0.0,21,15,4,1,6,71.42857143
2002021165,27,1600,0.0,9,8,1,0,1,88.88888889
2002021165,27,2000,0.0,23,18,6,1,5,78.26086957
2002021165,21,3600,0.0,28,27,5,0,1,96.42857143
2002021166,15,3769,0.0,30,26,6,1,4,86.66666667
2002021166,10,3776,0.0,31,28,3,0,3,90.32258065
2002021167,9,3587,0.0,24,23,2,4,1,95.83333333
2002021167,8,3552,0.0,31,28,3,1,3,90.32258065
2002021168,7,3597,0.0,39,38,8,0,1,97.43589744
2002021168,12,3531,0.0,15,12,6,1,3,80.0
2002021169,13,3900,0.0,40,39,10,2,1,97.5
2002021169,14,3836,0.0,30,29,6,2,1,96.66666667
2002021170,11,3600,0.0,41,39,7,1,2,95.12195122
2002021170,18,3538,0.0,22,19,2,2,3,86.36363636
2002021171,29,3593,0.0,39,35,5,1,4,89.74358974
2002021171,20,3557,0.0,25,20,7,0,5,80.0
2002021172,23,3595,0.0,32,31,10,1,1,96.875
2002021172,26,3600,0.0,34,29,2,3,5,85.29411765
2002021173,25,3600,0.0,27,24,1,0,3,88.88888889
2002021173,28,3528,0.0,38,34,7,0,4,89.47368421
2002021174,2,3600,0.0,30,24,4,0,6,80.0
2002021174,1,3600,0.0,19,19,2,1,0,100.0
2002021175,22,3886,0.0,18,14,1,0,4,77.77777778
2002021175,16,3900,0.0,28,24,4,2,4,85.71428571
2002021176,23,3483,0.0,24,21,3,0,3,87.5
2002021176,24,3600,0.0,42,41,6,1,1,97.61904762
2002021177,14,3900,0.0,35,33,5,0,2,94.28571429
2002021177,6,3900,0.0,17,15,1,0,2,88.23529412
2002021178,8,3600,0.0,33,33,3,1,0,100.0
2002021178,12,3600,0.0,21,17,2,0,4,80.95238095
2002021179,11,3755,0.0,41,38,3,1,3,92.68292683
2002021179,3,3755,0.0,25,21,3,1,4,84.0
2002021180,4,3584,0.0,17,16,3,0,1,94.11764706
2002021180,5,3597,0.0,28,22,1,3,6,78.57142857
2002021181,18,3587,0.0,23,21,2,1,2,91.30434783
2002021181,17,3600,0.0,27,27,5,0,0,100.0
2002021182,22,3900,0.0,30,25,1,0,5,83.33333333
2002021182,19,3900,0.0,30,25,2,0,5,83.33333333
2002021183,20,3594,0.0,16,13,3,1,3,81.25
2002021183,30,3600,0.0,26,26,11,0,0,100.0
2002021184,7,3488,0.0,20,18,2,0,2,90.0
2002021184,25,3593,0.0,18,18,0,1,0,100.0
2002021185,28,3540,0.0,28,25,2,0,3,89.28571429
2002021185,21,3600,0.0,23,22,5,1,1,95.65217391
2002021186,26,3699,0.0,33,29,2,1,4,87.87878788
2002021186,27,3698,0.0,27,22,4,2,5,81.48148148
2002021187,6,3578,0.0,31,28,11,2,3,90.32258065
2002021187,9,3596,0.0,19,17,6,2,2,89.47368421
2002021188,3,3895,0.0,30,28,4,3,2,93.33333333
2002021188,2,3900,0.0,37,35,6,2,2,94.59459459
2002021189,29,3600,0.0,29,25,4,0,4,86.20689655
2002021189,4,3600,0.0,10,10,3,0,0,100.0
2002021190,13,3599,0.0,33,30,3,0,3,90.90909091
2002021190,15,3595,0.0,31,31,1,0,0,100.0
2002021191,10,3762,0.0,39,37,7,2,2,94.87179487
2002021191,1,3753,0.0,24,21,2,4,3,87.5
2002021192,24,3847,0.0,40,39,4,1,1,97.5
2002021192,18,3847,0.0,31,29,5,1,2,93.5483871
2002021193,11,3575,0.0,40,36,6,2,4,90.0
2002021193,7,3598,0.0,23,20,4,1,3,86.95652174
2002021194,8,3581,0.0,31,29,5,0,2,93.5483871
2002021194,14,3598,0.0,27,26,0,1,1,96.2962963
2002021195,30,3600,0.0,24,21,6,4,3,87.5
2002021195,29,3580,0.0,27,27,9,3,0,100.0
2002021196,12,3589,0.0,29,26,4,1,3,89.65517241
2002021196,5,3584,2.0,27,25,5,0,2,92.59259259
2002021197,24,3528,0.0,31,29,7,1,2,93.5483871
2002021197,25,3598,0.0,27,26,6,2,1,96.2962963
2002021198,28,3898,0.0,31,29,11,1,2,93.5483871
2002021198,20,3898,0.0,19,17,3,0,2,89.47368421
2002021199,23,3900,0.0,27,24,4,0,3,88.88888889
2002021199,27,3891,0.0,40,37,8,2,3,92.5
2002021200,21,3584,2.0,22,18,3,1,4,81.81818182
2002021200,26,3600,0.0,33,30,5,1,3,90.90909091
2002021201,9,3600,0.0,28,27,5,0,1,96.42857143
2002021201,15,1178,0.0,9,9,1,0,0,100.0
2002021201,15,2400,0.0,19,14,3,2,5,73.68421053
2002021202,30,3532,0.0,26,24,3,1,2,92.30769231
2002021202,10,3600,0.0,21,20,5,0,1,95.23809524
2002021203,6,3900,0.0,29,28,2,3,1,96.55172414
2002021203,1,3900,0.0,23,22,0,0,1,95.65217391
2002021204,2,3596,2.0,27,22,3,2,5,81.48148148
2002021204,17,3600,0.0,23,21,6,0,2,91.30434783
2002021205,16,3600,0.0,45,41,9,2,4,91.11111111
2002021205,19,1136,0.0,3,2,0,0,1,66.66666667
2002021205,19,2400,0.0,24,19,6,1,5,79.16666667
2002021206,28,3878,0.0,41,38,12,1,3,92.68292683
2002021206,22,3900,0.0,20,17,3,0,3,85.0
2002021207,17,3830,0.0,35,30,13,1,5,85.71428571
2002021207,29,3900,0.0,35,30,7,2,5,85.71428571
2002021208,1,3600,0.0,19,18,1,0,1,94.73684211
2002021208,3,3527,0.0,41,39,6,0,2,95.12195122
2002021209,4,3600,0.0,28,27,5,2,1,96.42857143
2002021209,14,2394,0.0,17,13,1,3,4,76.47058824
2002021209,14,1200,0.0,10,10,2,0,0,100.0
2002021210,12,3596,0.0,26,22,7,3,4,84.61538462
2002021210,13,3592,0.0,35,34,9,0,1,97.14285714
2002021211,19,3897,0.0,28,26,2,1,2,92.85714286
2002021211,16,3895,0.0,29,27,4,1,2,93.10344828
2002021212,26,3733,0.0,26,24,4,0,2,92.30769231
2002021212,20,3733,0.0,31,30,6,1,1,96.77419355
2002021213,18,3550,0.0,27,26,0,1,1,96.2962963
2002021213,27,3600,0.0,24,24,1,0,0,100.0
2002021214,21,3890,2.0,22,19,4,5,3,86.36363636
2002021214,24,3885,0.0,37,33,8,3,4,89.18918919
2002021215,7,3600,0.0,37,29,6,0,8,78.37837838
2002021215,6,1200,0.0,7,5,2,0,2,71.42857143
2002021215,6,2400,0.0,18,15,0,2,3,83.33333333
2002021216,11,3596,0.0,30,28,10,1,2,93.33333333
2002021216,2,3565,0.0,19,16,4,0,3,84.21052632
2002021217,9,3600,0.0,24,23,1,0,1,95.83333333
2002021217,10,3593,0.0,30,27,3,1,3,90.0
2002021218,3,3560,0.0,23,19,3,0,4,82.60869565
2002021218,8,3571,0.0,38,34,3,2,4,89.47368421
2002021219,5,3583,0.0,35,31,6,2,4,88.57142857
2002021219,15,3596,0.0,25,22,5,0,3,88.0
2002021220,20,3600,0.0,24,23,7,3,1,95.83333333
2002021220,22,3600,0.0,36,32,10,0,4,88.88888889
2002021221,2,3600,4.0,45,44,15,0,1,97.77777778
2002021221,12,3535,0.0,14,12,2,0,2,85.71428571
2002021222,17,3730,0.0,30,26,1,2,4,86.66666667
2002021222,16,3721,0.0,35,32,6,4,3,91.42857143
2002021223,1,3883,0.0,30,28,4,4,2,93.33333333
2002021223,7,3896,0.0,30,28,5,2,2,93.33333333
2002021224,29,3567,2.0,23,19,0,0,4,82.60869565
2002021224,30,3587,0.0,20,17,1,0,3,85.0
2002021225,14,3600,2.0,41,35,7,0,6,85.36585366
2002021225,11,3600,0.0,21,19,0,0,2,90.47619048
2002021226,4,3600,0.0,27,25,11,0,2,92.59259259
2002021226,13,3600,0.0,39,33,7,5,6,84.61538462
2002021227,18,3483,2.0,17,15,0,0,2,88.23529412
2002021227,25,3585,2.0,21,21,3,0,0,100.0
2002021228,19,3563,0.0,28,24,1,0,4,85.71428571
2002021228,21,3600,0.0,27,25,1,3,2,92.59259259
2002021229,26,3598,0.0,27,27,9,0,0,100.0
2002021229,23,3544,0.0,25,24,2,2,1,96.0
2002021230,27,3900,0.0,44,41,10,1,3,93.18181818
2002021230,28,3888,0.0,25,22,2,3,3,88.0
2003020001,1,3900,2.0,31,28,9,1,3,90.32258065
2003020001,6,3900,0.0,35,32,4,0,3,91.42857143
2003020002,24,3600,0.0,22,18,1,2,4,81.81818182
2003020002,25,3593,0.0,21,20,3,0,1,95.23809524
2003020003,30,3541,0.0,22,21,3,1,1,95.45454545
2003020003,16,3600,0.0,33,33,6,2,0,100.0
2003020004,8,3598,0.0,28,23,2,0,5,82.14285714
2003020004,9,3575,0.0,29,27,7,0,2,93.10344828
2003020005,7,3501,0.0,26,24,4,5,2,92.30769231
2003020005,4,3600,0.0,17,17,3,0,0,100.0
2003020006,2,1584,0.0,26,20,8,1,6,76.92307692
2003020006,2,1992,0.0,11,11,6,0,0,100.0
2003020006,15,3584,0.0,18,17,1,2,1,94.44444444
2003020007,29,3557,0.0,27,25,12,0,2,92.59259259
2003020007,11,3600,0.0,27,26,5,4,1,96.2962963
2003020008,12,3490,0.0,25,23,5,0,2,92.0
2003020008,13,3600,0.0,32,31,5,0,1,96.875
2003020009,26,3600,0.0,38,35,11,1,3,92.10526316
2003020009,17,3595,0.0,23,21,4,2,2,91.30434783
2003020010,24,3520,0.0,26,23,1,2,3,88.46153846
2003020010,18,3597,0.0,29,28,5,5,1,96.55172414
2003020011,28,3600,0.0,28,23,1,1,5,82.14285714
2003020011,22,3600,0.0,21,19,1,1,2,90.47619048
2003020012,20,3600,0.0,26,22,8,0,4,84.61538462
2003020012,23,3600,0.0,23,22,3,2,1,95.65217391
2003020013,26,3596,0.0,11,11,0,1,0,100.0
2003020013,5,3570,0.0,48,46,22,0,2,95.83333333
2003020014,6,1200,0.0,5,4,0,1,1,80.0
2003020014,6,2400,0.0,20,16,5,0,4,80.0
2003020014,14,3600,2.0,30,29,1,1,1,96.66666667
2003020015,3,3599,0.0,19,14,3,1,5,73.68421053
2003020015,30,3584,0.0,28,25,10,0,3,89.28571429
2003020016,16,3600,0.0,29,24,2,1,5,82.75862069
2003020016,21,3600,0.0,31,31,6,1,0,100.0
2003020017,19,3876,0.0,21,19,4,2,2,90.47619048
2003020017,27,3878,0.0,24,23,6,0,1,95.83333333
2003020018,2,3600,0.0,13,13,2,0,0,100.0
2003020018,7,3600,0.0,24,18,2,0,6,75.0
2003020019,8,3600,0.0,21,21,2,2,0,100.0
2003020019,10,3600,0.0,22,18,8,0,4,81.81818182
2003020020,17,3767,0.0,23,21,7,0,2,91.30434783
2003020020,9,3761,0.0,19,16,9,1,3,84.21052632
2003020021,5,3879,0.0,35,32,7,2,3,91.42857143
2003020021,4,3900,0.0,23,20,6,0,3,86.95652174
2003020022,11,3594,0.0,30,27,7,0,3,90.0
2003020022,15,3553,0.0,19,15,2,2,4,78.94736842
2003020023,1,3579,0.0,31,30,2,2,1,96.77419355
2003020023,12,3537,0.0,22,20,6,3,2,90.90909091
2003020024,3,3582,0.0,36,31,22,0,5,86.11111111
2003020024,29,3554,0.0,25,25,6,2,0,100.0
2003020025,6,3900,0.0,35,34,4,1,1,97.14285714
2003020025,13,3893,0.0,33,32,1,2,1,96.96969697
2003020026,25,3590,10.0,25,24,8,0,1,96.0
2003020026,18,3489,0.0,30,27,3,2,3,90.0
2003020027,28,3555,0.0,20,17,4,0,3,85.0
2003020027,20,1363,0.0,10,8,1,0,2,80.0
2003020028,22,3600,0.0,22,19,5,1,3,86.36363636
2003020028,23,3599,0.0,14,14,2,0,0,100.0
2003020029,26,3598,0.0,34,32,1,3,2,94.11764706
2003020029,16,3575,0.0,26,22,5,3,4,84.61538462
2003020030,28,3600,0.0,25,23,2,2,2,92.0
2003020030,30,2338,0.0,15,15,0,0,0,100.0
2003020030,30,1200,0.0,13,10,2,0,3,76.92307692
2003020031,27,3600,2.0,31,31,3,0,0,100.0
2003020031,24,3547,0.0,27,26,5,1,1,96.2962963
2003020032,19,3600,0.0,40,39,14,2,1,97.5
2003020032,21,3485,0.0,26,24,7,1,2,92.30769231
2003020033,25,1115,0.0,6,6,0,0,0,100.0
2003020033,25,2395,0.0,15,11,1,1,4,73.33333333
2003020033,7,3600,0.0,21,18,8,0,3,85.71428571
2003020034,13,3900,0.0,35,33,12,0,2,94.28571429
2003020034,12,3900,0.0,20,18,8,0,2,90.0
2003020035,23,3547,2.0,26,23,4,1,3,88.46153846
2003020035,29,3600,0.0,29,27,3,0,2,93.10344828
2003020036,15,3896,0.0,36,34,15,0,2,94.44444444
2003020036,10,3900,0.0,18,16,1,2,2,88.88888889
2003020037,15,3600,0.0,30,25,3,1,5,83.33333333
2003020037,8,3600,0.0,17,16,5,2,1,94.11764706
2003020038,2,3900,0.0,23,21,3,0,2,91.30434783
2003020038,11,3900,0.0,25,23,4,1,2,92.0
2003020039,22,3539,0.0,15,14,4,1,1,93.33333333
2003020039,20,3600,0.0,19,19,3,0,0,100.0
2003020040,27,3599,0.0,30,29,6,4,1,96.66666667
2003020040,13,3523,0.0,36,34,9,1,2,94.44444444
2003020041,6,3600,0.0,27,27,9,0,0,100.0
2003020041,25,3541,0.0,12,11,1,1,1,91.66666667
2003020042,9,3600,0.0,27,23,8,1,4,85.18518519
2003020042,26,3598,0.0,16,13,3,0,3,81.25
2003020043,11,3884,0.0,29,29,8,0,0,100.0
2003020043,3,3898,0.0,30,30,11,0,0,100.0
2003020044,27,3600,0.0,31,26,5,1,5,83.87096774
2003020044,14,3595,0.0,21,20,4,2,1,95.23809524
2003020045,16,3529,0.0,36,34,14,1,2,94.44444444
2003020045,29,3593,0.0,31,30,3,0,1,96.77419355
2003020046,5,3597,0.0,32,28,4,1,4,87.5
2003020046,8,3600,0.0,23,22,8,0,1,95.65217391
2003020047,10,3900,0.0,33,31,6,0,2,93.93939394
2003020047,1,3828,0.0,14,12,2,2,2,85.71428571
2003020048,23,3563,0.0,31,28,5,1,3,90.32258065
2003020048,17,3600,0.0,38,36,11,0,2,94.73684211
2003020049,21,3600,0.0,23,21,4,0,2,91.30434783
2003020049,30,3600,0.0,31,26,0,0,5,83.87096774
2003020050,19,3571,0.0,23,20,5,2,3,86.95652174
2003020050,18,3598,0.0,31,30,11,0,1,96.77419355
2003020051,7,3501,0.0,32,29,5,6,3,90.625
2003020051,22,3595,0.0,32,31,5,5,1,96.875
2003020052,4,3900,0.0,27,27,10,1,0,100.0
2003020052,28,3889,2.0,26,26,6,0,0,100.0
2003020053,15,3567,0.0,18,14,6,0,4,77.77777778
2003020053,25,3561,0.0,25,23,10,0,2,92.0
2003020054,9,3600,0.0,27,27,6,2,0,100.0
2003020054,24,3581,0.0,27,25,2,1,2,92.59259259
2003020055,10,3600,0.0,15,15,2,1,0,100.0
2003020055,8,3554,0.0,25,24,6,1,1,96.0
2003020056,13,3544,0.0,46,44,11,3,2,95.65217391
2003020056,2,3597,0.0,21,20,4,0,1,95.23809524
2003020057,12,3900,0.0,28,26,4,2,2,92.85714286
2003020057,3,3900,0.0,31,29,8,1,2,93.5483871
2003020058,16,1590,0.0,16,14,9,1,2,87.5
2003020058,16,2010,0.0,28,23,3,0,5,82.14285714
2003020058,11,3552,0.0,26,24,1,1,2,92.30769231
2003020059,14,3600,0.0,31,29,5,1,2,93.5483871
2003020059,1,3542,0.0,23,20,3,2,3,86.95652174
2003020060,17,3523,0.0,17,13,4,1,4,76.47058824
2003020060,5,3600,0.0,34,31,6,6,3,91.17647059
2003020061,15,3600,0.0,27,23,7,1,4,85.18518519
2003020061,19,1200,0.0,4,4,0,0,0,100.0
2003020061,19,2381,0.0,10,9,5,1,1,90.0
2003020062,29,3503,0.0,33,30,7,1,3,90.90909091
2003020062,18,3600,0.0,28,26,6,0,2,92.85714286
2003020063,23,3898,0.0,18,16,4,0,2,88.88888889
2003020063,30,3900,2.0,24,22,2,0,2,91.66666667
2003020064,7,3572,0.0,20,20,9,2,0,100.0
2003020064,20,3531,0.0,18,16,6,0,2,88.88888889
2003020065,21,3549,0.0,24,19,10,1,5,79.16666667
2003020065,22,3591,0.0,34,31,11,1,3,91.17647059
2003020066,4,3600,0.0,23,19,8,1,4,82.60869565
2003020066,27,3544,4.0,35,30,15,2,5,85.71428571
2003020067,6,3596,0.0,18,15,9,0,3,83.33333333
2003020067,26,3553,0.0,27,23,9,1,4,85.18518519
2003020068,9,3600,0.0,29,28,10,1,1,96.55172414
2003020068,28,3594,0.0,23,19,3,1,4,82.60869565
2003020069,18,3437,0.0,31,28,10,1,3,90.32258065
2003020069,16,3594,0.0,22,21,9,1,1,95.45454545
2003020070,30,3600,0.0,30,27,4,1,3,90.0
2003020070,25,3591,0.0,11,10,0,0,1,90.90909091
2003020071,6,3848,0.0,29,26,1,0,3,89.65517241
2003020071,24,3848,0.0,30,26,0,0,4,86.66666667
2003020072,10,2213,0.0,6,5,1,0,1,83.33333333
2003020072,10,1377,0.0,9,5,0,0,4,55.55555556
2003020072,2,3600,0.0,26,24,3,1,2,92.30769231
2003020073,13,3592,0.0,27,25,6,0,2,92.59259259
2003020073,3,3592,0.0,35,34,9,0,1,97.14285714
2003020074,17,3540,0.0,15,13,6,0,2,86.66666667
2003020074,8,3600,0.0,19,18,2,0,1,94.73684211
2003020075,7,1200,0.0,8,5,0,0,3,62.5
2003020075,7,2386,0.0,21,18,4,0,3,85.71428571
2003020075,23,3576,0.0,18,17,4,1,1,94.44444444
2003020076,11,3779,0.0,23,20,6,1,3,86.95652174
2003020076,14,3808,0.0,37,35,5,3,2,94.59459459
2003020077,30,3577,0.0,27,24,3,2,3,88.88888889
2003020078,6,3600,0.0,27,26,3,0,1,96.2962963
2003020078,21,3572,0.0,34,30,7,2,4,88.23529412
2003020079,19,852,0.0,6,3,0,0,3,50.0
2003020079,19,2735,0.0,18,17,5,0,1,94.44444444
2003020079,22,2275,0.0,19,14,1,0,5,73.68421053
2003020079,22,1222,0.0,2,2,0,0,0,100.0
2003020080,4,3598,0.0,25,21,5,0,4,84.0
2003020080,26,3597,0.0,22,22,7,0,0,100.0
2003020081,24,3600,0.0,34,34,7,2,0,100.0
2003020081,28,3512,0.0,27,25,6,2,2,92.59259259
2003020082,13,3600,0.0,33,32,7,0,1,96.96969697
2003020082,1,3541,0.0,23,21,5,1,2,91.30434783
2003020083,12,3900,2.0,23,22,6,1,1,95.65217391
2003020083,5,3900,0.0,36,35,13,1,1,97.22222222
2003020084,29,3600,0.0,28,24,1,2,4,85.71428571
2003020084,17,3599,0.0,19,18,4,0,1,94.73684211
2003020085,10,3600,0.0,16,15,1,1,1,93.75
2003020085,25,3553,0.0,23,21,11,0,2,91.30434783
2003020086,19,3576,0.0,28,25,7,1,3,89.28571429
2003020086,23,3598,0.0,22,20,7,1,2,90.90909091
2003020087,4,3601,0.0,29,25,8,1,4,86.20689655
2003020087,24,3625,0.0,35,32,5,1,3,91.42857143
2003020088,14,3600,0.0,20,20,3,0,0,100.0
2003020088,29,3515,0.0,28,27,6,1,1,96.42857143
2003020089,12,3600,0.0,18,18,5,0,0,100.0
2003020089,6,3503,0.0,32,30,4,1,2,93.75
2003020090,2,3599,0.0,21,18,1,0,3,85.71428571
2003020090,8,3600,0.0,34,34,5,2,0,100.0
2003020091,15,820,0.0,13,13,2,1,0,100.0
2003020091,15,2780,0.0,22,17,3,0,5,77.27272727
2003020091,9,3595,0.0,18,17,6,0,1,94.44444444
2003020092,18,3498,0.0,19,16,5,2,3,84.21052632
2003020092,11,3600,0.0,30,28,9,3,2,93.33333333
2003020093,22,2229,0.0,21,17,11,1,4,80.95238095
2003020093,22,1367,0.0,13,11,1,0,2,84.61538462
2003020093,21,3600,0.0,34,33,3,4,1,97.05882353
2003020094,10,3596,0.0,33,29,12,2,4,87.87878788
2003020094,27,3545,0.0,23,18,5,2,5,78.26086957
2003020095,7,3590,0.0,26,25,7,0,1,96.15384615
2003020095,26,3513,0.0,34,30,6,2,4,88.23529412
2003020096,16,3900,0.0,37,34,3,2,3,91.89189189
2003020096,28,3900,0.0,36,33,15,3,3,91.66666667
2003020097,1,3600,0.0,18,17,3,0,1,94.44444444
2003020097,5,3539,0.0,34,32,6,2,2,94.11764706
2003020098,30,3597,0.0,33,30,6,3,3,90.90909091
2003020098,13,3578,0.0,40,36,14,0,4,90.0
2003020099,25,3593,0.0,23,19,1,0,4,82.60869565
2003020099,17,3600,0.0,22,22,5,0,0,100.0
2003020100,19,3600,0.0,26,25,3,2,1,96.15384615
2003020101,7,3598,0.0,36,34,4,0,2,94.44444444
2003020101,24,3600,0.0,37,32,1,0,5,86.48648649
2003020102,15,3548,0.0,21,18,6,4,3,85.71428571
2003020102,10,3600,0.0,40,39,17,2,1,97.5
2003020103,9,3588,0.0,25,23,8,0,2,92.0
2003020103,8,3598,0.0,31,25,5,4,6,80.64516129
2003020104,5,3600,2.0,38,31,6,0,7,81.57894737
2003020104,2,3600,0.0,21,19,0,1,2,90.47619048
2003020105,17,3560,2.0,31,29,5,0,2,93.5483871
2003020105,3,3600,0.0,24,23,2,0,1,95.83333333
2003020106,12,3900,0.0,32,28,1,1,4,87.5
2003020106,4,3898,0.0,35,31,2,0,4,88.57142857
2003020107,13,3600,0.0,35,33,5,0,2,94.28571429
2003020107,11,3523,2.0,25,22,0,1,3,88.0
2003020108,25,3600,0.0,27,25,9,0,2,92.59259259
2003020108,29,3564,0.0,34,31,0,0,3,91.17647059
2003020109,6,3600,0.0,33,31,4,2,2,93.93939394
2003020109,1,3600,0.0,26,21,2,0,5,80.76923077
2003020110,30,3565,0.0,29,26,12,2,3,89.65517241
2003020110,14,3600,0.0,21,19,3,0,2,90.47619048
2003020111,21,3600,0.0,19,16,4,0,3,84.21052632
2003020111,18,3570,0.0,31,27,3,0,4,87.09677419
2003020112,20,3600,0.0,18,16,2,2,2,88.88888889
2003020112,22,3535,2.0,21,17,2,3,4,80.95238095
2003020113,16,3581,0.0,46,44,10,1,2,95.65217391
2003020113,26,3488,0.0,24,21,4,0,3,87.5
2003020114,27,3900,2.0,45,41,7,1,4,91.11111111
2003020114,28,3900,0.0,35,31,1,0,4,88.57142857
2003020115,16,3900,0.0,32,31,5,2,1,96.875
2003020115,24,3900,0.0,26,25,5,1,1,96.15384615
2003020116,7,3591,0.0,33,32,12,2,1,96.96969697
2003020116,21,3550,0.0,20,18,4,0,2,90.0
2003020117,27,3900,0.0,31,28,8,0,3,90.32258065
2003020117,23,3900,0.0,21,18,1,2,3,85.71428571
2003020118,8,3600,0.0,39,34,3,3,5,87.17948718
2003020118,4,3590,0.0,20,20,1,0,0,100.0
2003020119,11,3880,0.0,27,25,6,1,2,92.59259259
2003020119,10,3885,2.0,27,24,10,0,3,88.88888889
2003020120,30,3600,0.0,33,32,2,1,1,96.96969697
2003020120,7,3530,0.0,21,18,4,0,3,85.71428571
2003020121,6,3591,0.0,23,23,5,0,0,100.0
2003020121,8,3600,0.0,33,31,2,0,2,93.93939394
2003020122,1,3600,0.0,25,25,2,2,0,100.0
2003020122,2,3600,2.0,27,23,1,1,4,85.18518519
2003020123,28,3596,0.0,28,25,11,0,3,89.28571429
2003020123,12,3600,0.0,28,28,9,4,0,100.0
2003020124,24,3598,0.0,39,38,1,2,1,97.43589744
2003020124,3,3544,0.0,22,19,2,2,3,86.36363636
2003020125,18,3521,0.0,18,17,6,0,1,94.44444444
2003020125,19,3600,0.0,26,26,5,1,0,100.0
2003020126,16,3884,0.0,37,35,8,2,2,94.59459459
2003020126,27,3898,0.0,28,26,12,1,2,92.85714286
2003020127,20,3572,0.0,18,15,2,1,3,83.33333333
2003020127,21,3600,0.0,28,26,5,0,2,92.85714286
2003020128,29,3600,0.0,28,22,2,1,6,78.57142857
2003020128,23,3600,0.0,19,16,1,0,3,84.21052632
2003020129,13,548,0.0,5,3,0,0,2,60.0
2003020129,13,3047,4.0,25,22,7,1,3,88.0
2003020129,4,3594,2.0,22,21,5,0,1,95.45454545
2003020130,24,3600,0.0,25,23,6,0,2,92.0
2003020130,15,3494,0.0,31,27,0,2,4,87.09677419
2003020131,2,3900,0.0,24,20,6,0,4,83.33333333
2003020131,5,3892,0.0,39,35,2,8,4,89.74358974
2003020132,19,3600,0.0,50,45,13,3,5,90.0
2003020132,17,2012,0.0,21,19,2,0,2,90.47619048
2003020132,17,1486,0.0,13,9,1,0,4,69.23076923
2003020133,20,3605,0.0,28,24,7,0,4,85.71428571
2003020133,25,2038,0.0,6,6,0,0,0,100.0
2003020133,25,1579,0.0,11,8,1,0,3,72.72727273
2003020134,8,3699,0.0,21,21,0,1,0,100.0
2003020134,6,3699,0.0,38,37,5,1,1,97.36842105
2003020135,10,3539,0.0,35,31,7,0,4,88.57142857
2003020135,7,3600,0.0,21,18,2,0,3,85.71428571
2003020136,12,3584,0.0,26,22,5,1,4,84.61538462
2003020136,3,3600,0.0,30,29,3,1,1,96.66666667
2003020137,28,3900,0.0,35,33,10,2,2,94.28571429
2003020137,14,3896,2.0,27,25,9,2,2,92.59259259
2003020138,13,3600,0.0,32,30,7,2,2,93.75
2003020138,9,3551,0.0,22,19,8,1,3,86.36363636
2003020139,4,3550,0.0,28,25,7,1,3,89.28571429
2003020139,1,3600,0.0,16,14,2,0,2,87.5
2003020140,17,3577,0.0,23,19,8,1,4,82.60869565
2003020140,18,3600,0.0,27,24,6,0,3,88.88888889
2003020141,11,3516,2.0,24,21,2,0,3,87.5
2003020141,30,3600,0.0,23,21,2,1,2,91.30434783
2003020142,5,3600,0.0,20,20,3,1,0,100.0
2003020142,16,3548,0.0,19,18,3,1,1,94.73684211
2003020143,29,3749,0.0,41,37,6,2,4,90.24390244
2003020143,22,3749,0.0,22,19,2,2,3,86.36363636
2003020144,23,3600,0.0,38,37,3,0,1,97.36842105
2003020144,26,1707,0.0,7,5,0,0,2,71.42857143
2003020144,26,1785,0.0,8,7,0,0,1,87.5
2003020145,11,3556,0.0,38,36,6,1,2,94.73684211
2003020145,15,3600,0.0,20,19,6,1,1,95.0
2003020146,23,3596,0.0,24,23,7,2,1,95.83333333
2003020146,27,3600,0.0,31,27,8,4,4,87.09677419
2003020147,21,3519,0.0,31,27,6,0,4,87.09677419
2003020147,1,3600,0.0,23,20,4,0,3,86.95652174
2003020148,24,2110,0.0,12,11,5,0,1,91.66666667
2003020148,24,1490,0.0,8,5,2,0,3,62.5
2003020148,2,3590,0.0,18,17,5,0,1,94.44444444
2003020149,6,3730,0.0,28,25,3,3,3,89.28571429
2003020149,5,3730,0.0,32,30,1,0,2,93.75
2003020150,4,3597,0.0,22,21,6,0,1,95.45454545
2003020150,10,3595,0.0,22,15,1,0,7,68.18181818
2003020151,3,3600,0.0,35,34,13,5,1,97.14285714
2003020151,8,3591,0.0,27,22,2,2,5,81.48148148
2003020152,7,3900,2.0,35,34,9,2,1,97.14285714
2003020152,9,3882,0.0,38,37,6,1,1,97.36842105
2003020153,12,3581,0.0,28,24,5,0,4,85.71428571
2003020153,14,3600,2.0,36,33,7,1,3,91.66666667
2003020154,28,3600,0.0,29,27,8,0,2,93.10344828
2003020154,13,3594,0.0,20,14,5,1,6,70.0
2003020155,16,3600,0.0,33,31,6,1,2,93.93939394
2003020155,19,3533,0.0,19,16,3,1,3,84.21052632
2003020156,25,3895,2.0,26,25,2,0,1,96.15384615
2003020156,18,3900,0.0,28,27,0,1,1,96.42857143
2003020157,15,3582,0.0,25,23,4,1,2,92.0
2003020157,30,3583,0.0,16,15,0,1,1,93.75
2003020158,29,3558,0.0,33,31,2,4,2,93.93939394
2003020158,20,3600,0.0,15,15,1,0,0,100.0
2003020159,17,3900,0.0,33,29,4,0,4,87.87878788
2003020159,22,3900,0.0,31,27,2,1,4,87.09677419
2003020160,27,1200,0.0,7,5,0,1,2,71.42857143
2003020160,27,2400,0.0,18,13,6,1,5,72.22222222
2003020160,26,3600,0.0,25,22,11,1,3,88.0
2003020161,21,3669,0.0,24,22,7,1,2,91.66666667
2003020161,3,3674,0.0,38,35,9,0,3,92.10526316
2003020162,10,3600,0.0,25,24,7,2,1,96.0
2003020162,12,3549,0.0,18,16,7,0,2,88.88888889
2003020163,28,3900,0.0,26,24,4,0,2,92.30769231
2003020163,11,3900,0.0,35,33,5,0,2,94.28571429
2003020164,24,3491,0.0,25,22,5,1,3,88.0
2003020164,16,3594,0.0,30,29,2,2,1,96.66666667
2003020165,18,871,0.0,11,10,3,0,1,90.90909091
2003020165,18,2724,0.0,22,16,5,0,6,72.72727273
2003020165,25,3600,0.0,24,21,6,0,3,87.5
2003020166,9,3455,0.0,25,20,2,0,5,80.0
2003020166,2,3600,0.0,32,29,9,0,3,90.625
2003020167,17,3594,0.0,25,20,1,0,5,80.0
2003020167,23,3600,0.0,23,22,2,0,1,95.65217391
2003020168,25,3529,0.0,17,15,0,0,2,88.23529412
2003020168,3,3595,0.0,30,30,2,0,0,100.0
2003020169,15,3600,0.0,42,41,13,0,1,97.61904762
2003020169,14,1720,2.0,11,7,0,0,4,63.63636364
2003020169,14,1864,0.0,12,11,2,1,1,91.66666667
2003020170,5,3538,0.0,38,34,7,1,4,89.47368421
2003020170,10,3600,0.0,24,22,10,1,2,91.66666667
2003020171,22,3597,0.0,28,26,11,1,2,92.85714286
2003020171,8,3558,0.0,17,13,1,2,4,76.47058824
2003020172,24,3865,0.0,32,30,4,1,2,93.75
2003020172,19,3869,0.0,25,24,5,1,1,96.0
2003020173,30,3888,0.0,36,32,2,0,4,88.88888889
2003020173,21,1500,0.0,10,10,2,0,0,100.0
2003020173,21,2400,0.0,14,10,1,0,4,71.42857143
2003020174,17,3600,0.0,21,21,1,3,0,100.0
2003020174,20,2400,0.0,18,16,1,0,2,88.88888889
2003020174,20,1197,0.0,7,6,4,0,1,85.71428571
2003020175,11,3600,0.0,32,28,5,1,4,87.5
2003020175,7,384,0.0,1,1,0,0,0,100.0
2003020175,7,3200,0.0,21,14,3,1,7,66.66666667
2003020176,28,3857,2.0,32,29,3,0,3,90.625
2003020176,1,3857,0.0,15,13,0,1,2,86.66666667
2003020177,26,3598,0.0,26,24,6,3,2,92.30769231
2003020177,13,3540,0.0,35,32,6,0,3,91.42857143
2003020178,23,3597,0.0,26,23,4,1,3,88.46153846
2003020178,18,3503,0.0,24,20,7,0,4,83.33333333
2003020179,25,3571,0.0,22,19,2,1,3,86.36363636
2003020179,2,3600,0.0,28,27,6,0,1,96.42857143
2003020180,15,3496,0.0,36,32,11,0,4,88.88888889
2003020180,4,3599,0.0,22,20,3,1,2,90.90909091
2003020181,3,3582,0.0,33,28,10,0,5,84.84848485
2003020181,12,3600,0.0,32,29,6,2,3,90.625
2003020182,26,3892,0.0,30,30,1,0,0,100.0
2003020182,14,3892,0.0,20,19,0,1,1,95.0
2003020183,28,3900,0.0,52,47,8,0,5,90.38461538
2003020183,6,3854,0.0,23,18,1,1,5,78.26086957
2003020184,22,3900,0.0,34,31,1,1,3,91.17647059
2003020184,9,3900,0.0,36,33,8,0,3,91.66666667
2003020185,23,3516,2.0,31,28,2,1,3,90.32258065
2003020185,19,3600,0.0,29,27,6,2,2,93.10344828
2003020186,27,3566,0.0,31,29,9,3,2,93.5483871
2003020186,21,3589,0.0,28,27,10,0,1,96.42857143
2003020187,11,3584,0.0,22,19,3,0,3,86.36363636
2003020187,29,3600,0.0,14,12,0,0,2,85.71428571
2003020188,10,3893,2.0,22,21,3,0,1,95.45454545
2003020188,1,3900,0.0,28,27,8,1,1,96.42857143
2003020189,5,3486,0.0,45,40,2,1,5,88.88888889
2003020189,13,3600,0.0,21,18,4,1,3,85.71428571
2003020190,8,3538,0.0,17,15,1,0,2,88.23529412
2003020190,7,3600,0.0,37,36,4,0,1,97.2972973
2003020191,16,3600,0.0,32,31,6,6,1,96.875
2003020191,18,3573,0.0,24,23,4,1,1,95.83333333
2003020192,30,3600,0.0,34,34,5,1,0,100.0
2003020192,20,3575,0.0,20,17,9,0,3,85.0
2003020193,4,3660,0.0,22,21,1,0,1,95.45454545
2003020193,3,3659,0.0,32,30,0,1,2,93.75
2003020194,25,3600,0.0,33,29,3,0,4,87.87878788
2003020194,6,3600,0.0,28,27,0,0,1,96.42857143
2003020195,22,1425,0.0,8,5,0,1,3,62.5
2003020195,22,2161,0.0,14,14,1,1,0,100.0
2003020195,10,3600,0.0,35,34,10,0,1,97.14285714
2003020196,7,3584,0.0,27,24,6,3,3,88.88888889
2003020196,8,3600,0.0,16,16,2,3,0,100.0
2003020197,1,3600,0.0,26,26,1,1,0,100.0
2003020197,9,3535,0.0,20,19,2,2,1,95.0
2003020198,11,3600,2.0,30,27,6,0,3,90.0
2003020198,2,3540,0.0,23,19,7,1,4,82.60869565
2003020199,28,3599,0.0,34,32,6,0,2,94.11764706
2003020199,15,3543,0.0,29,26,1,1,3,89.65517241
2003020200,26,3724,0.0,17,14,2,0,3,82.35294118
2003020200,12,3754,0.0,35,33,11,0,2,94.28571429
2003020201,5,680,0.0,5,4,0,0,1,80.0
2003020201,5,2920,0.0,37,29,12,2,8,78.37837838
2003020201,14,3600,0.0,15,15,4,1,0,100.0
2003020202,18,3589,0.0,31,28,6,1,3,90.32258065
2003020202,17,3560,0.0,31,27,12,0,4,87.09677419
2003020203,13,2400,0.0,22,20,6,0,2,90.90909091
2003020203,13,1102,0.0,6,6,1,0,0,100.0
2003020203,19,3600,0.0,21,21,0,1,0,100.0
2003020204,24,3680,0.0,35,31,3,1,4,88.57142857
2003020204,27,3667,0.0,26,23,4,2,3,88.46153846
2003020205,30,1173,0.0,8,5,1,0,3,62.5
2003020205,30,2352,0.0,19,18,3,0,1,94.73684211
2003020205,23,3600,0.0,29,26,8,0,3,89.65517241
2003020206,20,1821,0.0,19,16,7,1,3,84.21052632
2003020206,20,1720,0.0,9,8,3,1,1,88.88888889
2003020206,29,3600,0.0,45,42,7,4,3,93.33333333
2003020207,14,3900,0.0,39,38,5,0,1,97.43589744
2003020207,12,3898,0.0,26,25,0,0,1,96.15384615
2003020208,21,3894,0.0,27,24,2,1,3,88.88888889
2003020208,16,3891,0.0,33,29,4,0,4,87.87878788
2003020209,27,2620,0.0,29,28,1,0,1,96.55172414
2003020209,27,1200,0.0,17,16,4,1,1,94.11764706
2003020209,24,3818,0.0,28,27,5,3,1,96.42857143
2003020210,22,3600,0.0,36,32,4,0,4,88.88888889
2003020210,3,3555,0.0,28,23,0,1,5,82.14285714
2003020211,26,3600,0.0,25,23,1,1,2,92.0
2003020211,15,3547,0.0,30,27,5,1,3,90.0
2003020212,16,3600,0.0,31,28,4,1,3,90.32258065
2003020213,22,3571,0.0,39,35,8,3,4,89.74358974
2003020213,6,3600,0.0,34,31,8,1,3,91.17647059
2003020214,29,3900,0.0,31,30,4,0,1,96.77419355
2003020214,8,3900,0.0,36,35,3,2,1,97.22222222
2003020215,2,3510,0.0,33,31,0,0,2,93.93939394
2003020215,4,3600,0.0,24,23,0,0,1,95.83333333
2003020216,9,3600,0.0,25,22,3,0,3,88.0
2003020216,11,3587,0.0,28,24,0,0,4,85.71428571
2003020217,14,3593,0.0,29,25,3,6,4,86.20689655
2003020217,13,3600,0.0,26,26,5,1,0,100.0
2003020218,23,3516,0.0,24,23,1,1,1,95.83333333
2003020218,30,3587,0.0,29,29,3,1,0,100.0
2003020219,21,3600,0.0,29,26,2,0,3,89.65517241
2003020219,28,3552,0.0,31,27,9,0,4,87.09677419
2003020220,1,3900,0.0,28,26,5,2,2,92.85714286
2003020220,7,3894,2.0,35,33,12,2,2,94.28571429
2003020221,5,3600,0.0,42,36,6,1,6,85.71428571
2003020221,3,3600,0.0,29,27,10,1,2,93.10344828
2003020222,12,2614,0.0,17,13,2,0,4,76.47058824
2003020222,12,986,0.0,15,12,9,0,3,80.0
2003020222,15,3600,0.0,30,29,7,2,1,96.66666667
2003020223,20,3600,0.0,33,31,6,0,2,93.93939394
2003020223,16,1858,0.0,12,11,7,0,1,91.66666667
2003020223,16,1739,0.0,21,16,1,1,5,76.19047619
2003020224,17,3600,0.0,18,16,0,1,2,88.88888889
2003020224,25,3588,0.0,27,21,3,1,6,77.77777778
2003020225,10,3597,0.0,27,22,5,0,5,81.48148148
2003020225,24,3600,0.0,30,29,1,2,1,96.66666667
2003020226,8,3569,0.0,25,23,1,2,2,92.0
2003020226,2,3600,0.0,29,28,2,0,1,96.55172414
2003020227,23,3642,0.0,27,23,2,0,4,85.18518519
2003020227,4,3707,0.0,32,29,8,0,3,90.625
2003020228,11,3600,2.0,33,28,6,0,5,84.84848485
2003020228,12,3581,2.0,22,21,0,1,1,95.45454545
2003020229,29,3600,0.0,35,30,11,3,5,85.71428571
2003020229,9,3588,0.0,17,15,7,3,2,88.23529412
2003020230,13,3466,0.0,29,26,2,0,3,89.65517241
2003020230,1,3600,0.0,21,20,1,0,1,95.23809524
2003020231,20,3600,0.0,22,18,7,1,4,81.81818182
2003020231,18,3592,2.0,30,29,7,1,1,96.66666667
2003020232,22,3600,0.0,22,22,4,0,0,100.0
2003020232,30,3568,0.0,30,28,0,2,2,93.33333333
2003020233,21,3710,0.0,25,22,3,0,3,88.0
2003020233,27,3685,0.0,29,27,5,0,2,93.10344828
2003020234,10,3893,0.0,27,23,6,0,4,85.18518519
2003020234,26,3899,0.0,37,33,6,3,4,89.18918919
2003020235,19,3882,0.0,33,30,12,0,3,90.90909091
2003020235,28,3885,0.0,35,31,4,3,4,88.57142857
2003020236,14,3600,2.0,22,20,2,1,2,90.90909091
2003020236,15,1200,0.0,7,7,0,0,0,100.0
2003020236,15,2399,2.0,14,9,4,0,5,64.28571429
2003020237,6,3600,0.0,24,24,5,0,0,100.0
2003020237,29,1200,0.0,14,10,1,0,4,71.42857143
2003020237,29,2395,0.0,13,13,0,0,0,100.0
2003020238,5,3789,0.0,22,21,1,2,1,95.45454545
2003020238,7,3789,0.0,23,21,7,1,2,91.30434783
2003020239,17,3639,0.0,31,28,9,1,3,90.32258065
2003020239,16,3668,0.0,26,22,6,3,4,84.61538462
2003020240,27,3876,0.0,35,32,9,1,3,91.42857143
2003020240,25,3896,0.0,26,23,6,0,3,88.46153846
2003020241,3,1200,0.0,10,9,4,1,1,90.0
2003020241,3,2400,0.0,24,20,2,0,4,83.33333333
2003020241,1,3600,0.0,18,18,3,1,0,100.0
2003020242,19,3590,0.0,18,18,5,0,0,100.0
2003020242,26,3544,0.0,20,19,2,1,1,95.0
2003020243,23,3853,2.0,39,37,10,0,2,94.87179487
2003020243,6,3855,0.0,24,23,2,0,1,95.83333333
2003020244,8,3600,0.0,40,38,5,0,2,95.0
2003020244,9,3540,0.0,13,10,4,0,3,76.92307692
2003020245,11,3600,0.0,35,31,2,0,4,88.57142857
2003020245,4,3600,0.0,24,24,0,0,0,100.0
2003020246,15,3600,0.0,39,38,10,2,1,97.43589744
2003020246,12,3540,0.0,20,18,2,1,2,90.0
2003020247,13,3600,0.0,35,33,6,1,2,94.28571429
2003020247,5,3545,0.0,20,17,0,0,3,85.0
2003020248,2,3559,0.0,22,18,5,1,4,81.81818182
2003020248,18,3598,0.0,29,26,5,0,3,89.65517241
2003020249,17,3895,0.0,26,25,6,1,1,96.15384615
2003020249,30,3900,0.0,28,27,3,1,1,96.42857143
2003020250,25,3588,0.0,41,38,10,1,3,92.68292683
2003020250,21,3600,0.0,29,29,8,2,0,100.0
2003020251,20,3874,0.0,24,22,2,3,2,91.66666667
2003020251,22,3884,0.0,34,33,5,1,1,97.05882353
2003020252,10,3900,0.0,27,25,2,0,2,92.59259259
2003020252,28,3900,0.0,18,16,0,1,2,88.88888889
2003020253,13,3600,0.0,30,25,4,0,5,83.33333333
2003020253,11,3600,0.0,28,26,1,0,2,92.85714286
2003020254,27,3900,0.0,27,25,7,2,2,92.59259259
2003020254,29,3900,0.0,31,29,7,0,2,93.5483871
2003020255,3,3900,0.0,41,39,11,0,2,95.12195122
2003020255,16,3900,0.0,34,32,8,0,2,94.11764706
2003020256,19,3556,0.0,25,21,4,0,4,84.0
2003020256,24,3600,0.0,30,27,1,1,3,90.0
2003020257,7,3594,0.0,24,23,2,0,1,95.83333333
2003020257,9,3551,0.0,25,23,1,0,2,92.0
2003020258,4,3896,0.0,24,22,0,0,2,91.66666667
2003020258,12,3900,0.0,43,41,5,2,2,95.34883721
2003020259,24,3791,0.0,40,38,9,1,2,95.0
2003020259,21,3791,0.0,25,24,2,2,1,96.0
2003020260,10,3684,0.0,26,23,2,1,3,88.46153846
2003020260,20,3682,0.0,17,15,3,0,2,88.23529412
2003020261,16,3556,0.0,29,25,2,0,4,86.20689655
2003020261,22,3600,0.0,35,33,5,0,2,94.28571429
2003020262,8,3782,0.0,42,37,7,2,5,88.0952381
2003020262,23,3775,0.0,23,19,3,1,4,82.60869565
2003020263,3,3900,0.0,33,31,3,0,2,93.93939394
2003020263,28,3899,0.0,31,29,3,2,2,93.5483871
2003020264,7,1835,0.0,9,9,1,2,0,100.0
2003020264,7,1765,0.0,19,15,0,0,4,78.94736842
2003020264,1,3600,0.0,22,21,6,1,1,95.45454545
2003020265,30,3600,0.0,40,38,10,0,2,95.0
2003020265,5,1172,0.0,9,6,0,0,3,66.66666667
2003020265,5,2423,0.0,19,16,2,1,3,84.21052632
2003020266,6,3822,0.0,28,23,5,3,5,82.14285714
2003020266,11,3795,0.0,21,17,3,0,4,80.95238095
2003020267,2,3597,0.0,27,26,5,0,1,96.2962963
2003020267,13,3600,0.0,32,28,5,0,4,87.5
2003020268,29,3600,2.0,42,37,9,1,5,88.0952381
2003020268,17,3600,0.0,38,37,5,0,1,97.36842105
2003020269,24,3885,0.0,29,26,3,0,3,89.65517241
2003020269,25,3887,0.0,33,30,3,4,3,90.90909091
2003020270,19,3543,0.0,25,20,1,2,5,80.0
2003020270,27,3600,0.0,26,22,3,0,4,84.61538462
2003020271,18,42,0.0,0,0,0,0,0,
2003020271,18,3347,0.0,20,17,1,1,3,85.0
2003020271,26,3600,0.0,30,30,7,0,0,100.0
2003020272,15,3535,0.0,25,22,3,0,3,88.0
2003020272,6,3600,0.0,22,20,1,0,2,90.90909091
2003020273,2,3543,2.0,32,29,8,1,3,90.625
2003020273,14,3600,0.0,28,26,4,0,2,92.85714286
2003020274,12,2400,0.0,20,14,3,3,6,70.0
2003020274,12,1200,0.0,3,3,1,0,0,100.0
2003020274,9,3569,0.0,23,22,7,2,1,95.65217391
2003020275,30,3596,2.0,41,38,4,1,3,92.68292683
2003020275,4,3600,0.0,23,22,1,1,1,95.65217391
2003020276,17,3600,0.0,24,21,4,1,3,87.5
2003020276,29,3600,0.0,25,25,1,1,0,100.0
2003020277,8,3549,0.0,32,30,1,3,2,93.75
2003020277,20,3597,0.0,23,22,9,1,1,95.65217391
2003020278,10,3534,0.0,22,19,4,0,3,86.36363636
2003020278,22,3592,0.0,33,31,10,2,2,93.93939394
2003020279,3,3509,2.0,33,29,5,2,4,87.87878788
2003020279,21,3600,0.0,34,31,3,3,3,91.17647059
2003020280,16,3775,0.0,27,24,5,1,3,88.88888889
2003020280,23,3757,2.0,31,29,9,2,2,93.5483871
2003020281,5,3586,0.0,33,31,11,4,2,93.93939394
2003020281,1,3630,0.0,19,18,5,0,1,94.73684211
2003020282,11,3600,0.0,24,21,3,0,3,87.5
2003020282,13,3573,0.0,29,24,3,3,5,82.75862069
2003020283,12,3587,0.0,25,20,0,2,5,80.0
2003020283,7,3598,0.0,35,35,4,2,0,100.0
2003020284,26,3540,0.0,16,14,0,0,2,87.5
2003020284,25,3600,0.0,26,25,2,2,1,96.15384615
2003020285,28,1191,0.0,9,9,3,0,0,100.0
2003020285,28,2400,0.0,31,31,9,3,0,100.0
2003020285,27,1550,0.0,21,17,10,0,4,80.95238095
2003020285,27,2050,0.0,12,11,4,1,1,91.66666667
2003020286,18,3691,0.0,37,34,5,3,3,91.89189189
2003020286,24,3691,0.0,33,29,9,1,4,87.87878788
2003020287,6,3566,0.0,26,23,1,3,3,88.46153846
2003020287,4,3600,0.0,13,11,1,1,2,84.61538462
2003020288,13,3703,0.0,41,39,16,0,2,95.12195122
2003020288,15,3694,0.0,25,22,3,2,3,88.0
2003020289,2,3532,0.0,29,27,8,1,2,93.10344828
2003020289,29,3600,0.0,25,24,7,0,1,96.0
2003020290,8,3600,0.0,37,34,3,0,3,91.89189189
2003020290,22,3544,0.0,23,19,0,0,4,82.60869565
2003020291,9,3760,0.0,19,17,3,0,2,89.47368421
2003020291,5,3760,0.0,32,31,5,0,1,96.875
2003020292,7,3548,0.0,23,21,0,1,2,91.30434783
2003020292,14,3600,0.0,26,25,2,0,1,96.15384615
2003020293,25,3519,2.0,24,22,4,0,2,91.66666667
2003020293,19,3600,0.0,22,21,6,0,1,95.45454545
2003020294,17,3599,2.0,29,27,3,1,2,93.10344828
2003020294,30,3599,0.0,33,28,4,0,5,84.84848485
2003020295,26,3600,0.0,21,21,7,1,0,100.0
2003020295,21,3513,0.0,25,23,4,1,2,92.0
2003020296,16,3577,0.0,28,26,8,2,2,92.85714286
2003020296,20,3590,0.0,25,24,4,0,1,96.0
2003020297,10,3600,0.0,28,25,8,1,3,89.28571429
2003020297,23,3550,0.0,28,24,7,2,4,85.71428571
2003020298,18,3532,0.0,32,29,4,1,3,90.625
2003020298,28,3587,0.0,33,32,8,3,1,96.96969697
2003020299,27,3537,0.0,28,27,4,1,1,96.42857143
2003020299,11,3597,2.0,21,21,3,0,0,100.0
2003020300,9,823,0.0,6,6,2,0,0,100.0
2003020300,9,2777,0.0,22,16,2,1,6,72.72727273
2003020300,3,3600,0.0,25,23,7,1,2,92.0
2003020301,14,3900,0.0,37,37,8,0,0,100.0
2003020301,12,3900,0.0,21,21,1,1,0,100.0
2003020302,23,3545,0.0,33,31,6,2,2,93.93939394
2003020302,10,3595,0.0,25,24,3,1,1,96.0
2003020303,7,3550,0.0,24,22,2,0,2,91.66666667
2003020303,13,3600,0.0,37,36,1,2,1,97.2972973
2003020304,15,3600,0.0,39,38,8,0,1,97.43589744
2003020304,17,661,0.0,9,6,0,0,3,66.66666667
2003020304,17,2939,0.0,10,9,2,0,1,90.0
2003020305,27,3521,2.0,18,14,5,1,4,77.77777778
2003020305,25,3593,0.0,22,20,4,0,2,90.90909091
2003020306,18,3600,0.0,36,34,6,0,2,94.44444444
2003020306,21,3461,0.0,23,20,1,2,3,86.95652174
2003020307,3,3600,0.0,36,36,6,0,0,100.0
2003020307,14,3484,0.0,26,24,7,2,2,92.30769231
2003020308,22,3900,0.0,34,31,5,1,3,91.17647059
2003020308,29,3895,0.0,34,31,5,0,3,91.17647059
2003020309,23,3598,0.0,27,25,2,2,2,92.59259259
2003020309,8,3600,0.0,40,35,2,1,5,87.5
2003020310,9,1446,0.0,6,3,2,0,3,50.0
2003020310,9,2153,0.0,8,8,0,1,0,100.0
2003020310,11,3591,0.0,32,26,9,0,6,81.25
2003020311,6,3837,0.0,32,28,2,1,4,87.5
2003020311,19,3837,0.0,27,24,3,0,3,88.88888889
2003020312,1,3600,0.0,25,25,5,0,0,100.0
2003020312,26,3506,0.0,22,19,9,3,3,86.36363636
2003020313,15,3471,0.0,26,21,5,0,5,80.76923077
2003020313,7,3600,0.0,20,18,4,1,2,90.0
2003020314,12,3600,0.0,28,28,4,2,0,100.0
2003020314,2,3530,0.0,25,23,6,1,2,92.0
2003020315,4,3896,0.0,20,19,5,0,1,95.0
2003020315,5,3900,0.0,39,38,1,0,1,97.43589744
2003020316,3,3899,0.0,31,28,0,1,3,90.32258065
2003020316,13,3900,0.0,40,37,1,0,3,92.5
2003020317,22,832,0.0,7,5,2,0,2,71.42857143
2003020317,22,2767,0.0,36,31,7,0,5,86.11111111
2003020317,17,3598,0.0,16,15,0,1,1,93.75
2003020318,29,3597,2.0,33,29,11,2,4,87.87878788
2003020318,18,3600,0.0,28,26,2,6,2,92.85714286
2003020319,25,3600,0.0,19,18,1,0,1,94.73684211
2003020319,30,3543,0.0,19,17,2,1,2,89.47368421
2003020320,1,3900,0.0,36,33,2,0,3,91.66666667
2003020320,24,3893,0.0,36,33,5,2,3,91.66666667
2003020321,16,3527,0.0,22,19,3,2,3,86.36363636
2003020321,28,3596,0.0,25,23,4,2,2,92.0
2003020322,10,3600,0.0,32,31,7,5,1,96.875
2003020322,11,3503,0.0,28,26,8,0,2,92.85714286
2003020323,23,3853,0.0,33,31,4,1,2,93.93939394
2003020323,9,3834,0.0,27,24,3,1,3,88.88888889
2003020324,21,3744,0.0,32,27,7,0,5,84.375
2003020324,20,3735,0.0,24,18,2,1,6,75.0
2003020325,26,3561,0.0,22,17,1,0,5,77.27272727
2003020325,27,3600,0.0,43,39,8,0,4,90.69767442
2003020326,18,3585,0.0,33,32,4,5,1,96.96969697
2003020326,6,3511,0.0,29,27,7,0,2,93.10344828
2003020327,12,3556,0.0,28,25,6,4,3,89.28571429
2003020327,4,3596,0.0,30,28,9,0,2,93.33333333
2003020328,28,3594,2.0,18,17,4,1,1,94.44444444
2003020328,30,3545,0.0,21,19,8,1,2,90.47619048
2003020329,16,3543,0.0,25,21,9,1,4,84.0
2003020329,24,3600,0.0,37,34,12,2,3,91.89189189
2003020330,8,3600,0.0,34,31,1,0,3,91.17647059
2003020330,15,77,0.0,0,0,0,0,0,
2003020330,15,3412,0.0,22,17,2,0,5,77.27272727
2003020331,3,3592,0.0,21,20,2,0,1,95.23809524
2003020331,5,3595,0.0,35,31,1,6,4,88.57142857
2003020332,19,3900,0.0,27,25,3,0,2,92.59259259
2003020332,14,3900,0.0,24,22,6,0,2,91.66666667
2003020333,2,3590,0.0,27,21,7,0,6,77.77777778
2003020333,17,3600,0.0,30,30,5,2,0,100.0
2003020334,13,3529,0.0,34,30,1,2,4,88.23529412
2003020334,7,399,0.0,7,5,0,0,2,71.42857143
2003020334,7,3198,0.0,12,11,2,0,1,91.66666667
2003020335,1,3535,0.0,21,19,1,1,2,90.47619048
2003020335,25,3600,0.0,21,21,4,0,0,100.0
2003020336,21,3600,0.0,41,40,5,2,1,97.56097561
2003020336,22,3598,0.0,27,23,0,0,4,85.18518519
2003020337,16,3548,0.0,29,26,4,2,3,89.65517241
2003020337,26,3595,0.0,21,20,1,0,1,95.23809524
2003020338,10,3600,0.0,25,24,8,1,1,96.0
2003020338,9,3549,0.0,24,22,4,0,2,91.66666667
2003020339,13,3878,0.0,37,36,6,1,1,97.2972973
2003020339,8,3900,0.0,24,23,5,2,1,95.83333333
2003020340,4,3600,0.0,17,16,4,0,1,94.11764706
2003020340,2,1200,6.0,7,7,2,0,0,100.0
2003020340,2,2400,0.0,18,13,4,1,5,72.22222222
2003020341,5,3546,2.0,38,34,9,2,4,89.47368421
2003020341,12,3599,0.0,25,22,9,0,3,88.0
2003020342,14,3507,0.0,20,18,1,0,2,90.0
2003020342,11,3600,0.0,28,27,5,1,1,96.42857143
2003020343,15,3599,0.0,28,25,5,0,3,89.28571429
2003020343,29,1864,0.0,14,10,0,1,4,71.42857143
2003020343,29,1677,0.0,10,9,2,0,1,90.0
2003020344,17,3600,0.0,22,21,4,0,1,95.45454545
2003020344,19,3540,0.0,28,26,1,2,2,92.85714286
2003020345,7,3600,0.0,32,28,10,3,4,87.5
2003020345,18,3599,0.0,23,22,3,1,1,95.65217391
2003020346,23,3900,0.0,33,29,7,2,4,87.87878788
2003020346,20,3898,2.0,34,30,14,1,4,88.23529412
2003020347,28,3597,0.0,36,35,1,0,1,97.22222222
2003020347,22,3557,0.0,21,19,0,1,2,90.47619048
2003020348,24,3900,0.0,26,25,1,4,1,96.15384615
2003020348,30,3900,0.0,33,32,4,0,1,96.96969697
2003020349,27,3892,0.0,40,37,9,0,3,92.5
2003020349,6,3890,0.0,31,28,5,0,3,90.32258065
2003020350,10,3600,0.0,35,33,10,1,2,94.28571429
2003020350,3,3515,0.0,25,21,5,0,4,84.0
2003020351,26,3600,0.0,19,18,7,0,1,94.73684211
2003020351,25,3572,0.0,21,19,4,3,2,90.47619048
2003020352,1,3900,0.0,26,25,1,0,1,96.15384615
2003020352,21,3900,0.0,28,27,5,1,1,96.42857143
2003020353,4,3591,2.0,29,26,9,0,3,89.65517241
2003020353,9,3597,0.0,32,31,1,1,1,96.875
2003020354,11,3563,0.0,32,28,7,0,4,87.5
2003020354,5,3600,0.0,27,24,2,2,3,88.88888889
2003020355,15,3588,0.0,26,25,7,2,1,96.15384615
2003020355,2,3600,0.0,25,21,5,0,4,84.0
2003020356,24,3519,2.0,32,30,9,0,2,93.75
2003020356,29,3600,0.0,31,30,5,2,1,96.77419355
2003020357,3,983,0.0,15,12,1,0,3,80.0
2003020357,3,2535,0.0,17,15,6,0,2,88.23529412
2003020357,10,3594,0.0,29,25,2,3,4,86.20689655
2003020358,14,3546,0.0,25,22,0,1,3,88.0
2003020358,8,3600,0.0,26,24,5,0,2,92.30769231
2003020359,27,3599,0.0,28,27,7,2,1,96.42857143
2003020359,1,3530,0.0,23,20,4,3,3,86.95652174
2003020360,26,1693,0.0,9,6,2,0,3,66.66666667
2003020360,26,1824,0.0,11,11,0,1,0,100.0
2003020360,19,3583,0.0,28,27,8,0,1,96.42857143
2003020361,28,3588,0.0,32,30,3,0,2,93.75
2003020361,20,3600,0.0,20,19,2,0,1,95.0
2003020362,5,3592,0.0,39,34,8,2,5,87.17948718
2003020362,4,3600,0.0,32,30,5,0,2,93.75
2003020363,18,3810,0.0,41,40,4,1,1,97.56097561
2003020363,12,3810,0.0,22,20,7,0,2,90.90909091
2003020364,6,3600,0.0,30,26,0,1,4,86.66666667
2003020364,11,3529,0.0,40,35,2,0,5,87.5
2003020365,9,3600,0.0,30,30,1,0,0,100.0
2003020365,13,3600,0.0,43,39,0,0,4,90.69767442
2003020366,24,1785,0.0,24,20,1,0,4,83.33333333
2003020366,24,1815,0.0,14,11,0,0,3,78.57142857
2003020366,17,3600,0.0,23,21,0,1,2,91.30434783
2003020367,7,3600,0.0,24,22,7,0,2,91.66666667
2003020367,16,3499,0.0,28,25,2,0,3,89.28571429
2003020368,30,3600,0.0,34,34,2,2,0,100.0
2003020368,22,3524,0.0,31,30,11,0,1,96.77419355
2003020369,10,3600,0.0,25,25,6,0,0,100.0
2003020369,6,3600,0.0,29,23,1,1,6,79.31034483
2003020370,27,3586,0.0,36,34,11,0,2,94.44444444
2003020370,7,3538,0.0,31,28,2,3,3,90.32258065
2003020371,3,3600,0.0,39,37,7,0,2,94.87179487
2003020371,2,3527,2.0,16,12,4,0,4,75.0
2003020372,9,3600,0.0,30,29,12,2,1,96.66666667
2003020372,14,3562,0.0,25,22,7,0,3,88.0
2003020373,18,3600,0.0,39,37,8,0,2,94.87179487
2003020373,29,3568,0.0,23,20,3,0,3,86.95652174
2003020374,15,3600,0.0,41,38,15,1,3,92.68292683
2003020374,1,3600,0.0,9,9,0,0,0,100.0
2003020375,17,3900,0.0,18,14,3,1,4,77.77777778
2003020375,19,3900,0.0,27,23,2,0,4,85.18518519
2003020376,20,3594,0.0,29,28,6,1,1,96.55172414
2003020376,23,3500,0.0,22,19,3,0,3,86.36363636
2003020377,25,3600,0.0,23,20,5,1,3,86.95652174
2003020377,26,3595,0.0,17,17,4,0,0,100.0
2003020378,21,3898,0.0,27,25,5,1,2,92.59259259
2003020378,28,3899,0.0,27,25,1,0,2,92.59259259
2003020379,27,3561,0.0,31,28,1,3,3,90.32258065
2003020379,4,3600,0.0,20,18,3,0,2,90.0
2003020380,8,3900,0.0,36,35,11,2,1,97.22222222
2003020380,12,3866,0.0,27,26,10,1,1,96.2962963
2003020381,24,2640,0.0,28,23,3,0,5,82.14285714
2003020381,24,960,0.0,9,8,0,0,1,88.88888889
2003020381,11,3598,0.0,37,35,1,1,2,94.59459459
2003020382,30,3598,0.0,31,29,0,1,2,93.5483871
2003020382,20,3600,0.0,23,22,3,0,1,95.65217391
2003020383,18,2400,0.0,18,16,3,0,2,88.88888889
2003020383,18,1200,0.0,5,3,0,0,2,60.0
2003020383,19,3591,0.0,15,14,3,0,1,93.33333333
2003020384,4,3900,0.0,39,38,9,1,1,97.43589744
2003020384,6,3900,0.0,23,22,4,0,1,95.65217391
2003020385,14,3600,0.0,38,37,7,2,1,97.36842105
2003020385,7,3555,0.0,29,26,3,1,3,89.65517241
2003020386,17,3600,0.0,24,19,0,2,5,79.16666667
2003020386,10,3600,0.0,31,29,1,0,2,93.5483871
2003020387,12,3526,0.0,26,23,3,0,3,88.46153846
2003020387,8,3600,0.0,23,22,4,0,1,95.65217391
2003020388,1,3600,0.0,19,18,3,0,1,94.73684211
2003020388,9,3582,0.0,20,18,4,3,2,90.0
2003020389,16,3600,0.0,33,28,7,2,5,84.84848485
2003020389,2,3600,0.0,23,21,2,0,2,91.30434783
2003020390,11,3777,0.0,34,31,2,0,3,91.17647059
2003020390,13,3777,0.0,42,38,16,0,4,90.47619048
2003020391,29,3600,0.0,38,33,4,0,5,86.84210526
2003020391,21,3598,0.0,36,35,7,0,1,97.22222222
2003020392,5,3554,0.0,42,38,11,0,4,90.47619048
2003020392,22,3589,0.0,27,24,4,2,3,88.88888889
2003020393,30,3896,0.0,34,33,6,0,1,97.05882353
2003020393,23,3900,0.0,17,16,1,0,1,94.11764706
2003020394,15,727,0.0,6,5,3,0,1,83.33333333
2003020394,15,2871,4.0,31,25,8,0,6,80.64516129
2003020394,26,3600,0.0,33,30,9,0,3,90.90909091
2003020395,25,3526,0.0,20,18,7,0,2,90.0
2003020395,28,3600,0.0,16,15,3,1,1,93.75
2003020396,14,3600,0.0,31,29,5,0,2,93.5483871
2003020396,3,3542,0.0,24,21,2,1,3,87.5
2003020397,27,3900,0.0,39,37,16,5,2,94.87179487
2003020397,16,3885,0.0,16,14,2,0,2,87.5
2003020398,5,3600,0.0,43,37,5,0,6,86.04651163
2003020398,20,3600,0.0,22,21,2,1,1,95.45454545
2003020399,25,3600,0.0,37,33,5,2,4,89.18918919
2003020399,24,3600,0.0,32,32,5,0,0,100.0
2003020400,9,3900,0.0,23,21,2,0,2,91.30434783
2003020400,6,3900,0.0,30,28,0,1,2,93.33333333
2003020401,4,3600,0.0,38,36,4,0,2,94.73684211
2003020401,8,3531,0.0,31,28,2,0,3,90.32258065
2003020402,26,3711,0.0,20,17,1,0,3,85.0
2003020402,17,3711,0.0,28,26,4,0,2,92.85714286
2003020403,15,3560,0.0,28,25,11,0,3,89.28571429
2003020403,21,3600,0.0,23,22,1,0,1,95.65217391
2003020404,14,3519,0.0,34,30,9,2,4,88.23529412
2003020404,2,3600,0.0,31,29,4,4,2,93.5483871
2003020405,19,3630,0.0,15,13,1,0,2,86.66666667
2003020405,10,3588,0.0,27,24,1,0,3,88.88888889
2003020406,20,3554,0.0,19,17,6,0,2,89.47368421
2003020406,30,3600,0.0,32,31,3,1,1,96.875
2003020407,12,3600,0.0,27,25,3,0,2,92.59259259
2003020407,22,3492,0.0,25,22,3,2,3,88.0
2003020408,5,3624,0.0,37,33,8,1,4,89.18918919
2003020408,23,3624,0.0,17,14,0,2,3,82.35294118
2003020409,8,3600,0.0,29,28,3,1,1,96.55172414
2003020409,3,3543,0.0,23,21,1,1,2,91.30434783
2003020410,4,3900,0.0,20,19,2,0,1,95.0
2003020410,29,3898,0.0,41,40,11,1,1,97.56097561
2003020411,2,3729,0.0,35,34,1,0,1,97.14285714
2003020411,1,3723,0.0,18,18,3,0,0,100.0
2003020412,26,3755,0.0,21,17,2,3,4,80.95238095
2003020412,11,3814,0.0,32,29,5,0,3,90.625
2003020413,6,3900,0.0,31,30,3,2,1,96.77419355
2003020413,13,3900,0.0,30,29,7,2,1,96.66666667
2003020414,17,3600,0.0,25,23,2,2,2,92.0
2003020414,7,3570,0.0,23,16,2,0,7,69.56521739
2003020415,25,3557,0.0,18,16,2,0,2,88.88888889
2003020415,27,3600,0.0,40,39,7,0,1,97.5
2003020416,28,3554,0.0,30,27,3,2,3,90.0
2003020416,24,3600,0.0,20,18,2,0,2,90.0
2003020417,6,3136,0.0,21,19,1,0,2,90.47619048
2003020417,6,397,0.0,5,2,2,0,3,40.0
2003020417,15,3600,0.0,39,34,8,1,5,87.17948718
2003020418,14,3533,0.0,40,37,2,1,3,92.5
2003020418,9,3600,0.0,24,22,3,0,2,91.66666667
2003020419,26,687,0.0,7,7,0,0,0,100.0
2003020419,26,2907,0.0,30,29,8,0,1,96.66666667
2003020419,18,3397,0.0,21,18,9,0,3,85.71428571
2003020420,10,3600,2.0,28,28,9,1,0,100.0
2003020420,30,3515,0.0,17,16,2,1,1,94.11764706
2003020421,17,3584,0.0,26,22,1,0,4,84.61538462
2003020421,16,3615,0.0,33,30,3,3,3,90.90909091
2003020422,12,3539,0.0,31,30,13,0,1,96.77419355
2003020422,20,3596,0.0,23,23,2,2,0,100.0
2003020423,21,3900,0.0,38,37,8,0,1,97.36842105
2003020423,23,3898,0.0,28,27,4,3,1,96.42857143
2003020424,22,3900,0.0,30,28,5,0,2,93.33333333
2003020424,28,3900,0.0,44,42,11,2,2,95.45454545
2003020425,19,3891,0.0,32,30,5,0,2,93.75
2003020425,29,3891,0.0,33,30,2,1,3,90.90909091
2003020426,4,3897,0.0,21,18,4,0,3,85.71428571
2003020426,1,3899,2.0,40,37,5,1,3,92.5
2003020427,5,1753,0.0,15,11,0,0,4,73.33333333
2003020427,5,1820,0.0,16,15,5,0,1,93.75
2003020427,11,3600,0.0,27,24,12,0,3,88.88888889
2003020428,8,3524,0.0,49,45,4,1,4,91.83673469
2003020428,13,3596,0.0,31,29,3,0,2,93.5483871
2003020429,3,3600,0.0,20,19,8,0,1,95.0
2003020429,7,3491,0.0,34,31,9,0,3,91.17647059
2003020430,16,3543,0.0,26,25,4,3,1,96.15384615
2003020430,25,3600,0.0,16,16,4,0,0,100.0
2003020431,22,3900,0.0,21,18,3,1,3,85.71428571
2003020431,27,3900,0.0,42,39,4,2,3,92.85714286
2003020432,3,3600,0.0,36,33,8,1,3,91.66666667
2003020432,10,3600,2.0,29,28,5,1,1,96.55172414
2003020433,6,3600,0.0,24,22,9,0,2,91.66666667
2003020433,9,3540,0.0,31,28,6,0,3,90.32258065
2003020434,11,3577,0.0,28,25,6,1,3,89.28571429
2003020434,2,3595,0.0,18,18,3,1,0,100.0
2003020435,1,3594,0.0,32,32,2,0,0,100.0
2003020435,4,3539,0.0,22,20,5,0,2,90.90909091
2003020436,17,3600,0.0,19,18,7,0,1,94.73684211
2003020436,15,3595,0.0,26,21,7,1,5,80.76923077
2003020437,29,3595,2.0,25,20,2,0,5,80.0
2003020437,5,3582,0.0,26,23,5,1,3,88.46153846
2003020438,8,3600,0.0,37,35,4,2,2,94.59459459
2003020438,14,1706,0.0,10,10,2,0,0,100.0
2003020438,14,1817,0.0,11,7,0,0,4,63.63636364
2003020439,26,3520,0.0,27,25,5,1,2,92.59259259
2003020439,19,3590,0.0,22,21,2,0,1,95.45454545
2003020440,13,3900,0.0,36,34,10,1,2,94.44444444
2003020440,18,3900,2.0,28,26,4,1,2,92.85714286
2003020441,7,3600,0.0,24,21,7,2,3,87.5
2003020441,30,3600,0.0,17,15,1,0,2,88.23529412
2003020442,21,3900,0.0,33,32,5,0,1,96.96969697
2003020442,20,3897,0.0,24,23,3,0,1,95.83333333
2003020443,24,3525,2.0,25,23,6,0,2,92.0
2003020443,28,3600,0.0,28,28,4,1,0,100.0
2003020444,25,3900,0.0,30,29,5,0,1,96.66666667
2003020444,16,3900,0.0,32,31,13,2,1,96.875
2003020445,22,3596,0.0,30,28,0,0,2,93.33333333
2003020445,24,3547,0.0,29,26,8,1,3,89.65517241
2003020446,12,2928,0.0,23,22,2,0,1,95.65217391
2003020446,12,925,0.0,9,8,0,0,1,88.88888889
2003020446,23,3853,0.0,31,30,0,1,1,96.77419355
2003020447,13,3549,0.0,39,36,9,1,3,92.30769231
2003020447,17,3597,0.0,22,21,6,2,1,95.45454545
2003020448,30,3599,0.0,20,18,1,1,2,90.0
2003020448,27,3565,0.0,27,24,0,1,3,88.88888889
2003020449,1,3526,0.0,28,23,1,3,5,82.14285714
2003020449,2,3600,0.0,33,29,6,0,4,87.87878788
2003020450,20,3813,0.0,37,35,7,1,2,94.59459459
2003020450,4,3784,0.0,26,23,2,0,3,88.46153846
2003020451,14,3594,0.0,20,18,2,0,2,90.0
2003020451,10,3600,0.0,21,21,3,1,0,100.0
2003020452,6,3900,0.0,29,28,8,0,1,96.55172414
2003020452,8,3894,2.0,31,30,3,2,1,96.77419355
2003020453,7,3555,0.0,26,24,3,0,2,92.30769231
2003020453,5,3600,0.0,22,21,2,3,1,95.45454545
2003020454,15,3600,0.0,37,37,7,1,0,100.0
2003020454,11,3566,0.0,29,24,6,2,5,82.75862069
2003020455,29,3849,0.0,37,35,6,0,2,94.59459459
2003020455,19,3850,0.0,27,26,3,1,1,96.2962963
2003020456,23,3679,0.0,30,29,4,0,1,96.66666667
2003020456,18,3679,0.0,24,22,1,1,2,91.66666667
2003020457,22,3545,0.0,24,21,2,1,3,87.5
2003020457,26,3592,0.0,24,22,2,1,2,91.66666667
2003020458,15,3900,0.0,22,20,0,5,2,90.90909091
2003020458,13,3900,0.0,27,25,9,0,2,92.59259259
2003020459,28,3831,0.0,29,26,7,0,3,89.65517241
2003020459,17,3780,0.0,28,26,8,0,2,92.85714286
2003020460,23,3477,0.0,28,25,6,1,3,89.28571429
2003020460,25,3600,0.0,23,22,7,1,1,95.65217391
2003020461,30,3597,0.0,29,27,2,0,2,93.10344828
2003020461,21,3524,0.0,28,25,0,0,3,89.28571429
2003020462,20,3600,0.0,30,30,5,2,0,100.0
2003020462,6,2400,0.0,10,5,0,0,5,50.0
2003020462,6,1196,0.0,4,4,0,0,0,100.0
2003020463,14,3723,0.0,41,37,3,0,4,90.24390244
2003020463,4,3723,0.0,28,23,5,1,5,82.14285714
2003020464,5,3734,0.0,36,34,6,0,2,94.44444444
2003020464,12,3721,0.0,11,10,0,0,1,90.90909091
2003020465,18,3635,0.0,36,31,3,1,5,86.11111111
2003020465,8,2435,0.0,18,16,5,0,2,88.88888889
2003020465,8,1200,0.0,4,2,0,0,2,50.0
2003020466,16,3600,0.0,32,26,4,0,6,81.25
2003020466,9,3600,0.0,28,27,3,0,1,96.42857143
2003020467,1,3600,0.0,15,15,6,1,0,100.0
2003020467,11,3600,0.0,38,35,5,0,3,92.10526316
2003020468,2,3524,0.0,30,26,10,0,4,86.66666667
2003020468,3,3600,0.0,26,23,3,2,3,88.46153846
2003020469,28,3600,0.0,35,31,3,0,4,88.57142857
2003020469,19,3585,2.0,29,27,7,2,2,93.10344828
2003020470,30,3887,0.0,31,30,0,1,1,96.77419355
2003020470,22,3848,0.0,20,19,1,5,1,95.0
2003020471,27,3894,0.0,34,30,3,0,4,88.23529412
2003020471,26,3900,0.0,33,29,4,3,4,87.87878788
2003020472,10,3900,0.0,27,25,7,0,2,92.59259259
2003020472,15,3881,0.0,34,32,2,5,2,94.11764706
2003020473,20,3590,0.0,34,33,15,2,1,97.05882353
2003020473,29,3559,0.0,21,19,6,3,2,90.47619048
2003020474,25,3529,0.0,24,23,5,1,1,95.83333333
2003020474,13,3586,0.0,36,36,8,3,0,100.0
2003020475,16,3532,0.0,26,23,4,0,3,88.46153846
2003020475,17,3593,0.0,30,28,2,1,2,93.33333333
2003020476,1,3600,0.0,33,31,3,1,2,93.93939394
2003020476,7,3589,0.0,18,13,3,1,5,72.22222222
2003020477,21,3547,0.0,30,29,9,4,1,96.66666667
2003020477,24,3600,0.0,38,38,7,2,0,100.0
2003020478,12,3600,0.0,37,36,8,0,1,97.2972973
2003020478,6,3565,0.0,25,23,8,2,2,92.0
2003020479,2,3531,2.0,19,16,7,0,3,84.21052632
2003020479,4,3600,0.0,19,18,1,2,1,94.73684211
2003020480,8,3572,0.0,30,27,4,0,3,90.0
2003020480,10,3598,0.0,21,19,2,2,2,90.47619048
2003020481,3,3559,0.0,23,20,4,1,3,86.95652174
2003020481,9,3599,0.0,25,24,2,0,1,96.0
2003020482,11,3600,0.0,25,21,3,0,4,84.0
2003020482,5,2400,0.0,23,18,2,1,5,78.26086957
2003020482,5,1200,0.0,9,7,2,0,2,77.77777778
2003020483,25,3600,2.0,27,26,7,0,1,96.2962963
2003020483,14,3551,0.0,22,20,0,1,2,90.90909091
2003020484,27,3892,0.0,31,30,7,1,1,96.77419355
2003020484,19,3900,2.0,25,24,6,0,1,96.0
2003020485,17,3524,0.0,17,16,4,1,1,94.11764706
2003020485,18,3596,2.0,21,21,9,0,0,100.0
2003020486,29,2400,0.0,19,15,3,2,4,78.94736842
2003020486,29,1200,0.0,16,15,0,0,1,93.75
2003020486,30,3600,0.0,29,27,7,0,2,93.10344828
2003020487,23,3600,0.0,24,24,6,1,0,100.0
2003020487,22,3600,0.0,31,28,7,0,3,90.32258065
2003020488,21,3886,0.0,37,34,8,0,3,91.89189189
2003020488,26,1200,0.0,6,4,1,0,2,66.66666667
2003020488,26,2700,0.0,13,12,0,1,1,92.30769231
2003020489,2,1983,0.0,13,12,2,0,1,92.30769231
2003020489,2,1602,2.0,12,9,0,1,3,75.0
2003020489,15,3508,0.0,44,39,2,0,5,88.63636364
2003020490,4,3419,0.0,30,26,10,1,4,86.66666667
2003020490,11,3579,0.0,26,25,5,0,1,96.15384615
2003020491,1,3900,0.0,34,32,2,0,2,94.11764706
2003020491,16,3900,0.0,29,27,0,1,2,93.10344828
2003020492,28,3598,0.0,25,24,8,0,1,96.0
2003020492,24,3570,0.0,24,22,3,0,2,91.66666667
2003020493,6,3538,0.0,28,25,4,0,3,89.28571429
2003020493,3,3600,0.0,33,31,4,0,2,93.93939394
2003020494,25,3597,0.0,17,16,1,2,1,94.11764706
2003020494,12,3512,0.0,27,24,5,1,3,88.88888889
2003020495,5,3567,0.0,36,33,4,1,3,91.66666667
2003020495,8,3599,0.0,17,16,2,0,1,94.11764706
2003020496,13,3690,0.0,45,42,10,3,3,93.33333333
2003020496,9,3694,0.0,21,19,0,1,2,90.47619048
2003020497,19,3533,0.0,24,22,4,0,2,91.66666667
2003020497,17,3594,0.0,25,24,3,1,1,96.0
2003020498,27,3882,0.0,29,26,3,2,3,89.65517241
2003020498,18,3900,0.0,27,24,3,0,3,88.88888889
2003020499,26,3898,0.0,44,40,10,1,4,90.90909091
2003020499,23,3898,0.0,28,24,5,0,4,85.71428571
2003020500,24,3544,0.0,27,25,5,1,2,92.59259259
2003020500,28,3600,0.0,25,24,7,0,1,96.0
2003020501,14,3900,0.0,22,21,0,1,1,95.45454545
2003020501,6,3897,0.0,32,31,0,0,1,96.875
2003020502,9,3900,0.0,38,36,5,0,2,94.73684211
2003020502,7,3899,0.0,33,31,2,0,2,93.93939394
2003020503,4,3570,0.0,29,26,2,1,3,89.65517241
2003020503,2,3600,0.0,36,34,3,0,2,94.44444444
2003020504,8,3584,0.0,22,19,1,2,3,86.36363636
2003020504,15,3600,0.0,40,38,6,0,2,95.0
2003020505,27,3591,0.0,28,27,5,0,1,96.42857143
2003020505,29,3535,0.0,26,24,3,0,2,92.30769231
2003020506,13,2507,0.0,23,19,1,0,4,82.60869565
2003020506,13,1093,0.0,3,2,0,0,1,66.66666667
2003020506,10,3600,0.0,31,29,2,1,2,93.5483871
2003020507,18,3900,0.0,26,23,3,0,3,88.46153846
2003020507,30,3900,0.0,22,19,5,0,3,86.36363636
2003020508,19,3600,0.0,21,18,1,1,3,85.71428571
2003020508,16,3598,0.0,23,23,6,1,0,100.0
2003020509,22,3511,0.0,21,19,3,0,2,90.47619048
2003020509,20,3600,0.0,31,30,5,1,1,96.77419355
2003020510,10,2388,0.0,27,23,5,2,4,85.18518519
2003020510,10,1415,0.0,8,7,0,0,1,87.5
2003020510,3,1415,0.0,12,11,0,0,1,91.66666667
2003020510,3,2400,0.0,13,8,2,2,5,61.53846154
2003020511,5,3900,0.0,44,41,5,0,3,93.18181818
2003020511,9,3899,0.0,11,8,0,0,3,72.72727273
2003020512,2,3683,4.0,29,26,3,2,3,89.65517241
2003020512,1,3685,0.0,24,20,1,1,4,83.33333333
2003020513,14,3568,0.0,23,21,4,2,2,91.30434783
2003020513,11,3600,0.0,35,34,3,3,1,97.14285714
2003020514,30,3900,0.0,40,38,0,2,2,95.0
2003020514,17,3879,0.0,24,22,2,2,2,91.66666667
2003020515,12,3552,0.0,32,30,3,0,2,93.75
2003020515,7,3600,0.0,31,30,1,0,1,96.77419355
2003020516,21,3900,0.0,30,27,7,1,3,90.0
2003020516,19,3881,2.0,25,22,4,0,3,88.0
2003020517,29,3600,0.0,31,30,2,0,1,96.77419355
2003020517,16,3589,0.0,32,29,3,0,3,90.625
2003020518,18,3563,0.0,17,15,2,0,2,88.23529412
2003020518,25,3600,0.0,24,23,5,0,1,95.83333333
2003020519,23,3600,0.0,31,31,4,2,0,100.0
2003020519,20,3584,0.0,31,29,7,0,2,93.5483871
2003020520,26,1187,0.0,7,6,0,1,1,85.71428571
2003020520,26,2400,0.0,19,15,2,3,4,78.94736842
2003020520,28,3600,0.0,25,25,7,0,0,100.0
2003020521,10,3533,0.0,27,25,8,2,2,92.59259259
2003020521,2,3599,0.0,20,19,5,2,1,95.0
2003020522,7,3587,0.0,22,21,1,0,1,95.45454545
2003020522,15,3576,0.0,39,37,0,2,2,94.87179487
2003020523,8,3639,0.0,26,24,4,0,2,92.30769231
2003020523,12,3639,0.0,19,18,2,2,1,94.73684211
2003020524,25,3600,0.0,24,21,3,0,3,87.5
2003020524,29,2341,0.0,6,5,1,0,1,83.33333333
2003020524,29,1200,0.0,12,9,0,0,3,75.0
2003020525,1,3592,0.0,21,21,2,1,0,100.0
2003020525,5,3489,0.0,28,26,5,0,2,92.85714286
2003020526,6,3556,0.0,22,18,4,2,4,81.81818182
2003020526,14,3600,0.0,19,17,1,1,2,89.47368421
2003020527,24,3548,0.0,40,37,1,0,3,92.5
2003020527,13,3600,0.0,34,32,1,0,2,94.11764706
2003020528,4,3678,0.0,31,28,7,2,3,90.32258065
2003020528,21,3694,0.0,22,20,2,1,2,90.90909091
2003020529,18,3600,0.0,33,32,1,0,1,96.96969697
2003020529,27,3491,0.0,21,18,4,0,3,85.71428571
2003020530,22,3600,0.0,33,31,4,1,2,93.93939394
2003020530,23,3600,0.0,26,20,0,1,6,76.92307692
2003020531,28,3872,0.0,33,29,4,0,4,87.87878788
2003020531,26,3900,2.0,27,23,3,0,4,85.18518519
2003020532,11,3481,0.0,23,19,5,0,4,82.60869565
2003020532,9,3573,0.0,23,21,3,2,2,91.30434783
2003020533,17,3600,0.0,27,24,7,4,3,88.88888889
2003020533,16,3596,0.0,20,20,3,4,0,100.0
2003020534,20,3600,0.0,21,20,2,2,1,95.23809524
2003020534,22,3568,0.0,21,19,2,0,2,90.47619048
2003020535,1,3514,0.0,24,21,3,0,3,87.5
2003020535,2,3600,0.0,29,28,5,0,1,96.55172414
2003020536,6,3600,0.0,29,28,4,0,1,96.55172414
2003020536,15,3495,0.0,34,31,2,0,3,91.17647059
2003020537,7,3531,0.0,31,29,6,2,2,93.5483871
2003020537,12,3599,0.0,22,21,1,0,1,95.45454545
2003020538,24,3600,0.0,31,31,6,1,0,100.0
2003020538,14,3469,0.0,25,23,2,3,2,92.0
2003020539,19,3368,0.0,24,22,5,0,2,91.66666667
2003020539,19,232,0.0,1,1,1,0,0,100.0
2003020539,29,3518,0.0,34,31,10,1,3,91.17647059
2003020540,16,3507,0.0,21,20,0,0,1,95.23809524
2003020540,5,3600,2.0,31,31,0,1,0,100.0
2003020541,8,3600,0.0,27,26,0,2,1,96.2962963
2003020541,11,3524,0.0,28,26,4,0,2,92.85714286
2003020542,10,3900,0.0,39,35,4,0,4,89.74358974
2003020542,13,3900,0.0,38,34,6,3,4,89.47368421
2003020543,4,3900,0.0,22,20,2,1,2,90.90909091
2003020543,25,3891,2.0,28,26,5,2,2,92.85714286
2003020544,23,3595,0.0,36,34,10,3,2,94.44444444
2003020544,21,3543,0.0,27,24,6,2,3,88.88888889
2003020545,30,3899,0.0,46,44,2,0,2,95.65217391
2003020545,20,3896,0.0,19,17,0,0,2,89.47368421
2003020546,3,3623,0.0,24,22,6,2,2,91.66666667
2003020546,27,3660,0.0,31,28,10,1,3,90.32258065
2003020547,18,2365,0.0,15,14,3,0,1,93.33333333
2003020547,18,1200,0.0,13,10,6,0,3,76.92307692
2003020547,28,3600,0.0,21,19,6,0,2,90.47619048
2003020548,9,3600,0.0,24,24,5,1,0,100.0
2003020548,6,3598,0.0,26,23,6,3,3,88.46153846
2003020549,4,3600,0.0,30,28,3,1,2,93.33333333
2003020549,19,1836,0.0,16,12,3,1,4,75.0
2003020549,19,1764,0.0,13,10,1,0,3,76.92307692
2003020550,30,3900,0.0,40,38,3,3,2,95.0
2003020550,22,3896,0.0,18,16,3,0,2,88.88888889
2003020551,3,3627,0.0,30,28,10,0,2,93.33333333
2003020551,26,3639,2.0,25,22,5,3,3,88.0
2003020552,2,3600,0.0,22,21,6,0,1,95.45454545
2003020552,5,2400,0.0,22,17,3,2,5,77.27272727
2003020552,5,1200,0.0,4,3,0,0,1,75.0
2003020553,13,3900,2.0,42,40,0,0,2,95.23809524
2003020553,14,3900,0.0,32,30,0,0,2,93.75
2003020554,15,3600,0.0,42,35,8,1,7,83.33333333
2003020554,7,3588,0.0,26,25,5,0,1,96.15384615
2003020555,11,3744,0.0,44,38,2,1,6,86.36363636
2003020555,17,3744,0.0,27,22,2,2,5,81.48148148
2003020556,28,3599,0.0,26,26,6,2,0,100.0
2003020556,29,3526,0.0,29,28,2,2,1,96.55172414
2003020557,24,3600,0.0,18,17,2,0,1,94.44444444
2003020557,12,3470,0.0,31,28,5,0,3,90.32258065
2003020558,21,3566,0.0,31,30,3,1,1,96.77419355
2003020558,20,3527,0.0,29,27,1,0,2,93.10344828
2003020559,23,3873,0.0,32,29,2,0,3,90.625
2003020559,16,3873,0.0,29,25,4,1,4,86.20689655
2003020560,8,3900,0.0,20,19,0,1,1,95.0
2003020560,25,3880,0.0,21,20,2,0,1,95.23809524
2003020561,26,3594,0.0,35,31,19,1,4,88.57142857
2003020561,27,3595,0.0,21,21,4,2,0,100.0
2003020562,5,3533,0.0,30,27,7,1,3,90.0
2003020562,18,3600,0.0,31,29,7,0,2,93.5483871
2003020563,1,3900,0.0,27,25,2,0,2,92.59259259
2003020563,15,3900,0.0,36,34,14,0,2,94.44444444
2003020564,10,3600,2.0,41,38,5,1,3,92.68292683
2003020564,6,3600,2.0,24,22,3,0,2,91.66666667
2003020565,2,3555,0.0,23,22,4,2,1,95.65217391
2003020565,9,3600,0.0,32,32,3,0,0,100.0
2003020566,3,2015,0.0,10,9,3,0,1,90.0
2003020566,3,1502,0.0,12,8,3,2,4,66.66666667
2003020566,19,3591,0.0,43,39,9,2,4,90.69767442
2003020567,29,3600,0.0,37,37,2,0,0,100.0
2003020567,14,3498,0.0,14,13,0,0,1,92.85714286
2003020568,4,3600,0.0,30,29,5,0,1,96.66666667
2003020568,13,3527,0.0,23,21,1,0,2,91.30434783
2003020569,17,3600,0.0,30,29,13,2,1,96.66666667
2003020569,12,1200,0.0,7,5,0,1,2,71.42857143
2003020569,12,2300,0.0,15,13,4,1,2,86.66666667
2003020570,24,3600,0.0,33,28,2,0,5,84.84848485
2003020570,7,3600,0.0,26,24,0,0,2,92.30769231
2003020571,22,3600,0.0,25,24,0,0,1,96.0
2003020571,30,3529,0.0,18,16,0,0,2,88.88888889
2003020572,27,3600,0.0,35,35,2,0,0,100.0
2003020572,25,969,0.0,7,5,2,0,2,71.42857143
2003020572,25,2626,0.0,19,15,7,0,4,78.94736842
2003020573,28,3530,2.0,30,28,3,1,2,93.33333333
2003020573,16,3600,0.0,32,31,1,0,1,96.875
2003020574,21,3600,2.0,24,22,6,1,2,91.66666667
2003020574,23,3437,2.0,33,29,5,5,4,87.87878788
2003020575,3,3600,0.0,41,40,7,5,1,97.56097561
2003020575,5,3475,0.0,26,23,7,0,3,88.46153846
2003020576,11,3598,0.0,35,30,5,1,5,85.71428571
2003020576,8,3587,0.0,28,27,8,0,1,96.42857143
2003020577,2,3900,0.0,30,27,1,0,3,90.0
2003020577,6,3900,0.0,30,27,1,1,3,90.0
2003020578,7,3900,0.0,37,34,6,1,3,91.89189189
2003020578,10,3900,0.0,16,13,3,0,3,81.25
2003020579,15,3576,0.0,26,23,4,0,3,88.46153846
2003020579,9,3600,0.0,16,14,3,1,2,87.5
2003020580,4,1481,0.0,12,9,2,0,3,75.0
2003020580,4,2119,0.0,15,12,1,0,3,80.0
2003020580,14,3598,0.0,19,18,2,0,1,94.73684211
2003020581,29,3542,0.0,34,33,6,2,1,97.05882353
2003020581,13,3600,0.0,42,42,10,2,0,100.0
2003020582,24,3517,2.0,41,38,7,1,3,92.68292683
2003020582,17,3600,0.0,32,31,0,0,1,96.875
2003020583,28,3600,0.0,26,25,4,0,1,96.15384615
2003020583,19,3600,0.0,33,30,4,3,3,90.90909091
2003020584,1,3543,0.0,27,24,2,1,3,88.88888889
2003020584,18,3600,0.0,40,38,7,2,2,95.0
2003020585,23,3600,0.0,32,31,2,0,1,96.875
2003020585,20,3540,0.0,27,24,1,0,3,88.88888889
2003020586,25,3898,0.0,26,24,3,0,2,92.30769231
2003020586,26,3856,0.0,28,26,8,0,2,92.85714286
2003020587,27,3595,0.0,26,26,3,0,0,100.0
2003020587,12,3600,0.0,23,20,1,0,3,86.95652174
2003020588,15,3600,0.0,34,30,6,2,4,88.23529412
2003020588,8,3600,0.0,20,19,1,0,1,95.0
2003020589,22,3600,0.0,25,22,5,1,3,88.0
2003020589,16,3528,0.0,21,17,4,0,4,80.95238095
2003020590,30,3577,0.0,28,26,2,2,2,92.85714286
2003020590,21,3600,0.0,26,25,0,1,1,96.15384615
2003020591,20,3588,0.0,36,36,6,0,0,100.0
2003020591,3,1200,0.0,13,10,1,0,3,76.92307692
2003020591,3,2400,0.0,14,12,0,0,2,85.71428571
2003020592,22,3641,0.0,26,23,1,4,3,88.46153846
2003020592,1,3637,0.0,25,23,5,0,2,92.0
2003020593,10,3600,0.0,25,25,5,0,0,100.0
2003020593,5,3600,0.0,34,29,1,0,5,85.29411765
2003020594,18,934,2.0,10,8,1,1,2,80.0
2003020594,18,2666,2.0,17,13,2,1,4,76.47058824
2003020594,17,3600,0.0,26,26,0,1,0,100.0
2003020595,30,3900,0.0,24,23,2,0,1,95.83333333
2003020595,19,3900,0.0,24,23,2,1,1,95.83333333
2003020596,28,3600,0.0,38,37,4,0,1,97.36842105
2003020596,23,3574,0.0,19,17,1,0,2,89.47368421
2003020597,25,3867,0.0,19,17,1,2,2,89.47368421
2003020597,24,3900,0.0,23,21,4,0,2,91.30434783
2003020598,20,3600,0.0,33,31,5,0,2,93.93939394
2003020598,2,3520,2.0,34,31,4,0,3,91.17647059
2003020599,19,3513,0.0,24,22,6,0,2,91.66666667
2003020599,12,3600,0.0,19,19,1,1,0,100.0
2003020600,18,3557,0.0,21,19,2,1,2,90.47619048
2003020600,10,3600,0.0,25,24,6,1,1,96.0
2003020601,7,3574,0.0,36,34,4,0,2,94.44444444
2003020601,8,3593,0.0,35,34,5,1,1,97.14285714
2003020602,14,3600,2.0,27,22,4,1,5,81.48148148
2003020602,9,3600,0.0,29,27,1,1,2,93.10344828
2003020603,29,1200,0.0,7,5,0,3,2,71.42857143
2003020603,29,2400,0.0,29,25,0,0,4,86.20689655
2003020603,21,3594,0.0,35,35,6,0,0,100.0
2003020604,4,3900,0.0,21,20,6,1,1,95.23809524
2003020604,7,3900,2.0,45,44,2,0,1,97.77777778
2003020605,27,3600,0.0,27,27,5,2,0,100.0
2003020605,15,3498,0.0,18,16,0,2,2,88.88888889
2003020606,5,3600,0.0,33,31,4,5,2,93.93939394
2003020606,1,3548,0.0,20,17,7,1,3,85.0
2003020607,6,3576,0.0,36,36,6,1,0,100.0
2003020607,17,3600,0.0,26,23,3,2,3,88.46153846
2003020608,16,3578,0.0,18,12,0,1,6,66.66666667
2003020608,30,1438,0.0,13,10,0,0,3,76.92307692
2003020608,30,2162,0.0,16,15,1,0,1,93.75
2003020609,26,2700,0.0,15,14,1,1,1,93.33333333
2003020609,26,1200,0.0,11,8,0,0,3,72.72727273
2003020609,24,3898,0.0,28,24,2,0,4,85.71428571
2003020610,5,3579,0.0,26,24,2,0,2,92.30769231
2003020610,6,3600,0.0,32,31,2,1,1,96.875
2003020611,22,3532,0.0,29,26,4,1,3,89.65517241
2003020611,2,3599,0.0,23,21,5,2,2,91.30434783
2003020612,13,3776,0.0,49,46,7,0,3,93.87755102
2003020612,4,3776,0.0,19,15,0,1,4,78.94736842
2003020613,3,3536,0.0,23,20,3,1,3,86.95652174
2003020613,12,3591,0.0,23,21,5,0,2,91.30434783
2003020614,14,3600,0.0,15,14,1,2,1,93.33333333
2003020614,8,3600,0.0,27,23,4,0,4,85.18518519
2003020615,21,3641,0.0,23,19,2,0,4,82.60869565
2003020615,18,3668,2.0,34,31,7,1,3,91.17647059
2003020616,20,3577,0.0,23,21,5,0,2,91.30434783
2003020616,16,3596,0.0,29,28,7,1,1,96.55172414
2003020617,11,3534,0.0,26,24,2,0,2,92.30769231
2003020617,25,3600,0.0,16,15,3,0,1,93.75
2003020618,23,3587,0.0,17,16,0,0,1,94.11764706
2003020618,26,3422,0.0,28,25,5,0,3,89.28571429
2003020619,29,3891,0.0,36,34,4,2,2,94.44444444
2003020619,28,3859,0.0,25,22,4,0,3,88.0
2003020620,12,3596,0.0,16,12,4,0,4,75.0
2003020620,15,3600,0.0,30,29,11,2,1,96.66666667
2003020621,14,3596,0.0,19,18,3,3,1,94.73684211
2003020621,1,3600,0.0,37,33,5,1,4,89.18918919
2003020622,9,3534,0.0,32,29,5,1,3,90.625
2003020622,7,3594,0.0,25,23,2,0,2,92.0
2003020623,27,3600,0.0,21,21,2,0,0,100.0
2003020623,30,3563,0.0,32,30,5,2,2,93.75
2003020624,23,3600,0.0,46,44,2,0,2,95.65217391
2003020624,24,1999,0.0,20,16,0,0,4,80.0
2003020624,24,1541,0.0,4,4,0,0,0,100.0
2003020625,17,3750,0.0,35,33,8,1,2,94.28571429
2003020625,6,3744,0.0,28,27,5,5,1,96.42857143
2003020626,3,3600,0.0,30,28,2,3,2,93.33333333
2003020626,2,461,0.0,7,4,3,0,3,57.14285714
2003020626,2,3090,0.0,27,27,3,1,0,100.0
2003020627,8,3597,0.0,25,25,4,0,0,100.0
2003020627,5,3600,0.0,34,26,4,0,8,76.47058824
2003020628,21,3600,0.0,26,24,4,1,2,92.30769231
2003020628,25,3452,0.0,19,15,10,0,4,78.94736842
2003020629,11,2300,0.0,18,17,0,1,1,94.44444444
2003020629,11,1200,0.0,7,4,1,0,3,57.14285714
2003020629,28,3594,2.0,33,31,2,1,2,93.93939394
2003020630,1,3600,0.0,25,25,0,0,0,100.0
2003020630,10,3544,0.0,33,32,1,0,1,96.96969697
2003020631,22,3600,0.0,26,26,4,3,0,100.0
2003020631,4,3598,0.0,22,19,4,0,3,86.36363636
2003020632,19,3500,0.0,24,21,8,0,3,87.5
2003020632,18,3600,0.0,27,26,3,3,1,96.2962963
2003020633,13,3532,0.0,38,34,11,2,4,89.47368421
2003020633,20,3600,2.0,23,21,3,1,2,91.30434783
2003020634,29,3900,0.0,32,30,0,0,2,93.75
2003020634,26,3900,0.0,33,31,2,1,2,93.93939394
2003020635,14,3720,0.0,23,22,3,1,1,95.65217391
2003020635,3,3723,0.0,39,37,8,0,2,94.87179487
2003020636,9,3900,0.0,20,18,4,1,2,90.0
2003020636,12,3899,0.0,40,38,2,3,2,95.0
2003020637,22,3574,0.0,22,21,6,1,1,95.45454545
2003020637,15,3591,0.0,26,26,5,1,0,100.0
2003020638,11,3900,0.0,41,40,1,0,1,97.56097561
2003020638,27,3900,0.0,21,20,0,2,1,95.23809524
2003020639,21,3822,0.0,34,30,6,0,4,88.23529412
2003020639,16,3822,0.0,37,32,4,0,5,86.48648649
2003020640,29,3900,0.0,43,41,11,2,2,95.34883721
2003020640,24,3897,0.0,37,35,12,2,2,94.59459459
2003020641,13,3897,0.0,29,27,2,1,2,93.10344828
2003020641,23,3897,0.0,31,29,10,2,2,93.5483871
2003020642,7,3557,0.0,23,19,3,0,4,82.60869565
2003020642,6,3600,0.0,22,19,2,0,3,86.36363636
2003020643,5,3600,0.0,34,33,3,1,1,97.05882353
2003020643,4,3557,0.0,21,19,7,1,2,90.47619048
2003020644,16,1559,2.0,16,12,4,0,4,75.0
2003020644,16,2038,0.0,16,14,2,0,2,87.5
2003020644,19,2075,0.0,15,15,7,0,0,100.0
2003020644,19,1516,0.0,14,10,1,0,4,71.42857143
2003020645,18,3898,0.0,39,36,4,2,3,92.30769231
2003020645,30,3871,0.0,23,20,2,3,3,86.95652174
2003020646,4,3600,0.0,25,19,6,1,6,76.0
2003020646,7,3600,0.0,37,35,6,0,2,94.59459459
2003020647,2,3600,2.0,31,27,13,1,4,87.09677419
2003020647,3,3590,0.0,19,18,7,2,1,94.73684211
2003020648,20,3596,0.0,23,19,1,0,4,82.60869565
2003020648,10,3600,0.0,16,15,6,2,1,93.75
2003020649,19,3600,0.0,28,23,8,2,5,82.14285714
2003020649,8,3600,0.0,18,16,4,2,2,88.88888889
2003020650,9,3600,0.0,26,26,4,2,0,100.0
2003020650,1,3600,0.0,23,19,5,0,4,82.60869565
2003020651,14,3600,0.0,13,12,3,1,1,92.30769231
2003020651,5,3569,0.0,31,28,2,0,3,90.32258065
2003020652,26,3900,0.0,29,29,3,0,0,100.0
2003020652,18,3900,0.0,33,33,8,5,0,100.0
2003020653,24,3552,0.0,18,15,4,1,3,83.33333333
2003020653,21,3598,0.0,30,29,6,0,1,96.66666667
2003020654,13,3542,0.0,28,24,7,1,4,85.71428571
2003020654,22,3597,0.0,16,14,0,2,2,87.5
2003020655,23,3598,2.0,20,19,3,0,1,95.0
2003020655,27,3490,0.0,19,16,6,0,3,84.21052632
2003020656,25,3600,0.0,17,17,3,0,0,100.0
2003020656,28,3593,0.0,23,20,0,1,3,86.95652174
2003020657,20,3898,0.0,25,22,4,0,3,88.0
2003020657,15,3823,0.0,44,41,8,1,3,93.18181818
2003020658,8,3600,2.0,37,36,9,2,1,97.2972973
2003020658,11,3513,0.0,31,29,7,3,2,93.5483871
2003020659,16,3539,0.0,34,30,11,1,4,88.23529412
2003020659,17,3578,0.0,24,22,1,2,2,91.66666667
2003020660,26,3900,0.0,23,21,3,0,2,91.30434783
2003020660,30,3900,0.0,46,44,7,1,2,95.65217391
2003020661,6,3600,2.0,27,27,1,0,0,100.0
2003020661,7,3540,0.0,24,23,3,0,1,95.83333333
2003020662,1,3899,0.0,33,30,6,0,3,90.90909091
2003020662,3,3900,0.0,33,30,9,4,3,90.90909091
2003020663,12,204,0.0,2,0,0,0,2,0.0
2003020663,12,3369,0.0,24,21,3,2,3,87.5
2003020663,14,3600,0.0,24,20,2,0,4,83.33333333
2003020664,2,3900,0.0,44,40,12,4,4,90.90909091
2003020664,9,3900,0.0,38,34,10,4,4,89.47368421
2003020665,29,3580,0.0,25,21,5,0,4,84.0
2003020665,19,3600,0.0,26,23,3,0,3,88.46153846
2003020666,27,3600,0.0,32,28,3,0,4,87.5
2003020666,18,3575,0.0,24,21,2,0,3,87.5
2003020667,25,3600,0.0,22,18,1,2,4,81.81818182
2003020667,21,3600,0.0,30,29,2,0,1,96.66666667
2003020668,24,3547,0.0,16,15,2,0,1,93.75
2003020668,22,3600,0.0,28,28,4,0,0,100.0
2003020669,23,3487,0.0,30,27,1,3,3,90.0
2003020669,28,3600,0.0,35,34,7,1,1,97.14285714
2003020670,10,2925,0.0,17,16,3,0,1,94.11764706
2003020670,10,675,0.0,12,9,0,0,3,75.0
2003020670,4,3600,0.0,22,21,2,1,1,95.45454545
2003020671,26,3778,0.0,31,28,10,0,3,90.32258065
2003020671,29,3766,0.0,24,22,2,1,2,91.66666667
2003020672,12,3600,0.0,30,27,8,0,3,90.0
2003020672,11,3521,0.0,26,22,0,3,4,84.61538462
2003020673,27,3900,0.0,34,31,5,2,3,91.17647059
2003020673,17,3900,0.0,30,27,3,1,3,90.0
2003020674,5,3527,0.0,25,21,5,0,4,84.0
2003020674,30,3600,2.0,24,22,4,1,2,91.66666667
2003020675,15,3737,0.0,31,29,5,0,2,93.5483871
2003020675,1,3730,2.0,19,18,4,1,1,94.73684211
2003020676,4,3600,0.0,34,34,7,2,0,100.0
2003020676,10,3592,0.0,24,20,2,0,4,83.33333333
2003020677,3,3900,0.0,27,25,2,0,2,92.59259259
2003020677,8,3900,0.0,29,27,2,2,2,93.10344828
2003020678,6,3600,4.0,23,19,7,0,4,82.60869565
2003020678,9,3600,0.0,20,20,1,0,0,100.0
2003020679,7,3516,0.0,23,19,4,0,4,82.60869565
2003020679,2,3593,2.0,29,27,3,0,2,93.10344828
2003020680,14,3488,0.0,15,13,0,0,2,86.66666667
2003020680,13,3600,0.0,51,50,9,0,1,98.03921569
2003020681,30,3900,0.0,34,32,2,1,2,94.11764706
2003020681,19,3848,0.0,17,15,1,0,2,88.23529412
2003020682,22,3478,0.0,31,29,9,3,2,93.5483871
2003020682,18,3600,0.0,22,21,5,1,1,95.45454545
2003020683,28,3600,0.0,33,32,11,2,1,96.96969697
2003020683,21,3547,0.0,24,22,4,0,2,91.66666667
2003020684,25,3600,0.0,21,19,2,0,2,90.47619048
2003020684,20,3566,0.0,26,23,1,0,3,88.46153846
2003020685,24,3600,0.0,25,24,1,0,1,96.0
2003020685,23,3522,0.0,31,29,2,1,2,93.5483871
2003020686,5,3563,0.0,26,22,7,2,4,84.61538462
2003020686,15,3600,0.0,25,22,0,2,3,88.0
2003020687,11,3591,0.0,31,29,5,1,2,93.5483871
2003020687,12,3509,0.0,25,21,7,0,4,84.0
2003020688,22,3900,0.0,38,34,9,0,4,89.47368421
2003020688,29,3900,0.0,30,26,5,1,4,86.66666667
2003020689,26,3600,0.0,35,34,6,0,1,97.14285714
2003020689,16,3593,0.0,22,20,1,2,2,90.90909091
2003020690,9,3600,0.0,23,18,6,1,5,78.26086957
2003020690,2,3600,0.0,32,30,2,5,2,93.75
2003020691,3,3600,0.0,22,17,5,1,5,77.27272727
2003020691,6,3600,0.0,36,34,10,1,2,94.44444444
2003020692,19,3648,2.0,22,21,6,2,1,95.45454545
2003020692,13,3648,0.0,34,32,11,0,2,94.11764706
2003020693,21,3659,0.0,35,31,6,0,4,88.57142857
2003020693,14,3659,0.0,24,19,0,1,5,79.16666667
2003020694,30,3550,0.0,30,28,4,2,2,93.33333333
2003020694,18,3600,0.0,26,26,9,1,0,100.0
2003020695,20,3584,0.0,37,36,13,1,1,97.2972973
2003020695,24,3600,2.0,27,22,5,0,5,81.48148148
2003020696,17,3531,0.0,24,22,2,0,2,91.66666667
2003020696,28,3596,0.0,35,34,6,2,1,97.14285714
2003020697,25,3600,0.0,25,23,1,1,2,92.0
2003020697,23,3537,0.0,20,17,5,1,3,85.0
2003020698,6,3597,0.0,32,31,0,2,1,96.875
2003020698,3,3592,0.0,34,30,6,0,4,88.23529412
2003020699,8,3600,0.0,23,22,5,0,1,95.65217391
2003020699,4,3600,0.0,22,18,3,1,4,81.81818182
2003020700,9,3600,0.0,14,13,1,1,1,92.85714286
2003020700,12,3517,0.0,29,27,2,0,2,93.10344828
2003020701,2,3532,0.0,21,19,2,0,2,90.47619048
2003020701,10,3597,0.0,25,25,4,0,0,100.0
2003020702,1,3600,0.0,25,25,5,0,0,100.0
2003020702,5,3600,0.0,19,16,3,1,3,84.21052632
2003020703,7,3598,0.0,23,19,10,1,4,82.60869565
2003020703,11,3592,0.0,25,24,3,5,1,96.0
2003020704,25,3590,0.0,24,21,1,2,3,87.5
2003020704,22,3600,0.0,16,16,1,0,0,100.0
2003020705,20,160,0.0,0,0,0,0,0,
2003020705,20,3353,0.0,35,32,14,1,3,91.42857143
2003020705,26,3600,0.0,21,20,6,1,1,95.23809524
2003020706,10,3600,0.0,23,21,6,2,2,91.30434783
2003020706,15,3534,0.0,21,18,2,0,3,85.71428571
2003020707,19,3467,0.0,30,27,10,3,3,90.0
2003020707,29,3600,0.0,28,27,6,2,1,96.42857143
2003020708,12,3600,0.0,21,20,2,0,1,95.23809524
2003020708,1,3537,0.0,23,21,6,0,2,91.30434783
2003020709,21,3589,0.0,29,24,4,0,5,82.75862069
2003020709,13,3474,0.0,29,23,0,3,6,79.31034483
2003020709,13,64,0.0,1,1,0,0,0,100.0
2003020710,16,3594,0.0,24,21,4,2,3,87.5
2003020710,30,3598,0.0,31,29,5,0,2,93.5483871
2003020711,28,3576,0.0,28,26,5,2,2,92.85714286
2003020711,27,3587,0.0,38,34,10,1,4,89.47368421
2003020712,14,3879,0.0,28,23,2,0,5,82.14285714
2003020712,23,3879,2.0,35,31,6,1,4,88.57142857
2003020713,17,3892,0.0,30,28,0,1,2,93.33333333
2003020713,24,3888,0.0,24,22,5,0,2,91.66666667
2003020714,7,3600,0.0,25,23,1,0,2,92.0
2003020714,6,3530,0.0,28,26,6,2,2,92.85714286
2003020715,5,2399,0.0,23,17,1,2,6,73.91304348
2003020715,5,1189,0.0,8,8,2,0,0,100.0
2003020715,9,3600,0.0,27,22,1,2,5,81.48148148
2003020716,21,3900,0.0,21,20,11,1,1,95.23809524
2003020716,11,3900,0.0,21,20,4,1,1,95.23809524
2003020717,4,3597,0.0,25,23,2,2,2,92.0
2003020717,3,1200,0.0,7,6,0,0,1,85.71428571
2003020717,3,2400,0.0,20,17,0,1,3,85.0
2003020718,29,3600,0.0,39,32,7,1,7,82.05128205
2003020718,16,3596,0.0,30,30,3,1,0,100.0
2003020719,18,1729,0.0,11,11,6,0,0,100.0
2003020719,18,1871,0.0,17,13,1,0,4,76.47058824
2003020719,20,3600,0.0,23,23,6,0,0,100.0
2003020720,14,3588,0.0,28,26,2,2,2,92.85714286
2003020720,22,3553,0.0,22,19,1,0,3,86.36363636
2003020721,17,3600,0.0,29,25,4,2,4,86.20689655
2003020721,26,3499,0.0,29,24,4,0,5,82.75862069
2003020722,27,3600,0.0,35,34,6,1,1,97.14285714
2003020722,28,3524,0.0,20,18,0,0,2,90.0
2003020723,2,3600,0.0,27,25,4,0,2,92.59259259
2003020723,12,3516,0.0,21,18,2,0,3,85.71428571
2003020724,8,3600,0.0,24,22,1,0,2,91.66666667
2003020724,1,3599,0.0,21,21,2,0,0,100.0
2003020725,15,3510,0.0,39,35,16,2,4,89.74358974
2003020725,13,3574,0.0,29,28,5,3,1,96.55172414
2003020726,19,3502,0.0,20,18,4,0,2,90.0
2003020726,25,3600,0.0,33,33,11,0,0,100.0
2003020727,30,3570,0.0,47,41,13,0,6,87.23404255
2003020727,24,3600,0.0,11,9,1,1,2,81.81818182
2003020728,7,3557,0.0,22,20,1,2,2,90.90909091
2003020728,4,3600,0.0,26,25,5,2,1,96.15384615
2003020729,13,3600,0.0,44,43,2,4,1,97.72727273
2003020729,6,3510,0.0,26,24,8,0,2,92.30769231
2003020730,10,3600,0.0,15,14,3,0,1,93.33333333
2003020730,8,3600,0.0,25,21,1,0,4,84.0
2003020731,3,2400,0.0,19,13,7,0,6,68.42105263
2003020731,3,1200,0.0,6,3,0,0,3,50.0
2003020731,9,3593,0.0,29,28,2,0,1,96.55172414
2003020732,2,3595,0.0,25,25,11,3,0,100.0
2003020732,11,3459,0.0,26,23,4,2,3,88.46153846
2003020733,16,3525,2.0,34,30,10,2,4,88.23529412
2003020733,29,3591,0.0,23,20,6,3,3,86.95652174
2003020734,21,3600,0.0,28,25,4,1,3,89.28571429
2003020734,5,3460,0.0,33,28,6,1,5,84.84848485
2003020735,25,3600,2.0,21,19,2,1,2,90.47619048
2003020735,19,3547,0.0,23,20,2,0,3,86.95652174
2003020736,17,2396,0.0,8,4,0,0,4,50.0
2003020736,17,1087,0.0,5,5,2,0,0,100.0
2003020736,27,3600,0.0,46,44,14,1,2,95.65217391
2003020737,14,3600,0.0,20,18,3,1,2,90.0
2003020737,20,3597,0.0,29,23,7,0,6,79.31034483
2003020738,18,3600,0.0,25,22,5,1,3,88.0
2003020738,22,2396,0.0,14,10,3,0,4,71.42857143
2003020738,22,1099,0.0,5,5,2,0,0,100.0
2003020739,24,3499,0.0,31,27,4,3,4,87.09677419
2003020739,26,3600,0.0,32,30,6,1,2,93.75
2003020740,30,3600,0.0,37,33,4,0,4,89.18918919
2003020740,28,3597,0.0,24,24,2,0,0,100.0
2003020741,7,3600,0.0,39,37,7,1,2,94.87179487
2003020741,12,3527,0.0,21,17,3,3,4,80.95238095
2003020742,4,3593,0.0,13,12,3,0,1,92.30769231
2003020742,15,3600,0.0,22,18,0,2,4,81.81818182
2003020743,11,3542,0.0,34,31,10,1,3,91.17647059
2003020743,1,3600,0.0,26,24,6,1,2,92.30769231
2003020744,18,3592,0.0,32,28,5,0,4,87.5
2003020744,23,3600,0.0,16,15,2,3,1,93.75
2003020745,13,3554,0.0,37,33,2,2,4,89.18918919
2003020745,3,3541,0.0,40,38,9,0,2,95.0
2003020746,17,3900,0.0,29,27,1,0,2,93.10344828
2003020746,25,3900,0.0,26,24,4,0,2,92.30769231
2003020747,30,3899,0.0,36,34,7,0,2,94.44444444
2003020747,26,3896,0.0,23,21,3,0,2,91.30434783
2003020748,8,3600,0.0,28,24,2,3,4,85.71428571
2003020748,7,3600,2.0,30,29,7,1,1,96.66666667
2003020749,6,3894,0.0,28,26,0,1,2,92.85714286
2003020749,2,3900,0.0,37,35,0,0,2,94.59459459
2003020750,1,3600,0.0,31,28,6,0,3,90.32258065
2003020750,29,3565,0.0,38,35,6,0,3,92.10526316
2003020751,12,3600,0.0,32,32,6,0,0,100.0
2003020751,10,3502,0.0,19,17,2,3,2,89.47368421
2003020752,14,3600,0.0,22,20,0,0,2,90.90909091
2003020752,5,3590,0.0,38,33,6,0,5,86.84210526
2003020753,22,3567,0.0,22,19,0,3,3,86.36363636
2003020753,21,3600,0.0,34,33,3,0,1,97.05882353
2003020754,20,3600,0.0,12,11,2,0,1,91.66666667
2003020754,27,3562,0.0,34,32,2,0,2,94.11764706
2003020755,16,3539,0.0,30,27,8,0,3,90.0
2003020755,23,3600,0.0,20,18,3,0,2,90.0
2003020756,15,3600,0.0,33,32,7,1,1,96.96969697
2003020756,3,3529,0.0,24,22,1,0,2,91.66666667
2003020756,3,7,0.0,0,0,0,0,0,
2003020757,4,3900,0.0,25,22,3,0,3,88.0
2003020757,13,3890,0.0,47,44,9,1,3,93.61702128
2003020758,19,3900,0.0,23,22,3,0,1,95.65217391
2003020758,11,3900,0.0,31,30,6,1,1,96.77419355
2003020759,9,3600,0.0,27,22,1,3,5,81.48148148
2003020759,25,3599,0.0,24,21,5,1,3,87.5
2003020760,26,3757,0.0,25,22,2,0,3,88.0
2003020760,24,3750,0.0,30,26,7,1,4,86.66666667
2003020761,20,3528,0.0,34,31,10,1,3,91.17647059
2003020761,28,3600,0.0,19,18,5,1,1,94.73684211
2003020762,15,3600,0.0,35,32,7,0,3,91.42857143
2003020762,12,3570,0.0,18,14,0,2,4,77.77777778
2003020763,5,3591,0.0,32,27,1,3,5,84.375
2003020763,14,3585,0.0,14,13,1,1,1,92.85714286
2003020764,18,3600,0.0,31,27,3,0,4,87.09677419
2003020764,29,1329,0.0,16,12,3,0,4,75.0
2003020764,29,2206,0.0,15,13,3,0,2,86.66666667
2003020765,1,3567,0.0,19,15,3,0,4,78.94736842
2003020765,17,3600,0.0,33,31,13,0,2,93.93939394
2003020766,2,3745,0.0,38,36,4,2,2,94.73684211
2003020766,6,3732,0.0,24,23,5,0,1,95.83333333
2003020767,23,3590,0.0,33,31,10,2,2,93.93939394
2003020767,19,3481,0.0,27,23,10,0,4,85.18518519
2003020768,8,3872,0.0,29,27,2,0,2,93.10344828
2003020768,30,3863,0.0,29,26,2,0,3,89.65517241
2003020769,16,3521,0.0,31,27,4,1,4,87.09677419
2003020769,22,3600,0.0,32,30,10,1,2,93.75
2003020770,9,3600,0.0,21,20,3,1,1,95.23809524
2003020770,27,3504,0.0,24,21,4,0,3,87.5
2003020771,21,3900,0.0,31,28,3,1,3,90.32258065
2003020771,26,3899,0.0,29,26,6,2,3,89.65517241
2003020772,7,3598,0.0,34,33,1,1,1,97.05882353
2003020772,3,3582,0.0,34,32,6,1,2,94.11764706
2003020773,10,3600,0.0,26,25,5,0,1,96.15384615
2003020773,11,2400,0.0,18,15,1,0,3,83.33333333
2003020773,11,1200,0.0,9,8,4,0,1,88.88888889
2003020774,28,3570,0.0,35,33,10,1,2,94.28571429
2003020774,25,3600,0.0,15,14,1,0,1,93.33333333
2003020775,16,3592,0.0,33,30,8,0,3,90.90909091
2003020775,20,3519,0.0,34,29,4,2,5,85.29411765
2003020776,21,3807,0.0,24,20,7,1,4,83.33333333
2003020776,24,3798,0.0,32,29,10,2,3,90.625
2003020777,4,3600,0.0,30,27,6,0,3,90.0
2003020777,5,3576,0.0,31,27,3,0,4,87.09677419
2003020778,6,3600,0.0,34,34,2,1,0,100.0
2003020778,8,3565,0.0,16,15,3,1,1,93.75
2003020779,3,3529,0.0,28,26,9,0,2,92.85714286
2003020779,7,3592,0.0,32,31,7,1,1,96.875
2003020780,9,3589,0.0,25,20,4,4,5,80.0
2003020780,10,3600,4.0,25,24,13,1,1,96.0
2003020781,13,3526,0.0,30,27,2,3,3,90.0
2003020781,2,3600,0.0,28,26,3,1,2,92.85714286
2003020782,23,3597,0.0,16,15,0,0,1,93.75
2003020782,15,3600,0.0,40,34,8,1,6,85.0
2003020783,12,3900,0.0,44,40,11,2,4,90.90909091
2003020783,17,1200,0.0,8,5,2,0,3,62.5
2003020783,17,2700,0.0,10,9,1,0,1,90.0
2003020784,30,3779,0.0,29,27,7,0,2,93.10344828
2003020784,29,3773,2.0,32,31,7,0,1,96.875
2003020785,11,3507,0.0,37,33,4,0,4,89.18918919
2003020785,14,3600,0.0,23,21,5,4,2,91.30434783
2003020786,1,3600,0.0,31,30,8,2,1,96.77419355
2003020786,19,3516,2.0,24,21,4,0,3,87.5
2003020787,28,3884,2.0,30,27,6,0,3,90.0
2003020787,18,3882,0.0,26,24,1,0,2,92.30769231
2003020788,25,3600,2.0,25,21,7,0,4,84.0
2003020788,27,3532,0.0,27,22,1,1,5,81.48148148
2003020789,26,3570,0.0,36,33,6,0,3,91.66666667
2003020789,22,3594,0.0,17,13,4,0,4,76.47058824
2003020790,5,3578,0.0,45,43,5,2,2,95.55555556
2003020790,6,3600,0.0,39,38,4,1,1,97.43589744
2003020791,16,1709,0.0,14,13,4,0,1,92.85714286
2003020791,16,1817,0.0,12,8,1,0,4,66.66666667
2003020791,8,3593,0.0,41,37,3,1,4,90.24390244
2003020792,24,2801,0.0,14,11,1,0,3,78.57142857
2003020792,24,689,0.0,8,5,0,0,3,62.5
2003020792,20,3600,0.0,24,20,3,2,4,83.33333333
2003020793,23,3520,0.0,31,27,9,1,4,87.09677419
2003020793,3,3600,0.0,30,27,8,2,3,90.0
2003020794,14,3600,0.0,19,18,0,0,1,94.73684211
2003020794,4,1523,0.0,10,10,0,0,0,100.0
2003020794,4,1992,0.0,8,6,0,0,2,75.0
2003020795,19,2020,0.0,11,10,1,0,1,90.90909091
2003020795,19,1580,0.0,9,6,3,0,3,66.66666667
2003020795,30,3600,0.0,24,24,6,1,0,100.0
2003020796,24,3636,0.0,28,26,4,0,2,92.85714286
2003020796,22,3635,0.0,20,19,3,0,1,95.0
2003020797,29,3898,0.0,32,29,6,1,3,90.625
2003020797,27,122,0.0,1,1,0,0,0,100.0
2003020797,27,3778,0.0,28,25,6,1,3,89.28571429
2003020798,11,3517,0.0,29,24,1,0,5,82.75862069
2003020798,6,3600,0.0,30,26,3,0,4,86.66666667
2003020799,23,3630,0.0,28,23,3,2,5,82.14285714
2003020799,2,3636,0.0,25,21,7,1,4,84.0
2003020800,14,3537,0.0,14,12,3,1,2,85.71428571
2003020800,15,3600,0.0,39,38,6,0,1,97.43589744
2003020801,16,3600,2.0,44,43,10,3,1,97.72727273
2003020801,10,3600,0.0,15,11,0,1,4,73.33333333
2003020802,9,3565,0.0,26,24,2,0,2,92.30769231
2003020802,1,3600,0.0,24,23,0,1,1,95.83333333
2003020803,8,3600,0.0,35,32,6,3,3,91.42857143
2003020803,5,3534,0.0,30,26,3,0,4,86.66666667
2003020804,17,3600,0.0,24,23,3,0,1,95.83333333
2003020804,18,1952,0.0,14,14,0,0,0,100.0
2003020804,18,1577,0.0,11,8,3,0,3,72.72727273
2003020805,12,1744,0.0,18,15,3,0,3,83.33333333
2003020805,12,1723,0.0,2,2,0,1,0,100.0
2003020805,21,3600,0.0,37,36,2,2,1,97.2972973
2003020806,26,1291,0.0,13,10,0,0,3,76.92307692
2003020806,26,2609,0.0,22,21,1,0,1,95.45454545
2003020806,20,3900,0.0,29,25,1,0,4,86.20689655
2003020807,13,3600,0.0,28,25,3,1,3,89.28571429
2003020807,28,3600,2.0,26,26,3,1,0,100.0
2003020808,30,3597,2.0,28,25,2,0,3,89.28571429
2003020808,3,3536,0.0,22,18,2,1,4,81.81818182
2003020809,15,3590,0.0,40,36,7,2,4,90.0
2003020809,4,3600,0.0,20,19,4,0,1,95.0
2003020810,29,3492,0.0,29,28,3,1,1,96.55172414
2003020810,25,3600,0.0,18,18,8,1,0,100.0
2003020811,13,3798,2.0,28,24,12,1,4,85.71428571
2003020811,27,3797,0.0,28,23,2,2,5,82.14285714
2003020812,19,2400,0.0,22,18,6,1,4,81.81818182
2003020812,19,1121,0.0,9,8,0,0,1,88.88888889
2003020812,22,3600,0.0,26,23,7,1,3,88.46153846
2003020813,12,3560,0.0,43,40,10,1,3,93.02325581
2003020813,24,3600,0.0,24,22,6,2,2,91.66666667
2003020814,6,3600,0.0,28,26,5,1,2,92.85714286
2003020814,7,1200,0.0,5,3,1,0,2,60.0
2003020814,7,2400,0.0,16,12,3,2,4,75.0
2003020815,2,3527,0.0,38,36,8,1,2,94.73684211
2003020815,8,3600,0.0,28,27,2,1,1,96.42857143
2003020816,10,3869,0.0,30,26,9,0,4,86.66666667
2003020816,9,3866,0.0,27,22,6,1,5,81.48148148
2003020817,23,3600,0.0,24,24,0,1,0,100.0
2003020817,1,3600,0.0,22,18,3,0,4,81.81818182
2003020818,4,3597,0.0,21,20,3,2,1,95.23809524
2003020818,11,3599,0.0,31,26,3,1,5,83.87096774
2003020819,14,3594,0.0,26,24,6,1,2,92.30769231
2003020819,18,3566,0.0,28,24,3,3,4,85.71428571
2003020820,19,3600,0.0,20,19,2,1,1,95.0
2003020820,20,3545,0.0,26,24,7,0,2,92.30769231
2003020821,17,3657,0.0,31,29,14,0,2,93.5483871
2003020821,21,3657,0.0,31,28,4,4,3,90.32258065
2003020822,27,3600,0.0,35,30,14,0,5,85.71428571
2003020822,28,3595,0.0,20,20,3,3,0,100.0
2003020823,28,3513,0.0,35,33,4,0,2,94.28571429
2003020823,7,3595,0.0,28,27,4,1,1,96.42857143
2003020824,1,3600,0.0,27,23,10,1,4,85.18518519
2003020824,4,3598,0.0,36,35,2,0,1,97.22222222
2003020825,10,3879,0.0,29,25,1,1,4,86.20689655
2003020825,14,3900,0.0,29,25,5,0,4,86.20689655
2003020826,19,185,0.0,0,0,0,0,0,
2003020826,19,3293,0.0,31,28,2,0,3,90.32258065
2003020826,9,3600,0.0,23,22,5,0,1,95.65217391
2003020827,6,3600,0.0,33,30,4,0,3,90.90909091
2003020827,5,3534,0.0,26,21,5,0,5,80.76923077
2003020828,8,3531,0.0,22,20,2,0,2,90.90909091
2003020828,13,3600,0.0,41,40,9,0,1,97.56097561
2003020829,26,3600,0.0,23,22,5,1,1,95.65217391
2003020829,30,3578,0.0,31,29,5,1,2,93.5483871
2003020830,20,3596,0.0,25,23,9,0,2,92.0
2003020831,2,3900,2.0,37,36,10,2,1,97.2972973
2003020831,21,3900,0.0,36,35,5,1,1,97.22222222
2003020832,26,3716,0.0,34,31,8,0,3,91.17647059
2003020832,29,3706,0.0,32,30,3,1,2,93.75
2003020833,3,3600,0.0,29,28,3,4,1,96.55172414
2003020833,1,3512,0.0,16,13,2,0,3,81.25
2003020834,28,3516,0.0,33,29,1,5,4,87.87878788
2003020834,17,1200,0.0,5,5,1,0,0,100.0
2003020834,17,2400,0.0,19,17,1,0,2,89.47368421
2003020835,18,1904,0.0,14,14,1,0,0,100.0
2003020835,18,1694,0.0,18,13,1,0,5,72.22222222
2003020835,16,3587,0.0,27,25,5,2,2,92.59259259
2003020836,2,3900,2.0,35,31,9,0,4,88.57142857
2003020836,25,3849,0.0,23,19,4,2,4,82.60869565
2003020837,11,1200,0.0,17,15,0,1,2,88.23529412
2003020837,11,2291,17.0,15,13,1,0,2,86.66666667
2003020837,22,109,0.0,2,2,0,2,0,100.0
2003020837,22,3490,17.0,23,22,1,0,1,95.65217391
2003020838,20,3600,0.0,34,32,10,0,2,94.11764706
2003020838,23,3554,0.0,29,26,4,0,3,89.65517241
2003020839,27,3503,2.0,28,23,8,2,5,82.14285714
2003020839,24,3599,0.0,25,22,12,0,3,88.0
2003020840,4,3600,0.0,27,26,0,0,1,96.2962963
2003020840,3,3525,0.0,20,18,4,0,2,90.0
2003020841,15,3886,0.0,41,38,10,2,3,92.68292683
2003020841,12,3897,0.0,21,18,2,0,3,85.71428571
2003020842,8,3556,0.0,40,36,6,1,4,90.0
2003020842,14,3590,0.0,25,22,5,1,3,88.0
2003020843,29,3563,0.0,27,24,4,1,3,88.88888889
2003020843,10,3584,0.0,19,18,2,0,1,94.73684211
2003020844,6,3662,0.0,27,24,2,1,3,88.88888889
2003020844,9,3683,0.0,24,22,2,0,2,91.66666667
2003020845,5,1322,0.0,8,6,1,1,2,75.0
2003020845,5,2278,0.0,29,26,3,4,3,89.65517241
2003020845,13,3600,0.0,35,34,6,5,1,97.14285714
2003020846,21,3600,0.0,29,29,7,1,0,100.0
2003020846,19,3582,0.0,24,20,7,1,4,83.33333333
2003020847,26,2434,2.0,22,17,5,1,5,77.27272727
2003020847,26,1166,0.0,14,11,3,0,3,78.57142857
2003020847,7,3600,0.0,24,21,2,0,3,87.5
2003020848,15,3600,0.0,36,31,9,2,5,86.11111111
2003020848,18,3591,0.0,19,17,3,1,2,89.47368421
2003020849,22,2268,0.0,16,15,9,0,1,93.75
2003020849,22,1200,0.0,14,12,1,0,2,85.71428571
2003020849,30,3598,0.0,28,28,1,2,0,100.0
2003020850,24,3540,0.0,24,22,5,0,2,91.66666667
2003020850,20,3595,0.0,26,25,5,0,1,96.15384615
2003020851,2,3600,0.0,24,22,8,2,2,91.66666667
2003020851,27,3533,0.0,28,24,3,1,4,85.71428571
2003020852,11,3596,0.0,31,30,10,3,1,96.77419355
2003020852,23,3562,10.0,18,14,5,1,4,77.77777778
2003020852,23,35,0.0,1,1,1,0,0,100.0
2003020853,12,3599,0.0,26,22,2,1,4,84.61538462
2003020853,1,3600,0.0,15,14,0,0,1,93.33333333
2003020854,3,1200,0.0,5,5,2,0,0,100.0
2003020854,3,2400,0.0,18,12,3,0,6,66.66666667
2003020854,4,3599,0.0,27,25,7,0,2,92.59259259
2003020855,21,3600,0.0,30,28,4,1,2,93.33333333
2003020855,17,3557,0.0,29,25,7,0,4,86.20689655
2003020856,6,3840,0.0,26,24,5,1,2,92.30769231
2003020856,16,3840,0.0,32,31,0,1,1,96.875
2003020857,7,1628,0.0,18,17,2,1,1,94.44444444
2003020857,7,1972,0.0,18,15,2,0,3,83.33333333
2003020857,10,3561,0.0,31,26,6,2,5,83.87096774
2003020858,8,740,0.0,6,6,2,0,0,100.0
2003020858,8,2806,0.0,25,21,0,2,4,84.0
2003020858,9,3581,0.0,22,20,9,1,2,90.90909091
2003020859,28,3883,0.0,24,23,3,0,1,95.83333333
2003020859,29,3883,0.0,50,48,6,3,2,96.0
2003020860,13,3505,0.0,36,33,2,0,3,91.66666667
2003020860,14,3600,0.0,31,29,7,0,2,93.5483871
2003020861,5,3726,0.0,26,23,2,1,3,88.46153846
2003020861,19,3726,0.0,24,22,8,0,2,91.66666667
2003020862,25,3492,2.0,21,18,6,1,3,85.71428571
2003020862,27,3600,0.0,34,32,8,1,2,94.11764706
2003020863,24,3600,0.0,35,34,4,1,1,97.14285714
2003020863,23,3521,0.0,33,31,4,3,2,93.93939394
2003020864,26,3833,0.0,35,32,6,0,3,91.42857143
2003020864,1,3825,0.0,26,24,3,2,2,92.30769231
2003020865,20,3585,0.0,16,15,1,1,1,93.75
2003020865,30,3565,0.0,16,14,1,0,2,87.5
2003020866,22,3900,0.0,32,30,4,1,2,93.75
2003020866,18,3900,0.0,29,27,7,2,2,93.10344828
2003020867,15,3600,0.0,38,38,14,2,0,100.0
2003020867,16,3586,0.0,33,29,6,1,4,87.87878788
2003020868,26,3900,0.0,37,36,11,2,1,97.2972973
2003020868,2,3878,2.0,30,29,4,1,1,96.66666667
2003020869,9,3600,0.0,15,14,2,0,1,93.33333333
2003020869,3,3596,0.0,31,27,7,0,4,87.09677419
2003020870,11,2012,0.0,19,15,5,1,4,78.94736842
2003020870,11,1566,0.0,16,13,1,3,3,81.25
2003020870,7,3600,0.0,25,23,12,3,2,92.0
2003020871,27,3557,0.0,31,28,2,1,3,90.32258065
2003020871,19,3600,0.0,21,19,3,0,2,90.47619048
2003020872,13,3503,0.0,22,20,8,2,2,90.90909091
2003020872,12,3580,0.0,21,20,4,4,1,95.23809524
2003020873,18,3493,0.0,23,19,3,2,4,82.60869565
2003020873,29,3600,2.0,34,32,2,4,2,94.11764706
2003020874,10,3600,0.0,26,22,5,1,4,84.61538462
2003020874,5,2391,0.0,28,23,7,1,5,82.14285714
2003020874,5,1200,0.0,9,6,1,0,3,66.66666667
2003020875,22,3546,0.0,26,24,0,1,2,92.30769231
2003020875,17,3600,0.0,30,29,1,1,1,96.66666667
2003020876,28,3598,0.0,22,20,1,1,2,90.90909091
2003020876,4,3600,0.0,20,15,2,0,5,75.0
2003020877,25,3564,0.0,24,22,8,0,2,91.66666667
2003020877,24,3592,0.0,37,36,7,0,1,97.2972973
2003020878,23,3584,0.0,23,23,4,3,0,100.0
2003020878,21,3519,0.0,21,20,3,2,1,95.23809524
2003020879,9,3900,0.0,19,18,4,0,1,94.73684211
2003020879,15,3889,0.0,48,47,15,0,1,97.91666667
2003020880,4,3600,0.0,36,31,14,0,5,86.11111111
2003020880,14,3600,0.0,20,18,3,0,2,90.0
2003020881,6,3600,0.0,24,22,6,1,2,91.66666667
2003020881,10,3594,0.0,26,21,6,3,5,80.76923077
2003020882,11,3600,2.0,30,29,5,1,1,96.66666667
2003020882,8,3598,0.0,25,21,3,1,4,84.0
2003020883,30,3900,0.0,36,32,7,0,4,88.88888889
2003020883,1,3900,0.0,34,30,8,0,4,88.23529412
2003020884,13,3896,0.0,42,41,14,2,1,97.61904762
2003020884,7,3896,0.0,23,22,0,2,1,95.65217391
2003020885,5,3569,0.0,34,30,7,1,4,88.23529412
2003020885,2,3600,0.0,21,18,2,1,3,85.71428571
2003020886,27,3566,0.0,33,29,3,3,4,87.87878788
2003020886,17,3600,0.0,26,24,2,0,2,92.30769231
2003020887,28,2400,0.0,14,9,2,0,5,64.28571429
2003020887,28,1200,0.0,6,4,1,0,2,66.66666667
2003020887,18,3597,0.0,27,24,4,0,3,88.88888889
2003020888,22,3600,0.0,15,14,1,1,1,93.33333333
2003020888,21,2732,2.0,24,20,6,1,4,83.33333333
2003020888,21,868,0.0,6,5,1,0,1,83.33333333
2003020889,29,3568,0.0,33,31,9,1,2,93.93939394
2003020889,24,3596,0.0,20,19,4,1,1,95.0
2003020890,25,3600,0.0,28,25,0,1,3,89.28571429
2003020890,26,1967,0.0,17,14,3,1,3,82.35294118
2003020890,26,1579,0.0,14,13,1,0,1,92.85714286
2003020891,2,404,10.0,5,5,4,0,0,100.0
2003020891,2,3196,2.0,31,25,3,0,6,80.64516129
2003020891,3,3600,0.0,32,30,10,0,2,93.75
2003020892,1,3490,0.0,26,23,6,0,3,88.46153846
2003020892,15,3600,0.0,44,43,10,2,1,97.72727273
2003020893,10,3738,0.0,35,34,8,0,1,97.14285714
2003020893,12,3738,0.0,22,20,3,1,2,90.90909091
2003020894,20,3551,0.0,31,28,2,2,3,90.32258065
2003020894,8,3600,0.0,20,19,3,3,1,95.0
2003020895,11,3636,0.0,33,31,7,2,2,93.93939394
2003020895,9,3672,0.0,17,14,3,1,3,82.35294118
2003020896,6,3600,0.0,27,24,2,0,3,88.88888889
2003020896,4,3564,0.0,41,37,2,0,4,90.24390244
2003020897,28,3600,0.0,34,31,3,1,3,91.17647059
2003020897,16,3587,0.0,29,24,9,0,5,82.75862069
2003020898,14,3666,0.0,29,25,2,2,4,86.20689655
2003020898,19,3666,0.0,23,20,5,2,3,86.95652174
2003020899,23,1393,0.0,10,6,0,2,4,60.0
2003020899,23,2194,2.0,12,10,2,1,2,83.33333333
2003020899,30,3600,0.0,28,26,3,0,2,92.85714286
2003020900,13,3595,0.0,34,34,5,0,0,100.0
2003020900,5,3505,0.0,32,30,1,5,2,93.75
2003020901,19,3590,0.0,38,33,9,2,5,86.84210526
2003020901,17,3593,0.0,26,25,5,1,1,96.15384615
2003020902,14,3685,0.0,26,22,1,1,4,84.61538462
2003020902,7,3781,0.0,33,30,4,1,3,90.90909091
2003020903,21,3600,0.0,22,17,2,0,5,77.27272727
2003020903,25,3584,0.0,16,15,0,1,1,93.75
2003020904,29,3567,0.0,31,28,4,1,3,90.32258065
2003020904,27,3600,0.0,28,26,7,0,2,92.85714286
2003020905,18,3794,0.0,39,37,3,0,2,94.87179487
2003020905,24,3814,0.0,33,30,3,0,3,90.90909091
2003020906,1,3600,0.0,29,26,10,0,3,89.65517241
2003020906,3,2234,0.0,16,14,0,0,2,87.5
2003020906,3,1357,0.0,17,12,1,1,5,70.58823529
2003020907,11,3554,0.0,32,27,1,0,5,84.375
2003020907,4,3600,0.0,36,32,4,0,4,88.88888889
2003020908,20,3538,0.0,24,22,3,2,2,91.66666667
2003020908,9,3600,0.0,19,18,1,0,1,94.73684211
2003020909,8,1057,0.0,11,8,1,0,3,72.72727273
2003020909,8,2479,0.0,14,12,3,0,2,85.71428571
2003020909,10,3600,0.0,31,27,1,0,4,87.09677419
2003020910,7,1200,0.0,11,11,2,0,0,100.0
2003020910,7,2400,0.0,25,21,0,0,4,84.0
2003020910,2,3600,0.0,25,24,1,0,1,96.0
2003020911,13,3897,0.0,25,23,9,0,2,92.0
2003020911,15,3900,0.0,24,22,7,1,2,91.66666667
2003020912,6,3897,0.0,37,34,4,0,3,91.89189189
2003020912,12,3900,0.0,28,25,2,1,3,89.28571429
2003020913,18,3600,0.0,26,24,4,3,2,92.30769231
2003020913,27,1828,0.0,14,9,2,0,5,64.28571429
2003020913,27,1772,0.0,15,12,5,2,3,80.0
2003020914,23,3836,0.0,38,34,4,1,4,89.47368421
2003020914,22,3830,0.0,21,18,2,1,3,85.71428571
2003020915,29,3580,0.0,42,38,9,0,4,90.47619048
2003020915,26,3572,0.0,21,18,4,2,3,85.71428571
2003020916,20,3588,0.0,25,23,2,4,2,92.0
2003020916,1,3600,0.0,19,18,3,0,1,94.73684211
2003020917,9,3600,0.0,26,23,1,1,3,88.46153846
2003020917,5,3517,0.0,33,28,2,1,5,84.84848485
2003020918,19,3880,0.0,30,27,3,0,3,90.0
2003020918,16,3880,0.0,30,28,6,1,2,93.33333333
2003020919,24,3600,0.0,29,25,8,0,4,86.20689655
2003020919,25,3600,0.0,14,14,0,0,0,100.0
2003020920,21,3600,0.0,25,24,5,1,1,96.0
2003020920,30,3600,0.0,14,11,1,2,3,78.57142857
2003020921,13,3600,0.0,38,38,7,1,0,100.0
2003020921,6,3519,0.0,32,30,6,2,2,93.75
2003020922,8,3600,0.0,32,31,8,0,1,96.875
2003020922,3,3600,0.0,21,17,6,0,4,80.95238095
2003020923,14,3600,0.0,21,18,2,0,3,85.71428571
2003020923,15,3594,0.0,35,29,2,1,6,82.85714286
2003020924,12,3600,0.0,29,28,5,2,1,96.55172414
2003020924,10,3513,0.0,29,27,1,5,2,93.10344828
2003020925,17,3874,0.0,30,29,1,1,1,96.66666667
2003020925,22,3900,0.0,26,25,9,1,1,96.15384615
2003020926,24,3884,0.0,38,37,9,3,1,97.36842105
2003020926,27,3900,0.0,24,23,7,3,1,95.83333333
2003020927,18,3592,0.0,19,16,3,0,3,84.21052632
2003020927,26,3600,0.0,21,21,3,3,0,100.0
2003020928,29,3591,0.0,38,34,8,1,4,89.47368421
2003020928,28,3592,0.0,26,24,7,1,2,92.30769231
2003020929,9,3577,0.0,26,23,7,0,3,88.46153846
2003020929,8,3598,0.0,19,17,0,1,2,89.47368421
2003020930,6,3900,0.0,33,33,0,0,0,100.0
2003020930,2,3900,0.0,28,28,1,1,0,100.0
2003020931,16,3578,0.0,25,23,0,1,2,92.0
2003020931,4,3591,0.0,28,27,1,0,1,96.42857143
2003020932,20,3600,0.0,26,26,4,0,0,100.0
2003020932,21,3570,0.0,24,23,2,0,1,95.83333333
2003020933,17,3566,0.0,32,29,3,0,3,90.625
2003020933,23,3592,0.0,30,28,5,1,2,93.33333333
2003020934,12,3589,2.0,19,18,7,1,1,94.73684211
2003020934,15,3519,0.0,33,31,9,4,2,93.93939394
2003020935,16,3587,0.0,42,39,10,1,3,92.85714286
2003020935,29,3520,0.0,28,24,5,2,4,85.71428571
2003020936,7,2566,0.0,26,20,6,0,6,76.92307692
2003020936,7,1033,0.0,5,3,2,0,2,60.0
2003020936,1,3600,0.0,22,20,0,2,2,90.90909091
2003020937,14,3594,0.0,25,23,0,1,2,92.0
2003020937,11,3571,0.0,33,30,5,2,3,90.90909091
2003020938,10,3600,0.0,28,24,2,0,4,85.71428571
2003020938,13,3595,0.0,33,33,10,1,0,100.0
2003020939,26,3900,0.0,27,26,1,0,1,96.2962963
2003020939,25,3900,0.0,27,26,2,0,1,96.2962963
2003020940,5,3708,0.0,31,28,11,0,3,90.32258065
2003020940,27,3708,0.0,22,18,1,0,4,81.81818182
2003020941,22,3512,0.0,32,28,6,0,4,87.5
2003020941,24,3595,0.0,26,24,7,0,2,92.30769231
2003020942,8,3833,0.0,39,37,2,1,2,94.87179487
2003020942,6,3840,0.0,26,23,0,1,3,88.46153846
2003020943,3,3595,0.0,28,25,7,2,3,89.28571429
2003020943,2,2544,0.0,18,15,2,1,3,83.33333333
2003020943,2,1056,0.0,7,4,1,0,3,57.14285714
2003020944,10,3574,0.0,26,22,5,1,4,84.61538462
2003020944,14,3600,0.0,22,19,5,1,3,86.36363636
2003020945,4,3900,0.0,41,40,7,2,1,97.56097561
2003020945,9,3900,0.0,18,17,5,0,1,94.44444444
2003020946,30,3600,0.0,23,19,1,2,4,82.60869565
2003020946,18,3600,0.0,27,27,8,0,0,100.0
2003020947,19,3900,0.0,27,25,5,2,2,92.59259259
2003020947,21,3891,0.0,21,19,2,0,2,90.47619048
2003020948,17,3600,0.0,34,33,2,1,1,97.05882353
2003020948,20,3542,0.0,22,20,0,1,2,90.90909091
2003020949,28,3732,0.0,36,33,8,0,3,91.66666667
2003020949,23,3734,0.0,21,19,2,0,2,90.47619048
2003020950,11,3595,0.0,17,15,3,0,2,88.23529412
2003020950,1,3540,0.0,23,20,5,0,3,86.95652174
2003020951,15,3600,0.0,29,28,6,1,1,96.55172414
2003020951,13,3511,0.0,28,25,3,1,3,89.28571429
2003020952,2,3574,0.0,44,42,2,0,2,95.45454545
2003020952,7,3497,0.0,25,21,2,0,4,84.0
2003020953,29,3600,0.0,36,33,8,1,3,91.66666667
2003020953,16,3555,0.0,29,25,7,1,4,86.20689655
2003020954,30,3600,0.0,31,28,2,1,3,90.32258065
2003020954,25,3596,0.0,19,18,2,0,1,94.73684211
2003020955,22,3600,0.0,32,30,9,3,2,93.75
2003020955,27,2019,0.0,18,14,2,1,4,77.77777778
2003020955,27,1581,0.0,9,6,2,1,3,66.66666667
2003020956,5,3512,0.0,30,26,6,0,4,86.66666667
2003020956,28,3600,0.0,33,31,3,1,2,93.93939394
2003020957,4,3663,0.0,32,29,1,0,3,90.625
2003020957,6,3681,0.0,28,26,7,0,2,92.85714286
2003020958,3,3830,0.0,43,41,17,0,2,95.34883721
2003020958,18,3824,0.0,26,25,4,2,1,96.15384615
2003020959,24,3539,0.0,37,35,6,1,2,94.59459459
2003020959,26,3600,0.0,30,29,0,0,1,96.66666667
2003020960,1,3597,0.0,27,24,7,1,3,88.88888889
2003020960,10,3600,0.0,17,17,1,0,0,100.0
2003020961,12,3818,0.0,32,31,8,2,1,96.875
2003020961,8,3790,0.0,18,18,3,2,0,100.0
2003020962,7,3594,0.0,33,26,8,2,7,78.78787879
2003020962,9,3600,0.0,15,14,1,0,1,93.33333333
2003020963,21,3804,0.0,44,39,9,2,5,88.63636364
2003020963,29,3804,2.0,36,32,6,0,4,88.88888889
2003020964,15,3526,0.0,22,19,1,2,3,86.36363636
2003020964,14,3584,0.0,23,21,1,2,2,91.30434783
2003020965,19,3482,0.0,29,27,12,0,2,93.10344828
2003020965,23,3589,0.0,31,31,0,0,0,100.0
2003020966,3,3524,0.0,20,17,5,1,3,85.0
2003020966,11,3600,0.0,30,28,4,0,2,93.33333333
2003020967,13,3900,0.0,45,43,13,0,2,95.55555556
2003020967,16,3894,0.0,32,30,14,0,2,93.75
2003020968,22,3655,0.0,27,22,7,1,5,81.48148148
2003020968,25,3655,0.0,26,22,3,1,4,84.61538462
2003020969,5,3756,0.0,40,38,2,2,2,95.0
2003020969,2,3765,0.0,24,21,0,0,3,87.5
2003020970,26,163,0.0,2,2,0,0,0,100.0
2003020970,26,3008,0.0,30,24,8,1,6,80.0
2003020970,24,3600,0.0,44,41,9,0,3,93.18181818
2003020971,4,3532,0.0,27,23,5,0,4,85.18518519
2003020971,17,3600,0.0,20,18,3,2,2,90.0
2003020972,12,3900,0.0,28,25,3,2,3,89.28571429
2003020972,30,3894,0.0,28,25,3,1,3,89.28571429
2003020973,27,3541,0.0,32,28,6,0,4,87.5
2003020973,20,3595,0.0,21,19,0,1,2,90.47619048
2003020974,19,3553,0.0,18,17,4,0,1,94.44444444
2003020974,28,3600,0.0,24,24,5,0,0,100.0
2003020975,1,3600,0.0,39,37,8,0,2,94.87179487
2003020975,8,3600,0.0,29,28,0,1,1,96.55172414
2003020976,9,3593,0.0,35,34,1,1,1,97.14285714
2003020976,10,3600,0.0,30,23,5,2,7,76.66666667
2003020977,16,3897,2.0,35,33,11,0,2,94.28571429
2003020977,18,3900,6.0,33,31,3,1,2,93.93939394
2003020978,14,3589,0.0,16,16,0,1,0,100.0
2003020978,21,3538,0.0,28,26,3,0,2,92.85714286
2003020979,11,3600,2.0,29,26,4,1,3,89.65517241
2003020979,3,2992,0.0,13,11,2,3,2,84.61538462
2003020979,3,573,0.0,3,1,0,0,2,33.33333333
2003020980,13,3582,0.0,29,29,12,1,0,100.0
2003020980,15,3496,0.0,27,26,3,2,1,96.2962963
2003020981,29,3600,0.0,25,25,4,0,0,100.0
2003020981,12,3597,0.0,17,14,1,1,3,82.35294118
2003020982,6,3600,0.0,35,32,1,0,3,91.42857143
2003020982,10,3600,0.0,21,19,1,1,2,90.47619048
2003020983,2,3900,0.0,24,21,3,0,3,87.5
2003020983,5,3900,0.0,34,31,5,0,3,91.17647059
2003020984,20,3600,0.0,30,28,10,0,2,93.33333333
2003020984,19,3570,0.0,19,16,2,0,3,84.21052632
2003020985,27,3736,0.0,27,22,2,0,5,81.48148148
2003020985,22,3746,0.0,33,29,2,2,4,87.87878788
2003020986,9,3517,0.0,27,23,1,0,4,85.18518519
2003020986,7,3583,0.0,34,31,4,0,3,91.17647059
2003020987,18,3475,0.0,25,21,2,0,4,84.0
2003020987,4,3600,0.0,24,22,1,0,2,91.66666667
2003020988,1,3600,0.0,29,27,7,2,2,93.10344828
2003020988,13,2400,0.0,26,22,3,1,4,84.61538462
2003020988,13,1200,0.0,11,10,2,2,1,90.90909091
2003020989,20,3597,0.0,22,20,5,1,2,90.90909091
2003020989,17,3600,0.0,29,28,3,0,1,96.55172414
2003020990,14,3599,0.0,30,27,3,3,3,90.0
2003020990,16,3577,0.0,28,24,5,1,4,85.71428571
2003020991,29,3577,0.0,36,32,2,1,4,88.88888889
2003020991,25,3600,0.0,17,15,1,0,2,88.23529412
2003020992,23,3884,0.0,34,29,7,0,5,85.29411765
2003020992,21,3887,2.0,24,19,1,2,5,79.16666667
2003020993,30,3557,0.0,22,20,2,0,2,90.90909091
2003020993,24,3600,0.0,28,28,3,0,0,100.0
2003020994,8,3560,0.0,29,25,5,2,4,86.20689655
2003020994,28,3590,0.0,28,25,7,0,3,89.28571429
2003020995,2,3586,0.0,24,18,4,0,6,75.0
2003020995,10,3598,0.0,18,16,2,1,2,88.88888889
2003020996,18,3600,0.0,24,20,1,1,4,83.33333333
2003020996,5,3592,0.0,32,23,7,1,9,71.875
2003020997,3,3547,0.0,29,26,4,2,3,89.65517241
2003020997,6,3600,0.0,17,16,5,0,1,94.11764706
2003020998,22,3900,2.0,28,27,3,1,1,96.42857143
2003020998,19,3900,0.0,32,31,3,2,1,96.875
2003020999,30,3900,0.0,26,25,1,0,1,96.15384615
2003020999,26,3900,0.0,32,31,1,3,1,96.875
2003021000,15,3528,0.0,22,19,6,0,3,86.36363636
2003021000,3,3600,0.0,21,19,5,1,2,90.47619048
2003021001,9,3495,17.0,30,25,4,1,5,83.33333333
2003021001,9,105,0.0,0,0,0,0,0,
2003021001,4,105,0.0,4,3,3,0,1,75.0
2003021001,4,3495,27.0,22,20,5,3,2,90.90909091
2003021002,12,3872,2.0,34,32,12,1,2,94.11764706
2003021002,11,3896,0.0,34,31,7,3,3,91.17647059
2003021003,1,3737,0.0,22,19,1,1,3,86.36363636
2003021003,14,3663,2.0,32,30,3,1,2,93.75
2003021004,23,3498,0.0,27,24,8,0,3,88.88888889
2003021004,17,3600,0.0,24,23,1,1,1,95.83333333
2003021005,24,3600,0.0,36,34,4,0,2,94.44444444
2003021005,16,3600,0.0,36,31,5,0,5,86.11111111
2003021006,20,3592,0.0,34,29,13,0,5,85.29411765
2003021006,25,3596,0.0,23,22,7,0,1,95.65217391
2003021007,28,1554,0.0,12,9,2,0,3,75.0
2003021007,28,2046,0.0,21,19,0,1,2,90.47619048
2003021007,21,3600,0.0,28,27,7,0,1,96.42857143
2003021008,8,3586,0.0,24,21,4,0,3,87.5
2003021008,27,3516,0.0,25,21,5,1,4,84.0
2003021009,11,3900,0.0,31,29,2,1,2,93.5483871
2003021009,6,3891,0.0,26,24,8,2,2,92.30769231
2003021010,7,3600,0.0,33,32,7,2,1,96.96969697
2003021010,10,3600,0.0,32,27,5,3,5,84.375
2003021011,18,3552,2.0,30,27,4,1,3,90.0
2003021011,9,3600,0.0,27,25,7,0,2,92.59259259
2003021012,19,3600,0.0,41,39,3,1,2,95.12195122
2003021012,2,3533,0.0,17,14,4,0,3,82.35294118
2003021013,1,3600,0.0,26,25,1,1,1,96.15384615
2003021013,12,3600,0.0,20,16,1,0,4,80.0
2003021014,23,3600,0.0,32,32,5,2,0,100.0
2003021014,29,3600,0.0,24,20,1,2,4,83.33333333
2003021015,24,3545,0.0,28,26,4,0,2,92.85714286
2003021015,5,3595,0.0,27,26,3,0,1,96.2962963
2003021016,14,3595,0.0,32,29,8,1,3,90.625
2003021016,13,2400,0.0,24,19,6,0,5,79.16666667
2003021016,13,1103,0.0,6,6,0,0,0,100.0
2003021017,4,3536,0.0,20,18,2,0,2,90.0
2003021017,15,3592,0.0,25,24,3,0,1,96.0
2003021018,8,3600,2.0,48,46,8,1,2,95.83333333
2003021018,26,3523,0.0,23,20,1,1,3,86.95652174
2003021019,22,3644,0.0,23,20,2,0,3,86.95652174
2003021019,16,3644,0.0,33,29,3,1,4,87.87878788
2003021020,20,3600,0.0,22,21,4,3,1,95.45454545
2003021020,21,3600,0.0,33,26,5,0,7,78.78787879
2003021021,28,3600,0.0,28,24,3,0,4,85.71428571
2003021021,25,3600,0.0,22,22,0,1,0,100.0
2003021022,5,3600,0.0,42,38,6,1,4,90.47619048
2003021022,3,3600,0.0,31,24,7,0,7,77.41935484
2003021023,19,3600,0.0,19,18,7,1,1,94.73684211
2003021023,7,3562,0.0,25,20,5,1,5,80.0
2003021024,30,3894,0.0,26,25,6,4,1,96.15384615
2003021024,27,3884,0.0,31,30,3,1,1,96.77419355
2003021025,9,3580,0.0,14,13,3,2,1,92.85714286
2003021025,15,3600,0.0,21,17,4,0,4,80.95238095
2003021026,12,3588,0.0,28,27,4,1,1,96.42857143
2003021026,29,3528,0.0,37,34,7,0,3,91.89189189
2003021027,14,3892,0.0,29,28,1,2,1,96.55172414
2003021027,17,3900,0.0,38,37,7,0,1,97.36842105
2003021028,21,3600,0.0,18,16,5,1,2,88.88888889
2003021028,23,931,0.0,10,6,0,0,4,60.0
2003021028,23,2666,6.0,25,20,11,1,5,80.0
2003021029,8,3600,0.0,38,36,3,0,2,94.73684211
2003021029,24,3480,0.0,23,19,0,0,4,82.60869565
2003021030,13,3600,0.0,42,37,2,4,5,88.0952381
2003021030,10,3600,0.0,15,15,3,0,0,100.0
2003021031,4,3600,0.0,21,20,1,0,1,95.23809524
2003021031,1,3546,0.0,19,17,2,1,2,89.47368421
2003021032,25,3600,0.0,19,15,0,1,4,78.94736842
2003021032,5,3580,0.0,45,45,13,0,0,100.0
2003021033,3,3600,0.0,25,25,10,1,0,100.0
2003021033,11,3543,0.0,24,23,2,12,1,95.83333333
2003021034,2,3661,0.0,39,36,1,0,3,92.30769231
2003021034,19,3661,0.0,24,22,2,0,2,91.66666667
2003021035,6,3600,0.0,26,24,3,0,2,92.30769231
2003021035,18,3532,0.0,30,27,1,1,3,90.0
2003021036,22,3900,0.0,31,30,6,3,1,96.77419355
2003021036,20,3881,0.0,28,27,10,0,1,96.42857143
2003021037,27,3555,0.0,37,34,6,0,3,91.89189189
2003021037,26,3600,0.0,19,17,2,1,2,89.47368421
2003021038,30,3600,0.0,31,28,4,0,3,90.32258065
2003021038,28,1789,0.0,20,16,2,1,4,80.0
2003021038,28,1740,0.0,4,4,0,0,0,100.0
2003021039,7,3596,0.0,27,27,2,0,0,100.0
2003021039,15,3600,0.0,35,29,7,1,6,82.85714286
2003021040,14,3600,0.0,33,31,7,2,2,93.93939394
2003021040,12,3581,0.0,15,12,0,1,3,80.0
2003021041,21,3757,0.0,29,27,7,0,2,93.10344828
2003021041,22,3738,0.0,30,27,6,0,3,90.0
2003021042,26,3593,0.0,23,22,6,2,1,95.65217391
2003021042,27,3518,0.0,21,18,6,0,3,85.71428571
2003021043,30,3871,0.0,30,29,5,2,1,96.66666667
2003021043,23,3878,0.0,21,20,5,4,1,95.23809524
2003021044,6,3675,0.0,20,18,5,0,2,90.0
2003021044,7,3652,0.0,32,29,1,1,3,90.625
2003021045,25,3794,0.0,22,20,2,1,2,90.90909091
2003021045,4,3894,0.0,39,37,7,1,2,94.87179487
2003021046,17,3600,0.0,33,31,8,1,2,93.93939394
2003021046,29,3540,0.0,34,31,4,2,3,91.17647059
2003021047,5,2400,0.0,34,33,8,0,1,97.05882353
2003021047,5,1200,0.0,12,11,0,0,1,91.66666667
2003021047,10,3500,2.0,17,14,0,0,3,82.35294118
2003021048,13,3689,0.0,34,32,8,0,2,94.11764706
2003021048,8,3679,0.0,32,29,6,0,3,90.625
2003021049,16,3547,0.0,27,22,4,0,5,81.48148148
2003021049,1,3573,0.0,35,31,6,0,4,88.57142857
2003021050,18,3900,0.0,29,28,3,0,1,96.55172414
2003021050,19,3898,0.0,25,24,2,1,1,96.0
2003021051,9,3555,0.0,33,30,2,0,3,90.90909091
2003021051,20,3600,0.0,23,21,3,0,2,91.30434783
2003021052,2,1025,0.0,7,7,1,0,0,100.0
2003021052,2,2519,0.0,21,16,5,2,5,76.19047619
2003021052,28,3600,0.0,41,37,4,0,4,90.24390244
2003021053,16,3595,0.0,30,27,6,0,3,90.0
2003021053,15,3558,0.0,32,28,10,2,4,87.5
2003021054,11,3541,0.0,23,20,7,2,3,86.95652174
2003021054,12,3593,0.0,25,23,7,0,2,92.0
2003021055,3,3600,0.0,37,32,8,2,5,86.48648649
2003021055,14,3600,0.0,28,26,0,1,2,92.85714286
2003021056,23,3867,0.0,27,24,4,0,3,88.88888889
2003021056,22,3867,0.0,24,20,1,1,4,83.33333333
2003021057,21,3578,0.0,25,23,2,3,2,92.0
2003021057,27,3564,0.0,30,27,9,2,3,90.0
2003021058,2,3597,0.0,46,45,8,1,1,97.82608696
2003021058,24,3559,0.0,28,26,3,1,2,92.85714286
2003021059,7,3896,0.0,39,36,2,2,3,92.30769231
2003021059,6,3896,0.0,25,23,1,1,2,92.0
2003021060,1,3521,0.0,21,19,5,0,2,90.47619048
2003021060,4,3600,0.0,38,37,7,0,1,97.36842105
2003021061,25,3539,0.0,20,18,1,2,2,90.0
2003021061,17,3600,0.0,31,31,8,1,0,100.0
2003021062,26,3429,0.0,27,24,1,1,3,88.88888889
2003021062,28,2400,0.0,25,25,2,1,0,100.0
2003021062,28,1200,0.0,8,7,1,0,1,87.5
2003021063,10,3548,0.0,29,25,3,0,4,86.20689655
2003021063,8,3600,0.0,25,22,1,0,3,88.0
2003021064,15,3560,0.0,27,23,7,0,4,85.18518519
2003021064,11,3597,0.0,21,19,3,2,2,90.47619048
2003021065,12,3600,0.0,21,20,2,3,1,95.23809524
2003021065,14,3600,0.0,26,21,9,1,5,80.76923077
2003021066,3,3774,0.0,32,29,0,1,3,90.625
2003021066,13,3768,0.0,39,37,6,0,2,94.87179487
2003021067,29,2400,0.0,25,21,5,1,4,84.0
2003021067,29,1200,0.0,7,6,0,0,1,85.71428571
2003021067,19,3600,0.0,22,19,3,1,3,86.36363636
2003021068,20,3895,0.0,32,28,12,0,4,87.5
2003021068,18,3885,2.0,24,20,2,2,4,83.33333333
2003021069,9,3593,0.0,20,19,1,0,1,95.0
2003021069,23,3536,0.0,20,18,5,1,2,90.0
2003021070,4,3900,0.0,21,18,3,1,3,85.71428571
2003021070,5,3900,0.0,27,24,7,1,3,88.88888889
2003021071,25,3589,0.0,26,26,3,0,0,100.0
2003021071,16,3600,0.0,31,27,7,1,4,87.09677419
2003021072,27,3600,0.0,25,21,4,0,4,84.0
2003021072,21,3600,0.0,27,26,2,2,1,96.2962963
2003021073,24,3464,0.0,29,25,5,2,4,86.20689655
2003021073,26,3589,0.0,30,29,4,3,1,96.66666667
2003021074,18,3613,0.0,31,28,2,2,3,90.32258065
2003021074,17,3640,0.0,29,27,3,0,2,93.10344828
2003021075,20,3600,0.0,25,25,2,1,0,100.0
2003021075,19,3580,0.0,23,21,0,1,2,91.30434783
2003021076,29,3575,0.0,30,27,5,0,3,90.0
2003021076,30,3588,0.0,21,19,2,2,2,90.47619048
2003021077,9,2400,0.0,16,13,2,0,3,81.25
2003021077,9,1134,0.0,6,6,0,0,0,100.0
2003021077,22,3600,0.0,13,12,0,0,1,92.30769231
2003021078,10,3793,0.0,28,23,10,1,5,82.14285714
2003021078,7,3822,0.0,34,28,5,0,6,82.35294118
2003021079,1,3600,0.0,18,17,0,1,1,94.44444444
2003021079,3,3600,0.0,45,42,10,0,3,93.33333333
2003021080,12,3698,0.0,24,23,4,2,1,95.83333333
2003021080,11,3703,0.0,31,31,12,1,0,100.0
2003021081,2,3600,0.0,20,19,1,0,1,95.0
2003021081,14,3549,0.0,22,20,1,0,2,90.90909091
2003021082,6,3595,0.0,23,22,6,0,1,95.65217391
2003021082,10,3523,0.0,29,27,8,1,2,93.10344828
2003021083,21,3584,0.0,28,25,7,0,3,89.28571429
2003021083,8,3600,0.0,31,29,4,2,2,93.5483871
2003021084,15,3595,0.0,27,23,7,0,4,85.18518519
2003021084,5,3595,0.0,21,20,2,1,1,95.23809524
2003021085,20,3600,0.0,26,25,3,0,1,96.15384615
2003021085,17,3572,0.0,18,14,0,1,4,77.77777778
2003021086,9,3600,0.0,22,17,2,0,5,77.27272727
2003021086,30,3595,0.0,38,36,3,1,2,94.73684211
2003021087,28,3842,0.0,21,18,2,0,3,85.71428571
2003021087,25,3900,2.0,27,24,5,1,3,88.88888889
2003021088,29,3562,0.0,27,24,5,0,3,88.88888889
2003021088,22,3600,0.0,23,21,2,0,2,91.30434783
2003021089,24,3629,0.0,28,26,8,1,2,92.85714286
2003021089,27,3629,0.0,28,25,6,1,3,89.28571429
2003021090,18,3883,0.0,27,25,1,0,2,92.59259259
2003021090,23,3898,0.0,28,26,2,1,2,92.85714286
2003021091,19,3600,0.0,34,31,4,1,3,91.17647059
2003021091,26,3557,0.0,23,19,2,1,4,82.60869565
2003021092,5,1960,0.0,19,18,1,0,1,94.73684211
2003021092,5,1640,0.0,23,18,0,0,5,78.26086957
2003021092,1,3600,0.0,15,14,0,0,1,93.33333333
2003021093,7,3523,2.0,23,20,5,3,3,86.95652174
2003021093,11,3558,2.0,33,29,12,0,4,87.87878788
2003021094,2,1191,2.0,12,10,0,1,2,83.33333333
2003021094,2,2399,0.0,12,8,1,1,4,66.66666667
2003021094,13,3600,0.0,54,50,20,0,4,92.59259259
2003021095,12,3600,0.0,23,21,3,2,2,91.30434783
2003021095,16,3533,0.0,49,46,8,2,3,93.87755102
2003021096,19,3900,0.0,29,28,1,1,1,96.55172414
2003021096,24,3899,0.0,31,30,0,1,1,96.77419355
2003021097,3,3670,0.0,21,17,4,1,4,80.95238095
2003021097,15,3670,0.0,33,30,10,1,3,90.90909091
2003021098,7,3570,0.0,25,23,7,0,2,92.0
2003021098,14,3585,0.0,26,25,3,0,1,96.15384615
2003021099,21,3513,0.0,35,33,6,1,2,94.28571429
2003021099,9,3600,0.0,23,23,3,1,0,100.0
2003021100,30,3600,0.0,31,31,0,0,0,100.0
2003021100,6,3512,0.0,15,13,1,0,2,86.66666667
2003021101,10,3591,0.0,28,26,7,0,2,92.85714286
2003021101,4,3483,0.0,14,11,1,0,3,78.57142857
2003021102,23,2400,0.0,17,14,2,0,3,82.35294118
2003021102,23,1200,0.0,4,4,2,1,0,100.0
2003021102,25,3600,0.0,20,20,4,0,0,100.0
2003021103,29,3540,0.0,34,33,6,2,1,97.05882353
2003021103,20,3600,0.0,23,23,8,1,0,100.0
2003021104,17,3900,0.0,29,28,4,0,1,96.55172414
2003021104,27,3900,0.0,47,46,9,2,1,97.87234043
2003021105,28,3600,2.0,31,28,8,3,3,90.32258065
2003021105,26,2397,0.0,15,11,3,0,4,73.33333333
2003021105,26,1130,0.0,7,7,0,1,0,100.0
2003021106,30,3550,0.0,23,21,6,0,2,91.30434783
2003021106,2,3600,0.0,17,16,4,2,1,94.11764706
2003021107,8,3900,0.0,30,29,0,0,1,96.66666667
2003021107,1,3900,0.0,31,30,2,0,1,96.77419355
2003021108,12,3677,0.0,31,27,6,1,4,87.09677419
2003021108,5,3662,0.0,24,21,1,1,3,87.5
2003021109,13,3576,0.0,30,27,11,0,3,90.0
2003021109,11,3600,0.0,21,19,8,1,2,90.47619048
2003021110,23,1613,0.0,15,12,3,0,3,80.0
2003021110,23,2085,0.0,20,19,2,0,1,95.0
2003021110,16,3703,0.0,35,32,3,2,3,91.42857143
2003021111,18,3549,0.0,36,31,1,4,5,86.11111111
2003021111,22,3596,0.0,27,23,5,0,4,85.18518519
2003021112,28,3588,0.0,23,21,1,1,2,91.30434783
2003021112,24,2875,0.0,29,27,6,1,2,93.10344828
2003021112,24,694,0.0,12,10,0,0,2,83.33333333
2003021113,14,3515,0.0,30,25,0,1,5,83.33333333
2003021113,6,3600,0.0,40,36,1,2,4,90.0
2003021114,3,3574,0.0,24,22,5,1,2,91.66666667
2003021114,4,3600,0.0,24,24,5,1,0,100.0
2003021115,19,3527,0.0,29,26,3,0,3,89.65517241
2003021115,25,3600,0.0,19,18,1,0,1,94.73684211
2003021116,21,3513,0.0,23,19,8,1,4,82.60869565
2003021116,10,3600,2.0,34,32,12,2,2,94.11764706
2003021117,1,3561,0.0,24,22,3,1,2,91.66666667
2003021117,8,3600,0.0,35,33,4,0,2,94.28571429
2003021118,12,3840,0.0,29,27,6,0,2,93.10344828
2003021118,9,3840,0.0,29,26,2,2,3,89.65517241
2003021119,11,3819,0.0,18,16,1,1,2,88.88888889
2003021119,15,3897,0.0,45,43,4,1,2,95.55555556
2003021120,7,3598,0.0,24,23,4,1,1,95.83333333
2003021120,13,3527,0.0,23,21,4,1,2,91.30434783
2003021121,18,3600,17.0,21,20,7,0,1,95.23809524
2003021121,20,3555,15.0,30,28,5,0,2,93.33333333
2003021122,17,3595,0.0,25,23,5,0,2,92.0
2003021122,26,3448,0.0,23,20,1,1,3,86.95652174
2003021123,14,3600,0.0,25,22,2,1,3,88.0
2003021123,2,3584,0.0,29,29,5,1,0,100.0
2003021124,3,3892,0.0,35,31,5,2,4,88.57142857
2003021124,5,3867,0.0,34,31,4,3,3,91.17647059
2003021125,27,3896,0.0,34,32,2,0,2,94.11764706
2003021125,16,3900,0.0,41,39,5,1,2,95.12195122
2003021126,17,2210,0.0,17,14,7,0,3,82.35294118
2003021126,17,1355,0.0,12,8,1,1,4,66.66666667
2003021126,24,3585,0.0,57,51,17,4,6,89.47368421
2003021127,22,3600,0.0,34,32,8,3,2,94.11764706
2003021127,28,3517,0.0,27,22,4,0,5,81.48148148
2003021128,29,3600,0.0,31,27,5,1,4,87.09677419
2003021128,23,3519,0.0,23,18,4,2,5,78.26086957
2003021129,27,3873,0.0,29,27,4,1,2,93.10344828
2003021129,30,3854,0.0,28,25,3,1,3,89.28571429
2003021130,25,3600,2.0,29,29,10,0,0,100.0
2003021130,20,3567,0.0,23,20,0,1,3,86.95652174
2003021131,22,3600,0.0,26,25,4,2,1,96.15384615
2003021131,26,3497,0.0,23,21,3,0,2,91.30434783
2003021132,9,3562,0.0,36,32,8,2,4,88.88888889
2003021132,6,3600,0.0,30,28,4,1,2,93.33333333
2003021133,15,1200,0.0,14,14,5,0,0,100.0
2003021133,15,2391,0.0,19,16,3,0,3,84.21052632
2003021133,2,3600,0.0,17,17,3,1,0,100.0
2003021134,4,3600,0.0,28,26,6,1,2,92.85714286
2003021134,12,3485,0.0,25,21,4,1,4,84.0
2003021135,14,3596,0.0,29,27,3,0,2,93.10344828
2003021135,10,3596,0.0,40,33,7,1,7,82.5
2003021136,5,3598,0.0,37,35,10,2,2,94.59459459
2003021136,3,3600,0.0,17,12,2,0,5,70.58823529
2003021137,1,3835,0.0,24,21,0,0,3,87.5
2003021137,13,3835,0.0,50,46,4,0,4,92.0
2003021138,24,3596,0.0,26,25,12,1,1,96.15384615
2003021138,18,3538,0.0,28,25,7,0,3,89.28571429
2003021139,16,3900,0.0,43,41,9,1,2,95.34883721
2003021139,21,3900,0.0,30,28,5,0,2,93.33333333
2003021140,17,3600,0.0,20,15,0,0,5,75.0
2003021140,28,3600,0.0,39,37,3,2,2,94.87179487
2003021141,30,3547,0.0,23,21,3,6,2,91.30434783
2003021141,29,3600,0.0,20,20,5,0,0,100.0
2003021142,8,3546,0.0,33,31,3,1,2,93.93939394
2003021142,7,3600,0.0,25,24,2,0,1,96.0
2003021143,15,3542,0.0,33,30,6,2,3,90.90909091
2003021143,11,3599,0.0,25,23,1,0,2,92.0
2003021144,20,3600,0.0,22,22,4,1,0,100.0
2003021144,27,3600,0.0,31,27,2,0,4,87.09677419
2003021145,25,3772,4.0,27,24,9,1,3,88.88888889
2003021145,22,3791,0.0,27,23,4,0,4,85.18518519
2003021146,26,3544,0.0,27,26,3,1,1,96.2962963
2003021146,23,3597,0.0,15,15,3,1,0,100.0
2003021147,10,3585,0.0,33,33,8,4,0,100.0
2003021147,6,3585,0.0,34,32,6,0,2,94.11764706
2003021148,2,2396,0.0,14,14,4,1,0,100.0
2003021148,2,1200,0.0,6,4,0,0,2,66.66666667
2003021148,4,3539,0.0,15,11,2,0,4,73.33333333
2003021149,13,3487,0.0,45,42,6,0,3,93.33333333
2003021149,12,3600,0.0,21,19,0,2,2,90.47619048
2003021150,1,3574,0.0,17,15,0,1,2,88.23529412
2003021150,14,3600,0.0,19,18,0,0,1,94.73684211
2003021151,9,3600,0.0,29,29,5,0,0,100.0
2003021151,8,3600,0.0,31,27,4,2,4,87.09677419
2003021152,18,3584,0.0,28,26,1,0,2,92.85714286
2003021152,3,3600,0.0,32,28,2,0,4,87.5
2003021153,24,3571,0.0,23,20,2,0,3,86.95652174
2003021153,19,3600,0.0,22,20,0,0,2,90.90909091
2003021154,17,3600,0.0,35,34,5,0,1,97.14285714
2003021154,21,3583,0.0,22,20,1,2,2,90.90909091
2003021155,30,3593,0.0,35,33,3,0,2,94.28571429
2003021155,16,3600,0.0,25,17,2,0,8,68.0
2003021156,20,3583,0.0,27,24,4,0,3,88.88888889
2003021156,28,3600,0.0,30,28,5,0,2,93.33333333
2003021157,24,3575,0.0,28,26,9,1,2,92.85714286
2003021157,29,3594,0.0,44,43,11,1,1,97.72727273
2003021158,1,3578,0.0,18,18,3,0,0,100.0
2003021158,11,3598,2.0,32,27,12,1,5,84.375
2003021159,5,3524,0.0,30,26,6,1,4,86.66666667
2003021159,7,3597,0.0,25,24,8,3,1,96.0
2003021160,26,3427,0.0,32,29,6,0,3,90.625
2003021160,22,3589,0.0,19,18,6,0,1,94.73684211
2003021161,28,3600,0.0,30,30,2,5,0,100.0
2003021161,27,3600,0.0,26,23,6,0,3,88.46153846
2003021162,3,3595,0.0,39,38,11,0,1,97.43589744
2003021162,4,2161,0.0,9,9,0,1,0,100.0
2003021162,4,1359,0.0,12,9,0,1,3,75.0
2003021163,21,3475,0.0,27,25,2,0,2,92.59259259
2003021163,17,3600,0.0,27,27,6,0,0,100.0
2003021164,16,3710,0.0,29,25,3,0,4,86.20689655
2003021164,19,3710,0.0,22,19,2,1,3,86.36363636
2003021165,26,3666,0.0,24,21,5,0,3,87.5
2003021165,20,3666,0.0,29,27,5,0,2,93.10344828
2003021166,8,3872,0.0,39,36,3,3,3,92.30769231
2003021166,6,3872,0.0,22,20,4,2,2,90.90909091
2003021167,9,3522,0.0,23,21,3,0,2,91.30434783
2003021167,9,378,0.0,2,2,0,0,0,100.0
2003021167,10,3900,0.0,30,28,1,0,2,93.33333333
2003021168,12,3596,0.0,38,36,12,2,2,94.73684211
2003021168,2,3566,0.0,24,21,5,2,3,87.5
2003021169,7,3895,0.0,39,37,4,0,2,94.87179487
2003021169,5,3895,0.0,28,26,2,1,2,92.85714286
2003021170,15,3600,2.0,32,28,6,1,4,87.5
2003021170,14,3599,0.0,22,21,3,1,1,95.45454545
2003021171,11,3600,0.0,30,30,6,0,0,100.0
2003021171,13,3600,0.0,19,16,2,0,3,84.21052632
2003021172,29,3723,0.0,37,35,7,4,2,94.59459459
2003021172,18,3722,0.0,32,29,4,1,3,90.625
2003021173,25,3640,0.0,30,27,4,0,3,90.0
2003021173,23,3638,0.0,24,22,0,3,2,91.66666667
2003021174,19,3600,0.0,37,36,10,1,1,97.2972973
2003021174,16,3497,0.0,25,22,5,0,3,88.0
2003021175,24,3553,0.0,22,20,3,1,2,90.90909091
2003021175,30,3598,0.0,19,18,0,0,1,94.73684211
2003021176,27,3481,0.0,25,21,7,0,4,84.0
2003021176,22,3587,0.0,27,25,5,0,2,92.59259259
2003021177,2,3567,2.0,28,25,2,0,3,89.28571429
2003021177,1,3600,0.0,14,12,1,0,2,85.71428571
2003021178,25,3777,0.0,31,29,5,2,2,93.5483871
2003021178,28,3756,0.0,21,20,3,0,1,95.23809524
2003021179,29,3592,0.0,39,33,3,0,6,84.61538462
2003021179,7,3600,0.0,23,23,4,0,0,100.0
2003021180,9,3840,0.0,28,24,1,2,4,85.71428571
2003021180,14,3813,0.0,36,31,2,0,5,86.11111111
2003021181,30,3600,0.0,38,33,4,1,5,86.84210526
2003021181,17,3600,0.0,24,21,3,1,3,87.5
2003021182,11,3532,0.0,38,34,10,4,4,89.47368421
2003021182,10,3600,0.0,25,23,7,0,2,92.0
2003021183,12,3563,0.0,25,23,12,1,2,92.0
2003021183,13,3594,0.0,29,28,9,1,1,96.55172414
2003021184,26,3534,0.0,33,31,6,1,2,93.93939394
2003021184,21,3600,0.0,20,19,2,0,1,95.0
2003021185,27,3600,0.0,45,39,2,0,6,86.66666667
2003021185,23,3599,0.0,17,16,3,0,1,94.11764706
2003021186,5,3570,2.0,29,25,3,2,4,86.20689655
2003021186,15,3600,0.0,29,27,10,0,2,93.10344828
2003021187,6,3600,0.0,23,21,0,0,2,91.30434783
2003021187,12,3515,0.0,29,26,3,1,3,89.65517241
2003021188,3,3600,0.0,32,27,1,0,5,84.375
2003021188,1,3600,0.0,24,24,0,0,0,100.0
2003021189,22,3559,0.0,28,27,4,2,1,96.42857143
2003021189,19,3600,0.0,18,18,0,0,0,100.0
2003021190,16,3600,0.0,35,30,6,0,5,85.71428571
2003021190,18,3600,0.0,26,24,0,1,2,92.30769231
2003021191,8,1200,0.0,8,8,0,0,0,100.0
2003021191,8,2400,0.0,15,10,2,0,5,66.66666667
2003021191,2,3600,2.0,21,20,3,0,1,95.23809524
2003021192,17,3600,0.0,32,30,13,0,2,93.75
2003021192,29,3508,0.0,30,27,1,1,3,90.0
2003021193,7,3600,0.0,40,37,0,0,3,92.5
2003021193,3,3540,0.0,39,35,4,0,4,89.74358974
2003021194,9,2007,2.0,16,15,7,1,1,93.75
2003021194,9,1593,0.0,18,15,2,0,3,83.33333333
2003021194,13,3456,0.0,35,30,4,2,5,85.71428571
2003021195,21,3642,0.0,29,24,6,0,5,82.75862069
2003021195,30,3605,2.0,29,25,8,2,4,86.20689655
2003021196,22,3596,0.0,30,29,4,2,1,96.66666667
2003021196,25,3531,0.0,23,20,5,0,3,86.95652174
2003021197,27,3563,0.0,32,31,4,0,1,96.875
2003021197,20,3595,0.0,27,27,7,2,0,100.0
2003021198,23,3600,0.0,23,22,0,1,1,95.65217391
2003021198,24,3579,0.0,43,41,6,0,2,95.34883721
2003021199,28,3595,0.0,22,22,8,0,0,100.0
2003021199,26,3571,0.0,24,22,0,2,2,91.66666667
2003021200,13,3512,0.0,25,21,4,0,4,84.0
2003021200,14,3590,2.0,32,29,4,1,3,90.625
2003021201,15,3900,0.0,38,35,8,1,3,92.10526316
2003021201,6,3900,0.0,27,24,0,5,3,88.88888889
2003021202,4,3600,0.0,24,24,8,3,0,100.0
2003021202,8,3584,0.0,23,21,3,0,2,91.30434783
2003021203,17,3600,0.0,28,26,1,0,2,92.85714286
2003021203,19,3575,0.0,12,9,0,0,3,75.0
2003021204,18,3600,0.0,35,34,8,0,1,97.14285714
2003021204,16,3503,0.0,29,26,7,0,3,89.65517241
2003021205,9,3600,0.0,40,39,9,0,1,97.5
2003021205,4,3490,0.0,19,16,0,2,3,84.21052632
2003021206,2,3600,0.0,27,23,4,1,4,85.18518519
2003021206,12,1767,0.0,18,13,0,0,5,72.22222222
2003021206,12,1802,0.0,9,8,2,0,1,88.88888889
2003021207,21,3600,0.0,39,37,5,4,2,94.87179487
2003021207,29,3563,0.0,39,36,9,1,3,92.30769231
2003021208,5,3600,0.0,33,31,4,0,2,93.93939394
2003021208,11,3525,0.0,23,21,4,1,2,91.30434783
2003021209,10,3599,0.0,17,17,2,1,0,100.0
2003021209,7,3560,0.0,28,27,6,0,1,96.42857143
2003021210,25,3473,0.0,21,17,3,0,4,80.95238095
2003021210,30,3595,0.0,34,32,5,0,2,94.11764706
2003021211,20,3600,0.0,15,13,0,0,2,86.66666667
2003021211,26,3556,0.0,26,23,4,0,3,88.46153846
2003021212,23,3600,0.0,34,33,7,1,1,97.05882353
2003021212,28,3566,0.0,25,22,2,1,3,88.0
2003021213,1,3600,0.0,40,38,4,4,2,95.0
2003021213,6,3599,0.0,30,25,5,4,5,83.33333333
2003021214,3,3668,0.0,24,22,5,0,2,91.66666667
2003021214,15,3668,0.0,35,32,6,3,3,91.42857143
2003021215,19,3600,2.0,17,16,1,0,1,94.11764706
2003021215,18,3570,0.0,23,21,1,0,2,91.30434783
2003021216,16,3775,0.0,43,41,7,3,2,95.34883721
2003021216,27,3757,0.0,24,23,2,0,1,95.83333333
2003021217,7,3600,0.0,39,33,5,0,6,84.61538462
2003021217,8,3600,0.0,27,24,2,0,3,88.88888889
2003021218,10,3600,0.0,28,28,1,2,0,100.0
2003021218,9,1964,0.0,8,5,0,0,3,62.5
2003021218,9,1636,0.0,9,6,0,0,3,66.66666667
2003021219,11,3600,0.0,30,29,4,1,1,96.66666667
2003021219,14,3526,0.0,23,21,3,0,2,91.30434783
2003021220,29,3600,0.0,33,32,6,0,1,96.96969697
2003021220,17,3591,0.0,17,13,4,0,4,76.47058824
2003021221,22,1200,0.0,10,9,3,0,1,90.0
2003021221,22,2400,0.0,17,13,0,0,4,76.47058824
2003021221,23,3600,0.0,26,24,5,2,2,92.30769231
2003021222,6,3597,0.0,14,13,3,1,1,92.85714286
2003021222,1,3539,0.0,24,21,8,3,3,87.5
2003021223,4,3891,0.0,26,23,2,0,3,88.46153846
2003021223,2,3900,0.0,36,33,2,1,3,91.66666667
2003021224,15,3512,0.0,33,29,6,0,4,87.87878788
2003021224,5,3596,0.0,30,27,2,1,3,90.0
2003021225,12,1117,0.0,8,8,0,0,0,100.0
2003021225,12,2783,0.0,31,25,3,3,6,80.64516129
2003021225,13,3900,0.0,32,26,2,2,6,81.25
2003021226,19,3545,0.0,25,23,4,0,2,92.0
2003021226,30,3600,0.0,24,24,2,2,0,100.0
2003021227,16,3600,0.0,27,22,3,0,5,81.48148148
2003021227,25,3595,0.0,26,24,2,0,2,92.30769231
2003021228,18,3632,0.0,39,38,10,1,1,97.43589744
2003021228,21,3632,0.0,23,21,0,1,2,91.30434783
2003021229,20,3545,0.0,26,24,3,3,2,92.30769231
2003021229,24,3600,0.0,23,22,3,2,1,95.65217391
2003021230,26,3790,0.0,42,38,5,1,4,90.47619048
2003021230,28,3712,0.0,28,25,1,0,3,89.28571429
2005020001,8,3591,0.0,30,29,12,0,1,96.66666667
2005020001,6,3576,0.0,21,19,3,3,2,90.47619048
2005020002,2,3569,2.0,38,33,13,1,5,86.84210526
2005020002,7,3595,0.0,26,22,9,3,4,84.61538462
2005020003,3,3599,0.0,27,24,13,0,3,88.88888889
2005020003,4,3544,0.0,27,22,2,2,5,81.48148148
2005020004,29,3544,0.0,19,16,7,0,3,84.21052632
2005020004,15,3587,2.0,37,35,6,2,2,94.59459459
2005020005,11,2400,0.0,23,21,0,0,2,91.30434783
2005020005,11,1200,0.0,6,6,0,0,0,100.0
2005020005,13,3590,0.0,34,34,0,0,0,100.0
2005020006,9,3894,0.0,25,23,6,4,2,92.0
2005020006,10,3893,0.0,23,21,7,3,2,91.30434783
2005020007,5,3600,0.0,37,32,7,7,5,86.48648649
2005020007,1,3580,0.0,37,36,16,1,1,97.2972973
2005020008,12,1200,0.0,11,10,2,0,1,90.90909091
2005020008,12,2400,0.0,19,15,4,0,4,78.94736842
2005020008,14,3600,0.0,26,24,3,2,2,92.30769231
2005020009,19,1672,0.0,13,12,5,1,1,92.30769231
2005020009,19,1926,0.0,24,20,4,2,4,83.33333333
2005020009,17,3598,0.0,14,13,1,1,1,92.85714286
2005020010,28,3527,0.0,25,22,7,2,3,88.0
2005020010,18,3598,2.0,24,22,3,0,2,91.66666667
2005020011,24,3591,0.0,39,36,6,2,3,92.30769231
2005020011,16,3539,0.0,24,19,8,1,5,79.16666667
2005020012,20,3525,0.0,27,22,3,1,5,81.48148148
2005020012,30,3600,0.0,31,28,7,0,3,90.32258065
2005020013,26,3550,0.0,30,25,9,0,5,83.33333333
2005020013,25,3591,0.0,20,16,1,2,4,80.0
2005020014,21,3520,0.0,31,27,10,1,4,87.09677419
2005020014,22,3597,0.0,17,14,4,0,3,82.35294118
2005020015,27,3563,0.0,30,27,9,1,3,90.0
2005020015,23,3562,0.0,32,30,5,1,2,93.75
2005020016,8,3704,0.0,19,16,2,3,3,84.21052632
2005020016,3,3698,0.0,28,24,12,1,4,85.71428571
2005020017,17,3600,0.0,26,23,9,3,3,88.46153846
2005020017,19,3521,0.0,27,23,8,2,4,85.18518519
2005020018,27,3520,0.0,28,25,6,1,3,89.28571429
2005020018,26,3600,0.0,29,27,3,0,2,93.10344828
2005020019,1,3600,0.0,33,28,11,1,5,84.84848485
2005020019,4,3581,0.0,28,26,10,2,2,92.85714286
2005020020,11,3597,0.0,22,19,8,0,3,86.36363636
2005020020,15,3551,0.0,37,32,14,1,5,86.48648649
2005020021,5,3892,0.0,33,31,6,0,2,93.93939394
2005020021,12,3895,0.0,30,28,9,3,2,93.33333333
2005020022,20,3600,0.0,20,19,6,1,1,95.0
2005020022,29,3600,0.0,38,35,12,1,3,92.10526316
2005020023,14,3497,2.0,30,29,0,0,1,96.66666667
2005020023,13,3585,2.0,27,27,0,0,0,100.0
2005020024,6,3600,0.0,41,37,5,1,4,90.24390244
2005020024,7,3600,0.0,36,35,4,3,1,97.22222222
2005020025,28,2227,0.0,12,10,3,0,2,83.33333333
2005020025,28,1356,0.0,14,10,5,0,4,71.42857143
2005020025,16,3600,0.0,24,21,5,0,3,87.5
2005020026,8,3600,0.0,20,16,3,0,4,80.0
2005020026,10,3557,0.0,25,20,1,2,5,80.0
2005020027,7,3600,0.0,35,30,3,7,5,85.71428571
2005020027,9,3593,0.0,35,35,10,1,0,100.0
2005020028,12,3501,0.0,35,32,6,2,3,91.42857143
2005020028,2,3600,0.0,44,42,14,0,2,95.45454545
2005020029,15,3600,2.0,42,34,16,1,8,80.95238095
2005020029,11,3600,0.0,20,19,6,1,1,95.0
2005020030,3,3790,0.0,27,24,7,1,3,88.88888889
2005020030,1,3797,0.0,35,33,16,0,2,94.28571429
2005020031,6,3655,0.0,29,23,15,0,6,79.31034483
2005020031,5,3677,0.0,41,34,9,2,7,82.92682927
2005020032,13,3478,0.0,34,32,15,0,2,94.11764706
2005020032,14,3600,0.0,29,28,8,5,1,96.55172414
2005020033,28,3595,2.0,26,20,7,0,6,76.92307692
2005020033,19,3572,0.0,39,32,6,1,7,82.05128205
2005020034,24,3900,0.0,35,33,7,0,2,94.28571429
2005020034,18,3898,0.0,35,33,6,1,2,94.28571429
2005020035,21,3600,0.0,18,16,4,2,2,88.88888889
2005020035,25,3577,0.0,31,28,12,1,3,90.32258065
2005020036,23,3886,0.0,34,31,8,1,3,91.17647059
2005020036,22,3878,0.0,31,28,10,0,3,90.32258065
2005020037,30,3556,0.0,17,15,3,0,2,88.23529412
2005020037,27,3595,2.0,24,23,7,0,1,95.83333333
2005020038,20,1200,0.0,4,3,0,0,1,75.0
2005020038,20,2400,0.0,36,31,12,2,5,86.11111111
2005020038,17,3600,0.0,24,21,5,2,3,87.5
2005020039,29,3598,0.0,32,30,14,0,2,93.75
2005020039,16,3527,0.0,27,24,3,2,3,88.88888889
2005020040,30,3806,0.0,32,30,5,1,2,93.75
2005020040,26,3811,0.0,25,24,4,0,1,96.0
2005020041,13,3597,0.0,30,29,8,1,1,96.66666667
2005020041,2,3582,2.0,22,20,11,4,2,90.90909091
2005020042,3,3558,0.0,28,25,5,4,3,89.28571429
2005020042,15,3595,0.0,32,30,14,0,2,93.75
2005020043,5,3879,0.0,41,38,8,1,3,92.68292683
2005020043,7,3871,0.0,28,26,1,1,2,92.85714286
2005020044,10,3897,0.0,36,31,3,1,5,86.11111111
2005020044,9,3900,2.0,27,22,4,3,5,81.48148148
2005020045,6,3600,0.0,28,26,6,0,2,92.85714286
2005020045,14,487,0.0,4,4,2,0,0,100.0
2005020045,14,2972,0.0,20,16,3,2,4,80.0
2005020046,20,3594,0.0,41,34,13,2,7,82.92682927
2005020046,21,3593,2.0,33,30,7,0,3,90.90909091
2005020047,22,3597,0.0,33,31,7,0,2,93.93939394
2005020047,24,3520,2.0,31,28,9,4,3,90.32258065
2005020048,4,3508,0.0,22,18,2,0,4,81.81818182
2005020048,10,3594,0.0,33,31,1,0,2,93.93939394
2005020049,9,3600,0.0,29,27,4,4,2,93.10344828
2005020049,8,3506,0.0,32,28,11,1,4,87.5
2005020050,23,3590,0.0,30,28,4,0,2,93.33333333
2005020050,17,3557,0.0,28,25,5,4,3,89.28571429
2005020051,16,3473,0.0,23,19,6,0,4,82.60869565
2005020051,19,3600,0.0,33,32,6,1,1,96.96969697
2005020052,27,3500,0.0,23,20,3,2,3,86.95652174
2005020052,25,3599,0.0,25,23,7,1,2,92.0
2005020053,22,3466,0.0,35,32,11,1,3,91.42857143
2005020053,26,3591,0.0,24,23,6,1,1,95.83333333
2005020054,15,723,0.0,11,10,5,0,1,90.90909091
2005020054,15,2873,0.0,25,19,8,1,6,76.0
2005020054,12,3584,0.0,28,26,9,2,2,92.85714286
2005020055,8,3590,0.0,32,32,7,1,0,100.0
2005020055,11,3104,0.0,30,29,9,2,1,96.66666667
2005020055,11,403,0.0,5,4,0,0,1,80.0
2005020056,23,3598,0.0,28,22,4,1,6,78.57142857
2005020056,30,3600,0.0,33,33,11,0,0,100.0
2005020057,18,3600,0.0,24,20,1,2,4,83.33333333
2005020057,21,3555,2.0,18,13,2,1,5,72.22222222
2005020058,29,3600,0.0,36,32,11,1,4,88.88888889
2005020058,28,3594,2.0,27,26,10,0,1,96.2962963
2005020059,1,3600,0.0,23,19,4,0,4,82.60869565
2005020059,3,3581,0.0,21,20,3,2,1,95.23809524
2005020060,2,1867,0.0,14,13,6,0,1,92.85714286
2005020060,2,1731,0.0,15,13,3,0,2,86.66666667
2005020060,15,3550,0.0,49,44,17,1,5,89.79591837
2005020061,6,3600,0.0,35,33,0,0,2,94.28571429
2005020061,13,2001,0.0,10,9,0,0,1,90.0
2005020061,13,1519,0.0,15,12,0,0,3,80.0
2005020062,7,3894,0.0,35,32,6,1,3,91.42857143
2005020062,14,3900,0.0,33,30,6,1,3,90.90909091
2005020063,25,3844,2.0,20,18,2,0,2,90.0
2005020063,20,3841,0.0,22,19,6,0,3,86.36363636
2005020064,18,3898,0.0,31,27,7,0,4,87.09677419
2005020064,27,3889,0.0,26,22,2,6,4,84.61538462
2005020065,17,3600,0.0,28,26,3,0,2,92.85714286
2005020065,26,3515,2.0,19,16,2,0,3,84.21052632
2005020066,5,1447,0.0,20,16,4,0,4,80.0
2005020066,5,2350,0.0,21,19,5,2,2,90.47619048
2005020066,4,3795,0.0,20,15,4,1,5,75.0
2005020067,10,3560,0.0,20,19,11,3,1,95.0
2005020067,11,3591,0.0,34,25,13,0,9,73.52941176
2005020068,23,3590,0.0,13,10,1,2,3,76.92307692
2005020068,30,3546,2.0,40,36,4,0,4,90.0
2005020069,16,3883,0.0,29,27,15,1,2,93.10344828
2005020069,21,3876,0.0,40,38,6,7,2,95.0
2005020070,25,3592,0.0,36,34,6,1,2,94.44444444
2005020070,22,2316,0.0,18,17,4,0,1,94.44444444
2005020070,22,1216,0.0,7,5,2,0,2,71.42857143
2005020071,29,3545,0.0,36,32,6,3,4,88.88888889
2005020071,24,3600,0.0,19,16,5,0,3,84.21052632
2005020072,10,3600,0.0,31,29,5,0,2,93.5483871
2005020072,8,3564,0.0,21,18,3,1,3,85.71428571
2005020073,6,1979,0.0,24,20,5,0,4,83.33333333
2005020073,6,1621,0.0,18,17,0,0,1,94.44444444
2005020073,9,3600,0.0,35,34,6,1,1,97.14285714
2005020074,11,3600,0.0,29,24,4,0,5,82.75862069
2005020074,3,3587,0.0,29,28,5,1,1,96.55172414
2005020075,2,3600,0.0,46,41,23,0,5,89.13043478
2005020075,4,3598,2.0,20,19,5,4,1,95.0
2005020076,12,3600,0.0,28,27,5,3,1,96.42857143
2005020076,1,2400,0.0,19,14,3,0,5,73.68421053
2005020076,1,1200,0.0,6,5,0,0,1,83.33333333
2005020077,14,3581,0.0,21,20,2,0,1,95.23809524
2005020077,5,3546,0.0,30,27,6,1,3,90.0
2005020078,7,3573,0.0,42,39,0,0,3,92.85714286
2005020078,13,3600,0.0,34,32,0,0,2,94.11764706
2005020079,18,3600,0.0,29,28,4,1,1,96.55172414
2005020079,19,3570,0.0,23,20,7,0,3,86.95652174
2005020080,22,3541,0.0,27,25,7,0,2,92.59259259
2005020080,20,3594,0.0,33,33,9,2,0,100.0
2005020081,17,3595,0.0,23,23,4,1,0,100.0
2005020081,27,3591,0.0,20,18,6,0,2,90.0
2005020082,16,3471,0.0,44,40,13,6,4,90.90909091
2005020082,28,3587,0.0,27,24,6,1,3,88.88888889
2005020083,14,3851,0.0,14,12,0,1,2,85.71428571
2005020083,15,3900,0.0,40,38,13,2,2,95.0
2005020084,24,910,0.0,3,3,1,0,0,100.0
2005020084,24,2690,0.0,19,15,5,0,4,78.94736842
2005020084,30,3600,0.0,29,28,4,3,1,96.55172414
2005020085,29,3551,0.0,31,28,10,4,3,90.32258065
2005020085,26,3595,0.0,20,19,5,0,1,95.0
2005020086,25,3600,2.0,35,30,13,0,5,85.71428571
2005020086,23,3599,0.0,20,18,2,2,2,90.0
2005020087,13,2399,0.0,38,34,13,1,4,89.47368421
2005020087,3,3600,0.0,23,23,7,0,0,100.0
2005020088,28,3847,2.0,34,31,11,2,3,91.17647059
2005020088,17,3849,0.0,28,26,8,2,2,92.85714286
2005020089,27,3600,0.0,25,25,4,3,0,100.0
2005020089,20,3567,0.0,20,19,3,0,1,95.0
2005020090,6,3580,0.0,38,34,4,5,4,89.47368421
2005020090,8,3582,0.0,23,20,7,2,3,86.95652174
2005020091,13,3530,0.0,34,30,9,0,4,88.23529412
2005020091,1,3595,0.0,24,21,4,0,3,87.5
2005020092,27,3650,0.0,30,27,5,2,3,90.0
2005020092,22,3660,0.0,34,30,8,2,4,88.23529412
2005020093,16,3600,0.0,25,19,4,0,6,76.0
2005020093,23,3596,0.0,26,24,4,2,2,92.30769231
2005020094,2,3900,0.0,35,33,12,0,2,94.28571429
2005020094,3,3894,0.0,26,24,7,0,2,92.30769231
2005020095,24,1293,2.0,14,12,2,0,2,85.71428571
2005020095,24,2215,0.0,20,19,4,0,1,95.0
2005020095,19,3600,0.0,30,28,7,2,2,93.33333333
2005020096,28,3597,0.0,25,19,2,0,6,76.0
2005020096,30,3598,0.0,35,34,6,0,1,97.14285714
2005020097,26,3598,0.0,21,17,0,2,4,80.95238095
2005020097,21,3552,0.0,30,25,1,0,5,83.33333333
2005020098,7,3573,0.0,32,29,10,2,3,90.625
2005020098,6,3542,0.0,37,33,3,4,4,89.18918919
2005020099,3,3557,2.0,21,16,3,1,5,76.19047619
2005020099,2,3596,0.0,30,26,5,0,4,86.66666667
2005020100,14,3596,0.0,15,15,5,3,0,100.0
2005020100,11,694,0.0,7,4,0,0,3,57.14285714
2005020100,11,2906,0.0,29,26,14,1,3,89.65517241
2005020101,15,3562,0.0,49,46,0,0,3,93.87755102
2005020101,13,3568,0.0,31,29,2,0,2,93.5483871
2005020102,12,3884,0.0,23,18,3,1,5,78.26086957
2005020102,10,3884,0.0,32,28,7,2,4,87.5
2005020103,1,3600,0.0,33,30,6,1,3,90.90909091
2005020103,5,2528,0.0,29,23,7,1,6,79.31034483
2005020103,5,1072,0.0,7,7,0,0,0,100.0
2005020104,19,3900,0.0,29,27,6,1,2,93.10344828
2005020104,18,3900,0.0,31,29,3,0,2,93.5483871
2005020105,26,3593,0.0,30,28,5,1,2,93.33333333
2005020105,25,3080,2.0,21,17,3,1,4,80.95238095
2005020105,25,513,0.0,7,4,0,0,3,57.14285714
2005020106,22,3523,0.0,22,19,4,2,3,86.36363636
2005020106,20,3600,0.0,29,28,9,3,1,96.55172414
2005020107,27,3520,0.0,38,35,9,4,3,92.10526316
2005020107,23,3572,0.0,24,22,7,2,2,91.66666667
2005020108,28,1601,0.0,10,9,3,1,1,90.0
2005020108,28,1995,0.0,15,12,5,0,3,80.0
2005020108,29,3598,0.0,26,25,4,3,1,96.15384615
2005020109,9,3600,0.0,24,23,1,1,1,95.83333333
2005020109,14,3600,4.0,29,25,4,1,4,86.20689655
2005020110,24,3569,0.0,39,36,8,1,3,92.30769231
2005020110,17,3597,0.0,25,23,6,5,2,92.0
2005020111,21,3595,0.0,22,21,7,1,1,95.45454545
2005020111,22,2047,0.0,18,15,4,0,3,83.33333333
2005020111,22,1546,0.0,14,10,3,0,4,71.42857143
2005020112,5,3573,0.0,47,41,11,5,6,87.23404255
2005020112,6,3571,0.0,21,18,6,1,3,85.71428571
2005020113,4,3593,0.0,24,22,5,5,2,91.66666667
2005020113,10,3600,0.0,32,27,5,0,5,84.375
2005020114,2,3577,0.0,32,28,4,3,4,87.5
2005020114,8,3566,0.0,22,19,3,1,3,86.36363636
2005020115,12,228,0.0,1,1,0,0,0,100.0
2005020115,12,3345,0.0,17,17,2,1,0,100.0
2005020115,15,3600,0.0,41,37,13,3,4,90.24390244
2005020116,1,3543,0.0,28,24,5,2,4,85.71428571
2005020116,11,3596,0.0,35,32,8,0,3,91.42857143
2005020117,17,3600,0.0,17,17,6,0,0,100.0
2005020117,29,954,0.0,17,13,0,0,4,76.47058824
2005020117,29,2646,0.0,19,17,2,0,2,89.47368421
2005020118,3,3510,0.0,31,28,10,0,3,90.32258065
2005020118,7,3595,0.0,23,22,4,0,1,95.65217391
2005020119,9,3600,0.0,29,26,0,0,3,89.65517241
2005020119,13,856,0.0,10,10,0,0,0,100.0
2005020119,13,2744,0.0,33,27,5,0,6,81.81818182
2005020120,30,3600,0.0,40,38,3,0,2,95.0
2005020120,19,3541,0.0,31,28,5,1,3,90.32258065
2005020121,28,3526,0.0,30,28,8,3,2,93.33333333
2005020121,18,3589,0.0,38,37,9,1,1,97.36842105
2005020122,20,3560,0.0,23,21,5,1,2,91.30434783
2005020122,25,3600,2.0,30,29,9,0,1,96.66666667
2005020123,21,3511,0.0,22,17,4,2,5,77.27272727
2005020123,23,3600,0.0,32,28,12,1,4,87.5
2005020124,27,1200,0.0,11,8,0,1,3,72.72727273
2005020124,27,2397,0.0,17,15,2,2,2,88.23529412
2005020124,24,3600,0.0,27,24,7,1,3,88.88888889
2005020125,30,3600,0.0,32,28,5,2,4,87.5
2005020125,16,3600,0.0,17,15,4,1,2,88.23529412
2005020126,20,3600,2.0,20,18,6,1,2,90.0
2005020126,26,3591,0.0,31,28,16,3,3,90.32258065
2005020127,9,3563,0.0,27,24,0,0,3,88.88888889
2005020127,12,3600,0.0,47,45,0,0,2,95.74468085
2005020128,17,3600,0.0,33,31,9,2,2,93.93939394
2005020128,29,3558,0.0,37,31,13,2,6,83.78378378
2005020129,6,3900,0.0,32,28,7,3,4,87.5
2005020129,10,3898,0.0,53,49,22,4,4,92.45283019
2005020130,11,3538,0.0,26,22,4,2,4,84.61538462
2005020130,2,3600,0.0,36,33,16,0,3,91.66666667
2005020131,4,3735,0.0,29,26,15,0,3,89.65517241
2005020131,8,3748,0.0,22,20,3,1,2,90.90909091
2005020132,13,3643,0.0,41,38,19,1,3,92.68292683
2005020132,5,3650,0.0,34,30,4,6,4,88.23529412
2005020133,16,3515,0.0,22,17,1,3,5,77.27272727
2005020133,18,3600,2.0,41,38,18,0,3,92.68292683
2005020134,23,3597,0.0,28,27,4,3,1,96.42857143
2005020134,30,3598,0.0,36,33,8,2,3,91.66666667
2005020135,22,3588,0.0,32,27,7,1,5,84.375
2005020135,21,3600,0.0,28,25,6,2,3,89.28571429
2005020136,19,3711,0.0,31,26,8,0,5,83.87096774
2005020136,27,3678,0.0,28,24,11,2,4,85.71428571
2005020137,24,3600,0.0,33,30,9,2,3,90.90909091
2005020137,26,3600,0.0,30,29,18,1,1,96.66666667
2005020138,15,3597,0.0,17,15,3,2,2,88.23529412
2005020138,7,3570,0.0,28,25,4,0,3,89.28571429
2005020139,6,3804,0.0,33,29,5,0,4,87.87878788
2005020139,12,3796,0.0,27,24,6,0,3,88.88888889
2005020140,18,3594,0.0,34,31,10,4,3,91.17647059
2005020140,29,3628,0.0,24,22,10,1,2,91.66666667
2005020141,14,3600,0.0,23,20,4,1,3,86.95652174
2005020141,1,3190,0.0,34,30,8,0,4,88.23529412
2005020141,1,410,0.0,5,3,2,0,2,60.0
2005020142,28,2129,0.0,13,12,3,1,1,92.30769231
2005020142,28,1632,0.0,10,7,1,1,3,70.0
2005020142,25,3763,0.0,41,36,16,0,5,87.80487805
2005020143,20,3532,0.0,31,27,7,1,4,87.09677419
2005020143,24,3600,0.0,26,25,9,0,1,96.15384615
2005020144,10,3523,0.0,30,28,4,2,2,93.33333333
2005020144,6,3600,2.0,37,36,6,0,1,97.2972973
2005020145,2,3566,2.0,32,30,3,5,2,93.75
2005020145,3,3588,0.0,32,31,12,0,1,96.875
2005020146,13,3673,0.0,40,35,16,1,5,87.5
2005020146,4,3656,0.0,34,30,7,1,4,88.23529412
2005020147,8,3768,0.0,42,38,6,1,4,90.47619048
2005020147,9,3768,0.0,30,27,5,0,3,90.0
2005020148,11,3577,0.0,30,23,9,0,7,76.66666667
2005020148,5,3597,0.0,35,30,7,0,5,85.71428571
2005020149,16,3600,0.0,28,23,6,0,5,82.14285714
2005020149,17,3600,0.0,23,21,2,2,2,91.30434783
2005020150,23,1424,0.0,18,14,7,0,4,77.77777778
2005020150,23,2159,0.0,12,10,7,0,2,83.33333333
2005020150,21,3586,0.0,42,40,12,3,2,95.23809524
2005020151,20,3555,2.0,34,31,17,3,3,91.17647059
2005020151,27,3591,0.0,15,13,1,2,2,86.66666667
2005020152,4,3583,0.0,36,29,9,1,7,80.55555556
2005020152,12,3592,0.0,34,28,6,3,6,82.35294118
2005020153,30,3900,0.0,53,52,7,1,1,98.11320755
2005020153,29,3885,0.0,28,27,3,0,1,96.42857143
2005020154,7,3541,0.0,27,24,1,2,3,88.88888889
2005020154,1,3600,0.0,27,25,5,0,2,92.59259259
2005020155,15,3540,2.0,27,24,9,1,3,88.88888889
2005020155,14,3596,2.0,14,12,2,1,2,85.71428571
2005020156,22,3588,0.0,22,19,7,0,3,86.36363636
2005020156,25,3600,2.0,25,20,9,0,5,80.0
2005020157,19,3558,0.0,39,33,11,0,6,84.61538462
2005020157,24,3593,0.0,28,24,5,1,4,85.71428571
2005020158,28,3583,0.0,25,21,1,0,4,84.0
2005020158,26,1704,0.0,14,12,4,1,2,85.71428571
2005020158,26,1868,0.0,19,16,4,0,3,84.21052632
2005020159,1,3882,0.0,31,27,4,4,4,87.09677419
2005020159,6,3900,0.0,34,30,16,3,4,88.23529412
2005020160,9,3600,0.0,27,27,9,1,0,100.0
2005020160,10,2141,0.0,18,15,4,0,3,83.33333333
2005020160,10,1459,0.0,15,10,5,0,5,66.66666667
2005020161,3,3600,0.0,40,38,5,1,2,95.0
2005020161,8,2400,0.0,16,14,5,0,2,87.5
2005020161,8,1200,0.0,13,10,1,1,3,76.92307692
2005020162,7,3600,2.0,37,33,3,1,4,89.18918919
2005020162,2,2350,0.0,19,16,6,0,3,84.21052632
2005020162,2,1246,0.0,12,9,2,0,3,75.0
2005020163,14,3600,0.0,31,29,9,2,2,93.5483871
2005020163,11,3573,0.0,23,20,5,0,3,86.95652174
2005020164,12,3585,0.0,28,25,5,0,3,89.28571429
2005020164,5,3556,0.0,32,28,11,3,4,87.5
2005020165,15,3546,0.0,36,33,9,1,3,91.66666667
2005020165,13,3600,0.0,39,37,12,1,2,94.87179487
2005020166,22,3592,0.0,24,23,7,1,1,95.83333333
2005020166,18,3551,0.0,31,26,7,1,5,83.87096774
2005020167,29,3593,0.0,24,21,5,1,3,87.5
2005020167,30,3598,0.0,16,15,5,1,1,93.75
2005020168,17,3580,0.0,25,23,2,3,2,92.0
2005020168,16,3568,0.0,36,33,9,1,3,91.66666667
2005020169,23,642,0.0,6,5,1,0,1,83.33333333
2005020169,23,3073,0.0,26,23,7,0,3,88.46153846
2005020169,21,3714,0.0,25,22,4,1,3,88.0
2005020170,25,3563,0.0,23,20,4,0,3,86.95652174
2005020170,27,3566,0.0,40,36,7,1,4,90.0
2005020171,19,3600,0.0,30,25,3,1,5,83.33333333
2005020171,26,3600,0.0,31,29,5,1,2,93.5483871
2005020172,20,3900,0.0,21,19,3,2,2,90.47619048
2005020172,28,3855,2.0,25,23,6,1,2,92.0
2005020173,4,3599,0.0,42,39,15,2,3,92.85714286
2005020173,9,3522,0.0,32,27,10,0,5,84.375
2005020174,27,3516,0.0,27,24,2,3,3,88.88888889
2005020174,24,3600,0.0,36,34,5,1,2,94.44444444
2005020175,8,3593,2.0,24,23,6,0,1,95.83333333
2005020175,3,3588,0.0,30,27,13,0,3,90.0
2005020176,13,3519,0.0,24,22,4,0,2,91.66666667
2005020176,10,3600,0.0,32,31,12,2,1,96.875
2005020177,6,3862,0.0,23,19,3,3,4,82.60869565
2005020177,2,3853,0.0,32,29,10,0,3,90.625
2005020178,13,3788,0.0,38,33,12,1,5,86.84210526
2005020178,8,3731,0.0,30,26,7,1,4,86.66666667
2005020179,5,3653,0.0,29,26,5,1,3,89.65517241
2005020179,1,3654,0.0,37,33,12,0,4,89.18918919
2005020180,11,3589,0.0,33,29,3,0,4,87.87878788
2005020180,14,3530,0.0,28,23,6,1,5,82.14285714
2005020181,16,3571,0.0,20,16,2,1,4,80.0
2005020181,17,2603,0.0,24,23,4,0,1,95.83333333
2005020181,17,994,0.0,8,8,0,2,0,100.0
2005020182,30,3569,0.0,23,21,3,1,2,91.30434783
2005020182,20,3600,0.0,23,23,10,0,0,100.0
2005020183,29,3600,0.0,35,30,5,0,5,85.71428571
2005020183,22,3600,0.0,24,23,1,1,1,95.83333333
2005020184,18,3436,0.0,35,31,7,0,4,88.57142857
2005020184,24,3600,0.0,33,32,13,0,1,96.96969697
2005020185,9,3592,0.0,37,33,7,1,4,89.18918919
2005020185,7,1953,0.0,17,13,2,0,4,76.47058824
2005020185,7,1644,0.0,19,13,4,3,6,68.42105263
2005020186,16,3630,2.0,37,32,13,3,5,86.48648649
2005020186,19,3635,0.0,32,26,7,2,6,81.25
2005020187,26,3600,0.0,32,29,8,1,3,90.625
2005020187,25,3600,0.0,26,20,5,0,6,76.92307692
2005020188,30,3542,0.0,30,28,9,1,2,93.33333333
2005020188,23,3596,0.0,32,31,8,0,1,96.875
2005020189,18,3704,0.0,36,33,9,0,3,91.66666667
2005020189,28,3704,0.0,23,21,0,1,2,91.30434783
2005020190,13,3554,0.0,32,29,4,1,3,90.625
2005020190,6,3600,0.0,30,29,11,2,1,96.66666667
2005020191,5,3596,0.0,23,22,6,1,1,95.65217391
2005020191,2,3600,0.0,33,28,12,1,5,84.84848485
2005020192,15,3599,0.0,43,35,10,3,8,81.39534884
2005020192,4,3591,0.0,30,29,9,3,1,96.66666667
2005020193,10,3549,0.0,35,31,12,1,4,88.57142857
2005020193,12,3600,0.0,25,22,5,0,3,88.0
2005020194,14,3592,0.0,31,27,3,1,4,87.09677419
2005020194,9,3600,2.0,33,31,7,0,2,93.93939394
2005020195,3,3600,0.0,32,30,8,1,2,93.75
2005020195,1,3575,0.0,24,21,4,1,3,87.5
2005020196,22,3711,0.0,38,35,8,0,3,92.10526316
2005020196,17,3696,0.0,25,21,3,0,4,84.0
2005020197,24,3544,0.0,32,28,5,2,4,87.5
2005020197,21,3600,0.0,23,20,3,3,3,86.95652174
2005020198,29,3551,2.0,31,29,5,0,2,93.5483871
2005020198,20,3600,2.0,17,16,4,0,1,94.11764706
2005020199,26,2393,0.0,22,18,4,0,4,81.81818182
2005020199,26,1200,0.0,7,7,7,0,0,100.0
2005020199,27,3599,2.0,21,21,3,5,0,100.0
2005020200,11,3900,0.0,32,30,6,2,2,93.75
2005020200,15,3896,0.0,37,35,10,1,2,94.59459459
2005020201,8,3600,0.0,26,24,2,0,2,92.30769231
2005020201,7,3555,2.0,31,28,8,1,3,90.32258065
2005020202,22,3596,0.0,36,34,10,1,2,94.44444444
2005020202,19,1196,0.0,13,10,2,4,3,76.92307692
2005020202,19,2374,0.0,15,11,2,0,4,73.33333333
2005020203,16,870,0.0,18,14,2,0,4,77.77777778
2005020203,16,2721,0.0,22,17,9,0,5,77.27272727
2005020203,25,3600,0.0,19,18,7,1,1,94.73684211
2005020204,29,3549,0.0,25,21,7,2,4,84.0
2005020204,23,3590,0.0,24,21,5,1,3,87.5
2005020205,28,3651,0.0,21,21,5,0,0,100.0
2005020205,24,3624,0.0,32,31,11,5,1,96.875
2005020206,1,3900,0.0,37,35,7,0,2,94.59459459
2005020206,3,3900,0.0,25,23,5,0,2,92.0
2005020207,18,3900,0.0,38,36,14,2,2,94.73684211
2005020207,26,3900,0.0,22,20,6,0,2,90.90909091
2005020208,5,1823,0.0,14,13,5,2,1,92.85714286
2005020208,5,1777,0.0,18,13,1,3,5,72.22222222
2005020208,6,3597,0.0,29,26,8,3,3,89.65517241
2005020209,14,3571,0.0,25,21,10,2,4,84.0
2005020209,10,3600,2.0,36,33,9,0,3,91.66666667
2005020210,7,3563,0.0,29,26,3,2,3,89.65517241
2005020210,8,3597,0.0,30,28,4,2,2,93.33333333
2005020211,2,3600,2.0,32,26,6,3,6,81.25
2005020211,9,3600,0.0,28,28,6,2,0,100.0
2005020212,11,3552,0.0,18,14,4,2,4,77.77777778
2005020212,4,3594,0.0,31,28,16,4,3,90.32258065
2005020213,13,3588,0.0,29,27,9,0,2,93.10344828
2005020213,12,3596,0.0,27,27,1,2,0,100.0
2005020214,27,3600,0.0,37,36,14,2,1,97.2972973
2005020214,17,3519,0.0,28,25,11,0,3,89.28571429
2005020215,25,3900,0.0,29,27,12,1,2,93.10344828
2005020215,21,3874,2.0,35,33,11,1,2,94.28571429
2005020216,23,3546,0.0,27,26,3,2,1,96.2962963
2005020216,20,3600,0.0,23,23,4,1,0,100.0
2005020217,30,3589,2.0,36,35,9,1,1,97.22222222
2005020217,28,3530,0.0,24,22,3,0,2,91.66666667
2005020218,10,3570,0.0,33,28,12,3,5,84.84848485
2005020218,15,3600,0.0,30,26,8,0,4,86.66666667
2005020219,27,3858,0.0,36,34,4,0,2,94.44444444
2005020219,16,3853,0.0,29,28,5,3,1,96.55172414
2005020220,17,3600,2.0,27,26,8,0,1,96.2962963
2005020220,19,3585,0.0,25,21,5,2,4,84.0
2005020221,30,3880,2.0,42,39,11,1,3,92.85714286
2005020221,24,3879,0.0,21,18,6,0,3,85.71428571
2005020222,5,3600,0.0,37,35,7,1,2,94.59459459
2005020222,3,3526,0.0,24,21,5,2,3,87.5
2005020223,22,2508,0.0,23,19,6,0,4,82.60869565
2005020223,22,1092,0.0,3,3,0,1,0,100.0
2005020223,25,3594,0.0,16,16,5,1,0,100.0
2005020224,23,3594,0.0,28,24,14,1,4,85.71428571
2005020224,20,3593,0.0,21,18,4,0,3,85.71428571
2005020225,6,3715,0.0,36,32,9,1,4,88.88888889
2005020225,4,3691,0.0,30,27,6,2,3,90.0
2005020226,15,649,0.0,2,1,0,0,1,50.0
2005020226,15,2846,0.0,32,27,12,0,5,84.375
2005020226,10,3600,0.0,30,26,3,2,4,86.66666667
2005020227,14,3493,0.0,19,16,7,1,3,84.21052632
2005020227,8,3600,0.0,34,32,13,3,2,94.11764706
2005020228,2,3589,0.0,26,25,4,0,1,96.15384615
2005020228,1,3600,0.0,20,16,2,1,4,80.0
2005020229,22,3553,0.0,27,24,3,3,3,88.88888889
2005020229,18,3596,0.0,33,31,8,1,2,93.93939394
2005020230,27,3600,0.0,28,26,10,0,2,92.85714286
2005020230,30,2400,0.0,8,7,1,0,1,87.5
2005020230,30,1185,0.0,10,7,0,0,3,70.0
2005020231,28,3600,0.0,23,18,1,2,5,78.26086957
2005020231,21,3600,0.0,33,31,6,1,2,93.93939394
2005020232,12,3594,0.0,44,41,5,0,3,93.18181818
2005020232,7,3583,0.0,21,17,2,1,4,80.95238095
2005020233,5,173,0.0,2,1,0,0,1,50.0
2005020233,5,3427,0.0,38,34,8,0,4,89.47368421
2005020233,11,3586,0.0,26,26,3,1,0,100.0
2005020234,3,3805,0.0,41,38,0,0,3,92.68292683
2005020234,13,3892,0.0,40,37,0,0,3,92.5
2005020235,19,3600,0.0,23,20,3,0,3,86.95652174
2005020235,29,3600,0.0,25,24,9,2,1,96.0
2005020236,26,3697,0.0,39,34,6,3,5,87.17948718
2005020236,17,3699,0.0,41,37,6,4,4,90.24390244
2005020237,9,3600,0.0,39,37,6,2,2,94.87179487
2005020237,6,3600,0.0,30,25,13,1,5,83.33333333
2005020238,2,3583,0.0,30,27,3,0,3,90.0
2005020238,4,3600,0.0,40,38,7,3,2,95.0
2005020239,8,3892,0.0,23,21,3,0,2,91.30434783
2005020239,5,3900,0.0,32,30,6,1,2,93.75
2005020240,3,3600,0.0,25,23,4,3,2,92.0
2005020240,14,3551,0.0,19,15,5,1,4,78.94736842
2005020241,16,3600,2.0,33,31,12,0,2,93.93939394
2005020241,19,926,0.0,2,2,1,0,0,100.0
2005020241,19,2652,0.0,30,26,3,1,4,86.66666667
2005020242,25,3542,0.0,32,27,13,2,5,84.375
2005020242,18,3598,0.0,28,25,7,0,3,89.28571429
2005020243,20,3594,0.0,23,20,3,5,3,86.95652174
2005020243,27,3583,0.0,43,39,14,3,4,90.69767442
2005020244,21,3596,0.0,28,25,7,0,3,89.28571429
2005020244,23,3433,0.0,30,25,4,1,5,83.33333333
2005020245,1,3596,0.0,24,21,4,1,3,87.5
2005020245,15,3521,0.0,30,26,8,0,4,86.66666667
2005020246,14,1200,0.0,4,3,0,0,1,75.0
2005020246,14,2400,0.0,23,19,5,0,4,82.60869565
2005020246,11,3600,0.0,36,34,4,2,2,94.44444444
2005020247,22,3600,0.0,30,29,3,0,1,96.66666667
2005020247,29,3514,0.0,20,18,1,1,2,90.0
2005020248,12,3588,0.0,26,26,0,0,0,100.0
2005020248,13,3571,0.0,35,34,0,0,1,97.14285714
2005020249,30,3600,0.0,37,34,5,2,3,91.89189189
2005020249,17,3593,0.0,17,16,4,0,1,94.11764706
2005020250,10,3569,0.0,29,25,6,1,4,86.20689655
2005020250,7,3595,0.0,29,27,7,2,2,93.10344828
2005020251,26,3598,0.0,34,32,12,2,2,94.11764706
2005020251,16,3600,0.0,27,23,9,0,4,85.18518519
2005020252,15,3562,2.0,28,25,11,0,3,89.28571429
2005020252,1,3591,0.0,20,18,7,1,2,90.0
2005020253,10,3853,0.0,35,31,11,2,4,88.57142857
2005020253,8,3853,0.0,24,19,2,4,5,79.16666667
2005020254,7,3600,0.0,37,31,8,1,6,83.78378378
2005020254,9,3600,0.0,25,24,8,3,1,96.0
2005020255,6,3589,0.0,30,26,7,2,4,86.66666667
2005020255,2,3600,0.0,31,29,9,0,2,93.5483871
2005020256,13,3600,0.0,39,34,12,3,5,87.17948718
2005020256,4,3600,0.0,30,26,6,1,4,86.66666667
2005020257,11,2396,0.0,14,14,5,1,0,100.0
2005020257,11,1200,0.0,5,5,3,0,0,100.0
2005020257,12,2931,0.0,33,26,13,2,7,78.78787879
2005020257,12,653,0.0,3,1,0,0,2,33.33333333
2005020258,3,3553,0.0,24,23,8,0,1,95.83333333
2005020258,5,3584,0.0,41,35,10,1,6,85.36585366
2005020259,19,3495,0.0,29,26,10,2,3,89.65517241
2005020259,18,3600,0.0,27,26,4,0,1,96.2962963
2005020260,24,3785,0.0,30,28,3,0,2,93.33333333
2005020260,27,3789,0.0,44,43,11,0,1,97.72727273
2005020261,21,899,0.0,8,5,2,1,3,62.5
2005020261,21,2565,0.0,16,14,6,2,2,87.5
2005020261,20,3600,0.0,30,27,9,1,3,90.0
2005020262,25,3899,2.0,29,27,9,0,2,93.10344828
2005020262,28,3900,0.0,22,20,2,0,2,90.90909091
2005020263,26,3600,0.0,29,27,3,3,2,93.10344828
2005020263,29,3257,0.0,23,18,6,0,5,78.26086957
2005020263,29,343,0.0,5,2,0,0,3,40.0
2005020264,22,3438,0.0,19,16,0,1,3,84.21052632
2005020264,16,3600,0.0,27,26,8,1,1,96.2962963
2005020265,25,3600,0.0,41,40,10,3,1,97.56097561
2005020265,24,2011,0.0,12,11,1,0,1,91.66666667
2005020265,24,1468,0.0,7,5,0,0,2,71.42857143
2005020266,17,3600,0.0,26,22,8,0,4,84.61538462
2005020266,23,3587,2.0,35,34,7,1,1,97.14285714
2005020267,2,3895,0.0,28,26,0,2,2,92.85714286
2005020267,5,3900,0.0,37,35,4,2,2,94.59459459
2005020268,4,3526,0.0,32,28,2,0,4,87.5
2005020268,14,3600,0.0,24,22,3,1,2,91.66666667
2005020269,22,3597,0.0,33,31,7,0,2,93.93939394
2005020269,21,3566,0.0,22,17,4,1,5,77.27272727
2005020270,30,3542,0.0,42,39,11,2,3,92.85714286
2005020270,20,3600,0.0,26,24,10,2,2,92.30769231
2005020271,1,3592,0.0,24,20,0,2,4,83.33333333
2005020271,7,3576,0.0,22,21,3,0,1,95.45454545
2005020272,14,3900,0.0,40,37,7,0,3,92.5
2005020272,15,3900,2.0,35,32,10,2,3,91.42857143
2005020273,3,3562,0.0,24,22,8,0,2,91.66666667
2005020273,10,3598,0.0,28,27,6,1,1,96.42857143
2005020274,13,3894,0.0,46,42,16,1,4,91.30434783
2005020274,8,3882,0.0,30,27,6,0,3,90.0
2005020275,12,3598,0.0,36,35,7,6,1,97.22222222
2005020275,9,3537,2.0,19,17,2,1,2,89.47368421
2005020276,26,3490,0.0,26,23,2,0,3,88.46153846
2005020276,18,3598,0.0,37,35,8,1,2,94.59459459
2005020277,5,3853,0.0,47,45,4,4,2,95.74468085
2005020277,4,3842,0.0,29,26,10,4,3,89.65517241
2005020278,2,3600,0.0,42,39,17,3,3,92.85714286
2005020278,11,3593,0.0,39,32,14,2,7,82.05128205
2005020279,19,3600,0.0,36,36,6,2,0,100.0
2005020279,29,3475,0.0,16,14,1,0,2,87.5
2005020280,17,3561,0.0,28,25,8,2,3,89.28571429
2005020280,20,3600,0.0,22,21,2,1,1,95.45454545
2005020281,21,3600,0.0,22,21,2,1,1,95.45454545
2005020281,27,3507,0.0,33,30,12,0,3,90.90909091
2005020282,25,3600,0.0,32,30,6,6,2,93.75
2005020282,24,3516,2.0,38,34,14,0,4,89.47368421
2005020283,23,3600,0.0,26,25,5,3,1,96.15384615
2005020283,28,3500,0.0,24,21,3,0,3,87.5
2005020284,10,3600,0.0,32,31,6,4,1,96.875
2005020284,6,3600,0.0,26,22,6,0,4,84.61538462
2005020285,15,3600,0.0,27,19,8,2,8,70.37037037
2005020285,7,3597,2.0,39,34,9,3,5,87.17948718
2005020286,3,3600,0.0,27,22,11,0,5,81.48148148
2005020286,12,3600,0.0,29,28,5,1,1,96.55172414
2005020287,13,3600,0.0,45,41,11,2,4,91.11111111
2005020287,9,3600,0.0,32,31,6,0,1,96.875
2005020288,2,3544,0.0,31,28,7,2,3,90.32258065
2005020288,14,3600,0.0,36,34,5,3,2,94.44444444
2005020289,17,3633,2.0,28,22,6,3,6,78.57142857
2005020289,22,3628,0.0,28,23,6,2,5,82.14285714
2005020290,23,2596,0.0,27,22,7,0,5,81.48148148
2005020290,23,948,0.0,11,11,1,0,0,100.0
2005020290,26,3600,0.0,36,32,8,2,4,88.88888889
2005020291,11,3662,0.0,36,31,11,0,5,86.11111111
2005020291,4,3785,0.0,36,30,12,4,6,83.33333333
2005020292,8,3569,0.0,30,26,1,1,4,86.66666667
2005020292,1,3594,0.0,28,25,5,0,3,89.28571429
2005020293,29,3567,0.0,29,23,4,0,6,79.31034483
2005020293,25,3591,0.0,18,15,4,2,3,83.33333333
2005020294,16,3600,2.0,32,30,8,0,2,93.75
2005020294,20,1200,0.0,7,6,0,0,1,85.71428571
2005020294,20,2400,0.0,18,14,3,2,4,77.77777778
2005020295,21,3595,0.0,33,31,6,0,2,93.93939394
2005020295,24,3552,0.0,31,28,9,0,3,90.32258065
2005020296,12,3500,0.0,32,28,5,1,4,87.5
2005020296,3,3600,0.0,31,28,5,1,3,90.32258065
2005020297,7,3598,0.0,22,20,3,2,2,90.90909091
2005020297,6,3528,0.0,24,21,5,1,3,87.5
2005020298,11,2118,0.0,21,20,2,2,1,95.23809524
2005020298,11,1482,0.0,17,13,6,1,4,76.47058824
2005020298,10,3600,0.0,32,31,9,1,1,96.875
2005020299,15,3592,0.0,44,43,17,1,1,97.72727273
2005020299,8,1750,0.0,17,13,6,0,4,76.47058824
2005020299,8,1834,0.0,3,2,0,0,1,66.66666667
2005020300,1,3548,0.0,42,37,5,1,5,88.0952381
2005020300,9,3587,0.0,29,25,6,0,4,86.20689655
2005020301,4,3578,0.0,30,27,2,2,3,90.0
2005020301,5,3552,2.0,28,23,6,1,5,82.14285714
2005020302,2,3586,0.0,29,26,0,0,3,89.65517241
2005020302,13,3518,0.0,28,23,1,0,5,82.14285714
2005020303,19,3600,0.0,34,32,7,2,2,94.11764706
2005020303,17,3514,0.0,30,27,12,1,3,90.0
2005020304,18,3600,2.0,28,24,6,0,4,85.71428571
2005020304,30,3600,0.0,32,30,9,0,2,93.75
2005020305,16,3600,0.0,36,33,13,1,3,91.66666667
2005020305,22,2642,0.0,21,17,2,0,4,80.95238095
2005020305,22,916,0.0,4,4,2,1,0,100.0
2005020306,21,3525,2.0,25,21,5,1,4,84.0
2005020306,26,3590,0.0,37,34,12,1,3,91.89189189
2005020307,27,3899,0.0,43,40,13,1,3,93.02325581
2005020307,28,3900,0.0,21,18,2,3,3,85.71428571
2005020308,23,3600,2.0,33,31,4,4,2,93.93939394
2005020308,24,2566,0.0,18,16,5,0,2,88.88888889
2005020308,24,953,0.0,11,10,7,0,1,90.90909091
2005020309,6,3553,0.0,32,29,5,0,3,90.625
2005020309,3,3600,0.0,34,32,3,1,2,94.11764706
2005020310,14,3598,2.0,22,20,2,1,2,90.90909091
2005020310,12,3600,0.0,29,24,3,0,5,82.75862069
2005020311,29,3212,0.0,33,28,12,0,5,84.84848485
2005020311,29,374,0.0,0,0,0,0,0,
2005020311,27,3569,0.0,24,23,5,2,1,95.83333333
2005020312,18,3599,0.0,41,39,11,4,2,95.12195122
2005020312,17,3542,0.0,14,12,6,0,2,85.71428571
2005020313,20,3891,0.0,35,33,8,0,2,94.28571429
2005020313,21,3881,0.0,34,32,5,1,2,94.11764706
2005020314,28,3885,0.0,21,20,6,0,1,95.23809524
2005020314,22,3895,2.0,22,21,4,0,1,95.45454545
2005020315,3,3899,0.0,39,37,3,6,2,94.87179487
2005020315,7,3875,2.0,27,25,7,1,2,92.59259259
2005020315,7,1,0.0,0,0,0,0,0,
2005020316,14,3600,0.0,32,30,1,0,2,93.75
2005020316,4,3519,0.0,25,21,2,0,4,84.0
2005020317,9,3598,0.0,30,27,4,0,3,90.0
2005020317,12,3513,0.0,29,25,1,3,4,86.20689655
2005020318,11,3899,0.0,30,28,8,3,2,93.33333333
2005020318,8,3900,0.0,38,36,20,1,2,94.73684211
2005020319,15,3534,0.0,28,23,5,0,5,82.14285714
2005020319,5,3600,0.0,45,41,8,2,4,91.11111111
2005020320,26,3592,0.0,26,23,7,3,3,88.46153846
2005020320,19,3554,0.0,27,22,8,1,5,81.48148148
2005020321,24,3588,0.0,20,19,7,0,1,95.0
2005020321,27,3519,0.0,20,18,2,1,2,90.0
2005020322,16,3600,0.0,22,19,1,0,3,86.36363636
2005020322,23,3572,0.0,33,32,0,1,1,96.96969697
2005020323,7,3900,0.0,26,23,4,2,3,88.46153846
2005020323,2,3899,0.0,28,25,4,2,3,89.28571429
2005020324,14,3898,0.0,20,17,2,0,3,85.0
2005020324,15,3900,0.0,42,39,13,0,3,92.85714286
2005020325,1,3600,0.0,25,24,0,0,1,96.0
2005020325,13,2120,0.0,15,15,0,0,0,100.0
2005020325,13,1478,0.0,20,15,0,0,5,75.0
2005020326,18,3593,0.0,37,35,10,2,2,94.59459459
2005020326,29,3599,0.0,41,37,14,0,4,90.24390244
2005020327,6,3600,0.0,21,20,4,4,1,95.23809524
2005020327,10,3600,0.0,37,32,9,0,5,86.48648649
2005020328,21,3579,0.0,28,22,4,0,6,78.57142857
2005020328,17,3600,0.0,27,24,5,0,3,88.88888889
2005020329,22,3598,0.0,25,22,7,0,3,88.0
2005020329,30,3543,0.0,28,24,8,3,4,85.71428571
2005020330,24,3572,0.0,27,24,10,2,3,88.88888889
2005020330,25,3581,0.0,21,20,5,2,1,95.23809524
2005020331,28,3516,0.0,25,22,1,1,3,88.0
2005020331,20,3600,0.0,22,20,1,0,2,90.90909091
2005020332,3,2540,0.0,19,16,5,1,3,84.21052632
2005020332,3,1060,0.0,6,6,0,1,0,100.0
2005020332,11,2231,0.0,19,17,9,0,2,89.47368421
2005020332,11,1331,0.0,13,10,1,0,3,76.92307692
2005020333,26,3377,0.0,33,29,3,1,4,87.87878788
2005020333,18,3600,2.0,38,35,7,4,3,92.10526316
2005020334,28,3551,0.0,20,17,1,1,3,85.0
2005020334,23,3600,0.0,22,20,7,1,2,90.90909091
2005020335,4,3594,0.0,28,25,3,2,3,89.28571429
2005020335,6,3548,0.0,26,22,3,1,4,84.61538462
2005020336,9,3600,0.0,33,31,3,1,2,93.93939394
2005020336,2,3600,0.0,45,39,7,2,6,86.66666667
2005020337,19,3484,0.0,29,24,8,0,5,82.75862069
2005020337,30,3597,0.0,32,29,3,0,3,90.625
2005020338,17,2358,0.0,18,17,4,0,1,94.44444444
2005020338,17,1200,0.0,10,9,1,1,1,90.0
2005020338,24,3600,0.0,29,28,6,0,1,96.55172414
2005020339,10,3888,0.0,35,32,8,1,3,91.42857143
2005020339,12,3891,0.0,38,35,9,3,3,92.10526316
2005020340,21,3594,0.0,35,35,0,1,0,100.0
2005020340,29,769,0.0,2,2,0,0,0,100.0
2005020340,29,2827,0.0,32,27,8,2,5,84.375
2005020341,1,3596,0.0,26,24,2,0,2,92.30769231
2005020341,14,1753,0.0,17,11,5,0,6,64.70588235
2005020341,14,1838,0.0,9,7,0,0,2,77.77777778
2005020342,5,3092,0.0,39,36,0,0,3,92.30769231
2005020342,5,508,0.0,7,4,0,0,3,57.14285714
2005020342,13,3600,0.0,39,36,0,0,3,92.30769231
2005020343,8,3513,0.0,31,28,3,0,3,90.32258065
2005020343,7,3579,0.0,41,40,13,1,1,97.56097561
2005020344,27,3600,0.0,33,32,13,3,1,96.96969697
2005020344,25,3596,0.0,22,18,6,1,4,81.81818182
2005020345,22,3898,0.0,28,27,7,1,1,96.42857143
2005020345,20,3894,0.0,34,33,9,2,1,97.05882353
2005020346,2,3600,0.0,36,34,1,3,2,94.44444444
2005020346,4,3570,0.0,20,17,5,1,3,85.0
2005020347,8,3671,0.0,37,33,8,1,4,89.18918919
2005020347,10,3689,0.0,33,30,9,1,3,90.90909091
2005020348,6,3570,0.0,40,36,4,0,4,90.0
2005020348,9,3600,2.0,24,22,6,0,2,91.66666667
2005020349,15,3891,0.0,26,24,2,2,2,92.30769231
2005020349,3,3886,0.0,37,35,7,2,2,94.59459459
2005020350,13,1200,0.0,17,14,5,0,3,82.35294118
2005020350,13,2400,0.0,20,16,4,0,4,80.0
2005020350,11,3590,0.0,20,16,0,3,4,80.0
2005020351,29,3598,0.0,34,31,4,1,3,91.17647059
2005020351,19,3540,0.0,19,15,2,0,4,78.94736842
2005020352,25,3593,2.0,24,23,11,1,1,95.83333333
2005020352,18,3506,0.0,32,29,14,1,3,90.625
2005020353,23,3545,0.0,24,22,10,0,2,91.66666667
2005020353,27,3600,0.0,35,34,9,8,1,97.14285714
2005020354,16,3517,0.0,29,26,8,3,3,89.65517241
2005020354,26,3590,0.0,27,25,3,2,2,92.59259259
2005020355,17,3600,2.0,33,27,13,0,6,81.81818182
2005020355,28,3523,0.0,30,23,2,2,7,76.66666667
2005020356,11,3596,0.0,29,27,10,1,2,93.10344828
2005020356,12,3579,0.0,19,15,0,3,4,78.94736842
2005020357,5,3600,0.0,36,32,10,0,4,88.88888889
2005020357,14,3599,0.0,21,20,0,5,1,95.23809524
2005020358,7,3595,0.0,19,17,7,1,2,89.47368421
2005020358,15,3540,0.0,29,26,7,1,3,89.65517241
2005020359,16,3459,0.0,24,22,11,1,2,91.66666667
2005020359,24,3600,0.0,35,34,7,4,1,97.14285714
2005020360,23,3600,0.0,36,30,11,1,6,83.33333333
2005020360,21,3600,0.0,40,38,13,1,2,95.0
2005020361,10,3589,0.0,35,34,14,2,1,97.14285714
2005020361,13,3554,0.0,26,24,8,0,2,92.30769231
2005020362,17,3595,0.0,24,22,6,0,2,91.66666667
2005020362,26,3496,0.0,28,24,5,1,4,85.71428571
2005020363,4,3600,0.0,23,20,4,1,3,86.95652174
2005020363,2,3554,0.0,35,31,9,1,4,88.57142857
2005020364,3,2976,0.0,21,16,3,0,5,76.19047619
2005020364,3,624,0.0,2,2,0,0,0,100.0
2005020364,15,3598,0.0,38,37,8,1,1,97.36842105
2005020365,12,3632,0.0,31,28,4,0,3,90.32258065
2005020365,11,3632,0.0,23,19,6,0,4,82.60869565
2005020366,8,3592,0.0,26,22,3,1,4,84.61538462
2005020366,9,3600,0.0,27,27,6,1,0,100.0
2005020367,6,3568,0.0,34,31,12,0,3,91.17647059
2005020367,1,3600,0.0,23,21,2,2,2,91.30434783
2005020368,7,3581,0.0,32,30,8,3,2,93.75
2005020368,5,3526,0.0,27,24,8,0,3,88.88888889
2005020369,20,3560,0.0,17,15,2,3,2,88.23529412
2005020369,18,3598,0.0,31,31,8,0,0,100.0
2005020370,21,3598,2.0,31,29,5,3,2,93.5483871
2005020370,22,3514,0.0,17,14,2,0,3,82.35294118
2005020371,1,3560,0.0,33,31,12,0,2,93.93939394
2005020371,4,3592,0.0,31,30,6,1,1,96.77419355
2005020372,10,3537,0.0,24,22,4,0,2,91.66666667
2005020372,14,3598,0.0,21,20,5,1,1,95.23809524
2005020373,29,3888,0.0,34,32,10,2,2,94.11764706
2005020373,30,3900,0.0,31,29,9,0,2,93.5483871
2005020374,26,3520,0.0,35,32,11,2,3,91.42857143
2005020374,16,3600,0.0,21,19,6,0,2,90.47619048
2005020375,28,3600,0.0,27,23,7,1,4,85.18518519
2005020375,25,3600,2.0,18,17,4,1,1,94.44444444
2005020376,21,3595,0.0,44,39,10,0,5,88.63636364
2005020376,23,3600,0.0,32,30,2,0,2,93.75
2005020377,27,3600,0.0,35,29,10,0,6,82.85714286
2005020377,24,3600,0.0,17,16,5,1,1,94.11764706
2005020378,9,3592,0.0,24,21,10,1,3,87.5
2005020378,6,3598,0.0,26,26,7,3,0,100.0
2005020379,5,3550,0.0,32,30,9,1,2,93.75
2005020379,3,3600,0.0,36,35,8,2,1,97.22222222
2005020380,10,3600,0.0,28,28,7,1,0,100.0
2005020380,11,3591,0.0,28,24,14,0,4,85.71428571
2005020381,7,3735,0.0,20,18,5,0,2,90.0
2005020381,8,3731,0.0,30,27,6,1,3,90.0
2005020382,20,3581,0.0,21,19,1,0,2,90.47619048
2005020382,17,3531,0.0,36,33,14,0,3,91.66666667
2005020383,29,3600,0.0,44,40,25,2,4,90.90909091
2005020383,19,3600,0.0,26,25,11,1,1,96.15384615
2005020384,30,3566,0.0,46,44,11,4,2,95.65217391
2005020384,18,3575,2.0,20,19,6,1,1,95.0
2005020385,23,164,0.0,0,0,0,0,0,
2005020385,23,3288,0.0,28,23,0,2,5,82.14285714
2005020385,22,3600,0.0,26,23,5,0,3,88.46153846
2005020386,26,3545,0.0,27,22,3,4,5,81.48148148
2005020386,9,3399,0.0,29,28,9,1,1,96.55172414
2005020386,9,201,0.0,3,3,3,0,0,100.0
2005020387,16,3889,0.0,27,25,2,1,2,92.59259259
2005020387,14,3900,0.0,36,34,2,2,2,94.44444444
2005020388,28,680,0.0,7,7,2,0,0,100.0
2005020388,28,2917,0.0,20,20,7,3,0,100.0
2005020388,7,686,0.0,11,7,1,0,4,63.63636364
2005020388,7,2913,0.0,15,14,2,0,1,93.33333333
2005020389,12,3892,0.0,31,27,6,0,4,87.09677419
2005020389,25,3892,0.0,20,16,5,0,4,80.0
2005020390,30,3900,2.0,33,31,5,2,2,93.93939394
2005020390,1,3900,0.0,39,37,10,3,2,94.87179487
2005020391,28,3600,0.0,28,24,3,2,4,85.71428571
2005020391,10,3543,0.0,27,22,7,2,5,81.48148148
2005020392,26,3520,0.0,31,28,7,1,3,90.32258065
2005020392,8,3580,0.0,30,28,3,1,2,93.33333333
2005020393,20,3600,0.0,30,28,12,1,2,93.33333333
2005020393,5,3580,0.0,26,23,4,1,3,88.46153846
2005020394,16,3834,0.0,26,22,5,1,4,84.61538462
2005020394,13,3837,0.0,38,35,10,1,3,92.10526316
2005020395,4,3900,0.0,32,29,10,1,3,90.625
2005020395,18,3883,0.0,33,30,9,1,3,90.90909091
2005020396,12,1857,0.0,17,11,3,1,6,64.70588235
2005020396,12,1740,0.0,16,14,2,0,2,87.5
2005020396,27,3582,0.0,29,25,4,2,4,86.20689655
2005020397,6,3858,0.0,40,36,6,1,4,90.0
2005020397,22,3863,0.0,26,21,0,1,5,80.76923077
2005020398,11,3537,0.0,28,26,6,0,2,92.85714286
2005020398,24,3589,0.0,21,20,3,0,1,95.23809524
2005020399,2,3600,0.0,36,35,5,2,1,97.22222222
2005020399,17,3526,0.0,28,26,2,2,2,92.85714286
2005020400,7,3597,0.0,29,25,1,0,4,86.20689655
2005020400,21,1200,0.0,16,12,0,2,4,75.0
2005020400,21,2341,0.0,13,12,2,2,1,92.30769231
2005020401,6,3597,0.0,39,34,6,1,5,87.17948718
2005020401,23,3589,0.0,27,25,13,1,2,92.59259259
2005020402,30,3583,0.0,39,37,7,2,2,94.87179487
2005020402,3,3598,0.0,23,22,4,3,1,95.65217391
2005020403,11,3575,0.0,30,26,5,1,4,86.66666667
2005020403,27,3600,0.0,29,27,6,0,2,93.10344828
2005020404,20,3900,0.0,37,37,5,1,0,100.0
2005020404,4,3900,0.0,28,28,4,1,0,100.0
2005020405,26,3600,0.0,37,36,13,5,1,97.2972973
2005020405,10,3572,0.0,23,21,8,3,2,91.30434783
2005020406,1,3600,0.0,44,39,3,6,5,88.63636364
2005020406,17,3600,0.0,27,25,4,0,2,92.59259259
2005020407,2,3600,0.0,34,31,15,0,3,91.17647059
2005020407,19,1298,0.0,10,8,3,1,2,80.0
2005020407,19,2302,0.0,13,9,1,0,4,69.23076923
2005020408,12,3599,0.0,37,35,3,2,2,94.59459459
2005020408,24,1881,0.0,14,11,2,1,3,78.57142857
2005020408,24,1709,0.0,17,14,7,0,3,82.35294118
2005020409,11,3547,0.0,26,21,1,3,5,80.76923077
2005020409,28,3586,0.0,25,22,5,0,3,88.0
2005020410,18,3600,0.0,32,30,10,0,2,93.75
2005020410,15,3534,0.0,33,29,7,1,4,87.87878788
2005020411,20,3600,0.0,32,31,13,2,1,96.875
2005020411,1,3597,0.0,15,11,0,2,4,73.33333333
2005020412,3,3667,0.0,19,17,2,1,2,89.47368421
2005020412,16,3680,4.0,31,30,11,0,1,96.77419355
2005020413,13,2790,0.0,15,14,5,1,1,93.33333333
2005020413,13,802,0.0,11,8,0,0,3,72.72727273
2005020413,25,3587,0.0,22,19,5,0,3,86.36363636
2005020414,6,3600,0.0,27,23,6,0,4,85.18518519
2005020414,21,3588,0.0,21,20,6,0,1,95.23809524
2005020415,24,3730,0.0,31,28,2,2,3,90.32258065
2005020415,7,3712,0.0,30,28,3,0,2,93.33333333
2005020416,22,3593,0.0,32,30,15,2,2,93.75
2005020416,4,3545,0.0,28,25,1,3,3,89.28571429
2005020417,2,3829,0.0,27,24,9,3,3,88.88888889
2005020417,29,3899,0.0,40,37,16,0,3,92.5
2005020418,30,3600,0.0,22,22,4,1,0,100.0
2005020418,5,3600,0.0,32,27,7,0,5,84.375
2005020419,19,3544,0.0,32,28,11,0,4,87.5
2005020419,14,3600,2.0,22,18,10,0,4,81.81818182
2005020420,3,3600,0.0,31,30,12,1,1,96.77419355
2005020420,18,2400,0.0,17,14,0,0,3,82.35294118
2005020420,18,1200,0.0,8,6,0,2,2,75.0
2005020421,12,3600,0.0,37,35,6,2,2,94.59459459
2005020421,26,3548,0.0,22,19,5,0,3,86.36363636
2005020422,13,3600,0.0,24,18,5,0,6,75.0
2005020422,28,3600,2.0,36,34,5,3,2,94.44444444
2005020423,17,3598,0.0,30,27,7,0,3,90.0
2005020423,15,3530,0.0,30,26,12,1,4,86.66666667
2005020424,29,1941,0.0,15,15,1,0,0,100.0
2005020424,29,1643,0.0,15,11,1,1,4,73.33333333
2005020424,11,3600,0.0,28,26,6,2,2,92.85714286
2005020425,21,3893,0.0,31,28,4,1,3,90.32258065
2005020425,1,3897,0.0,25,22,4,0,3,88.0
2005020426,9,3900,0.0,38,36,17,4,2,94.73684211
2005020426,23,3897,0.0,23,21,4,1,2,91.30434783
2005020427,30,3575,0.0,21,18,6,1,3,85.71428571
2005020427,4,3575,0.0,25,23,6,1,2,92.0
2005020428,13,3577,0.0,32,29,11,1,3,90.625
2005020428,26,3586,0.0,36,35,8,0,1,97.22222222
2005020429,25,3595,0.0,20,19,7,0,1,95.0
2005020429,10,3575,0.0,34,32,8,0,2,94.11764706
2005020430,24,3599,0.0,24,21,7,0,3,87.5
2005020430,8,3434,0.0,37,32,10,0,5,86.48648649
2005020431,22,3877,0.0,24,22,7,1,2,91.66666667
2005020431,2,3900,0.0,29,27,5,1,2,93.10344828
2005020432,21,3502,0.0,35,31,6,1,4,88.57142857
2005020432,5,3578,0.0,26,23,10,1,3,88.46153846
2005020433,18,3515,0.0,29,25,11,3,4,86.20689655
2005020433,14,3594,2.0,16,13,2,2,3,81.25
2005020434,3,3685,0.0,31,27,16,0,4,87.09677419
2005020434,19,3658,0.0,28,23,9,0,5,82.14285714
2005020435,9,3818,0.0,29,27,6,0,2,93.10344828
2005020435,20,3793,0.0,21,20,1,1,1,95.23809524
2005020436,12,3564,4.0,39,35,5,1,4,89.74358974
2005020436,28,3600,0.0,32,29,3,1,3,90.625
2005020437,16,3900,0.0,37,33,4,1,4,89.18918919
2005020437,11,3890,0.0,32,28,3,0,4,87.5
2005020438,27,3630,2.0,19,18,1,0,1,94.73684211
2005020438,6,3630,0.0,32,30,9,3,2,93.75
2005020439,1,3886,0.0,39,36,5,1,3,92.30769231
2005020439,29,3884,0.0,30,28,9,1,2,93.33333333
2005020440,7,3590,0.0,36,34,14,2,2,94.44444444
2005020440,30,3582,0.0,30,27,5,0,3,90.0
2005020441,24,3545,0.0,27,24,9,1,3,88.88888889
2005020441,10,3600,0.0,29,27,9,3,2,93.10344828
2005020442,5,3600,0.0,39,36,13,5,3,92.30769231
2005020442,17,3595,0.0,17,16,2,0,1,94.11764706
2005020443,9,3599,0.0,24,22,6,2,2,91.66666667
2005020443,21,3585,2.0,31,25,10,1,6,80.64516129
2005020444,30,3600,0.0,35,32,12,3,3,91.42857143
2005020444,2,3496,0.0,22,18,3,1,4,81.81818182
2005020445,23,3600,0.0,36,34,2,1,2,94.44444444
2005020445,3,3566,0.0,31,28,1,0,3,90.32258065
2005020446,16,3600,0.0,36,31,5,1,5,86.11111111
2005020446,12,3591,0.0,20,17,0,0,3,85.0
2005020447,17,1387,0.0,16,13,2,1,3,81.25
2005020447,17,2164,0.0,16,12,5,1,4,75.0
2005020447,11,3600,0.0,36,30,11,0,6,83.33333333
2005020448,18,3600,0.0,41,34,3,4,7,82.92682927
2005020448,13,3600,0.0,34,31,11,0,3,91.17647059
2005020449,4,3597,0.0,24,23,11,1,1,95.83333333
2005020449,29,3548,0.0,30,28,7,0,2,93.33333333
2005020450,27,3600,0.0,28,23,9,3,5,82.14285714
2005020450,8,3584,0.0,29,27,8,0,2,93.10344828
2005020451,22,3900,0.0,28,27,10,0,1,96.42857143
2005020451,1,3900,0.0,30,29,9,1,1,96.66666667
2005020452,5,3557,0.0,41,39,14,2,2,95.12195122
2005020452,19,3584,0.0,21,21,2,4,0,100.0
2005020453,25,3522,0.0,22,18,2,0,4,81.81818182
2005020453,7,3590,0.0,35,32,4,4,3,91.42857143
2005020454,14,3506,0.0,32,29,6,3,3,90.625
2005020454,24,3595,0.0,24,22,9,1,2,91.66666667
2005020455,15,3596,0.0,26,24,9,0,2,92.30769231
2005020455,26,3518,0.0,29,26,14,1,3,89.65517241
2005020456,23,3600,0.0,43,39,8,0,4,90.69767442
2005020456,4,641,0.0,6,5,0,0,1,83.33333333
2005020456,4,2889,0.0,20,16,2,0,4,80.0
2005020457,29,3558,0.0,32,30,10,1,2,93.75
2005020457,12,3591,0.0,26,25,1,3,1,96.15384615
2005020458,25,3600,0.0,24,24,3,2,0,100.0
2005020458,9,3591,0.0,29,27,6,1,2,93.10344828
2005020459,11,3895,0.0,26,24,4,1,2,92.30769231
2005020459,1,3885,0.0,33,30,6,2,3,90.90909091
2005020460,17,3683,0.0,30,27,3,4,3,90.0
2005020460,13,3696,0.0,36,34,11,0,2,94.44444444
2005020461,16,3464,0.0,31,26,5,0,5,83.87096774
2005020461,18,3600,0.0,38,35,11,4,3,92.10526316
2005020462,6,3600,0.0,31,29,2,1,2,93.5483871
2005020462,30,3562,0.0,28,25,3,1,3,89.28571429
2005020463,8,3585,0.0,27,23,6,4,4,85.18518519
2005020463,22,3600,0.0,19,16,2,1,3,84.21052632
2005020464,14,3598,0.0,27,26,6,3,1,96.2962963
2005020464,27,3535,0.0,28,25,11,1,3,89.28571429
2005020465,7,3677,0.0,27,24,7,0,3,88.88888889
2005020465,5,3678,0.0,27,23,8,3,4,85.18518519
2005020466,19,1478,0.0,4,2,1,0,2,50.0
2005020466,19,2059,0.0,16,14,3,0,2,87.5
2005020466,16,3600,0.0,33,32,7,2,1,96.96969697
2005020467,26,3898,0.0,45,42,0,4,3,93.33333333
2005020467,24,3900,0.0,37,34,3,0,3,91.89189189
2005020468,15,3600,0.0,33,29,5,1,4,87.87878788
2005020468,28,3588,0.0,26,25,4,2,1,96.15384615
2005020469,10,3600,0.0,43,35,15,1,8,81.39534884
2005020469,9,3600,0.0,29,27,11,2,2,93.10344828
2005020470,21,2660,0.0,19,14,7,0,5,73.68421053
2005020470,21,857,0.0,6,6,3,0,0,100.0
2005020470,2,3588,0.0,33,29,13,1,4,87.87878788
2005020471,1,3595,0.0,25,21,10,0,4,84.0
2005020471,12,3588,0.0,23,22,8,1,1,95.65217391
2005020472,13,3532,0.0,31,29,1,1,2,93.5483871
2005020472,11,3600,0.0,28,27,1,0,1,96.42857143
2005020473,5,3538,0.0,29,25,6,2,4,86.20689655
2005020473,7,3598,0.0,33,30,8,0,3,90.90909091
2005020474,17,3600,2.0,31,28,9,0,3,90.32258065
2005020474,14,1033,2.0,5,4,1,0,1,80.0
2005020474,14,2567,0.0,24,19,1,2,5,79.16666667
2005020475,4,3600,0.0,31,29,8,0,2,93.5483871
2005020475,19,3561,0.0,26,22,5,4,4,84.61538462
2005020476,29,2400,0.0,25,19,7,0,6,76.0
2005020476,29,1200,0.0,7,6,2,0,1,85.71428571
2005020476,18,3599,0.0,26,23,4,1,3,88.46153846
2005020477,8,3787,0.0,28,24,10,1,4,85.71428571
2005020477,30,3790,0.0,33,30,3,2,3,90.90909091
2005020478,6,3581,0.0,29,26,3,1,3,89.65517241
2005020478,20,3597,0.0,26,26,6,1,0,100.0
2005020479,22,3414,0.0,18,16,5,1,2,88.88888889
2005020479,22,424,0.0,4,2,0,0,2,50.0
2005020479,23,3833,0.0,37,32,9,0,5,86.48648649
2005020480,27,3595,0.0,37,33,9,1,4,89.18918919
2005020480,26,3591,0.0,26,25,5,0,1,96.15384615
2005020481,21,3600,0.0,30,29,4,1,1,96.66666667
2005020481,3,3554,0.0,17,15,3,1,2,88.23529412
2005020482,13,3600,0.0,55,53,13,0,2,96.36363636
2005020482,15,3544,0.0,34,31,4,1,3,91.17647059
2005020483,25,3596,2.0,32,29,8,2,3,90.625
2005020483,16,3591,0.0,20,15,3,1,5,75.0
2005020484,28,3537,0.0,34,29,7,1,5,85.29411765
2005020484,24,3600,0.0,34,30,8,2,4,88.23529412
2005020485,7,3900,0.0,34,33,6,4,1,97.05882353
2005020485,4,3900,0.0,28,27,1,2,1,96.42857143
2005020486,2,1838,0.0,17,14,3,1,3,82.35294118
2005020486,2,1757,0.0,17,11,2,0,6,64.70588235
2005020486,10,3600,0.0,33,27,14,1,6,81.81818182
2005020487,25,3537,0.0,22,20,9,1,2,90.90909091
2005020487,30,3594,0.0,31,30,7,0,1,96.77419355
2005020488,20,3574,0.0,32,27,9,1,5,84.375
2005020488,22,2049,0.0,11,10,0,0,1,90.90909091
2005020488,22,1540,0.0,10,7,0,0,3,70.0
2005020489,26,3834,0.0,25,22,6,1,3,88.0
2005020489,23,3900,0.0,27,24,1,2,3,88.88888889
2005020490,1,3558,0.0,31,30,6,1,1,96.77419355
2005020490,3,3556,0.0,31,29,11,2,2,93.5483871
2005020491,14,3497,0.0,30,24,9,0,6,80.0
2005020491,12,3597,0.0,24,20,9,0,4,83.33333333
2005020492,9,3896,0.0,36,33,8,2,3,91.66666667
2005020492,8,3896,0.0,37,34,9,0,3,91.89189189
2005020493,29,3894,0.0,38,35,9,1,3,92.10526316
2005020493,17,3900,0.0,33,30,6,1,3,90.90909091
2005020494,21,3508,0.0,27,24,5,1,3,88.88888889
2005020494,18,3600,0.0,26,24,3,2,2,92.30769231
2005020495,19,3600,0.0,37,33,9,0,4,89.18918919
2005020495,27,447,0.0,1,1,0,0,0,100.0
2005020495,27,3026,0.0,13,8,1,0,5,61.53846154
2005020496,24,799,0.0,3,3,0,0,0,100.0
2005020496,24,2767,0.0,18,14,4,0,4,77.77777778
2005020496,28,3600,0.0,35,33,14,0,2,94.28571429
2005020497,1,3600,0.0,31,27,9,1,4,87.09677419
2005020497,2,3593,2.0,27,25,11,3,2,92.59259259
2005020498,25,3575,0.0,26,23,10,0,3,88.46153846
2005020498,29,3509,2.0,35,30,14,2,5,85.71428571
2005020499,18,3599,0.0,27,26,3,0,1,96.2962963
2005020499,16,1688,0.0,12,8,1,0,4,66.66666667
2005020499,16,1912,0.0,19,17,9,1,2,89.47368421
2005020500,26,3594,0.0,29,27,8,1,2,93.10344828
2005020500,20,3569,0.0,17,13,5,0,4,76.47058824
2005020501,22,1428,0.0,9,5,2,0,4,55.55555556
2005020501,22,2156,0.0,15,13,4,1,2,86.66666667
2005020501,23,3497,0.0,37,30,8,2,7,81.08108108
2005020502,19,3004,0.0,23,20,5,1,3,86.95652174
2005020502,19,581,0.0,13,10,2,1,3,76.92307692
2005020502,24,3600,0.0,25,22,4,1,3,88.0
2005020503,10,3594,0.0,25,21,3,2,4,84.0
2005020503,6,3600,0.0,27,26,6,1,1,96.2962963
2005020504,14,3564,0.0,35,32,4,3,3,91.42857143
2005020504,3,3600,0.0,32,30,8,1,2,93.75
2005020505,9,3563,0.0,30,26,3,4,4,86.66666667
2005020505,4,3600,0.0,28,25,10,2,3,89.28571429
2005020506,15,3900,4.0,34,29,10,1,5,85.29411765
2005020506,11,3900,0.0,37,32,5,0,5,86.48648649
2005020507,7,3598,0.0,30,26,7,0,4,86.66666667
2005020507,13,3590,0.0,28,27,5,1,1,96.42857143
2005020508,30,3599,0.0,37,33,12,3,4,89.18918919
2005020508,21,3594,0.0,30,27,4,0,3,90.0
2005020509,28,3510,0.0,26,24,11,1,2,92.30769231
2005020509,27,3578,0.0,21,20,7,1,1,95.23809524
2005020510,6,3550,2.0,28,26,12,0,2,92.85714286
2005020510,10,3591,0.0,26,25,5,3,1,96.15384615
2005020511,9,3595,0.0,27,25,6,0,2,92.59259259
2005020511,2,3537,0.0,26,22,2,2,4,84.61538462
2005020512,8,3451,0.0,31,27,4,2,4,87.09677419
2005020512,15,3596,0.0,43,41,16,1,2,95.34883721
2005020513,13,3539,0.0,39,35,15,0,4,89.74358974
2005020513,12,3577,0.0,25,22,3,7,3,88.0
2005020514,18,3593,0.0,39,35,11,3,4,89.74358974
2005020514,29,2326,0.0,11,10,1,1,1,90.90909091
2005020514,29,1200,0.0,11,7,3,0,4,63.63636364
2005020515,11,3600,0.0,29,29,11,1,0,100.0
2005020515,1,3529,0.0,23,22,3,2,1,95.65217391
2005020516,4,3600,0.0,26,22,6,3,4,84.61538462
2005020516,5,3541,0.0,32,27,10,1,5,84.375
2005020517,7,3600,0.0,31,30,9,1,1,96.77419355
2005020517,14,3585,0.0,30,27,5,1,3,90.0
2005020518,21,3600,0.0,24,19,3,1,5,79.16666667
2005020518,30,3592,0.0,23,20,3,0,3,86.95652174
2005020519,17,3831,0.0,31,29,1,2,2,93.5483871
2005020519,16,3899,0.0,37,34,6,3,3,91.89189189
2005020520,27,3569,0.0,28,26,12,0,2,92.85714286
2005020520,25,3508,0.0,13,10,4,0,3,76.92307692
2005020521,26,3547,4.0,32,28,10,0,4,87.5
2005020521,22,3597,0.0,29,26,8,0,3,89.65517241
2005020522,20,3871,0.0,37,32,14,0,5,86.48648649
2005020522,23,3900,0.0,37,32,8,2,5,86.48648649
2005020523,19,3900,0.0,22,21,7,0,1,95.45454545
2005020523,28,3891,0.0,28,27,4,1,1,96.42857143
2005020524,2,3570,0.0,34,29,4,2,5,85.29411765
2005020524,7,3597,0.0,19,16,1,2,3,84.21052632
2005020525,8,3593,0.0,38,34,15,2,4,89.47368421
2005020525,11,3597,0.0,36,36,12,0,0,100.0
2005020526,4,3888,0.0,36,34,6,0,2,94.44444444
2005020526,13,3899,0.0,44,42,11,1,2,95.45454545
2005020527,16,3711,0.0,32,28,7,1,4,87.5
2005020527,29,3736,0.0,45,42,11,4,3,93.33333333
2005020528,1,3531,0.0,27,25,4,1,2,92.59259259
2005020528,10,3581,0.0,34,33,12,2,1,97.05882353
2005020529,3,898,0.0,15,11,8,0,4,73.33333333
2005020529,3,2702,0.0,18,16,6,0,2,88.88888889
2005020529,9,3600,0.0,26,24,5,1,2,92.30769231
2005020530,12,3865,0.0,41,36,5,0,5,87.80487805
2005020530,14,3839,0.0,30,26,3,3,4,86.66666667
2005020531,25,3600,2.0,26,25,4,1,1,96.15384615
2005020531,19,1200,0.0,3,1,0,0,2,33.33333333
2005020531,19,2400,0.0,18,14,0,1,4,77.77777778
2005020532,27,2561,0.0,24,22,17,0,2,91.66666667
2005020532,27,985,0.0,4,1,0,0,3,25.0
2005020532,21,200,0.0,2,0,0,0,2,0.0
2005020532,21,3391,0.0,28,26,7,0,2,92.85714286
2005020533,30,3599,0.0,28,27,10,1,1,96.42857143
2005020533,22,3563,0.0,22,19,4,1,3,86.36363636
2005020534,20,3599,0.0,17,16,4,1,1,94.11764706
2005020534,23,3527,0.0,23,21,3,0,2,91.30434783
2005020535,28,3549,0.0,30,26,6,1,4,86.66666667
2005020535,26,3600,0.0,25,22,4,0,3,88.0
2005020536,6,3724,2.0,18,15,6,0,3,83.33333333
2005020536,15,3717,0.0,43,39,13,1,4,90.69767442
2005020537,10,3738,0.0,35,33,15,0,2,94.28571429
2005020537,5,3732,0.0,33,30,6,1,3,90.90909091
2005020538,17,3600,0.0,28,27,7,0,1,96.42857143
2005020538,25,3561,0.0,22,19,2,1,3,86.36363636
2005020539,18,3598,0.0,26,23,7,0,3,88.46153846
2005020539,20,3552,0.0,40,36,13,2,4,90.0
2005020540,3,3600,0.0,25,23,6,0,2,92.0
2005020540,2,3600,0.0,28,22,1,1,6,78.57142857
2005020541,4,3613,0.0,31,28,2,0,3,90.32258065
2005020541,11,3613,0.0,32,28,10,0,4,87.5
2005020542,6,3586,0.0,26,21,7,1,5,80.76923077
2005020542,13,3600,0.0,39,35,7,0,4,89.74358974
2005020543,24,3591,0.0,42,41,11,0,1,97.61904762
2005020543,29,3592,0.0,40,40,11,2,0,100.0
2005020544,12,1168,0.0,8,7,0,0,1,87.5
2005020544,12,2432,0.0,28,23,4,6,5,82.14285714
2005020544,9,3600,0.0,35,33,18,2,2,94.28571429
2005020545,15,1574,2.0,17,15,3,0,2,88.23529412
2005020545,15,2026,0.0,21,16,8,0,5,76.19047619
2005020545,1,3573,0.0,25,23,3,0,2,92.0
2005020546,8,3600,0.0,44,41,9,3,3,93.18181818
2005020546,14,3494,0.0,24,20,5,1,4,83.33333333
2005020547,19,3600,0.0,22,21,3,5,1,95.45454545
2005020547,16,2400,0.0,22,20,6,0,2,90.90909091
2005020547,16,1191,0.0,10,10,3,0,0,100.0
2005020548,26,3600,0.0,35,32,8,2,3,91.42857143
2005020548,21,2833,0.0,20,17,4,1,3,85.0
2005020548,21,665,0.0,4,2,0,0,2,50.0
2005020549,30,3587,2.0,30,28,6,1,2,93.33333333
2005020549,22,3568,0.0,22,19,3,1,3,86.36363636
2005020550,18,3552,0.0,32,28,6,1,4,87.5
2005020550,23,3590,0.0,35,32,7,0,3,91.42857143
2005020551,27,3585,2.0,34,30,7,2,4,88.23529412
2005020551,28,2684,2.0,24,19,7,0,5,79.16666667
2005020551,28,852,0.0,2,2,0,1,0,100.0
2005020552,4,3686,0.0,28,25,8,0,3,89.28571429
2005020552,12,3687,0.0,40,36,5,3,4,90.0
2005020553,7,3893,0.0,28,25,3,2,3,89.28571429
2005020553,10,3900,0.0,30,27,5,4,3,90.0
2005020554,1,3600,0.0,25,19,4,1,6,76.0
2005020554,5,3600,0.0,46,44,18,2,2,95.65217391
2005020555,19,3600,0.0,25,22,10,1,3,88.0
2005020555,25,3600,0.0,17,17,5,0,0,100.0
2005020556,30,3600,2.0,34,30,5,0,4,88.23529412
2005020556,20,3597,0.0,34,32,3,0,2,94.11764706
2005020557,26,3819,0.0,26,20,8,3,6,76.92307692
2005020557,27,3832,0.0,40,35,6,2,5,87.5
2005020558,2,3145,2.0,31,28,8,0,3,90.32258065
2005020558,2,389,0.0,6,5,0,0,1,83.33333333
2005020558,9,3589,0.0,23,20,1,0,3,86.95652174
2005020559,6,3599,0.0,32,31,15,0,1,96.875
2005020559,14,3514,0.0,24,22,3,1,2,91.66666667
2005020560,8,3588,0.0,30,28,3,0,2,93.33333333
2005020560,13,3600,0.0,28,27,6,1,1,96.42857143
2005020561,11,3599,0.0,29,25,4,4,4,86.20689655
2005020561,7,3596,0.0,35,34,12,2,1,97.14285714
2005020562,29,3600,0.0,43,41,8,1,2,95.34883721
2005020562,16,3544,0.0,21,18,1,0,3,85.71428571
2005020563,18,3591,0.0,35,31,3,3,4,88.57142857
2005020563,22,3596,0.0,31,29,9,3,2,93.5483871
2005020564,21,3599,0.0,43,38,11,0,5,88.37209302
2005020564,28,3599,0.0,22,20,8,0,2,90.90909091
2005020565,3,3776,0.0,37,33,16,1,4,89.18918919
2005020565,5,3809,0.0,17,14,7,0,3,82.35294118
2005020566,4,3900,0.0,46,43,20,1,3,93.47826087
2005020566,15,3898,0.0,37,34,18,1,3,91.89189189
2005020567,24,3900,0.0,34,30,12,1,4,88.23529412
2005020567,19,3417,0.0,27,26,6,1,1,96.2962963
2005020567,19,470,0.0,5,3,0,0,2,60.0
2005020568,23,3528,0.0,37,33,10,1,4,89.18918919
2005020568,30,3593,0.0,29,26,4,1,3,89.65517241
2005020569,10,3600,0.0,26,23,8,0,3,88.46153846
2005020569,1,3597,0.0,22,16,9,1,6,72.72727273
2005020570,29,2279,0.0,30,25,5,1,5,83.33333333
2005020570,29,1313,0.0,13,13,5,1,0,100.0
2005020570,17,3600,0.0,15,13,4,1,2,86.66666667
2005020571,8,3553,0.0,37,33,10,1,4,89.18918919
2005020571,12,3600,0.0,27,24,2,1,3,88.88888889
2005020572,26,3597,0.0,40,38,8,3,2,95.0
2005020572,25,3544,0.0,23,20,9,2,3,86.95652174
2005020573,21,3600,0.0,32,30,7,0,2,93.75
2005020573,27,3508,0.0,28,23,4,4,5,82.14285714
2005020574,22,3571,0.0,25,19,5,3,6,76.0
2005020574,20,3600,0.0,30,25,10,2,5,83.33333333
2005020575,11,3600,0.0,21,19,2,3,2,90.47619048
2005020575,15,3599,2.0,43,38,12,3,5,88.37209302
2005020576,13,3591,0.0,29,28,14,4,1,96.55172414
2005020576,7,3551,0.0,20,18,4,1,2,90.0
2005020577,24,3595,0.0,23,21,2,1,2,91.30434783
2005020577,18,3470,2.0,36,32,7,1,4,88.88888889
2005020578,4,3593,0.0,27,27,7,1,0,100.0
2005020578,6,3556,0.0,21,20,8,1,1,95.23809524
2005020579,16,3517,0.0,21,18,1,2,3,85.71428571
2005020579,20,3596,0.0,37,35,5,0,2,94.59459459
2005020580,14,3597,0.0,36,35,14,1,1,97.22222222
2005020580,2,3536,0.0,43,41,16,1,2,95.34883721
2005020581,9,3600,0.0,27,19,2,3,8,70.37037037
2005020581,11,1579,0.0,14,12,3,0,2,85.71428571
2005020581,11,2021,0.0,13,12,3,0,1,92.30769231
2005020582,5,3662,0.0,38,35,14,0,3,92.10526316
2005020582,10,3662,0.0,22,20,0,1,2,90.90909091
2005020583,23,3552,0.0,25,22,5,2,3,88.0
2005020583,19,3600,0.0,31,30,6,1,1,96.77419355
2005020584,25,3748,0.0,27,24,5,0,3,88.88888889
2005020584,26,3712,0.0,33,31,3,1,2,93.93939394
2005020585,14,3827,0.0,36,36,4,1,0,100.0
2005020585,3,3827,0.0,20,19,4,0,1,95.0
2005020586,5,3600,0.0,33,29,5,1,4,87.87878788
2005020586,8,3488,0.0,36,30,3,0,6,83.33333333
2005020587,13,3600,0.0,25,22,7,0,3,88.0
2005020587,1,3600,0.0,16,16,2,1,0,100.0
2005020588,30,3600,0.0,45,43,8,0,2,95.55555556
2005020588,17,3522,0.0,22,19,7,1,3,86.36363636
2005020589,18,3459,0.0,24,22,4,1,2,91.66666667
2005020589,21,3600,2.0,32,32,5,1,0,100.0
2005020590,16,3600,0.0,29,24,4,0,5,82.75862069
2005020590,22,3585,2.0,23,23,0,1,0,100.0
2005020591,13,1200,0.0,11,10,1,1,1,90.90909091
2005020591,13,2535,0.0,27,24,5,2,3,88.88888889
2005020591,2,3591,0.0,39,36,2,1,3,92.30769231
2005020591,2,144,0.0,3,3,0,0,0,100.0
2005020592,9,3594,0.0,24,23,7,0,1,95.83333333
2005020592,15,3563,0.0,26,24,11,0,2,92.30769231
2005020593,11,3530,0.0,22,18,7,0,4,81.81818182
2005020593,12,3597,0.0,26,23,5,2,3,88.46153846
2005020594,18,280,0.0,3,1,0,0,2,33.33333333
2005020594,18,3320,0.0,19,18,0,0,1,94.73684211
2005020594,19,3530,0.0,23,19,1,0,4,82.60869565
2005020595,23,3477,0.0,37,34,6,0,3,91.89189189
2005020595,25,3600,0.0,21,20,2,0,1,95.23809524
2005020596,9,3561,0.0,37,34,4,2,3,91.89189189
2005020596,6,1200,0.0,13,12,0,1,1,92.30769231
2005020596,6,2400,0.0,22,21,1,0,1,95.45454545
2005020597,14,3522,0.0,31,28,7,0,3,90.32258065
2005020597,7,3589,0.0,22,21,2,0,1,95.45454545
2005020598,4,3607,0.0,34,31,4,1,3,91.17647059
2005020598,3,3607,0.0,23,19,3,0,4,82.60869565
2005020599,8,3546,0.0,27,22,1,0,5,81.48148148
2005020599,1,3600,0.0,20,16,1,0,4,80.0
2005020600,19,3600,0.0,31,28,1,0,3,90.32258065
2005020600,17,3600,0.0,15,15,2,0,0,100.0
2005020601,21,3600,0.0,35,33,6,1,2,94.28571429
2005020601,30,1200,0.0,8,8,2,0,0,100.0
2005020601,30,2386,0.0,14,10,2,0,4,71.42857143
2005020602,23,3565,0.0,28,26,6,1,2,92.85714286
2005020602,16,3550,0.0,17,14,1,1,3,82.35294118
2005020603,27,1200,0.0,12,9,0,0,3,75.0
2005020603,27,2301,0.0,13,13,2,4,0,100.0
2005020603,26,3593,0.0,29,29,6,1,0,100.0
2005020604,29,3600,0.0,39,33,9,0,6,84.61538462
2005020604,28,3600,0.0,31,28,7,0,3,90.32258065
2005020605,4,3578,0.0,24,23,9,0,1,95.83333333
2005020605,15,3557,0.0,32,30,8,1,2,93.75
2005020606,2,3581,0.0,34,31,8,1,3,91.17647059
2005020606,12,3573,0.0,29,28,8,0,1,96.55172414
2005020607,5,2958,0.0,22,20,5,1,2,90.90909091
2005020607,5,627,0.0,9,6,1,0,3,66.66666667
2005020607,11,3600,2.0,31,27,3,1,4,87.09677419
2005020608,17,3580,0.0,30,29,4,0,1,96.66666667
2005020608,18,3551,0.0,36,33,5,0,3,91.66666667
2005020609,24,3900,2.0,25,22,7,1,3,88.0
2005020609,25,2700,0.0,16,16,5,1,0,100.0
2005020609,25,1193,0.0,10,7,1,0,3,70.0
2005020610,10,3573,2.0,28,27,6,1,1,96.42857143
2005020610,20,3600,2.0,27,27,9,1,0,100.0
2005020611,13,3600,0.0,25,21,3,1,4,84.0
2005020611,3,3600,0.0,38,38,13,4,0,100.0
2005020612,9,2667,0.0,13,13,4,0,0,100.0
2005020612,9,933,0.0,11,7,2,0,4,63.63636364
2005020612,8,3600,0.0,41,40,8,0,1,97.56097561
2005020613,29,3900,0.0,48,46,11,0,2,95.83333333
2005020613,21,3876,0.0,21,19,2,0,2,90.47619048
2005020614,14,622,0.0,2,2,0,0,0,100.0
2005020614,14,2915,0.0,31,26,2,1,5,83.87096774
2005020614,6,3557,0.0,32,29,6,0,3,90.625
2005020614,6,43,0.0,0,0,0,0,0,
2005020615,12,3595,0.0,30,30,3,3,0,100.0
2005020615,2,3591,0.0,28,25,7,1,3,89.28571429
2005020616,10,3600,0.0,38,36,5,3,2,94.73684211
2005020616,22,3520,0.0,19,16,2,0,3,84.21052632
2005020617,1,3600,0.0,28,26,2,0,2,92.85714286
2005020617,7,3534,0.0,27,24,0,0,3,88.88888889
2005020618,11,3600,0.0,31,28,9,0,3,90.32258065
2005020618,5,3507,0.0,32,28,11,1,4,87.5
2005020619,24,3600,0.0,36,32,10,0,4,88.88888889
2005020619,30,3597,0.0,23,22,5,4,1,95.65217391
2005020620,20,3766,0.0,36,32,11,0,4,88.88888889
2005020620,23,3750,0.0,30,27,11,0,3,90.0
2005020621,26,3526,0.0,25,22,3,1,3,88.0
2005020621,28,3594,0.0,29,27,6,0,2,93.10344828
2005020622,13,3900,0.0,36,33,10,0,3,91.66666667
2005020622,15,3894,0.0,42,39,11,4,3,92.85714286
2005020623,25,2308,0.0,12,12,0,0,0,100.0
2005020623,25,1292,0.0,13,10,1,1,3,76.92307692
2005020623,17,2915,0.0,23,17,1,1,6,73.91304348
2005020623,17,676,0.0,9,9,0,0,0,100.0
2005020624,18,3600,0.0,37,36,10,0,1,97.2972973
2005020624,16,3596,0.0,21,16,2,1,5,76.19047619
2005020625,29,3600,0.0,34,32,11,0,2,94.11764706
2005020625,27,3553,0.0,15,10,2,0,5,66.66666667
2005020626,4,3600,0.0,16,13,1,1,3,81.25
2005020626,1,3592,0.0,22,22,2,2,0,100.0
2005020627,25,3576,0.0,26,25,8,2,1,96.15384615
2005020627,30,3559,0.0,26,24,8,1,2,92.30769231
2005020628,19,3596,0.0,36,30,6,5,6,83.33333333
2005020628,21,3600,0.0,28,27,7,2,1,96.42857143
2005020629,26,3565,0.0,27,21,3,1,6,77.77777778
2005020629,24,3600,0.0,43,41,14,1,2,95.34883721
2005020630,28,3591,0.0,23,21,0,3,2,91.30434783
2005020630,6,2179,0.0,26,21,5,1,5,80.76923077
2005020630,6,1421,0.0,7,6,4,0,1,85.71428571
2005020631,20,3584,0.0,28,25,7,0,3,89.28571429
2005020631,3,3596,0.0,21,19,4,1,2,90.47619048
2005020632,16,3717,0.0,37,34,7,0,3,91.89189189
2005020632,15,3713,0.0,33,29,6,1,4,87.87878788
2005020633,17,3501,0.0,25,22,1,1,3,88.0
2005020633,12,3600,0.0,38,36,11,0,2,94.73684211
2005020634,27,3600,0.0,39,32,7,2,7,82.05128205
2005020634,9,3600,0.0,23,21,7,1,2,91.30434783
2005020635,22,3598,0.0,18,17,0,1,1,94.44444444
2005020635,5,3588,0.0,31,28,3,2,3,90.32258065
2005020636,2,3547,0.0,35,33,2,0,2,94.28571429
2005020636,18,3599,0.0,28,27,6,1,1,96.42857143
2005020637,10,3535,0.0,19,15,2,2,4,78.94736842
2005020637,23,3594,0.0,38,35,11,1,3,92.10526316
2005020638,18,3898,0.0,41,38,16,1,3,92.68292683
2005020638,11,3893,0.0,26,23,4,1,3,88.46153846
2005020639,5,1233,0.0,14,10,3,0,4,71.42857143
2005020639,5,2347,0.0,18,16,7,1,2,88.88888889
2005020639,29,3600,0.0,29,28,8,6,1,96.55172414
2005020640,4,3594,0.0,14,12,0,0,2,85.71428571
2005020640,16,3533,0.0,30,26,3,0,4,86.66666667
2005020641,8,3531,0.0,40,38,5,2,2,95.0
2005020641,21,3583,0.0,26,25,4,2,1,96.15384615
2005020642,26,3589,0.0,30,30,10,2,0,100.0
2005020642,6,3055,0.0,42,36,6,10,6,85.71428571
2005020642,6,545,0.0,0,0,0,0,0,
2005020643,27,3868,0.0,31,30,13,2,1,96.77419355
2005020643,7,3886,0.0,40,39,12,1,1,97.5
2005020644,20,3531,0.0,36,33,6,3,3,91.66666667
2005020644,2,3600,0.0,30,28,4,1,2,93.33333333
2005020645,22,3608,0.0,22,17,5,0,5,77.27272727
2005020645,3,3611,0.0,30,26,7,6,4,86.66666667
2005020646,19,3502,0.0,33,30,6,1,3,90.90909091
2005020646,13,3592,0.0,36,35,11,0,1,97.22222222
2005020647,28,3599,0.0,40,40,10,3,0,100.0
2005020647,9,3600,0.0,36,34,11,2,2,94.44444444
2005020648,4,3596,0.0,41,35,9,2,6,85.36585366
2005020648,17,3600,0.0,20,17,3,0,3,85.0
2005020649,15,3589,0.0,27,23,5,3,4,85.18518519
2005020649,25,3600,0.0,27,26,4,2,1,96.2962963
2005020650,18,3744,12.0,33,28,7,0,5,84.84848485
2005020650,12,3744,0.0,19,15,2,0,4,78.94736842
2005020651,19,3582,0.0,24,22,6,1,2,91.66666667
2005020651,11,3585,0.0,37,37,6,3,0,100.0
2005020652,23,3573,0.0,25,23,3,0,2,92.0
2005020652,1,3596,0.0,26,26,2,1,0,100.0
2005020653,29,3556,0.0,39,35,8,0,4,89.74358974
2005020653,14,3591,0.0,24,22,3,0,2,91.66666667
2005020654,5,3581,0.0,35,31,5,2,4,88.57142857
2005020654,16,3600,0.0,29,28,5,2,1,96.55172414
2005020655,15,3777,0.0,34,32,1,0,2,94.11764706
2005020655,24,3784,0.0,26,23,0,0,3,88.46153846
2005020656,25,3867,0.0,27,26,3,1,1,96.2962963
2005020656,6,3828,0.0,38,37,10,1,1,97.36842105
2005020657,21,3840,0.0,30,27,9,1,3,90.0
2005020657,4,3814,0.0,34,30,12,0,4,88.23529412
2005020658,3,3572,0.0,36,32,4,1,4,88.88888889
2005020658,17,3600,0.0,24,21,6,0,3,87.5
2005020659,27,3600,0.0,28,25,5,4,3,89.28571429
2005020659,10,3570,2.0,28,24,7,0,4,85.71428571
2005020660,28,2400,2.0,20,14,3,2,6,70.0
2005020660,28,1200,0.0,6,6,0,0,0,100.0
2005020660,8,3600,0.0,25,23,10,0,2,92.0
2005020661,23,3597,0.0,37,36,6,3,1,97.2972973
2005020661,2,2055,0.0,18,14,6,1,4,77.77777778
2005020661,2,1535,2.0,13,9,3,0,4,69.23076923
2005020662,26,549,0.0,10,6,0,0,4,60.0
2005020662,26,3049,0.0,24,18,6,2,6,75.0
2005020662,7,3587,0.0,33,32,8,1,1,96.96969697
2005020663,29,3883,0.0,52,48,7,4,4,92.30769231
2005020663,13,3832,0.0,23,18,7,0,5,78.26086957
2005020664,20,3600,0.0,22,21,2,1,1,95.45454545
2005020664,30,3568,0.0,22,19,3,0,3,86.36363636
2005020665,9,3595,0.0,26,23,3,0,3,88.46153846
2005020665,22,1553,0.0,8,7,0,0,1,87.5
2005020665,22,1913,0.0,16,12,1,0,4,75.0
2005020666,19,3564,0.0,37,33,18,3,4,89.18918919
2005020666,12,3592,0.0,33,31,11,0,2,93.93939394
2005020667,1,3894,0.0,31,29,2,0,2,93.5483871
2005020667,16,3895,0.0,26,24,3,2,2,92.30769231
2005020668,5,2287,0.0,18,17,3,1,1,94.44444444
2005020668,5,1271,0.0,14,10,3,2,4,71.42857143
2005020668,18,3600,0.0,40,36,8,1,4,90.0
2005020669,24,3714,0.0,24,20,3,3,4,83.33333333
2005020669,6,3715,0.0,28,25,4,1,3,89.28571429
2005020670,15,3597,0.0,22,21,7,1,1,95.45454545
2005020670,27,3593,0.0,34,28,8,0,6,82.35294118
2005020671,3,3549,0.0,32,28,2,1,4,87.5
2005020671,29,3594,0.0,36,33,2,2,3,91.66666667
2005020672,25,3512,0.0,15,11,1,0,4,73.33333333
2005020672,8,3597,0.0,37,35,9,2,2,94.59459459
2005020673,23,3587,2.0,25,23,12,0,2,92.0
2005020673,5,3543,0.0,25,21,8,1,4,84.0
2005020674,9,3598,0.0,16,15,5,1,1,93.75
2005020674,30,3597,0.0,34,28,6,1,6,82.35294118
2005020675,14,3525,0.0,25,22,3,0,3,88.0
2005020675,28,3600,0.0,22,21,1,1,1,95.45454545
2005020676,7,3595,0.0,23,22,5,3,1,95.65217391
2005020676,22,3464,0.0,19,16,6,0,3,84.21052632
2005020677,12,3900,0.0,26,23,6,1,3,88.46153846
2005020677,4,3900,0.0,22,19,4,0,3,86.36363636
2005020678,1,3600,0.0,29,26,2,0,3,89.65517241
2005020678,19,1708,0.0,11,8,1,0,3,72.72727273
2005020678,19,1828,0.0,8,7,0,0,1,87.5
2005020679,2,3750,0.0,35,34,7,0,1,97.14285714
2005020679,16,3769,0.0,23,21,4,2,2,91.30434783
2005020680,10,3558,2.0,31,26,7,3,5,83.87096774
2005020680,21,3585,0.0,28,25,5,2,3,89.28571429
2005020681,14,3600,0.0,23,22,5,3,1,95.65217391
2005020681,26,2261,0.0,13,11,3,1,2,84.61538462
2005020681,26,1200,0.0,11,10,3,0,1,90.90909091
2005020682,17,3586,0.0,26,26,7,0,0,100.0
2005020682,29,3592,0.0,41,37,11,0,4,90.24390244
2005020683,10,3557,0.0,22,18,1,1,4,81.81818182
2005020683,30,3600,0.0,22,19,6,1,3,86.36363636
2005020684,11,3600,0.0,27,25,2,1,2,92.59259259
2005020684,25,3600,0.0,21,16,7,1,5,76.19047619
2005020685,6,3600,0.0,37,35,6,0,2,94.59459459
2005020685,4,3585,0.0,18,13,1,1,5,72.22222222
2005020686,19,3898,0.0,30,26,4,1,4,86.66666667
2005020686,15,3875,2.0,34,30,7,0,4,88.23529412
2005020687,2,3559,0.0,25,21,1,2,4,84.0
2005020687,12,3600,0.0,39,36,9,0,3,92.30769231
2005020688,24,3883,0.0,33,30,3,2,3,90.90909091
2005020688,9,3887,0.0,39,36,10,0,3,92.30769231
2005020689,3,3600,0.0,30,28,9,0,2,93.33333333
2005020689,5,3560,0.0,25,21,5,2,4,84.0
2005020690,1,3900,0.0,32,29,4,0,3,90.625
2005020690,18,3899,0.0,34,31,1,1,3,91.17647059
2005020691,21,3515,2.0,25,21,2,3,4,84.0
2005020691,16,3600,0.0,39,37,9,0,2,94.87179487
2005020692,8,3579,0.0,30,27,10,3,3,90.0
2005020692,20,3582,0.0,18,16,4,0,2,88.88888889
2005020693,13,1200,0.0,7,6,0,1,1,85.71428571
2005020693,13,2400,0.0,28,23,8,1,5,82.14285714
2005020693,27,3594,2.0,29,26,8,2,3,89.65517241
2005020694,7,3522,0.0,26,23,8,2,3,88.46153846
2005020694,23,3600,0.0,25,24,8,0,1,96.0
2005020695,11,3567,0.0,35,28,7,1,7,80.0
2005020695,26,3600,0.0,39,33,5,3,6,84.61538462
2005020696,22,3884,0.0,29,27,10,0,2,93.10344828
2005020696,28,3880,2.0,27,25,8,2,2,92.59259259
2005020697,19,392,0.0,6,6,0,1,0,100.0
2005020697,19,3488,0.0,29,26,3,3,3,89.65517241
2005020697,29,3898,0.0,44,41,16,1,3,93.18181818
2005020698,16,3595,0.0,32,28,5,0,4,87.5
2005020698,30,3598,0.0,32,31,7,2,1,96.875
2005020699,14,3593,0.0,28,25,3,0,3,89.28571429
2005020699,25,2830,2.0,14,13,3,0,1,92.85714286
2005020699,25,755,0.0,7,3,0,0,4,42.85714286
2005020700,2,3900,0.0,37,35,5,2,2,94.59459459
2005020700,1,3900,0.0,39,37,9,0,2,94.87179487
2005020701,4,3600,0.0,33,32,7,0,1,96.96969697
2005020701,5,3519,0.0,26,24,8,0,2,92.30769231
2005020702,17,3591,0.0,23,20,10,0,3,86.95652174
2005020702,21,3471,0.0,32,28,10,3,4,87.5
2005020703,28,3859,0.0,18,15,3,0,3,83.33333333
2005020703,26,3891,0.0,33,29,10,0,4,87.87878788
2005020704,3,3900,0.0,31,29,6,0,2,93.5483871
2005020704,6,3900,0.0,29,27,3,0,2,93.10344828
2005020705,10,3600,0.0,41,34,13,0,7,82.92682927
2005020705,9,3600,2.0,23,23,8,2,0,100.0
2005020706,14,3600,0.0,20,20,7,0,0,100.0
2005020706,11,3499,0.0,24,22,2,1,2,91.66666667
2005020707,12,3490,0.0,26,22,8,1,4,84.61538462
2005020707,15,3596,0.0,33,31,17,1,2,93.93939394
2005020708,29,3596,0.0,48,41,6,1,7,85.41666667
2005020708,18,3600,0.0,29,27,2,0,2,93.10344828
2005020709,7,3567,0.0,36,33,8,0,3,91.66666667
2005020709,20,3600,0.0,30,29,8,1,1,96.66666667
2005020710,22,3900,0.0,29,26,5,0,3,89.65517241
2005020710,27,3863,0.0,27,24,8,0,3,88.88888889
2005020711,8,792,0.0,11,6,3,0,5,54.54545455
2005020711,8,2803,0.0,17,16,2,2,1,94.11764706
2005020711,23,3572,0.0,26,24,8,0,2,92.30769231
2005020712,13,3545,0.0,31,30,6,3,1,96.77419355
2005020712,24,3600,0.0,30,30,4,1,0,100.0
2005020713,1,3542,0.0,32,30,9,1,2,93.75
2005020713,3,3594,0.0,32,31,15,1,1,96.875
2005020714,30,3600,0.0,22,20,2,1,2,90.90909091
2005020714,16,1287,0.0,7,7,5,0,0,100.0
2005020714,16,2190,0.0,15,12,2,0,3,80.0
2005020715,5,3547,0.0,35,32,3,2,3,91.42857143
2005020715,4,3594,0.0,26,24,4,1,2,92.30769231
2005020716,6,3599,2.0,24,22,5,2,2,91.66666667
2005020716,15,3595,2.0,33,30,5,1,3,90.90909091
2005020717,8,1725,0.0,18,13,2,0,5,72.22222222
2005020717,8,1875,0.0,19,17,3,5,2,89.47368421
2005020717,12,3600,0.0,34,31,3,1,3,91.17647059
2005020718,10,3553,0.0,22,18,4,0,4,81.81818182
2005020718,9,3600,2.0,26,23,2,2,3,88.46153846
2005020719,23,3463,2.0,22,19,4,1,3,86.36363636
2005020719,19,3594,0.0,34,34,15,0,0,100.0
2005020720,17,3600,0.0,34,32,10,4,2,94.11764706
2005020720,18,3539,0.0,34,30,6,2,4,88.23529412
2005020721,27,3589,0.0,35,31,5,1,4,88.57142857
2005020721,25,3600,0.0,18,17,3,0,1,94.44444444
2005020722,20,3599,0.0,31,30,6,2,1,96.77419355
2005020722,22,3537,0.0,21,18,1,2,3,85.71428571
2005020723,24,3900,0.0,34,32,15,1,2,94.11764706
2005020723,26,3890,0.0,35,33,7,0,2,94.28571429
2005020724,1,3598,0.0,24,24,3,0,0,100.0
2005020724,2,1804,0.0,11,11,7,0,0,100.0
2005020724,2,1796,0.0,17,13,2,0,4,76.47058824
2005020725,7,3597,0.0,24,23,3,1,1,95.83333333
2005020725,3,3570,0.0,26,24,5,0,2,92.30769231
2005020726,6,3596,0.0,24,22,8,2,2,91.66666667
2005020726,11,3498,0.0,32,29,16,1,3,90.625
2005020727,23,3539,0.0,43,37,15,0,6,86.04651163
2005020727,29,3569,0.0,33,28,4,2,5,84.84848485
2005020728,13,3795,0.0,50,48,15,0,2,96.0
2005020728,14,3781,0.0,26,23,7,1,3,88.46153846
2005020729,18,3635,0.0,39,38,9,2,1,97.43589744
2005020729,17,3624,0.0,28,26,8,0,2,92.85714286
2005020730,27,3532,0.0,22,19,3,2,3,86.36363636
2005020730,30,3600,0.0,20,18,7,1,2,90.0
2005020731,20,3551,19.0,27,20,2,3,7,74.07407407
2005020731,20,32,0.0,0,0,0,0,0,
2005020731,21,3568,2.0,34,30,8,3,4,88.23529412
2005020731,21,32,0.0,0,0,0,0,0,
2005020732,26,3580,0.0,29,26,12,2,3,89.65517241
2005020732,28,3592,2.0,16,15,2,1,1,93.75
2005020733,8,3600,0.0,27,24,6,1,3,88.88888889
2005020733,4,3558,0.0,15,10,6,1,5,66.66666667
2005020734,12,3877,0.0,35,32,5,3,3,91.42857143
2005020734,13,3900,0.0,27,24,11,2,3,88.88888889
2005020735,15,3597,0.0,37,29,7,3,8,78.37837838
2005020735,5,3600,0.0,30,29,16,1,1,96.66666667
2005020736,19,3900,0.0,41,38,9,1,3,92.68292683
2005020736,25,3888,0.0,20,17,6,0,3,85.0
2005020737,22,3580,0.0,22,19,6,0,3,86.36363636
2005020737,24,3540,16.0,25,20,7,0,5,80.0
2005020738,15,3514,0.0,32,29,3,4,3,90.625
2005020738,6,3592,0.0,34,32,5,2,2,94.11764706
2005020739,5,3872,0.0,31,28,11,0,3,90.32258065
2005020739,2,3898,0.0,16,13,0,0,3,81.25
2005020740,12,3600,0.0,31,30,2,1,1,96.77419355
2005020740,11,3590,2.0,33,28,4,2,5,84.84848485
2005020741,7,3584,0.0,37,33,12,4,4,89.18918919
2005020741,10,2115,0.0,15,12,4,1,3,80.0
2005020741,10,1401,2.0,16,12,4,1,4,75.0
2005020742,8,3600,0.0,40,37,11,4,3,92.5
2005020742,9,3600,0.0,12,12,4,1,0,100.0
2005020743,1,3742,0.0,33,32,3,3,1,96.96969697
2005020743,14,3742,0.0,20,20,6,1,0,100.0
2005020744,23,3523,0.0,35,33,10,5,2,94.28571429
2005020744,17,3600,0.0,15,14,5,1,1,93.33333333
2005020745,27,3600,0.0,23,20,2,2,3,86.95652174
2005020745,19,3563,0.0,31,27,2,0,4,87.09677419
2005020746,18,3600,0.0,27,22,5,3,5,81.48148148
2005020746,30,3597,0.0,33,32,3,1,1,96.96969697
2005020747,20,3517,0.0,20,18,4,2,2,90.0
2005020747,16,3600,0.0,26,26,11,0,0,100.0
2005020748,25,3900,0.0,39,37,13,0,2,94.87179487
2005020748,21,3900,0.0,30,28,4,0,2,93.33333333
2005020749,22,3596,0.0,28,25,4,2,3,89.28571429
2005020749,26,3420,0.0,27,22,3,2,5,81.48148148
2005020750,24,3600,0.0,24,24,9,2,0,100.0
2005020750,28,3475,0.0,32,30,3,2,2,93.75
2005020751,30,3590,0.0,25,21,12,1,4,84.0
2005020751,29,3575,0.0,28,25,7,0,3,89.28571429
2005020752,1,3600,0.0,40,36,8,0,4,90.0
2005020752,13,3600,0.0,22,22,3,0,0,100.0
2005020753,14,3593,2.0,38,38,3,2,0,100.0
2005020753,4,3598,0.0,30,24,7,1,6,80.0
2005020754,17,3896,0.0,20,19,4,0,1,95.0
2005020754,25,3897,2.0,28,27,9,0,1,96.42857143
2005020755,24,3587,0.0,32,30,11,0,2,93.75
2005020755,26,2120,0.0,12,11,6,2,1,91.66666667
2005020755,26,1477,0.0,21,16,3,2,5,76.19047619
2005020756,2,3600,0.0,44,41,14,2,3,93.18181818
2005020756,6,3556,0.0,51,47,6,3,4,92.15686275
2005020757,8,3664,0.0,24,21,4,0,3,87.5
2005020757,10,3662,0.0,20,16,5,0,4,80.0
2005020758,5,3593,0.0,51,44,13,0,7,86.2745098
2005020758,3,3600,0.0,14,13,1,0,1,92.85714286
2005020759,11,3546,0.0,26,23,7,3,3,88.46153846
2005020759,12,3600,0.0,18,17,7,0,1,94.44444444
2005020760,18,3536,0.0,24,20,2,1,4,83.33333333
2005020760,29,3600,0.0,27,24,7,0,3,88.88888889
2005020761,28,1384,0.0,14,12,1,0,2,85.71428571
2005020761,28,2216,0.0,11,7,1,0,4,63.63636364
2005020761,27,3600,2.0,36,34,13,3,2,94.44444444
2005020762,23,3895,0.0,43,40,8,0,3,93.02325581
2005020762,21,3886,0.0,31,28,4,2,3,90.32258065
2005020763,14,3541,0.0,24,22,3,1,2,91.66666667
2005020763,15,3600,0.0,35,34,17,0,1,97.14285714
2005020764,20,3600,0.0,24,21,4,2,3,87.5
2005020764,16,3499,0.0,29,24,4,1,5,82.75862069
2005020765,22,3844,0.0,15,12,3,1,3,80.0
2005020765,27,3894,0.0,30,27,8,7,3,90.0
2005020766,4,3677,0.0,30,28,7,1,2,93.33333333
2005020766,3,3688,0.0,40,37,9,0,3,92.5
2005020767,10,3589,0.0,35,33,14,1,2,94.28571429
2005020767,13,3569,0.0,32,28,14,1,4,87.5
2005020768,6,3600,0.0,44,44,3,1,0,100.0
2005020768,9,3594,0.0,24,19,3,2,5,79.16666667
2005020769,20,3900,0.0,18,16,2,1,2,88.88888889
2005020769,19,3900,0.0,31,29,10,2,2,93.5483871
2005020770,17,2398,0.0,10,7,0,0,3,70.0
2005020770,17,1200,0.0,6,5,0,0,1,83.33333333
2005020770,30,1200,0.0,14,10,2,0,4,71.42857143
2005020770,30,2375,0.0,13,12,2,0,1,92.30769231
2005020771,28,3864,0.0,28,25,3,0,3,89.28571429
2005020771,25,3852,0.0,16,14,1,1,2,87.5
2005020772,26,3708,0.0,45,41,5,1,4,91.11111111
2005020772,24,3696,0.0,32,29,2,1,3,90.625
2005020773,15,3559,0.0,32,28,5,1,4,87.5
2005020773,2,3600,0.0,29,26,8,0,3,89.65517241
2005020774,7,3545,0.0,37,35,8,6,2,94.59459459
2005020774,11,3591,0.0,35,30,2,1,5,85.71428571
2005020775,12,3600,0.0,34,32,11,1,2,94.11764706
2005020775,8,1523,0.0,10,5,4,0,5,50.0
2005020775,8,2077,0.0,16,13,2,1,3,81.25
2005020776,10,3895,0.0,37,35,9,1,2,94.59459459
2005020776,14,3895,0.0,27,25,9,0,2,92.59259259
2005020777,30,3566,0.0,41,38,5,1,3,92.68292683
2005020777,21,3572,0.0,29,27,6,2,2,93.10344828
2005020778,23,3599,0.0,46,42,20,3,4,91.30434783
2005020778,27,1147,0.0,6,5,0,0,1,83.33333333
2005020778,27,2383,0.0,19,14,4,0,5,73.68421053
2005020779,5,3543,0.0,26,23,7,0,3,88.46153846
2005020779,3,3556,0.0,25,24,4,2,1,96.0
2005020780,9,3543,2.0,30,25,10,1,5,83.33333333
2005020780,1,3600,2.0,30,27,5,0,3,90.0
2005020781,19,3535,0.0,38,35,2,2,3,92.10526316
2005020781,17,3600,0.0,31,29,8,0,2,93.5483871
2005020782,18,3547,0.0,23,21,3,0,2,91.30434783
2005020782,25,3597,0.0,24,23,4,0,1,95.83333333
2005020783,29,3896,0.0,37,36,2,3,1,97.2972973
2005020783,20,3900,0.0,20,19,5,0,1,95.0
2005020784,28,3600,2.0,39,35,13,0,4,89.74358974
2005020784,24,3395,0.0,34,29,13,3,5,85.29411765
2005020785,8,3589,0.0,36,34,9,1,2,94.44444444
2005020785,6,3589,0.0,17,16,0,0,1,94.11764706
2005020786,4,3557,2.0,36,33,6,1,3,91.66666667
2005020786,7,3600,0.0,23,21,3,1,2,91.30434783
2005020787,3,3590,0.0,25,23,5,0,2,92.0
2005020787,2,3587,0.0,27,22,1,0,5,81.48148148
2005020788,9,3600,0.0,24,22,7,1,2,91.66666667
2005020788,5,3600,0.0,26,19,8,2,7,73.07692308
2005020789,16,3900,0.0,34,29,5,0,5,85.29411765
2005020789,19,3894,0.0,27,22,3,0,5,81.48148148
2005020790,21,3729,0.0,31,27,10,1,4,87.09677419
2005020790,18,3724,0.0,46,43,12,2,3,93.47826087
2005020791,29,3898,0.0,28,27,6,3,1,96.42857143
2005020791,22,3895,0.0,19,18,2,0,1,94.73684211
2005020792,26,3859,2.0,32,31,10,0,1,96.875
2005020792,27,3900,0.0,35,34,4,1,1,97.14285714
2005020793,30,3900,0.0,23,21,2,0,2,91.30434783
2005020793,28,3895,0.0,32,30,8,2,2,93.75
2005020794,10,3600,2.0,30,26,9,1,4,86.66666667
2005020794,15,3600,2.0,26,25,2,0,1,96.15384615
2005020795,12,3600,0.0,21,18,4,0,3,85.71428571
2005020795,1,3600,0.0,28,28,8,1,0,100.0
2005020796,11,3539,0.0,35,32,14,0,3,91.42857143
2005020796,13,3600,0.0,39,37,11,2,2,94.87179487
2005020797,23,3600,0.0,29,28,6,2,1,96.55172414
2005020797,20,3546,0.0,22,19,0,0,3,86.36363636
2005020798,6,3562,0.0,28,27,4,4,1,96.42857143
2005020798,8,3600,0.0,35,35,13,1,0,100.0
2005020799,3,3669,0.0,29,26,10,0,3,89.65517241
2005020799,4,3684,0.0,28,24,4,1,4,85.71428571
2005020800,25,3736,0.0,27,23,5,0,4,85.18518519
2005020800,19,3719,0.0,28,25,8,1,3,89.28571429
2005020801,16,2867,0.0,12,9,1,0,3,75.0
2005020801,16,723,0.0,7,4,2,0,3,57.14285714
2005020801,18,3589,0.0,40,40,7,3,0,100.0
2005020802,17,3585,0.0,28,28,10,0,0,100.0
2005020802,21,3595,0.0,32,29,7,2,3,90.625
2005020803,1,3575,0.0,18,15,0,0,3,83.33333333
2005020803,10,3600,0.0,38,36,3,0,2,94.73684211
2005020804,13,3600,0.0,27,21,5,0,6,77.77777778
2005020804,11,3600,0.0,32,28,5,2,4,87.5
2005020805,9,3900,2.0,27,26,9,1,1,96.2962963
2005020805,7,3894,0.0,29,28,6,1,1,96.55172414
2005020806,2,3893,0.0,44,40,13,0,4,90.90909091
2005020806,5,3886,0.0,29,25,3,1,4,86.20689655
2005020807,15,3600,0.0,37,32,8,1,5,86.48648649
2005020807,14,3593,0.0,29,29,3,0,0,100.0
2005020808,30,3600,0.0,36,32,3,2,4,88.88888889
2005020808,27,1200,0.0,14,12,2,0,2,85.71428571
2005020808,27,2372,0.0,21,17,7,0,4,80.95238095
2005020809,23,3503,0.0,40,37,11,2,3,92.5
2005020809,22,3588,0.0,17,16,0,0,1,94.11764706
2005020810,24,3594,0.0,35,35,12,1,0,100.0
2005020810,28,3504,0.0,23,22,5,1,1,95.65217391
2005020811,12,3900,0.0,27,24,4,2,3,88.88888889
2005020811,6,3900,0.0,43,40,10,1,3,93.02325581
2005020812,4,3600,0.0,36,31,11,1,5,86.11111111
2005020812,8,3600,0.0,25,25,5,0,0,100.0
2005020813,14,3809,0.0,30,28,5,4,2,93.33333333
2005020813,2,3844,0.0,24,21,6,0,3,87.5
2005020814,5,3600,0.0,46,41,4,2,5,89.13043478
2005020814,9,3600,0.0,24,22,6,1,2,91.66666667
2005020815,18,3524,0.0,40,36,17,2,4,90.0
2005020815,25,3598,0.0,19,17,6,0,2,89.47368421
2005020816,24,3900,0.0,30,25,6,2,5,83.33333333
2005020816,22,2843,0.0,33,28,10,1,5,84.84848485
2005020816,22,1055,0.0,7,7,0,0,0,100.0
2005020817,29,2397,0.0,22,15,6,0,7,68.18181818
2005020817,29,1200,0.0,16,16,5,1,0,100.0
2005020817,23,3599,0.0,33,29,9,1,4,87.87878788
2005020818,20,3599,0.0,31,28,13,1,3,90.32258065
2005020818,28,3552,2.0,29,25,8,3,4,86.20689655
2005020819,13,3600,0.0,44,44,5,2,0,100.0
2005020819,15,3600,0.0,40,35,4,0,5,87.5
2005020820,11,3600,0.0,28,24,5,2,4,85.71428571
2005020820,10,3600,0.0,34,33,3,4,1,97.05882353
2005020821,7,3611,0.0,32,30,7,0,2,93.75
2005020821,8,3630,0.0,34,31,5,1,3,91.17647059
2005020822,14,1197,0.0,8,5,2,0,3,62.5
2005020822,14,2400,0.0,22,18,4,0,4,81.81818182
2005020822,1,3591,0.0,35,31,8,2,4,88.57142857
2005020823,26,3580,0.0,26,21,9,0,5,80.76923077
2005020823,30,3565,0.0,20,19,5,3,1,95.0
2005020824,22,3591,0.0,35,30,12,2,5,85.71428571
2005020824,21,3593,0.0,18,16,6,0,2,88.88888889
2005020825,16,3597,0.0,24,23,5,2,1,95.83333333
2005020825,27,3488,2.0,32,29,10,0,3,90.625
2005020826,9,3596,0.0,23,18,4,0,5,78.26086957
2005020826,3,3595,0.0,25,24,11,2,1,96.0
2005020827,2,3527,0.0,26,22,3,5,4,84.61538462
2005020827,4,3600,0.0,22,20,6,1,2,90.90909091
2005020828,26,383,0.0,1,1,0,0,0,100.0
2005020828,26,3022,0.0,34,28,4,0,6,82.35294118
2005020828,29,3600,0.0,27,23,5,0,4,85.18518519
2005020829,6,3593,0.0,17,16,3,0,1,94.11764706
2005020829,5,3533,0.0,38,35,5,1,3,92.10526316
2005020830,18,1200,0.0,8,6,0,1,2,75.0
2005020830,18,2400,0.0,28,24,2,0,4,85.71428571
2005020830,17,3600,0.0,20,20,4,0,0,100.0
2005020831,24,3547,0.0,24,21,2,0,3,87.5
2005020831,20,3600,0.0,32,31,8,1,1,96.875
2005020832,19,1194,0.0,13,12,3,1,1,92.30769231
2005020832,19,2400,0.0,20,19,6,1,1,95.0
2005020832,23,3503,0.0,24,20,3,1,4,83.33333333
2005020833,16,3498,0.0,37,35,7,1,2,94.59459459
2005020833,28,3574,0.0,30,29,8,2,1,96.66666667
2005020834,1,3730,0.0,39,37,3,0,2,94.87179487
2005020834,6,3700,0.0,34,31,7,1,3,91.17647059
2005020835,8,3639,0.0,28,26,3,1,2,92.85714286
2005020835,7,3611,0.0,29,26,3,2,3,89.65517241
2005020836,11,3600,0.0,35,34,7,4,1,97.14285714
2005020836,9,3544,0.0,22,20,5,2,2,90.90909091
2005020837,12,3563,0.0,23,19,2,0,4,82.60869565
2005020837,14,1448,0.0,8,5,1,0,3,62.5
2005020837,14,2152,0.0,28,28,3,0,0,100.0
2005020838,17,3600,0.0,34,32,6,0,2,94.11764706
2005020838,18,3524,0.0,45,42,12,3,3,93.33333333
2005020839,21,3600,0.0,34,33,9,1,1,97.05882353
2005020839,30,3551,0.0,27,25,4,2,2,92.59259259
2005020840,25,3600,0.0,36,35,9,1,1,97.22222222
2005020840,27,3600,0.0,30,25,7,0,5,83.33333333
2005020841,10,3600,0.0,32,28,5,1,4,87.5
2005020841,3,3575,0.0,21,19,4,0,2,90.47619048
2005020842,15,3515,0.0,29,24,8,1,5,82.75862069
2005020842,4,3594,0.0,43,39,13,4,4,90.69767442
2005020843,5,3600,0.0,37,34,12,0,3,91.89189189
2005020843,12,3548,0.0,26,22,4,2,4,84.61538462
2005020844,21,3600,0.0,29,28,3,0,1,96.55172414
2005020844,29,3492,0.0,26,23,1,1,3,88.46153846
2005020845,19,3759,0.0,37,34,12,1,3,91.89189189
2005020845,20,3750,0.0,22,20,2,0,2,90.90909091
2005020846,30,3598,0.0,26,23,5,1,3,88.46153846
2005020846,22,2397,0.0,24,19,6,1,5,79.16666667
2005020846,22,1165,0.0,8,8,3,0,0,100.0
2005020847,24,3578,0.0,28,27,9,0,1,96.42857143
2005020847,23,2472,0.0,17,17,1,0,0,100.0
2005020847,23,1036,0.0,13,10,3,0,3,76.92307692
2005020848,25,3488,0.0,33,28,4,2,5,84.84848485
2005020848,28,3592,0.0,27,24,5,1,3,88.88888889
2005020849,2,3598,0.0,27,26,7,0,1,96.2962963
2005020849,1,3494,0.0,32,30,5,1,2,93.75
2005020850,16,3640,10.0,27,22,5,2,5,81.48148148
2005020850,26,2963,0.0,19,15,4,1,4,78.94736842
2005020850,26,662,0.0,2,2,1,0,0,100.0
2005020851,3,3600,0.0,30,28,9,0,2,93.33333333
2005020851,10,3545,0.0,22,18,3,0,4,81.81818182
2005020852,14,3582,0.0,26,21,2,3,5,80.76923077
2005020852,6,330,0.0,2,2,2,0,0,100.0
2005020852,6,3220,0.0,34,28,12,0,6,82.35294118
2005020853,11,3895,0.0,27,26,4,2,1,96.2962963
2005020853,8,3900,0.0,23,22,8,1,1,95.65217391
2005020854,4,2709,0.0,22,21,5,1,1,95.45454545
2005020854,4,847,0.0,13,11,1,0,2,84.61538462
2005020854,9,3597,0.0,31,29,5,1,2,93.5483871
2005020855,5,3590,0.0,39,36,5,4,3,92.30769231
2005020855,15,3600,0.0,29,23,11,0,6,79.31034483
2005020856,13,3562,0.0,35,30,5,0,5,85.71428571
2005020856,7,3600,0.0,32,29,6,1,3,90.625
2005020857,29,3598,0.0,36,31,9,1,5,86.11111111
2005020857,18,3582,0.0,25,23,7,0,2,92.0
2005020858,19,3900,0.0,28,24,4,1,4,85.71428571
2005020858,22,3091,0.0,16,14,1,0,2,87.5
2005020858,22,809,0.0,5,3,1,0,2,60.0
2005020859,25,3572,4.0,40,34,12,2,6,85.0
2005020859,26,3561,0.0,27,22,5,1,5,81.48148148
2005020860,7,3893,0.0,33,30,3,4,3,90.90909091
2005020860,12,3891,0.0,20,17,5,0,3,85.0
2005020861,21,3589,0.0,38,33,6,1,5,86.84210526
2005020861,17,3578,0.0,23,20,2,1,3,86.95652174
2005020862,28,3714,0.0,38,34,1,0,4,89.47368421
2005020862,27,3683,0.0,24,19,6,0,5,79.16666667
2005020863,16,3557,0.0,31,28,7,0,3,90.32258065
2005020863,24,3585,0.0,24,23,2,2,1,95.83333333
2005020864,30,3686,0.0,30,27,4,3,3,90.0
2005020864,23,3686,0.0,16,14,4,1,2,87.5
2005020865,8,3588,0.0,35,32,5,2,3,91.42857143
2005020865,2,2396,0.0,13,10,1,0,3,76.92307692
2005020865,2,1189,4.0,9,7,0,1,2,77.77777778
2005020866,15,3600,0.0,29,26,10,1,3,89.65517241
2005020866,10,3600,0.0,27,22,7,4,5,81.48148148
2005020867,13,3570,0.0,34,32,15,2,2,94.11764706
2005020867,14,2174,0.0,9,5,1,1,4,55.55555556
2005020867,14,1425,0.0,13,9,5,1,4,69.23076923
2005020868,30,3596,0.0,30,27,2,3,3,90.0
2005020868,21,3600,2.0,35,33,9,0,2,94.28571429
2005020869,23,3600,0.0,31,30,7,2,1,96.77419355
2005020869,20,3538,0.0,22,20,8,1,2,90.90909091
2005020870,17,3594,0.0,32,27,6,1,5,84.375
2005020870,28,3600,0.0,29,28,11,3,1,96.55172414
2005020871,11,3600,0.0,36,34,7,4,2,94.44444444
2005020871,7,3562,0.0,24,21,7,0,3,87.5
2005020872,6,3535,0.0,29,25,7,2,4,86.20689655
2005020872,12,3585,0.0,28,25,5,1,3,89.28571429
2005020873,4,3893,0.0,32,31,2,0,1,96.875
2005020873,1,3900,0.0,27,26,2,0,1,96.2962963
2005020874,9,3590,0.0,30,27,7,2,3,90.0
2005020874,5,3528,0.0,26,22,4,1,4,84.61538462
2005020875,18,3600,0.0,33,30,4,2,3,90.90909091
2005020875,16,3573,0.0,20,20,5,0,0,100.0
2005020876,19,3600,0.0,37,35,14,0,2,94.59459459
2005020876,22,2399,0.0,10,7,2,1,3,70.0
2005020876,22,1121,0.0,2,1,0,0,1,50.0
2005020877,17,3600,0.0,24,24,7,4,0,100.0
2005020877,24,3507,0.0,33,31,13,1,2,93.93939394
2005020878,11,3541,0.0,31,28,6,4,3,90.32258065
2005020878,6,3600,0.0,22,20,5,0,2,90.90909091
2005020879,1,3900,0.0,40,38,6,1,2,95.0
2005020879,2,3900,0.0,28,26,5,0,2,92.85714286
2005020880,3,3597,0.0,37,36,16,0,1,97.2972973
2005020880,4,2121,0.0,19,16,2,0,3,84.21052632
2005020880,4,1479,0.0,7,4,0,2,3,57.14285714
2005020881,8,3600,0.0,24,24,6,2,0,100.0
2005020881,13,3558,0.0,27,26,7,1,1,96.2962963
2005020882,15,1700,0.0,11,10,1,1,1,90.90909091
2005020882,15,1900,0.0,25,19,3,1,6,76.0
2005020882,9,3600,0.0,31,30,5,0,1,96.77419355
2005020883,23,3464,0.0,20,17,4,2,3,85.0
2005020883,18,3600,0.0,42,41,16,1,1,97.61904762
2005020884,29,3523,0.0,40,39,15,3,1,97.5
2005020884,21,3591,0.0,24,24,8,3,0,100.0
2005020885,19,3564,0.0,30,28,8,3,2,93.33333333
2005020885,20,3581,2.0,21,20,5,0,1,95.23809524
2005020886,25,2400,0.0,21,17,5,1,4,80.95238095
2005020886,25,1192,0.0,10,8,3,0,2,80.0
2005020886,27,3598,0.0,19,17,4,1,2,89.47368421
2005020887,30,3564,0.0,38,35,10,0,3,92.10526316
2005020887,26,3600,0.0,31,29,1,0,2,93.5483871
2005020888,13,3561,0.0,37,33,15,1,4,89.18918919
2005020888,12,3600,0.0,39,37,12,5,2,94.87179487
2005020889,10,3600,0.0,32,26,4,0,6,81.25
2005020889,7,3595,0.0,23,21,5,3,2,91.30434783
2005020890,23,3862,0.0,30,26,4,2,4,86.66666667
2005020890,16,3900,0.0,41,37,12,0,4,90.24390244
2005020891,28,3558,2.0,30,27,4,1,3,90.0
2005020891,22,3600,0.0,21,19,1,1,2,90.47619048
2005020892,30,3584,0.0,31,28,6,0,3,90.32258065
2005020892,24,3588,0.0,38,36,7,4,2,94.73684211
2005020893,29,3522,0.0,35,32,11,3,3,91.42857143
2005020893,26,3580,0.0,26,24,2,2,2,92.30769231
2005020894,7,3574,0.0,42,40,4,2,2,95.23809524
2005020894,6,3529,0.0,25,22,4,2,3,88.0
2005020895,9,3600,0.0,24,22,9,1,2,91.66666667
2005020895,10,3556,0.0,25,22,3,1,3,88.0
2005020896,4,3557,0.0,25,22,4,0,3,88.0
2005020896,2,3581,0.0,21,19,7,2,2,90.47619048
2005020897,15,3686,0.0,34,31,11,3,3,91.17647059
2005020897,11,3690,0.0,32,30,7,1,2,93.75
2005020898,3,3595,0.0,20,18,3,0,2,90.0
2005020898,1,3600,0.0,27,26,1,1,1,96.2962963
2005020899,12,3600,0.0,38,33,10,1,5,86.84210526
2005020899,5,504,0.0,4,1,0,0,3,25.0
2005020899,5,3021,0.0,25,21,9,1,4,84.0
2005020900,8,3600,0.0,29,27,11,2,2,93.10344828
2005020900,14,3596,0.0,22,16,8,0,6,72.72727273
2005020901,21,3600,0.0,31,26,4,3,5,83.87096774
2005020901,25,3582,0.0,17,14,3,1,3,82.35294118
2005020902,17,3592,0.0,35,32,10,0,3,91.42857143
2005020902,27,1188,0.0,7,7,0,4,0,100.0
2005020902,27,2396,4.0,27,20,3,0,7,74.07407407
2005020903,28,3488,0.0,20,18,5,2,2,90.0
2005020903,20,3600,0.0,26,26,12,1,0,100.0
2005020904,18,3857,0.0,42,39,12,2,3,92.85714286
2005020904,22,3846,0.0,20,18,2,0,2,90.0
2005020905,29,3898,0.0,45,43,5,7,2,95.55555556
2005020905,24,3900,0.0,34,32,11,1,2,94.11764706
2005020906,25,3584,0.0,20,18,3,0,2,90.0
2005020906,16,2099,0.0,17,13,3,1,4,76.47058824
2005020906,16,1492,0.0,11,8,2,1,3,72.72727273
2005020907,21,3535,0.0,30,26,12,2,4,86.66666667
2005020907,30,3592,0.0,29,26,4,2,3,89.65517241
2005020908,19,3583,0.0,24,23,3,1,1,95.83333333
2005020908,23,3600,0.0,35,31,12,1,4,88.57142857
2005020909,12,3600,0.0,38,37,12,3,1,97.36842105
2005020909,3,3541,0.0,19,17,4,0,2,89.47368421
2005020910,8,3885,0.0,28,24,7,0,4,85.71428571
2005020910,4,3886,0.0,36,32,7,1,4,88.88888889
2005020911,2,3598,0.0,33,28,6,0,5,84.84848485
2005020911,15,3580,0.0,42,40,11,2,2,95.23809524
2005020912,13,3899,0.0,34,31,4,4,3,91.17647059
2005020912,11,3896,0.0,40,37,2,1,3,92.5
2005020913,9,3600,2.0,31,31,6,0,0,100.0
2005020913,14,3600,0.0,34,30,2,0,4,88.23529412
2005020914,6,3535,0.0,35,32,3,1,3,91.42857143
2005020914,7,3598,0.0,27,25,5,0,2,92.59259259
2005020915,1,3900,0.0,30,29,2,1,1,96.66666667
2005020915,2,3900,0.0,31,30,11,0,1,96.77419355
2005020916,16,3600,0.0,28,27,3,1,1,96.42857143
2005020916,29,3559,0.0,43,41,9,0,2,95.34883721
2005020917,8,3565,0.0,34,29,16,1,5,85.29411765
2005020917,10,1,0.0,0,0,0,0,0,
2005020917,10,3588,0.0,33,30,10,1,3,90.90909091
2005020918,14,3894,0.0,27,23,7,3,4,85.18518519
2005020918,5,3883,0.0,34,30,6,1,4,88.23529412
2005020919,27,3596,0.0,37,35,6,4,2,94.59459459
2005020919,17,3600,0.0,24,19,4,0,5,79.16666667
2005020920,21,3900,0.0,24,23,0,1,1,95.83333333
2005020920,19,3900,0.0,23,22,7,2,1,95.65217391
2005020921,26,3681,0.0,23,21,6,0,2,91.30434783
2005020921,30,3681,0.0,24,21,1,0,3,87.5
2005020922,18,3585,0.0,32,30,4,3,2,93.75
2005020922,20,3538,0.0,26,23,2,1,3,88.46153846
2005020923,25,3900,0.0,29,26,2,0,3,89.65517241
2005020923,22,1,0.0,0,0,0,0,0,
2005020923,22,3899,0.0,26,23,1,1,3,88.46153846
2005020924,28,3656,0.0,27,22,3,3,5,81.48148148
2005020924,24,3658,0.0,48,44,4,0,4,91.66666667
2005020925,12,3900,0.0,35,33,7,2,2,94.28571429
2005020925,4,3876,0.0,31,29,8,0,2,93.5483871
2005020926,5,3474,0.0,41,36,17,2,5,87.80487805
2005020926,15,3600,0.0,25,22,9,1,3,88.0
2005020927,3,3890,0.0,35,33,7,2,2,94.28571429
2005020927,11,3900,0.0,34,32,5,2,2,94.11764706
2005020928,8,3584,0.0,28,28,8,1,0,100.0
2005020928,6,3525,0.0,40,38,10,2,2,95.0
2005020929,14,1152,0.0,6,4,1,0,2,66.66666667
2005020929,14,2400,0.0,16,11,1,2,5,68.75
2005020929,7,3598,0.0,40,35,6,0,5,87.5
2005020930,9,3600,0.0,38,32,5,4,6,84.21052632
2005020930,13,3597,0.0,35,33,7,2,2,94.28571429
2005020931,27,3528,0.0,30,25,8,0,5,83.33333333
2005020931,29,3599,0.0,33,29,6,0,4,87.87878788
2005020932,26,1545,0.0,14,12,3,0,2,85.71428571
2005020932,26,2029,0.0,30,26,4,1,4,86.66666667
2005020932,17,3597,0.0,25,22,7,0,3,88.0
2005020933,21,3600,0.0,27,26,1,1,1,96.2962963
2005020933,16,3538,0.0,24,22,2,0,2,91.66666667
2005020934,25,3542,0.0,24,23,3,4,1,95.83333333
2005020934,20,3600,0.0,39,39,9,1,0,100.0
2005020935,18,3606,0.0,25,23,3,0,2,92.0
2005020936,22,3586,0.0,31,26,5,1,5,83.87096774
2005020936,28,3600,0.0,21,19,3,0,2,90.47619048
2005020937,10,3894,0.0,27,26,9,2,1,96.2962963
2005020937,2,3900,0.0,23,22,8,1,1,95.65217391
2005020938,1,3900,0.0,28,25,5,1,3,89.28571429
2005020938,15,3867,0.0,27,24,9,0,3,88.88888889
2005020939,9,3600,0.0,17,16,2,2,1,94.11764706
2005020939,11,3596,0.0,35,32,8,0,3,91.42857143
2005020940,30,3625,0.0,29,27,2,0,2,93.10344828
2005020940,19,3625,0.0,23,22,2,0,1,95.65217391
2005020941,7,2400,0.0,20,15,3,1,5,75.0
2005020941,7,1200,0.0,1,1,0,0,0,100.0
2005020941,4,3600,0.0,39,33,10,3,6,84.61538462
2005020942,18,3725,2.0,42,39,12,1,3,92.85714286
2005020942,28,3754,0.0,19,17,1,0,2,89.47368421
2005020943,2,3575,0.0,33,32,9,5,1,96.96969697
2005020943,6,3557,0.0,44,42,9,0,2,95.45454545
2005020944,14,3598,0.0,30,25,8,3,5,83.33333333
2005020944,10,3600,0.0,30,29,8,1,1,96.66666667
2005020945,3,3551,0.0,24,23,7,0,1,95.83333333
2005020945,8,3595,0.0,26,26,9,0,0,100.0
2005020946,22,3844,0.0,31,27,5,3,4,87.09677419
2005020946,29,3846,0.0,27,24,6,1,3,88.88888889
2005020947,1,1529,2.0,16,10,6,1,6,62.5
2005020947,1,2071,0.0,10,10,2,0,0,100.0
2005020947,5,3572,0.0,41,38,12,2,3,92.68292683
2005020948,12,3674,0.0,30,26,6,0,4,86.66666667
2005020948,13,3661,0.0,42,39,15,3,3,92.85714286
2005020949,16,1834,0.0,20,15,0,1,5,75.0
2005020949,16,1706,0.0,26,25,16,0,1,96.15384615
2005020949,17,3586,0.0,29,25,1,2,4,86.20689655
2005020950,26,3900,0.0,32,31,3,1,1,96.875
2005020950,19,3895,0.0,26,25,6,0,1,96.15384615
2005020951,24,3598,0.0,17,14,4,3,3,82.35294118
2005020951,27,3571,0.0,35,31,9,4,4,88.57142857
2005020952,25,3600,0.0,19,18,5,2,1,94.73684211
2005020952,23,3541,0.0,33,31,5,0,2,93.93939394
2005020953,9,3595,0.0,27,25,6,1,2,92.59259259
2005020953,15,3600,0.0,24,19,3,0,5,79.16666667
2005020954,20,3600,0.0,25,22,4,2,3,88.0
2005020954,21,3556,0.0,33,33,6,1,0,100.0
2005020955,6,3593,0.0,30,24,4,0,6,80.0
2005020955,7,3586,0.0,39,37,5,1,2,94.87179487
2005020956,11,3765,0.0,35,33,10,1,2,94.28571429
2005020956,3,3749,0.0,31,28,8,1,3,90.32258065
2005020957,12,3535,0.0,38,34,1,0,4,89.47368421
2005020957,13,3600,0.0,27,24,8,0,3,88.88888889
2005020958,17,3591,0.0,20,17,2,1,3,85.0
2005020958,16,417,0.0,5,2,0,0,3,40.0
2005020958,16,3062,0.0,23,21,5,0,2,91.30434783
2005020959,22,3556,0.0,30,26,5,0,4,86.66666667
2005020959,30,3594,0.0,27,24,6,2,3,88.88888889
2005020960,4,3600,0.0,20,18,5,0,2,90.0
2005020960,5,3594,0.0,22,22,4,1,0,100.0
2005020961,27,3497,0.0,44,40,10,0,4,90.90909091
2005020961,24,3574,0.0,22,20,2,1,2,90.90909091
2005020962,14,3600,2.0,32,31,8,2,1,96.875
2005020962,8,3547,0.0,24,22,2,4,2,91.66666667
2005020963,29,3829,0.0,31,28,5,1,3,90.32258065
2005020963,19,1928,0.0,15,14,2,1,1,93.33333333
2005020963,19,1890,0.0,15,14,0,1,1,93.33333333
2005020964,23,3487,0.0,28,24,9,0,4,85.71428571
2005020964,25,3599,0.0,29,27,7,1,2,93.10344828
2005020965,21,3534,0.0,30,26,4,0,4,86.66666667
2005020965,20,3600,0.0,29,26,5,0,3,89.65517241
2005020966,26,3558,0.0,29,25,3,0,4,86.20689655
2005020966,28,3594,0.0,22,19,4,0,3,86.36363636
2005020967,7,3597,0.0,33,29,7,3,4,87.87878788
2005020967,15,3533,2.0,40,35,6,0,5,87.5
2005020968,3,3521,0.0,28,24,1,2,4,85.71428571
2005020968,12,3600,0.0,44,41,4,2,3,93.18181818
2005020969,6,3900,0.0,33,29,12,0,4,87.87878788
2005020969,10,3864,0.0,32,28,7,3,4,87.5
2005020970,14,3600,0.0,31,27,4,7,4,87.09677419
2005020970,9,3596,0.0,26,23,9,0,3,88.46153846
2005020971,2,3594,0.0,17,16,2,0,1,94.11764706
2005020971,1,2696,0.0,24,18,1,0,6,75.0
2005020971,1,899,0.0,2,2,0,0,0,100.0
2005020972,23,3591,0.0,27,22,6,2,5,81.48148148
2005020972,18,3574,0.0,31,31,12,1,0,100.0
2005020973,22,3600,0.0,31,30,10,2,1,96.77419355
2005020973,30,3571,0.0,29,27,2,1,2,93.10344828
2005020974,27,3586,0.0,29,27,9,3,2,93.10344828
2005020974,26,3580,0.0,28,22,11,0,6,78.57142857
2005020975,4,3600,0.0,27,27,1,0,0,100.0
2005020975,13,1200,0.0,8,7,0,0,1,87.5
2005020975,13,2400,0.0,26,23,4,0,3,88.46153846
2005020976,24,3547,0.0,28,26,3,0,2,92.85714286
2005020976,17,3599,0.0,26,25,4,0,1,96.15384615
2005020977,29,3568,0.0,29,26,3,1,3,89.65517241
2005020977,16,3595,0.0,35,33,6,0,2,94.28571429
2005020978,9,3900,0.0,30,28,7,5,2,93.33333333
2005020978,6,3869,0.0,33,31,2,0,2,93.93939394
2005020979,10,3537,0.0,32,30,6,1,2,93.75
2005020979,7,3592,0.0,28,27,10,0,1,96.42857143
2005020980,15,3556,0.0,27,22,7,0,5,81.48148148
2005020980,3,3579,0.0,40,36,11,2,4,90.0
2005020981,2,3561,0.0,38,35,6,1,3,92.10526316
2005020981,11,3600,0.0,30,28,7,0,2,93.33333333
2005020982,12,3600,0.0,29,28,5,1,1,96.55172414
2005020982,8,3600,0.0,41,36,6,0,5,87.80487805
2005020983,5,3541,0.0,23,21,4,0,2,91.30434783
2005020983,1,3594,0.0,14,13,4,1,1,92.85714286
2005020984,27,3467,0.0,23,21,5,0,2,91.30434783
2005020984,18,3600,0.0,24,24,16,2,0,100.0
2005020985,20,3781,0.0,28,25,9,0,3,89.28571429
2005020985,22,3776,2.0,20,18,4,1,2,90.0
2005020986,25,3600,0.0,25,24,7,1,1,96.0
2005020986,26,942,0.0,4,4,1,0,0,100.0
2005020986,26,2388,0.0,23,19,0,0,4,82.60869565
2005020987,19,3600,0.0,35,30,9,0,5,85.71428571
2005020987,28,3593,0.0,29,27,6,0,2,93.10344828
2005020988,23,3586,0.0,24,22,8,0,2,91.66666667
2005020988,29,3543,0.0,33,30,4,2,3,90.90909091
2005020989,4,3557,0.0,24,19,6,0,5,79.16666667
2005020989,14,3600,0.0,31,28,6,1,3,90.32258065
2005020990,2,3588,0.0,43,40,4,0,3,93.02325581
2005020990,13,3600,0.0,26,24,2,1,2,92.30769231
2005020991,24,3591,0.0,23,22,5,1,1,95.65217391
2005020991,16,3527,0.0,30,28,2,2,2,93.33333333
2005020992,12,3506,0.0,33,29,4,6,4,87.87878788
2005020992,6,3590,2.0,40,38,15,0,2,95.0
2005020993,25,3900,0.0,28,25,2,0,3,89.28571429
2005020993,28,3898,0.0,22,19,2,1,3,86.36363636
2005020994,5,3600,0.0,46,42,10,6,4,91.30434783
2005020994,8,3532,0.0,23,18,4,0,5,78.26086957
2005020995,7,3559,0.0,48,45,12,3,3,93.75
2005020995,9,3600,0.0,22,20,2,1,2,90.90909091
2005020996,10,3558,0.0,23,19,5,1,4,82.60869565
2005020996,3,3595,0.0,35,33,14,0,2,94.28571429
2005020997,13,3900,0.0,40,37,8,0,3,92.5
2005020997,15,3900,0.0,44,41,13,2,3,93.18181818
2005020998,4,3596,0.0,27,25,7,2,2,92.59259259
2005020998,11,3505,0.0,27,23,6,3,4,85.18518519
2005020999,20,3600,0.0,47,38,9,3,9,80.85106383
2005020999,18,3594,0.0,27,23,4,2,4,85.18518519
2005021000,17,3895,0.0,28,25,9,1,3,89.28571429
2005021000,22,3883,0.0,27,24,1,1,3,88.88888889
2005021001,19,3493,0.0,36,33,15,4,3,91.66666667
2005021001,26,3589,0.0,24,23,9,0,1,95.83333333
2005021002,27,3600,0.0,36,34,3,1,2,94.44444444
2005021002,16,3514,2.0,26,23,4,2,3,88.46153846
2005021003,2,3600,0.0,37,32,4,0,5,86.48648649
2005021003,14,3600,0.0,32,30,0,1,2,93.75
2005021004,24,1876,0.0,18,15,7,0,3,83.33333333
2005021004,24,1716,0.0,10,10,6,1,0,100.0
2005021004,29,3507,0.0,29,25,8,0,4,86.20689655
2005021005,20,3600,0.0,39,37,11,0,2,94.87179487
2005021005,30,3554,0.0,19,16,3,0,3,84.21052632
2005021006,9,3600,0.0,22,22,4,3,0,100.0
2005021006,1,3600,0.0,31,27,8,1,4,87.09677419
2005021007,10,3597,0.0,21,21,3,2,0,100.0
2005021007,5,3553,0.0,23,22,1,1,1,95.65217391
2005021008,21,3550,0.0,33,27,6,2,6,81.81818182
2005021008,28,3600,0.0,29,24,4,1,5,82.75862069
2005021009,17,3590,0.0,24,21,4,1,3,87.5
2005021009,23,978,0.0,9,9,4,0,0,100.0
2005021009,23,2622,0.0,28,21,11,0,7,75.0
2005021010,6,3600,0.0,29,24,1,1,5,82.75862069
2005021010,3,3581,0.0,21,19,4,0,2,90.47619048
2005021011,8,3600,0.0,26,24,6,0,2,92.30769231
2005021011,15,3593,0.0,32,28,2,3,4,87.5
2005021012,7,3600,4.0,23,18,9,0,5,78.26086957
2005021012,11,3600,0.0,20,20,1,1,0,100.0
2005021013,14,1396,0.0,13,12,0,2,1,92.30769231
2005021013,14,2388,2.0,25,20,3,0,5,80.0
2005021013,13,3796,0.0,34,29,3,0,5,85.29411765
2005021014,19,3597,0.0,41,37,9,3,4,90.24390244
2005021014,18,3595,0.0,30,28,4,2,2,93.33333333
2005021015,24,3600,0.0,25,24,3,1,1,96.0
2005021015,25,3497,0.0,18,16,2,0,2,88.88888889
2005021016,21,3600,2.0,21,21,6,0,0,100.0
2005021016,26,1703,0.0,7,6,2,0,1,85.71428571
2005021016,26,1894,0.0,13,9,1,1,4,69.23076923
2005021017,11,3895,0.0,31,27,5,2,4,87.09677419
2005021017,6,3878,0.0,40,36,15,1,4,90.0
2005021018,8,3435,0.0,25,22,1,0,3,88.0
2005021018,2,3600,0.0,37,36,8,0,1,97.2972973
2005021019,1,3523,0.0,21,19,5,1,2,90.47619048
2005021019,4,3595,0.0,22,21,4,0,1,95.45454545
2005021020,27,3600,0.0,33,31,4,1,2,93.93939394
2005021020,29,3539,0.0,35,31,9,0,4,88.57142857
2005021021,12,3533,0.0,29,26,6,0,3,89.65517241
2005021021,10,3597,0.0,35,33,3,2,2,94.28571429
2005021022,5,3592,0.0,39,34,15,0,5,87.17948718
2005021022,9,3600,0.0,24,22,4,0,2,91.66666667
2005021023,18,3898,0.0,41,39,5,0,2,95.12195122
2005021023,17,3885,0.0,36,34,7,0,2,94.44444444
2005021024,28,3600,0.0,33,33,9,2,0,100.0
2005021024,19,3585,0.0,29,23,4,2,6,79.31034483
2005021025,20,3567,0.0,38,36,5,1,2,94.73684211
2005021025,30,3600,0.0,18,17,1,2,1,94.44444444
2005021026,23,3591,0.0,30,29,8,0,1,96.66666667
2005021026,22,3568,0.0,31,28,9,0,3,90.32258065
2005021027,12,3600,0.0,27,24,4,2,3,88.88888889
2005021027,7,3557,0.0,25,21,4,1,4,84.0
2005021028,4,3600,0.0,23,20,6,1,3,86.95652174
2005021028,3,3521,0.0,35,30,7,0,5,85.71428571
2005021029,15,3538,0.0,40,37,6,4,3,92.5
2005021029,13,3596,0.0,30,28,6,4,2,93.33333333
2005021030,30,3600,0.0,24,20,5,0,4,83.33333333
2005021030,25,3593,0.0,17,15,7,2,2,88.23529412
2005021031,21,3802,0.0,36,31,6,1,5,86.11111111
2005021031,24,3163,0.0,19,18,2,2,1,94.73684211
2005021031,24,639,0.0,10,7,1,0,3,70.0
2005021032,1,3655,0.0,30,24,5,5,6,80.0
2005021032,11,3663,0.0,41,36,6,3,5,87.80487805
2005021033,10,3592,0.0,30,25,11,0,5,83.33333333
2005021033,8,3591,0.0,34,33,10,3,1,97.05882353
2005021034,15,3628,0.0,37,33,7,2,4,89.18918919
2005021034,14,3637,0.0,30,27,9,0,3,90.0
2005021035,28,3587,0.0,30,26,2,0,4,86.66666667
2005021035,17,3600,0.0,28,28,7,1,0,100.0
2005021036,20,3600,0.0,22,20,5,0,2,90.90909091
2005021036,19,1784,0.0,12,8,2,0,4,66.66666667
2005021036,19,1811,0.0,14,11,0,2,3,78.57142857
2005021037,16,3524,0.0,32,28,10,0,4,87.5
2005021037,27,3591,0.0,40,37,8,2,3,92.5
2005021038,22,3897,0.0,19,16,0,2,3,84.21052632
2005021038,23,3886,0.0,29,26,3,4,3,89.65517241
2005021039,20,3525,0.0,28,25,4,1,3,89.28571429
2005021039,29,3600,0.0,28,26,6,1,2,92.85714286
2005021040,6,1890,0.0,15,12,1,2,3,80.0
2005021040,6,1676,0.0,9,8,1,0,1,88.88888889
2005021040,1,3600,0.0,27,25,6,0,2,92.59259259
2005021041,2,3805,0.0,26,22,1,1,4,84.61538462
2005021041,5,3801,0.0,28,25,8,1,3,89.28571429
2005021042,3,3900,0.0,42,40,6,2,2,95.23809524
2005021042,13,3899,0.0,28,26,1,1,2,92.85714286
2005021043,9,3600,0.0,29,28,6,1,1,96.55172414
2005021043,7,3574,0.0,24,21,1,0,3,87.5
2005021044,16,3852,0.0,24,22,5,0,2,91.66666667
2005021044,25,3887,0.0,26,24,3,1,2,92.30769231
2005021045,18,1200,0.0,9,8,0,0,1,88.88888889
2005021045,18,2400,0.0,21,16,3,1,5,76.19047619
2005021045,24,3600,0.0,39,36,5,0,3,92.30769231
2005021046,7,3544,0.0,39,34,11,2,5,87.17948718
2005021046,6,3587,0.0,40,36,9,1,4,90.0
2005021047,10,3600,0.0,29,23,6,1,6,79.31034483
2005021047,8,3574,0.0,28,26,4,2,2,92.85714286
2005021048,11,752,0.0,4,4,0,0,0,100.0
2005021048,11,2840,0.0,29,24,5,2,5,82.75862069
2005021048,2,3600,0.0,22,21,3,0,1,95.45454545
2005021049,9,3059,0.0,31,29,4,1,2,93.5483871
2005021049,9,513,0.0,14,10,0,0,4,71.42857143
2005021049,4,3600,0.0,36,33,5,0,3,91.66666667
2005021050,15,3597,0.0,34,33,14,2,1,97.05882353
2005021050,12,3512,0.0,21,18,4,3,3,85.71428571
2005021051,3,3887,0.0,34,31,10,0,3,91.17647059
2005021051,14,3885,0.0,23,20,3,1,3,86.95652174
2005021052,29,3900,0.0,44,40,15,0,4,90.90909091
2005021052,17,3895,0.0,27,23,2,5,4,85.18518519
2005021053,21,3657,0.0,28,26,10,2,2,92.85714286
2005021053,19,3657,0.0,31,28,10,3,3,90.32258065
2005021054,28,3597,0.0,25,24,6,1,1,96.0
2005021054,30,3595,0.0,23,18,1,2,5,78.26086957
2005021055,24,3599,0.0,34,32,14,0,2,94.11764706
2005021055,27,3596,0.0,27,22,6,1,5,81.48148148
2005021056,22,3573,0.0,25,23,3,0,2,92.0
2005021056,23,3536,0.0,29,26,9,0,3,89.65517241
2005021057,18,3597,0.0,48,42,13,2,6,87.5
2005021057,26,3586,0.0,19,15,5,1,4,78.94736842
2005021058,20,3546,0.0,23,20,9,2,3,86.95652174
2005021058,25,3584,0.0,19,17,4,0,2,89.47368421
2005021059,28,3684,0.0,34,30,2,1,4,88.23529412
2005021059,16,3632,0.0,35,30,3,1,5,85.71428571
2005021060,10,3600,0.0,38,35,9,0,3,92.10526316
2005021060,1,3524,0.0,30,26,0,1,4,86.66666667
2005021061,8,3587,0.0,35,30,6,4,5,85.71428571
2005021061,5,3489,0.0,25,19,5,0,6,76.0
2005021062,22,3898,0.0,34,31,2,4,3,91.17647059
2005021062,21,3894,0.0,27,24,4,0,3,88.88888889
2005021063,13,3900,0.0,37,34,6,0,3,91.89189189
2005021063,6,3869,0.0,48,45,5,2,3,93.75
2005021064,7,3868,0.0,35,31,11,2,4,88.57142857
2005021064,3,2388,0.0,23,19,6,2,4,82.60869565
2005021064,3,1499,0.0,8,8,0,1,0,100.0
2005021065,14,3534,0.0,29,27,8,0,2,93.10344828
2005021065,12,3597,0.0,24,23,5,1,1,95.83333333
2005021066,17,3571,0.0,21,20,5,2,1,95.23809524
2005021066,19,3590,0.0,32,28,7,2,4,87.5
2005021067,26,3503,0.0,32,25,6,1,7,78.125
2005021067,23,3598,0.0,38,34,6,6,4,89.47368421
2005021068,10,3600,0.0,30,28,7,0,2,93.33333333
2005021068,4,3557,0.0,26,23,3,0,3,88.46153846
2005021069,28,3548,0.0,22,19,1,3,3,86.36363636
2005021069,29,3568,0.0,29,28,7,0,1,96.55172414
2005021070,2,3555,0.0,35,34,10,0,1,97.14285714
2005021070,8,3600,0.0,36,36,6,2,0,100.0
2005021071,1,3900,0.0,38,36,8,1,2,94.73684211
2005021071,9,3849,0.0,35,33,6,0,2,94.28571429
2005021072,24,3497,0.0,35,31,7,3,4,88.57142857
2005021072,21,3593,0.0,31,28,9,1,3,90.32258065
2005021073,30,3600,0.0,25,23,6,0,2,92.0
2005021073,22,3576,0.0,16,13,3,1,3,81.25
2005021074,18,3496,0.0,42,37,11,6,5,88.0952381
2005021074,27,3598,0.0,31,28,5,0,3,90.32258065
2005021075,6,3519,0.0,32,28,6,0,4,87.5
2005021075,7,3597,0.0,27,24,6,2,3,88.88888889
2005021076,3,3593,0.0,19,18,3,0,1,94.73684211
2005021076,2,3600,0.0,22,17,4,1,5,77.27272727
2005021077,15,3600,0.0,50,49,11,0,1,98.0
2005021077,12,3600,0.0,28,23,0,4,5,82.14285714
2005021078,13,3600,0.0,34,31,8,1,3,91.17647059
2005021078,5,1834,0.0,17,13,3,2,4,76.47058824
2005021078,5,1741,0.0,8,8,2,0,0,100.0
2005021079,19,3816,0.0,33,30,4,0,3,90.90909091
2005021079,16,3829,0.0,46,44,10,1,2,95.65217391
2005021080,24,3587,0.0,29,27,7,0,2,93.10344828
2005021080,25,3600,0.0,16,15,5,0,1,93.75
2005021081,26,3535,0.0,25,23,4,2,2,92.0
2005021081,20,3600,0.0,26,25,3,0,1,96.15384615
2005021082,30,3599,0.0,31,29,3,0,2,93.5483871
2005021082,23,3600,0.0,21,20,3,0,1,95.23809524
2005021083,15,3779,2.0,33,30,14,1,3,90.90909091
2005021083,8,3839,0.0,29,27,9,2,2,93.10344828
2005021084,3,3600,0.0,32,28,13,1,4,87.5
2005021084,9,3592,0.0,25,24,7,1,1,96.0
2005021085,7,3590,0.0,28,25,5,0,3,89.28571429
2005021085,1,3600,0.0,30,29,2,0,1,96.66666667
2005021086,11,3533,0.0,33,29,4,0,4,87.87878788
2005021086,14,3598,0.0,22,19,3,1,3,86.36363636
2005021087,26,3600,0.0,31,27,3,2,4,87.09677419
2005021087,22,3600,0.0,20,20,5,2,0,100.0
2005021088,27,3600,0.0,29,27,12,0,2,93.10344828
2005021088,28,3532,0.0,27,23,6,3,4,85.18518519
2005021089,5,3600,0.0,29,29,3,2,0,100.0
2005021089,2,3600,0.0,29,25,7,1,4,86.20689655
2005021090,13,3543,0.0,30,27,15,0,3,90.0
2005021090,12,3600,0.0,23,21,1,0,2,91.30434783
2005021091,16,3689,0.0,41,39,5,1,2,95.12195122
2005021091,17,3654,0.0,34,31,4,1,3,91.17647059
2005021092,29,3600,0.0,30,28,10,0,2,93.33333333
2005021092,19,3510,0.0,20,16,3,2,4,80.0
2005021093,21,336,0.0,1,1,0,0,0,100.0
2005021093,21,3126,0.0,29,23,8,2,6,79.31034483
2005021093,20,3590,0.0,26,23,4,0,3,88.46153846
2005021094,30,3900,0.0,29,28,3,0,1,96.55172414
2005021094,23,3900,0.0,20,19,3,0,1,95.0
2005021095,25,3897,0.0,36,32,0,1,4,88.88888889
2005021095,24,3897,0.0,31,27,6,0,4,87.09677419
2005021096,1,3599,0.0,34,33,6,1,1,97.05882353
2005021096,4,3600,0.0,31,27,6,1,4,87.09677419
2005021097,7,2728,0.0,17,12,0,1,5,70.58823529
2005021097,7,868,0.0,6,4,2,0,2,66.66666667
2005021097,10,3600,0.0,24,24,3,0,0,100.0
2005021098,6,3517,0.0,35,33,10,2,2,94.28571429
2005021098,8,3600,0.0,32,32,8,3,0,100.0
2005021099,15,3600,0.0,46,46,12,0,0,100.0
2005021099,9,3533,0.0,32,31,6,1,1,96.875
2005021100,12,2086,0.0,18,13,4,1,5,72.22222222
2005021100,12,1514,0.0,8,8,0,0,0,100.0
2005021100,11,3600,0.0,35,33,5,1,2,94.28571429
2005021101,16,3452,2.0,23,19,8,0,4,82.60869565
2005021101,29,3598,0.0,29,27,8,3,2,93.10344828
2005021102,14,1315,0.0,9,9,2,0,0,100.0
2005021102,14,2135,0.0,26,22,1,1,4,84.61538462
2005021102,13,3600,0.0,44,42,15,0,2,95.45454545
2005021103,19,491,0.0,1,1,0,1,0,100.0
2005021103,19,3059,0.0,37,35,11,0,2,94.59459459
2005021103,18,3579,0.0,35,34,9,0,1,97.14285714
2005021104,20,3600,0.0,26,25,3,1,1,96.15384615
2005021104,22,3593,0.0,26,22,3,3,4,84.61538462
2005021105,25,3526,0.0,25,24,10,1,1,96.0
2005021105,26,3596,0.0,27,27,5,0,0,100.0
2005021106,27,3821,0.0,29,26,4,2,3,89.65517241
2005021106,28,3834,0.0,36,32,11,3,4,88.88888889
2005021107,4,3600,0.0,32,31,6,0,1,96.875
2005021107,2,3468,2.0,21,18,1,0,3,85.71428571
2005021108,17,3595,0.0,18,16,2,0,2,88.88888889
2005021108,30,3554,0.0,37,34,6,3,3,91.89189189
2005021109,1,3661,0.0,26,24,4,0,2,92.30769231
2005021109,5,3742,0.0,39,36,4,3,3,92.30769231
2005021110,23,1804,0.0,7,5,1,1,2,71.42857143
2005021110,23,1796,0.0,23,19,0,0,4,82.60869565
2005021110,24,3594,0.0,29,27,3,0,2,93.10344828
2005021111,15,3809,0.0,42,36,9,1,6,85.71428571
2005021111,12,3807,0.0,24,19,3,0,5,79.16666667
2005021112,7,3892,0.0,33,31,10,0,2,93.93939394
2005021112,10,3900,0.0,36,34,7,3,2,94.44444444
2005021113,11,542,0.0,0,0,0,0,0,
2005021113,11,2929,0.0,28,22,3,3,6,78.57142857
2005021113,9,3586,0.0,37,33,8,3,4,89.18918919
2005021114,13,3574,0.0,29,26,4,1,3,89.65517241
2005021114,14,3600,0.0,30,29,9,4,1,96.66666667
2005021115,29,3576,0.0,37,36,11,1,1,97.2972973
2005021115,18,3475,0.0,28,25,9,1,3,89.28571429
2005021116,28,3879,0.0,18,16,3,0,2,88.88888889
2005021116,25,3879,2.0,34,31,6,1,3,91.17647059
2005021117,16,3587,0.0,32,28,5,0,4,87.5
2005021117,21,3534,0.0,26,23,3,4,3,88.46153846
2005021118,17,3887,0.0,28,27,7,3,1,96.42857143
2005021118,20,3897,2.0,42,41,13,1,1,97.61904762
2005021119,27,2388,0.0,25,19,4,0,6,76.0
2005021119,27,1200,0.0,11,10,0,0,1,90.90909091
2005021119,22,3584,0.0,34,33,4,0,1,97.05882353
2005021120,23,3526,0.0,37,36,9,1,1,97.2972973
2005021120,26,3597,0.0,23,23,4,2,0,100.0
2005021121,4,3898,0.0,40,38,12,0,2,95.0
2005021121,3,3859,0.0,23,21,1,1,2,91.30434783
2005021122,6,3534,0.0,47,42,13,0,5,89.36170213
2005021122,8,3598,0.0,29,26,5,3,3,89.65517241
2005021123,19,3891,0.0,36,32,1,1,4,88.88888889
2005021123,30,3900,0.0,26,22,4,0,4,84.61538462
2005021124,26,3539,0.0,40,35,2,1,5,87.5
2005021124,24,3593,0.0,18,16,3,3,2,88.88888889
2005021125,9,3843,0.0,39,34,8,0,5,87.17948718
2005021125,7,3817,0.0,34,30,8,5,4,88.23529412
2005021126,12,3900,0.0,30,27,6,2,3,90.0
2005021126,15,3895,0.0,33,30,7,1,3,90.90909091
2005021127,11,3600,0.0,40,38,9,2,2,95.0
2005021127,13,3513,0.0,33,29,7,3,4,87.87878788
2005021128,2,3581,0.0,22,19,4,0,3,86.36363636
2005021128,10,3600,0.0,29,27,5,0,2,93.10344828
2005021129,5,3514,0.0,27,21,2,2,6,77.77777778
2005021129,1,3600,0.0,29,25,7,0,4,86.20689655
2005021130,18,3350,0.0,26,23,6,1,3,88.46153846
2005021130,18,188,0.0,2,1,0,0,1,50.0
2005021130,16,3600,0.0,29,26,6,0,3,89.65517241
2005021131,28,3598,0.0,26,25,1,0,1,96.15384615
2005021131,21,3569,0.0,32,30,13,0,2,93.75
2005021132,27,3592,0.0,37,32,11,2,5,86.48648649
2005021132,20,3594,0.0,26,24,4,0,2,92.30769231
2005021133,10,3835,0.0,27,25,6,1,2,92.59259259
2005021133,6,3897,0.0,33,31,3,0,2,93.93939394
2005021134,2,3600,8.0,26,23,0,0,3,88.46153846
2005021134,3,3600,2.0,22,21,1,1,1,95.45454545
2005021135,8,3600,0.0,47,44,9,0,3,93.61702128
2005021135,9,3520,0.0,32,27,8,2,5,84.375
2005021136,11,2799,0.0,13,12,0,1,1,92.30769231
2005021136,11,992,0.0,16,15,4,0,1,93.75
2005021136,14,3892,0.0,31,29,4,0,2,93.5483871
2005021137,18,3594,0.0,18,18,3,0,0,100.0
2005021137,19,3600,0.0,30,27,10,2,3,90.0
2005021138,22,3881,0.0,27,26,5,1,1,96.2962963
2005021138,30,3892,0.0,33,32,5,1,1,96.96969697
2005021139,25,3600,0.0,35,32,6,1,3,91.42857143
2005021139,24,3516,0.0,27,23,7,0,4,85.18518519
2005021140,28,3597,0.0,14,14,2,1,0,100.0
2005021140,26,3600,0.0,34,29,6,3,5,85.29411765
2005021141,12,3591,0.0,42,39,9,1,3,92.85714286
2005021141,15,3518,0.0,32,28,9,3,4,87.5
2005021142,5,3597,0.0,37,36,15,0,1,97.2972973
2005021142,13,1200,0.0,9,8,4,0,1,88.88888889
2005021142,13,2400,0.0,18,14,3,0,4,77.77777778
2005021143,29,3893,0.0,36,31,4,0,5,86.11111111
2005021143,17,3898,0.0,23,18,4,0,5,78.26086957
2005021144,4,3595,0.0,22,20,0,2,2,90.90909091
2005021144,7,3546,0.0,34,30,5,0,4,88.23529412
2005021145,22,3790,0.0,26,23,0,0,3,88.46153846
2005021145,16,3796,0.0,39,35,3,3,4,89.74358974
2005021146,30,3558,0.0,29,27,7,1,2,93.10344828
2005021146,20,3597,0.0,22,21,5,1,1,95.45454545
2005021147,3,3640,0.0,26,23,7,2,3,88.46153846
2005021147,6,3636,0.0,25,21,1,1,4,84.0
2005021148,19,3552,0.0,36,33,7,1,3,91.66666667
2005021148,21,3575,0.0,33,31,10,2,2,93.93939394
2005021149,24,3577,0.0,27,25,9,1,2,92.59259259
2005021149,26,3517,0.0,23,19,4,2,4,82.60869565
2005021150,1,3597,0.0,42,40,6,0,2,95.23809524
2005021150,8,3555,0.0,29,26,7,1,3,89.65517241
2005021151,7,3600,0.0,34,32,3,1,2,94.11764706
2005021151,9,1579,0.0,22,18,1,0,4,81.81818182
2005021151,9,2021,0.0,9,7,3,1,2,77.77777778
2005021152,15,3600,0.0,45,40,12,4,5,88.88888889
2005021152,2,3585,2.0,20,20,0,2,0,100.0
2005021153,10,3596,0.0,30,28,8,1,2,93.33333333
2005021153,4,3588,0.0,28,24,15,1,4,85.71428571
2005021154,12,3600,0.0,34,29,3,1,5,85.29411765
2005021154,11,3600,0.0,25,23,7,1,2,92.0
2005021155,17,3597,0.0,29,27,3,3,2,93.10344828
2005021155,29,3512,0.0,29,26,6,0,3,89.65517241
2005021156,5,3536,0.0,25,24,12,0,1,96.0
2005021156,14,3600,0.0,25,25,7,0,0,100.0
2005021157,16,3900,0.0,43,42,12,0,1,97.6744186
2005021157,18,3892,0.0,24,23,3,1,1,95.83333333
2005021158,20,3747,0.0,27,24,5,4,3,88.88888889
2005021158,23,3743,0.0,24,22,5,3,2,91.66666667
2005021159,25,3900,0.0,30,28,6,1,2,93.33333333
2005021159,27,3862,2.0,29,27,2,0,2,93.10344828
2005021160,14,3578,0.0,47,42,0,5,5,89.36170213
2005021160,13,3600,0.0,32,29,5,0,3,90.625
2005021161,22,3470,0.0,18,16,4,0,2,88.88888889
2005021161,19,3600,0.0,37,36,8,3,1,97.2972973
2005021162,3,3576,0.0,26,23,8,2,3,88.46153846
2005021162,1,3585,0.0,26,24,4,2,2,92.30769231
2005021163,25,3597,4.0,36,32,15,1,4,88.88888889
2005021163,28,3600,0.0,22,21,0,0,1,95.45454545
2005021164,30,3598,0.0,42,40,12,4,2,95.23809524
2005021164,21,3274,0.0,19,16,8,1,3,84.21052632
2005021164,21,317,0.0,3,1,0,0,2,33.33333333
2005021165,15,3810,0.0,38,37,10,1,1,97.36842105
2005021165,6,3810,0.0,27,25,1,1,2,92.59259259
2005021166,9,3514,0.0,25,22,1,2,3,88.0
2005021166,8,3600,0.0,37,35,7,1,2,94.59459459
2005021167,24,3600,0.0,41,39,11,1,2,95.12195122
2005021167,23,3460,2.0,18,14,2,0,4,77.77777778
2005021168,28,3575,0.0,25,23,7,0,2,92.0
2005021168,27,3530,0.0,26,23,8,0,3,88.46153846
2005021169,2,3594,0.0,38,36,6,1,2,94.73684211
2005021169,3,3548,0.0,30,27,5,2,3,90.0
2005021170,5,3497,0.0,27,23,2,4,4,85.18518519
2005021170,4,3600,0.0,26,23,8,0,3,88.46153846
2005021171,1,3628,0.0,40,37,1,3,3,92.5
2005021171,12,3593,0.0,28,24,4,0,4,85.71428571
2005021172,13,3884,0.0,53,47,15,2,6,88.67924528
2005021172,10,3881,0.0,26,21,4,2,5,80.76923077
2005021173,6,3591,0.0,44,40,9,1,4,90.90909091
2005021173,9,3616,0.0,21,18,1,3,3,85.71428571
2005021174,11,3600,0.0,34,32,6,0,2,94.11764706
2005021174,14,1812,0.0,14,9,0,0,5,64.28571429
2005021174,14,1788,0.0,10,9,2,0,1,90.0
2005021175,22,3490,0.0,27,25,7,1,2,92.59259259
2005021175,17,3587,0.0,29,29,9,4,0,100.0
2005021176,18,3600,0.0,27,27,4,0,0,100.0
2005021176,19,3579,0.0,28,27,7,1,1,96.42857143
2005021177,16,3585,0.0,21,20,3,4,1,95.23809524
2005021177,30,3600,0.0,27,27,5,0,0,100.0
2005021178,29,3489,0.0,26,23,8,1,3,88.46153846
2005021178,25,3576,0.0,17,15,3,1,2,88.23529412
2005021179,27,1733,0.0,26,20,0,0,6,76.92307692
2005021179,27,1812,0.0,8,8,0,0,0,100.0
2005021179,21,3557,0.0,25,21,0,0,4,84.0
2005021180,24,3600,0.0,25,22,4,0,3,88.0
2005021180,20,3586,0.0,32,32,10,0,0,100.0
2005021181,8,3532,0.0,34,31,4,0,3,91.17647059
2005021181,7,3600,0.0,28,27,10,0,1,96.42857143
2005021182,28,3634,0.0,24,20,2,1,4,83.33333333
2005021182,23,3625,0.0,27,22,2,1,5,81.48148148
2005021183,8,3600,0.0,28,25,3,1,3,89.28571429
2005021183,6,3530,0.0,26,22,4,0,4,84.61538462
2005021184,10,3832,0.0,26,23,2,1,3,88.46153846
2005021184,2,3832,0.0,31,27,5,2,4,87.09677419
2005021185,15,3555,0.0,27,23,5,0,4,85.18518519
2005021185,11,3600,0.0,25,22,4,2,3,88.0
2005021186,19,3600,0.0,31,27,4,2,4,87.09677419
2005021186,29,3581,0.0,27,26,1,4,1,96.2962963
2005021187,13,3810,0.0,50,46,17,1,4,92.0
2005021187,9,3741,0.0,35,30,4,1,5,85.71428571
2005021188,4,3598,0.0,36,32,10,0,4,88.88888889
2005021188,1,3600,0.0,34,33,5,0,1,97.05882353
2005021189,3,3565,0.0,35,30,7,0,5,85.71428571
2005021189,5,3590,0.0,24,21,1,0,3,87.5
2005021190,30,3600,0.0,30,26,6,2,4,86.66666667
2005021190,18,3596,0.0,29,27,6,1,2,93.10344828
2005021191,17,3579,0.0,31,28,3,2,3,90.32258065
2005021191,16,1606,0.0,17,12,3,1,5,70.58823529
2005021191,16,1985,0.0,23,21,11,0,2,91.30434783
2005021192,21,3554,0.0,24,23,4,3,1,95.83333333
2005021192,20,3600,0.0,23,23,4,0,0,100.0
2005021193,24,3569,0.0,37,35,6,3,2,94.59459459
2005021193,22,3600,0.0,24,23,3,2,1,95.83333333
2005021194,26,1194,0.0,18,18,5,0,0,100.0
2005021194,26,2400,0.0,18,15,6,1,3,83.33333333
2005021194,27,3573,0.0,32,32,16,0,0,100.0
2005021195,23,3529,0.0,27,23,5,1,4,85.18518519
2005021195,28,3598,0.0,20,17,2,1,3,85.0
2005021196,14,3897,2.0,21,17,1,0,4,80.95238095
2005021196,12,3888,0.0,35,31,4,3,4,88.57142857
2005021197,3,3587,0.0,29,25,5,3,4,86.20689655
2005021197,4,3600,0.0,26,25,8,0,1,96.15384615
2005021198,17,3579,0.0,39,37,13,0,2,94.87179487
2005021198,19,3600,0.0,38,35,10,0,3,92.10526316
2005021199,30,3866,0.0,24,20,2,1,4,83.33333333
2005021199,25,3866,0.0,36,33,8,3,3,91.66666667
2005021200,24,1145,0.0,3,3,0,0,0,100.0
2005021200,24,2399,0.0,18,13,6,0,5,72.22222222
2005021200,28,3593,0.0,34,31,7,1,3,91.17647059
2005021201,9,3600,0.0,31,26,7,1,5,83.87096774
2005021201,10,3600,0.0,31,30,7,1,1,96.77419355
2005021202,7,3600,0.0,45,43,9,2,2,95.55555556
2005021202,8,3578,0.0,29,26,4,1,3,89.65517241
2005021203,5,3875,0.0,32,28,7,1,4,87.5
2005021203,2,3886,0.0,24,20,7,1,4,83.33333333
2005021204,6,3526,0.0,35,31,6,2,4,88.57142857
2005021204,11,3600,0.0,26,23,3,1,3,88.46153846
2005021205,16,3600,0.0,29,24,2,0,5,82.75862069
2005021205,29,3599,0.0,36,34,2,3,2,94.44444444
2005021206,12,3889,0.0,32,29,9,3,3,90.625
2005021206,14,3889,0.0,27,25,7,2,2,92.59259259
2005021207,15,3895,0.0,48,47,9,1,1,97.91666667
2005021207,13,3900,0.0,49,48,13,0,1,97.95918367
2005021208,27,3588,0.0,30,26,9,4,4,86.66666667
2005021208,18,3563,0.0,24,23,6,1,1,95.83333333
2005021209,21,3840,0.0,30,26,9,1,4,86.66666667
2005021209,23,3842,0.0,34,31,9,4,3,91.17647059
2005021210,20,3900,0.0,25,24,5,2,1,96.0
2005021210,26,3898,0.0,40,39,7,6,1,97.5
2005021211,4,2256,0.0,8,6,1,1,2,75.0
2005021211,4,1344,0.0,12,9,0,0,3,75.0
2005021211,1,3600,0.0,26,25,1,0,1,96.15384615
2005021212,10,3595,0.0,40,34,8,0,6,85.0
2005021212,7,3577,0.0,31,31,13,1,0,100.0
2005021213,29,3554,0.0,41,37,15,1,4,90.24390244
2005021213,16,3587,0.0,16,13,1,2,3,81.25
2005021214,27,3600,0.0,40,40,7,2,0,100.0
2005021214,19,3550,0.0,36,33,6,1,3,91.66666667
2005021215,11,945,0.0,5,4,1,0,1,80.0
2005021215,11,2462,0.0,23,18,9,1,5,78.26086957
2005021215,15,3600,0.0,42,38,13,2,4,90.47619048
2005021216,2,3592,0.0,29,23,2,3,6,79.31034483
2005021216,5,3587,0.0,27,26,7,1,1,96.2962963
2005021217,25,3562,0.0,32,29,5,0,3,90.625
2005021217,17,3600,0.0,30,28,2,0,2,93.33333333
2005021218,21,3561,0.0,35,32,5,1,3,91.42857143
2005021218,22,3600,0.0,18,16,1,0,2,88.88888889
2005021219,20,3592,0.0,34,30,13,1,4,88.23529412
2005021219,24,3526,0.0,32,29,9,1,3,90.625
2005021220,26,3600,0.0,31,31,8,1,0,100.0
2005021220,28,3589,0.0,29,25,4,1,4,86.20689655
2005021221,4,3600,0.0,32,31,5,3,1,96.875
2005021221,2,3535,0.0,24,22,2,0,2,91.66666667
2005021222,9,3581,0.0,28,27,2,2,1,96.42857143
2005021222,3,3600,0.0,32,27,3,0,5,84.375
2005021223,7,3599,0.0,33,33,5,4,0,100.0
2005021223,12,3600,0.0,34,30,7,0,4,88.23529412
2005021224,11,3693,0.0,30,28,6,0,2,93.33333333
2005021224,13,3654,0.0,40,39,7,4,1,97.5
2005021225,25,3635,0.0,31,26,5,2,5,83.87096774
2005021225,29,3608,0.0,36,32,8,3,4,88.88888889
2005021226,5,1827,0.0,11,11,1,0,0,100.0
2005021226,5,1693,0.0,21,16,6,1,5,76.19047619
2005021226,10,3600,0.0,33,30,8,1,3,90.90909091
2005021227,1,3600,0.0,32,29,9,0,3,90.625
2005021227,8,3520,0.0,40,36,5,3,4,90.0
2005021228,15,3600,0.0,43,42,13,2,1,97.6744186
2005021228,14,1963,0.0,12,11,3,1,1,91.66666667
2005021228,14,1637,0.0,16,13,1,1,3,81.25
2005021229,17,3589,0.0,30,24,6,2,6,80.0
2005021229,18,3595,0.0,33,30,5,0,3,90.90909091
2005021230,19,3800,0.0,52,49,0,2,3,94.23076923
2005021230,16,3800,0.0,32,30,1,0,2,93.75
2006020001,7,3900,0.0,34,32,6,3,2,94.11764706
2006020001,12,3895,2.0,32,30,7,3,2,93.75
2006020002,9,3600,0.0,34,33,5,1,1,97.05882353
2006020002,10,3525,0.0,35,32,12,2,3,91.42857143
2006020003,25,3727,0.0,38,36,20,1,2,94.73684211
2006020003,21,3719,0.0,33,30,5,1,3,90.90909091
2006020004,10,3600,0.0,34,34,12,0,0,100.0
2006020004,9,2397,0.0,24,19,4,1,5,79.16666667
2006020004,9,1200,0.0,16,15,3,0,1,93.75
2006020005,15,3560,0.0,35,31,3,0,4,88.57142857
2006020005,3,3587,0.0,27,25,9,0,2,92.59259259
2006020006,14,3888,0.0,11,9,3,1,2,81.81818182
2006020006,11,3894,0.0,26,24,8,4,2,92.30769231
2006020007,4,3596,0.0,21,17,4,1,4,80.95238095
2006020007,5,3594,0.0,40,40,14,2,0,100.0
2006020008,23,3600,0.0,28,27,7,1,1,96.42857143
2006020008,17,3535,0.0,17,14,3,0,3,82.35294118
2006020009,16,3600,0.0,40,34,15,0,6,85.0
2006020009,18,3509,0.0,32,25,2,1,7,78.125
2006020010,21,3653,0.0,33,30,5,3,3,90.90909091
2006020010,30,3663,0.0,31,29,9,0,2,93.5483871
2006020011,20,3539,0.0,22,19,1,0,3,86.36363636
2006020011,22,3584,0.0,32,31,15,0,1,96.875
2006020012,2,2400,4.0,32,26,13,1,6,81.25
2006020012,2,1169,0.0,12,12,5,0,0,100.0
2006020012,27,3600,0.0,29,26,11,4,3,89.65517241
2006020013,19,3672,0.0,35,30,9,1,5,85.71428571
2006020013,28,3723,0.0,35,31,8,3,4,88.57142857
2006020014,1,3597,0.0,29,29,6,1,0,100.0
2006020014,12,3600,0.0,30,26,4,0,4,86.66666667
2006020015,23,3626,0.0,20,18,3,1,2,90.0
2006020015,29,3626,0.0,44,41,9,0,3,93.18181818
2006020016,6,2892,0.0,34,27,2,3,7,79.41176471
2006020016,6,699,0.0,4,3,0,0,1,75.0
2006020016,13,3595,0.0,37,34,11,1,3,91.89189189
2006020017,8,3892,0.0,37,33,10,1,4,89.18918919
2006020017,7,3852,0.0,27,23,5,0,4,85.18518519
2006020018,26,3559,0.0,32,28,7,2,4,87.5
2006020018,24,3600,0.0,44,41,11,1,3,93.18181818
2006020019,8,3898,0.0,38,36,14,2,2,94.73684211
2006020019,10,3895,0.0,33,31,8,0,2,93.93939394
2006020020,7,3594,0.0,37,34,11,2,3,91.89189189
2006020020,9,3527,0.0,24,20,6,3,4,83.33333333
2006020021,3,3900,0.0,39,35,15,0,4,89.74358974
2006020021,4,3890,0.0,30,26,5,1,4,86.66666667
2006020022,12,3600,0.0,35,30,7,2,5,85.71428571
2006020022,15,3589,0.0,27,25,1,2,2,92.59259259
2006020023,13,1590,0.0,9,5,0,1,4,55.55555556
2006020023,13,1995,0.0,25,23,10,0,2,92.0
2006020023,11,3589,0.0,22,22,4,1,0,100.0
2006020024,17,3600,0.0,13,13,0,0,0,100.0
2006020024,5,3541,0.0,26,24,3,2,2,92.30769231
2006020025,6,3600,0.0,31,29,8,3,2,93.5483871
2006020025,14,3485,0.0,25,22,5,1,3,88.0
2006020026,18,3524,2.0,34,28,6,1,6,82.35294118
2006020026,30,2393,0.0,19,17,4,0,2,89.47368421
2006020026,30,1200,0.0,11,8,4,1,3,72.72727273
2006020027,1,3588,0.0,31,28,11,2,3,90.32258065
2006020027,25,3583,2.0,20,19,6,2,1,95.0
2006020028,29,3575,0.0,22,18,4,2,4,81.81818182
2006020028,16,3497,0.0,24,19,9,3,5,79.16666667
2006020029,22,3521,0.0,28,26,5,2,2,92.85714286
2006020029,20,3584,0.0,22,21,2,2,1,95.45454545
2006020030,24,3590,0.0,35,34,6,1,1,97.14285714
2006020030,27,3537,0.0,25,23,4,1,2,92.0
2006020031,19,3595,0.0,30,26,9,0,4,86.66666667
2006020031,26,3598,0.0,36,35,14,1,1,97.22222222
2006020032,2,3530,0.0,27,25,7,1,2,92.59259259
2006020032,28,3597,0.0,26,26,10,0,0,100.0
2006020033,23,3501,0.0,35,32,10,0,3,91.42857143
2006020033,21,3571,0.0,28,26,6,2,2,92.85714286
2006020034,19,3577,0.0,34,32,5,0,2,94.11764706
2006020034,24,3600,0.0,34,34,6,0,0,100.0
2006020035,27,3596,0.0,29,24,12,1,5,82.75862069
2006020035,29,3600,0.0,24,23,13,3,1,95.83333333
2006020036,13,3900,0.0,48,47,15,0,1,97.91666667
2006020036,10,3900,0.0,25,24,5,2,1,96.0
2006020037,11,3600,0.0,34,34,6,0,0,100.0
2006020037,14,3507,0.0,19,18,1,2,1,94.73684211
2006020038,28,3593,0.0,30,29,15,0,1,96.66666667
2006020038,20,3592,0.0,26,22,7,5,4,84.61538462
2006020039,4,3600,0.0,27,25,11,3,2,92.59259259
2006020039,3,3491,0.0,24,20,4,2,4,83.33333333
2006020040,23,3881,0.0,36,35,3,4,1,97.22222222
2006020040,30,3900,0.0,31,30,4,0,1,96.77419355
2006020041,2,3594,0.0,40,36,17,0,4,90.0
2006020041,26,3593,0.0,25,23,7,2,2,92.0
2006020042,8,3600,0.0,28,27,10,2,1,96.42857143
2006020042,4,3494,0.0,22,20,3,3,2,90.90909091
2006020043,6,3594,0.0,28,24,4,2,4,85.71428571
2006020043,11,3600,0.0,23,22,6,4,1,95.65217391
2006020044,12,3600,0.0,31,25,7,0,6,80.64516129
2006020044,13,3600,0.0,35,32,10,0,3,91.42857143
2006020045,27,1200,0.0,11,9,1,0,2,81.81818182
2006020045,27,2400,0.0,29,22,3,6,7,75.86206897
2006020045,17,3600,2.0,21,19,2,1,2,90.47619048
2006020046,2,3900,0.0,50,46,10,1,4,92.0
2006020046,24,3900,0.0,24,20,3,1,4,83.33333333
2006020047,5,3599,2.0,42,37,13,2,5,88.0952381
2006020047,3,3598,0.0,22,16,8,0,6,72.72727273
2006020048,20,3600,0.0,33,33,8,1,0,100.0
2006020048,9,3515,0.0,28,27,2,0,1,96.42857143
2006020049,10,3900,0.0,30,24,0,0,6,80.0
2006020049,1,3869,0.0,30,24,3,0,6,80.0
2006020050,6,3900,0.0,35,33,3,2,2,94.28571429
2006020050,19,3900,0.0,18,16,1,0,2,88.88888889
2006020051,15,3900,0.0,38,36,17,0,2,94.73684211
2006020051,30,3893,0.0,26,24,10,0,2,92.30769231
2006020052,18,3540,0.0,30,28,4,1,2,93.33333333
2006020052,16,3595,0.0,38,37,6,0,1,97.36842105
2006020053,28,3515,0.0,32,26,3,1,6,81.25
2006020053,22,3585,0.0,23,19,7,0,4,82.60869565
2006020054,25,3600,0.0,33,32,13,0,1,96.96969697
2006020054,26,3600,0.0,29,25,10,1,4,86.20689655
2006020055,12,3600,0.0,34,31,9,3,3,91.17647059
2006020055,11,2,0.0,0,0,0,0,0,
2006020055,11,3598,0.0,33,29,6,1,4,87.87878788
2006020056,14,3572,2.0,27,24,1,3,3,88.88888889
2006020056,13,3599,0.0,23,21,3,0,2,91.30434783
2006020057,7,3900,0.0,43,41,15,1,2,95.34883721
2006020057,17,3900,2.0,17,15,3,2,2,88.23529412
2006020058,28,3600,0.0,26,22,6,1,4,84.61538462
2006020058,23,3515,0.0,37,31,13,1,6,83.78378378
2006020059,3,3596,0.0,32,25,6,2,7,78.125
2006020059,7,3600,0.0,23,19,2,2,4,82.60869565
2006020060,20,3646,0.0,43,38,8,1,5,88.37209302
2006020060,10,3650,0.0,30,26,4,2,4,86.66666667
2006020061,9,3889,0.0,25,23,1,2,2,92.0
2006020061,8,3900,0.0,27,25,5,1,2,92.59259259
2006020062,6,3598,0.0,39,35,7,2,4,89.74358974
2006020062,2,3578,0.0,32,31,8,3,1,96.875
2006020063,11,3782,0.0,38,35,12,3,3,92.10526316
2006020063,15,3782,0.0,31,27,6,1,4,87.09677419
2006020064,4,3553,0.0,32,29,6,1,3,90.625
2006020064,1,3600,0.0,27,25,8,1,2,92.59259259
2006020065,12,3600,0.0,26,25,9,0,1,96.15384615
2006020065,5,1820,0.0,20,17,1,0,3,85.0
2006020065,5,1777,0.0,14,12,2,1,2,85.71428571
2006020066,13,3600,0.0,36,32,9,1,4,88.88888889
2006020066,14,3590,0.0,24,23,5,1,1,95.83333333
2006020067,16,3518,0.0,28,24,2,1,4,85.71428571
2006020067,19,3593,0.0,22,19,6,1,3,86.36363636
2006020068,27,3600,0.0,25,21,2,2,4,84.0
2006020068,18,3600,0.0,30,29,5,1,1,96.66666667
2006020069,29,2043,0.0,18,14,2,0,4,77.77777778
2006020069,29,1557,0.0,12,11,2,0,1,91.66666667
2006020069,30,3600,2.0,24,24,3,7,0,100.0
2006020070,22,3600,0.0,42,39,6,3,3,92.85714286
2006020070,21,3500,0.0,25,21,5,2,4,84.0
2006020071,25,3600,0.0,25,24,6,1,1,96.0
2006020071,26,3599,0.0,28,24,8,0,4,85.71428571
2006020072,25,3888,0.0,39,36,7,5,3,92.30769231
2006020072,24,1720,0.0,14,12,5,0,2,85.71428571
2006020072,24,2123,0.0,21,20,10,1,1,95.23809524
2006020073,1,3600,0.0,29,25,2,3,4,86.20689655
2006020073,3,3600,0.0,36,34,10,0,2,94.44444444
2006020074,12,3600,0.0,35,34,6,2,1,97.14285714
2006020074,14,2400,0.0,19,15,4,0,4,78.94736842
2006020074,14,1200,0.0,4,3,1,0,1,75.0
2006020075,18,3900,0.0,27,26,2,1,1,96.2962963
2006020075,2,3900,0.0,33,32,7,0,1,96.96969697
2006020076,16,3600,0.0,22,19,4,2,3,86.36363636
2006020076,21,3552,0.0,30,26,9,0,4,86.66666667
2006020077,22,3530,0.0,37,35,13,3,2,94.59459459
2006020077,23,3584,0.0,18,17,4,1,1,94.44444444
2006020078,17,3600,0.0,23,22,6,1,1,95.65217391
2006020078,26,3512,0.0,27,24,6,1,3,88.88888889
2006020079,4,3597,0.0,37,28,2,2,9,75.67567568
2006020079,7,3600,0.0,38,37,4,0,1,97.36842105
2006020080,20,3535,0.0,36,31,8,2,5,86.11111111
2006020080,8,3586,0.0,24,20,5,3,4,83.33333333
2006020081,27,3600,2.0,27,25,6,1,2,92.59259259
2006020081,19,3507,0.0,32,28,4,1,4,87.5
2006020082,23,3503,0.0,20,18,6,0,2,90.0
2006020082,22,3596,0.0,22,21,6,3,1,95.45454545
2006020083,25,3520,0.0,23,21,4,1,2,91.30434783
2006020083,28,3593,0.0,32,32,6,1,0,100.0
2006020084,18,3596,0.0,38,38,13,3,0,100.0
2006020084,3,3476,0.0,27,24,10,0,3,88.88888889
2006020085,13,2844,0.0,14,13,0,0,1,92.85714286
2006020085,13,756,0.0,12,8,1,0,4,66.66666667
2006020085,15,3600,0.0,36,34,6,0,2,94.44444444
2006020086,21,3580,0.0,28,27,5,0,1,96.42857143
2006020086,10,3600,0.0,26,22,5,0,4,84.61538462
2006020087,1,3591,0.0,38,37,1,4,1,97.36842105
2006020087,5,3551,0.0,34,32,3,0,2,94.11764706
2006020088,8,3542,0.0,23,21,7,1,2,91.30434783
2006020088,16,3600,0.0,29,28,10,0,1,96.55172414
2006020089,17,3600,0.0,31,27,13,2,4,87.09677419
2006020089,24,3560,0.0,22,21,1,4,1,95.45454545
2006020090,30,3625,0.0,35,34,5,1,1,97.14285714
2006020090,26,3625,0.0,27,25,6,1,2,92.59259259
2006020091,20,3572,0.0,30,27,8,0,3,90.0
2006020091,6,3600,0.0,28,26,5,4,2,92.85714286
2006020092,15,3900,0.0,43,40,9,2,3,93.02325581
2006020092,11,3861,0.0,30,27,5,2,3,90.0
2006020093,21,3600,0.0,27,26,4,1,1,96.2962963
2006020093,9,3528,0.0,36,34,11,0,2,94.44444444
2006020094,18,3891,0.0,33,30,9,4,3,90.90909091
2006020094,1,3847,0.0,18,15,1,2,3,83.33333333
2006020095,5,3811,0.0,37,34,11,3,3,91.89189189
2006020095,2,3806,0.0,36,32,11,2,4,88.88888889
2006020096,4,3577,0.0,36,32,6,0,4,88.88888889
2006020096,14,3600,0.0,35,34,6,1,1,97.14285714
2006020097,26,3550,0.0,40,40,6,5,0,100.0
2006020097,27,1200,0.0,13,10,4,0,3,76.92307692
2006020097,27,2390,0.0,18,17,11,0,1,94.44444444
2006020098,17,872,0.0,7,4,0,1,3,57.14285714
2006020098,17,2728,0.0,15,13,7,0,2,86.66666667
2006020098,28,3600,0.0,22,21,4,1,1,95.45454545
2006020099,10,3600,0.0,25,23,6,1,2,92.0
2006020099,29,3557,0.0,27,23,6,3,4,85.18518519
2006020100,4,3539,0.0,26,23,8,3,3,88.46153846
2006020100,13,3600,0.0,27,25,6,1,2,92.59259259
2006020101,12,3592,0.0,29,24,8,3,5,82.75862069
2006020101,7,3600,0.0,20,16,2,2,4,80.0
2006020102,23,3823,0.0,19,17,8,1,2,89.47368421
2006020102,19,3893,0.0,39,36,11,2,3,92.30769231
2006020103,16,3562,0.0,38,33,7,0,5,86.84210526
2006020103,25,3587,0.0,22,18,5,1,4,81.81818182
2006020104,30,3554,0.0,29,27,4,1,2,93.10344828
2006020104,24,3600,0.0,28,27,5,0,1,96.42857143
2006020105,7,3600,0.0,26,24,2,1,2,92.30769231
2006020105,6,2220,0.0,13,11,6,0,2,84.61538462
2006020105,6,1376,0.0,17,13,0,0,4,76.47058824
2006020106,3,3900,0.0,38,34,6,0,4,89.47368421
2006020106,10,3887,0.0,28,24,0,2,4,85.71428571
2006020107,21,3596,2.0,36,28,8,0,8,77.77777778
2006020107,8,3600,2.0,38,33,7,0,5,86.84210526
2006020108,1,2037,0.0,26,20,3,0,6,76.92307692
2006020108,1,1563,0.0,12,10,4,0,2,83.33333333
2006020108,9,3600,0.0,35,34,3,0,1,97.14285714
2006020109,12,3617,0.0,25,21,2,1,4,84.0
2006020109,2,3623,0.0,40,37,2,3,3,92.5
2006020110,14,3600,0.0,33,29,2,0,4,87.87878788
2006020110,15,3520,0.0,35,29,13,0,6,82.85714286
2006020111,13,3575,0.0,23,20,6,0,3,86.95652174
2006020111,11,3584,0.0,20,18,3,2,2,90.0
2006020112,29,3425,0.0,34,29,15,1,5,85.29411765
2006020112,5,3598,0.0,39,36,20,2,3,92.30769231
2006020113,23,3752,0.0,40,37,12,1,3,92.5
2006020113,18,3732,0.0,46,42,6,2,4,91.30434783
2006020114,19,3600,0.0,27,24,3,0,3,88.88888889
2006020114,16,3555,0.0,29,25,1,3,4,86.20689655
2006020115,17,3508,0.0,24,21,2,1,3,87.5
2006020115,22,3585,0.0,27,26,5,3,1,96.2962963
2006020116,25,3600,0.0,22,22,5,3,0,100.0
2006020116,27,3592,2.0,32,28,4,1,4,87.5
2006020117,30,3586,0.0,32,31,8,1,1,96.875
2006020117,28,3593,0.0,18,14,2,0,4,77.77777778
2006020118,24,3900,0.0,31,29,2,0,2,93.5483871
2006020118,26,3900,0.0,21,19,0,0,2,90.47619048
2006020119,28,3586,0.0,23,23,4,1,0,100.0
2006020119,29,3598,0.0,32,29,6,2,3,90.625
2006020120,7,3592,0.0,27,26,3,2,1,96.2962963
2006020120,8,3474,0.0,25,22,8,0,3,88.0
2006020121,11,3600,0.0,28,25,10,0,3,89.28571429
2006020121,13,1200,0.0,8,7,2,0,1,87.5
2006020121,13,2395,2.0,19,14,4,0,5,73.68421053
2006020122,26,2400,0.0,32,26,12,1,6,81.25
2006020122,26,1200,0.0,5,5,0,0,0,100.0
2006020122,21,3594,0.0,28,27,3,3,1,96.42857143
2006020123,23,3513,0.0,26,24,12,1,2,92.30769231
2006020123,25,3571,0.0,34,33,6,3,1,97.05882353
2006020124,27,3600,2.0,39,34,13,1,5,87.17948718
2006020124,22,3600,0.0,30,28,3,7,2,93.33333333
2006020125,1,3549,0.0,25,21,3,0,4,84.0
2006020125,5,3600,0.0,22,20,6,0,2,90.90909091
2006020126,9,3600,0.0,39,37,9,2,2,94.87179487
2006020126,10,2400,0.0,21,16,1,0,5,76.19047619
2006020126,10,1200,0.0,11,10,0,3,1,90.90909091
2006020127,27,1636,0.0,9,6,3,1,3,66.66666667
2006020127,27,1961,0.0,21,18,5,1,3,85.71428571
2006020127,20,3590,0.0,27,26,8,2,1,96.2962963
2006020128,13,3600,0.0,37,35,9,1,2,94.59459459
2006020128,3,3579,0.0,24,20,4,0,4,83.33333333
2006020129,11,3658,0.0,38,33,11,1,5,86.84210526
2006020129,12,3671,0.0,36,32,3,3,4,88.88888889
2006020130,28,3533,0.0,39,37,2,2,2,94.87179487
2006020130,17,3600,0.0,23,22,5,1,1,95.65217391
2006020131,26,3450,0.0,29,26,3,1,3,89.65517241
2006020131,30,3597,0.0,36,35,8,0,1,97.22222222
2006020132,23,3590,0.0,32,32,6,0,0,100.0
2006020132,16,3595,0.0,31,26,6,1,5,83.87096774
2006020133,15,3595,0.0,48,45,13,0,3,93.75
2006020133,21,3528,0.0,29,25,1,1,4,86.20689655
2006020134,22,3597,0.0,20,14,0,0,6,70.0
2006020134,24,3600,0.0,31,29,1,1,2,93.5483871
2006020135,8,3600,0.0,36,34,10,2,2,94.44444444
2006020135,6,3598,0.0,30,27,3,1,3,90.0
2006020136,11,3900,0.0,31,29,2,0,2,93.5483871
2006020136,11,0,0.0,0,0,0,0,0,
2006020136,4,3900,0.0,30,28,1,1,2,93.33333333
2006020137,10,3600,0.0,40,33,7,1,7,82.5
2006020137,9,3600,0.0,31,29,6,4,2,93.5483871
2006020138,13,3525,0.0,23,21,6,0,2,91.30434783
2006020138,1,3600,0.0,29,29,5,1,0,100.0
2006020139,7,3572,0.0,29,29,4,0,0,100.0
2006020139,2,3600,0.0,27,24,6,0,3,88.88888889
2006020140,12,2400,0.0,21,17,1,0,4,80.95238095
2006020140,12,1200,0.0,6,5,0,0,1,83.33333333
2006020140,14,3596,0.0,24,23,6,1,1,95.83333333
2006020141,28,3537,0.0,29,25,3,1,4,86.20689655
2006020141,18,3600,0.0,27,24,6,2,3,88.88888889
2006020142,22,1376,0.0,16,12,2,0,4,75.0
2006020142,22,2224,0.0,17,15,5,2,2,88.23529412
2006020142,27,3599,0.0,34,32,7,1,2,94.11764706
2006020143,26,3496,0.0,14,12,1,0,2,85.71428571
2006020143,29,3600,0.0,38,38,13,1,0,100.0
2006020144,24,3900,0.0,33,31,13,1,2,93.93939394
2006020144,30,3898,0.0,34,32,9,0,2,94.11764706
2006020145,17,3600,0.0,20,17,8,0,3,85.0
2006020145,25,3528,2.0,33,29,4,0,4,87.87878788
2006020146,15,3900,0.0,44,42,9,4,2,95.45454545
2006020146,23,3851,0.0,21,19,6,1,2,90.47619048
2006020147,9,3570,0.0,32,30,7,0,2,93.75
2006020147,6,3598,0.0,36,35,10,1,1,97.22222222
2006020148,11,3898,0.0,36,32,6,1,4,88.88888889
2006020148,7,3897,0.0,36,32,4,3,4,88.88888889
2006020149,10,3876,0.0,22,18,1,4,4,81.81818182
2006020149,8,3900,0.0,51,47,6,1,4,92.15686275
2006020150,13,3900,0.0,39,36,5,0,3,92.30769231
2006020150,2,3900,0.0,25,22,1,2,3,88.0
2006020151,5,3600,0.0,33,31,5,1,2,93.93939394
2006020151,4,1361,0.0,9,5,0,0,4,55.55555556
2006020151,4,2239,0.0,21,17,2,0,4,80.95238095
2006020152,14,1514,0.0,17,13,4,1,4,76.47058824
2006020152,14,2014,0.0,12,10,3,1,2,83.33333333
2006020152,12,3600,0.0,23,19,6,2,4,82.60869565
2006020153,29,3511,0.0,21,20,5,0,1,95.23809524
2006020153,1,3600,0.0,22,22,4,3,0,100.0
2006020154,17,3597,0.0,30,28,2,4,2,93.33333333
2006020154,19,3502,0.0,25,22,5,0,3,88.0
2006020155,15,3586,0.0,27,24,6,1,3,88.88888889
2006020155,22,3599,0.0,19,19,2,1,0,100.0
2006020156,26,3532,0.0,28,25,8,3,3,89.28571429
2006020156,25,3590,2.0,34,32,13,2,2,94.11764706
2006020157,24,3567,0.0,14,14,2,1,0,100.0
2006020157,16,3600,0.0,22,19,4,0,3,86.36363636
2006020158,18,3592,0.0,27,25,3,0,2,92.59259259
2006020158,20,3552,0.0,35,32,7,1,3,91.42857143
2006020159,3,3597,0.0,26,23,5,0,3,88.46153846
2006020159,27,3596,0.0,35,28,4,3,7,80.0
2006020160,28,3600,0.0,20,18,8,0,2,90.0
2006020160,14,3532,0.0,28,25,3,1,3,89.28571429
2006020161,30,3599,0.0,36,32,10,2,4,88.88888889
2006020161,21,3600,0.0,21,20,3,2,1,95.23809524
2006020162,16,3519,0.0,34,32,17,1,2,94.11764706
2006020162,4,3600,0.0,26,26,9,1,0,100.0
2006020163,11,3600,0.0,22,18,3,0,4,81.81818182
2006020163,10,3600,0.0,33,31,11,3,2,93.93939394
2006020164,24,3895,0.0,24,19,3,0,5,79.16666667
2006020164,19,3896,0.0,33,28,1,1,5,84.84848485
2006020165,15,3591,0.0,39,37,4,1,2,94.87179487
2006020165,20,3558,0.0,30,27,8,1,3,90.0
2006020166,3,3576,0.0,33,29,8,4,4,87.87878788
2006020166,26,3581,0.0,29,28,10,1,1,96.55172414
2006020167,16,3600,0.0,24,19,7,0,5,79.16666667
2006020167,2,3593,0.0,32,30,8,2,2,93.75
2006020168,9,3581,0.0,28,25,6,3,3,89.28571429
2006020168,8,3600,0.0,33,31,11,5,2,93.93939394
2006020169,28,3600,0.0,25,24,2,0,1,96.0
2006020169,13,3569,0.0,28,26,6,1,2,92.85714286
2006020170,18,3600,0.0,24,22,3,1,2,91.66666667
2006020170,23,3542,0.0,24,21,4,2,3,87.5
2006020171,12,3593,0.0,42,40,17,4,2,95.23809524
2006020171,11,1479,0.0,4,4,1,0,0,100.0
2006020171,11,2109,0.0,13,9,0,0,4,69.23076923
2006020172,21,3600,0.0,44,41,21,2,3,93.18181818
2006020172,29,3408,0.0,22,17,3,2,5,77.27272727
2006020173,10,3593,0.0,25,23,1,1,2,92.0
2006020173,14,3589,0.0,28,25,4,2,3,89.28571429
2006020174,20,3570,0.0,34,31,8,3,3,91.17647059
2006020174,17,3594,0.0,15,13,0,2,2,86.66666667
2006020175,19,3600,0.0,31,27,5,0,4,87.09677419
2006020175,25,3590,0.0,24,23,3,2,1,95.83333333
2006020176,18,3584,0.0,25,22,5,0,3,88.0
2006020176,22,3561,0.0,31,27,1,0,4,87.09677419
2006020177,3,3780,0.0,33,30,9,1,3,90.90909091
2006020177,24,3763,0.0,34,30,16,1,4,88.23529412
2006020178,5,3765,0.0,27,24,0,1,3,88.88888889
2006020178,26,3765,0.0,23,19,3,0,4,82.60869565
2006020179,7,3897,0.0,34,30,5,0,4,88.23529412
2006020179,6,3900,0.0,33,29,5,0,4,87.87878788
2006020180,14,3600,2.0,32,30,6,3,2,93.75
2006020180,4,3542,0.0,27,24,1,0,3,88.88888889
2006020181,8,3582,0.0,31,31,12,0,0,100.0
2006020181,12,3592,0.0,27,23,1,1,4,85.18518519
2006020182,2,3598,0.0,16,14,3,1,2,87.5
2006020182,1,3600,0.0,27,22,5,2,5,81.48148148
2006020183,10,3576,0.0,42,39,8,0,3,92.85714286
2006020183,13,3600,0.0,25,23,2,0,2,92.0
2006020184,21,3588,0.0,29,25,4,0,4,86.20689655
2006020184,19,3600,0.0,45,44,11,1,1,97.77777778
2006020185,23,3508,0.0,24,19,4,3,5,79.16666667
2006020185,30,2400,0.0,19,19,7,0,0,100.0
2006020185,30,1200,0.0,11,9,1,0,2,81.81818182
2006020186,17,3572,0.0,22,21,2,0,1,95.45454545
2006020186,16,3553,0.0,29,27,5,2,2,93.10344828
2006020187,3,3600,0.0,30,29,6,2,1,96.66666667
2006020187,28,3506,0.0,18,16,3,0,2,88.88888889
2006020188,11,3600,0.0,27,24,4,2,3,88.88888889
2006020188,15,3538,0.0,34,30,7,0,4,88.23529412
2006020189,20,3888,0.0,37,33,10,0,4,89.18918919
2006020189,29,3894,0.0,32,28,5,1,4,87.5
2006020190,25,3599,0.0,26,24,4,0,2,92.30769231
2006020190,22,3509,0.0,26,23,2,0,3,88.46153846
2006020191,27,2400,0.0,21,16,2,1,5,76.19047619
2006020191,27,1200,0.0,14,13,4,1,1,92.85714286
2006020191,24,3599,0.0,27,25,5,0,2,92.59259259
2006020192,14,3617,0.0,33,27,7,3,6,81.81818182
2006020192,6,1179,0.0,7,7,2,0,0,100.0
2006020192,6,2400,0.0,21,16,5,1,5,76.19047619
2006020193,10,3600,0.0,30,29,8,2,1,96.66666667
2006020193,7,3591,0.0,33,29,8,1,4,87.87878788
2006020194,1,3600,0.0,34,33,6,2,1,97.05882353
2006020194,8,3550,0.0,29,27,3,0,2,93.10344828
2006020195,12,3600,0.0,26,24,9,3,2,92.30769231
2006020195,9,3522,0.0,40,37,7,0,3,92.5
2006020196,11,3591,0.0,24,23,0,5,1,95.83333333
2006020196,2,3595,0.0,19,15,6,0,4,78.94736842
2006020197,15,3600,0.0,36,33,6,1,3,91.66666667
2006020197,4,2304,0.0,11,10,6,1,1,90.90909091
2006020197,4,1200,0.0,8,4,1,0,4,50.0
2006020198,29,2400,0.0,27,23,4,1,4,85.18518519
2006020198,29,1118,0.0,10,10,6,0,0,100.0
2006020198,17,3600,0.0,17,16,8,2,1,94.11764706
2006020199,20,3595,0.0,30,28,10,1,2,93.33333333
2006020199,19,3528,0.0,23,20,3,2,3,86.95652174
2006020200,18,3587,0.0,28,25,4,1,3,89.28571429
2006020200,30,3552,2.0,21,17,4,0,4,80.95238095
2006020201,23,3523,0.0,20,17,3,0,3,85.0
2006020201,21,3592,0.0,38,36,6,1,2,94.73684211
2006020202,26,1991,0.0,7,6,2,0,1,85.71428571
2006020202,26,1533,0.0,17,12,1,0,5,70.58823529
2006020202,27,413,0.0,3,1,0,0,2,33.33333333
2006020202,27,3187,0.0,40,38,4,2,2,95.0
2006020203,5,3533,0.0,34,31,5,2,3,91.17647059
2006020203,28,3600,0.0,27,25,0,2,2,92.59259259
2006020204,7,3837,0.0,29,26,8,0,3,89.65517241
2006020204,3,3827,0.0,28,24,1,0,4,85.71428571
2006020205,9,3693,0.0,26,22,5,0,4,84.61538462
2006020205,15,2937,0.0,21,21,2,0,0,100.0
2006020205,15,711,0.0,5,2,0,0,3,40.0
2006020206,6,3600,0.0,39,34,10,1,5,87.17948718
2006020206,11,3576,0.0,27,24,3,0,3,88.88888889
2006020207,4,3555,0.0,31,28,15,1,3,90.32258065
2006020207,10,3598,0.0,41,40,15,2,1,97.56097561
2006020208,14,3586,0.0,26,25,2,0,1,96.15384615
2006020208,2,3600,0.0,27,22,3,1,5,81.48148148
2006020209,25,3567,0.0,26,24,13,2,2,92.30769231
2006020209,23,3600,0.0,20,19,3,0,1,95.0
2006020210,5,3644,0.0,40,37,11,1,3,92.5
2006020210,24,3637,0.0,17,15,0,0,2,88.23529412
2006020211,12,3900,0.0,20,18,2,0,2,90.0
2006020211,1,3900,0.0,28,26,2,1,2,92.85714286
2006020212,22,3889,0.0,36,34,11,0,2,94.44444444
2006020212,8,3896,0.0,28,26,2,0,2,92.85714286
2006020213,26,3600,0.0,34,29,6,1,5,85.29411765
2006020213,21,2400,0.0,22,17,5,0,5,77.27272727
2006020213,21,1109,0.0,9,8,4,0,1,88.88888889
2006020214,25,3572,0.0,17,15,2,0,2,88.23529412
2006020214,20,3596,0.0,26,25,10,0,1,96.15384615
2006020215,30,3565,0.0,30,27,9,0,3,90.0
2006020215,28,3595,0.0,23,22,1,1,1,95.65217391
2006020216,9,3557,0.0,31,26,4,1,5,83.87096774
2006020216,11,1779,0.0,19,15,5,0,4,78.94736842
2006020216,11,1821,2.0,19,19,2,0,0,100.0
2006020217,14,3761,0.0,20,17,2,0,3,85.0
2006020217,5,3748,0.0,31,27,9,2,4,87.09677419
2006020218,3,3893,0.0,39,36,6,1,3,92.30769231
2006020218,13,3890,0.0,30,27,7,0,3,90.0
2006020219,22,3600,0.0,45,42,14,1,3,93.33333333
2006020219,17,3600,0.0,16,16,2,0,0,100.0
2006020220,10,2101,0.0,30,28,10,1,2,93.33333333
2006020220,10,1499,0.0,7,5,0,0,2,71.42857143
2006020220,6,1200,0.0,10,7,0,0,3,70.0
2006020220,6,2355,0.0,26,24,5,0,2,92.30769231
2006020221,2,3600,0.0,33,32,5,1,1,96.96969697
2006020221,4,3500,0.0,20,17,2,1,3,85.0
2006020222,15,3600,2.0,39,34,7,0,5,87.17948718
2006020222,12,3591,0.0,20,20,4,1,0,100.0
2006020223,16,3897,0.0,27,26,8,0,1,96.2962963
2006020223,1,3885,0.0,24,23,6,1,1,95.83333333
2006020224,29,3600,0.0,26,24,5,2,2,92.30769231
2006020224,19,1122,0.0,8,8,2,0,0,100.0
2006020224,19,2400,0.0,21,17,3,2,4,80.95238095
2006020225,25,3598,0.0,13,13,4,1,0,100.0
2006020225,27,3581,0.0,35,34,2,1,1,97.14285714
2006020226,24,3582,0.0,20,20,6,1,0,100.0
2006020226,23,2054,0.0,18,15,10,0,3,83.33333333
2006020226,23,1529,0.0,9,6,2,0,3,66.66666667
2006020227,28,3600,0.0,38,35,3,0,3,92.10526316
2006020227,26,3600,2.0,26,19,3,0,7,73.07692308
2006020228,22,3600,0.0,27,26,0,2,1,96.2962963
2006020228,29,3600,0.0,29,25,1,0,4,86.20689655
2006020229,9,3595,0.0,17,14,2,0,3,82.35294118
2006020229,5,3600,0.0,44,38,12,3,6,86.36363636
2006020230,3,3600,0.0,30,28,4,3,2,93.33333333
2006020230,11,3600,2.0,25,20,2,2,5,80.0
2006020231,18,3541,0.0,39,37,4,1,2,94.87179487
2006020231,17,3600,0.0,21,21,6,0,0,100.0
2006020232,13,3619,0.0,26,21,3,2,5,80.76923077
2006020232,7,3619,0.0,19,15,6,0,4,78.94736842
2006020233,19,3584,0.0,17,15,1,0,2,88.23529412
2006020233,16,3593,0.0,25,24,5,2,1,96.0
2006020234,24,1200,0.0,3,1,0,0,2,33.33333333
2006020234,24,2370,0.0,14,14,1,0,0,100.0
2006020234,20,3593,0.0,37,37,7,0,0,100.0
2006020235,9,3565,0.0,29,25,8,0,4,86.20689655
2006020235,6,3600,0.0,28,25,3,1,3,89.28571429
2006020236,8,2253,0.0,28,24,5,0,4,85.71428571
2006020236,8,1304,0.0,14,13,4,0,1,92.85714286
2006020236,10,3591,0.0,26,25,7,0,1,96.15384615
2006020237,7,3621,2.0,30,26,2,0,4,86.66666667
2006020237,4,3621,0.0,37,32,5,3,5,86.48648649
2006020238,3,3451,0.0,28,25,8,1,3,89.28571429
2006020238,15,3592,0.0,42,41,8,2,1,97.61904762
2006020239,5,3593,0.0,29,24,12,1,5,82.75862069
2006020239,12,3585,0.0,20,18,5,3,2,90.0
2006020240,13,3559,0.0,24,20,2,0,4,83.33333333
2006020240,1,3598,0.0,20,18,1,1,2,90.0
2006020241,11,3498,0.0,36,31,13,2,5,86.11111111
2006020241,14,3598,0.0,30,27,5,4,3,90.0
2006020242,21,3528,0.0,31,30,3,3,1,96.77419355
2006020242,18,3600,0.0,42,42,11,0,0,100.0
2006020243,28,1200,0.0,14,13,4,0,1,92.85714286
2006020243,28,2400,0.0,25,25,2,4,0,100.0
2006020243,27,3572,0.0,18,16,4,0,2,88.88888889
2006020244,20,3599,0.0,28,26,6,2,2,92.85714286
2006020244,23,3474,0.0,21,18,4,1,3,85.71428571
2006020245,30,3900,0.0,32,30,0,1,2,93.75
2006020245,26,3900,0.0,34,32,11,0,2,94.11764706
2006020246,22,3523,0.0,29,25,2,1,4,86.20689655
2006020246,19,3592,0.0,33,30,3,1,3,90.90909091
2006020247,29,3564,2.0,19,18,2,1,1,94.73684211
2006020247,16,3600,0.0,28,28,12,0,0,100.0
2006020248,30,3568,0.0,38,35,9,0,3,92.10526316
2006020248,24,3594,0.0,26,24,0,1,2,92.30769231
2006020249,7,3590,0.0,35,31,5,1,4,88.57142857
2006020249,12,3528,0.0,33,27,7,0,6,81.81818182
2006020250,8,3599,0.0,39,36,12,2,3,92.30769231
2006020250,9,3535,0.0,31,26,1,2,5,83.87096774
2006020251,4,3564,0.0,39,36,15,3,3,92.30769231
2006020251,5,3586,0.0,25,23,1,5,2,92.0
2006020252,15,3600,0.0,45,44,7,3,1,97.77777778
2006020252,13,3532,0.0,26,23,8,0,3,88.46153846
2006020253,22,3584,0.0,34,33,5,4,1,97.05882353
2006020253,21,3562,0.0,32,30,2,2,2,93.75
2006020254,28,3572,0.0,33,30,6,0,3,90.90909091
2006020254,26,3595,0.0,18,16,3,0,2,88.88888889
2006020255,1,3530,2.0,24,21,7,1,3,87.5
2006020255,3,3600,0.0,22,20,2,1,2,90.90909091
2006020256,19,814,0.0,4,3,0,2,1,75.0
2006020256,19,2782,0.0,19,17,4,3,2,89.47368421
2006020256,20,3600,0.0,24,24,4,2,0,100.0
2006020257,30,3559,0.0,34,30,6,0,4,88.23529412
2006020257,27,3593,0.0,29,26,6,1,3,89.65517241
2006020258,17,3596,0.0,20,18,2,1,2,90.0
2006020258,23,3522,0.0,33,30,8,1,3,90.90909091
2006020259,9,3586,0.0,29,27,9,1,2,93.10344828
2006020259,7,3533,0.0,22,19,7,4,3,86.36363636
2006020260,6,3900,0.0,35,33,10,1,2,94.28571429
2006020260,15,3900,0.0,35,33,8,0,2,94.28571429
2006020261,3,3549,0.0,24,22,5,0,2,91.66666667
2006020261,12,3600,0.0,24,23,5,1,1,95.83333333
2006020262,18,3585,0.0,33,29,3,0,4,87.87878788
2006020262,29,3514,0.0,30,25,7,1,5,83.33333333
2006020263,8,3600,0.0,30,29,10,4,1,96.66666667
2006020263,14,3557,0.0,28,25,3,2,3,89.28571429
2006020264,2,3600,0.0,35,35,10,1,0,100.0
2006020264,25,3580,0.0,22,19,5,1,3,86.36363636
2006020265,28,3597,0.0,43,40,9,1,3,93.02325581
2006020265,21,3477,0.0,26,22,2,2,4,84.61538462
2006020266,4,3600,0.0,41,37,7,2,4,90.24390244
2006020266,24,2614,0.0,5,3,1,0,2,60.0
2006020266,24,986,0.0,11,6,0,0,5,54.54545455
2006020267,10,3634,0.0,36,34,5,1,2,94.44444444
2006020267,6,3629,0.0,25,24,0,0,1,96.0
2006020268,8,2397,0.0,24,20,1,0,4,83.33333333
2006020268,8,1200,0.0,15,14,6,1,1,93.33333333
2006020268,13,3600,0.0,28,27,11,2,1,96.42857143
2006020269,30,1868,0.0,25,24,3,0,1,96.0
2006020269,30,2019,2.0,20,15,2,0,5,75.0
2006020269,18,3900,0.0,45,39,7,3,6,86.66666667
2006020270,19,1278,0.0,15,11,6,0,4,73.33333333
2006020270,19,2320,0.0,13,11,0,0,2,84.61538462
2006020270,22,3589,0.0,27,25,4,1,2,92.59259259
2006020271,16,3897,0.0,27,25,4,1,2,92.59259259
2006020271,27,3895,0.0,34,32,8,0,2,94.11764706
2006020272,4,3580,0.0,26,23,3,4,3,88.46153846
2006020272,26,3530,0.0,30,26,5,0,4,86.66666667
2006020273,12,3593,0.0,22,21,2,1,1,95.45454545
2006020273,15,3600,0.0,29,25,7,2,4,86.20689655
2006020274,21,3600,0.0,25,25,5,1,0,100.0
2006020274,29,3531,0.0,28,25,4,0,3,89.28571429
2006020275,9,3519,0.0,23,20,2,0,3,86.95652174
2006020275,1,3600,0.0,17,15,2,0,2,88.23529412
2006020276,25,3592,0.0,23,20,5,0,3,86.95652174
2006020276,11,2477,0.0,15,13,0,0,2,86.66666667
2006020276,11,1006,0.0,7,4,0,0,3,57.14285714
2006020277,5,3543,0.0,35,32,5,3,3,91.42857143
2006020277,7,3595,0.0,36,34,5,0,2,94.44444444
2006020278,2,3900,0.0,38,36,9,0,2,94.73684211
2006020278,14,3900,0.0,31,29,0,0,2,93.5483871
2006020279,17,3581,0.0,25,21,5,0,4,84.0
2006020279,20,3581,0.0,30,29,6,1,1,96.66666667
2006020280,19,3546,2.0,44,40,7,1,4,90.90909091
2006020280,23,3600,0.0,21,19,4,0,2,90.47619048
2006020281,16,3900,2.0,45,42,11,0,3,93.33333333
2006020281,24,3867,0.0,24,21,5,1,3,87.5
2006020282,27,1931,0.0,22,21,5,0,1,95.45454545
2006020282,27,1620,0.0,16,13,5,1,3,81.25
2006020282,26,3581,0.0,39,36,6,1,3,92.30769231
2006020283,15,3726,0.0,38,35,17,0,3,92.10526316
2006020283,6,3726,0.0,29,27,3,0,2,93.10344828
2006020284,1,3600,0.0,34,33,3,1,1,97.05882353
2006020284,10,3540,0.0,19,17,1,0,2,89.47368421
2006020285,11,3552,2.0,32,30,7,1,2,93.75
2006020285,8,3599,0.0,40,39,8,1,1,97.5
2006020286,7,3594,0.0,41,37,12,0,4,90.24390244
2006020286,9,3600,0.0,24,23,2,2,1,95.83333333
2006020287,25,3573,0.0,24,20,6,0,4,83.33333333
2006020287,12,3592,0.0,25,21,1,3,4,84.0
2006020288,3,3492,0.0,25,22,9,0,3,88.0
2006020288,5,3600,0.0,24,23,4,5,1,95.83333333
2006020289,2,3600,0.0,44,43,6,0,1,97.72727273
2006020289,13,3570,0.0,31,28,0,1,3,90.32258065
2006020290,29,3535,2.0,25,21,10,1,4,84.0
2006020290,18,3590,2.0,30,28,8,1,2,93.33333333
2006020291,21,3900,0.0,29,28,2,2,1,96.55172414
2006020291,30,3900,0.0,31,30,4,0,1,96.77419355
2006020292,17,3844,0.0,21,18,2,0,3,85.71428571
2006020292,22,3890,0.0,41,38,3,2,3,92.68292683
2006020293,4,1655,0.0,7,7,0,0,0,100.0
2006020293,4,1945,0.0,18,12,2,0,6,66.66666667
2006020293,28,3600,0.0,18,17,1,1,1,94.44444444
2006020294,14,3600,0.0,34,30,5,0,4,88.23529412
2006020294,3,3600,0.0,28,27,6,0,1,96.42857143
2006020295,27,3529,0.0,29,24,8,0,5,82.75862069
2006020295,24,3595,0.0,28,24,5,1,4,85.71428571
2006020296,16,3542,2.0,39,37,10,3,2,94.87179487
2006020296,23,3536,0.0,23,22,4,2,1,95.65217391
2006020297,13,3593,0.0,31,29,5,3,2,93.5483871
2006020297,6,3510,0.0,28,25,3,2,3,89.28571429
2006020298,14,3599,0.0,29,22,4,2,7,75.86206897
2006020298,7,3600,0.0,26,24,7,0,2,92.30769231
2006020299,5,3599,0.0,25,22,4,3,3,88.0
2006020299,4,3589,0.0,34,29,10,1,5,85.29411765
2006020300,18,3599,0.0,24,23,0,4,1,95.83333333
2006020300,29,3569,0.0,23,20,3,0,3,86.95652174
2006020301,2,3600,0.0,33,29,6,2,4,87.87878788
2006020301,10,3590,0.0,21,19,5,0,2,90.47619048
2006020302,30,3600,0.0,33,28,3,1,5,84.84848485
2006020302,9,3600,0.0,45,42,6,1,3,93.33333333
2006020303,21,3530,0.0,31,26,5,2,5,83.87096774
2006020303,25,3179,0.0,18,16,1,1,2,88.88888889
2006020303,25,411,0.0,5,3,2,0,2,60.0
2006020304,12,3600,0.0,27,23,2,0,4,85.18518519
2006020304,3,3598,0.0,34,34,4,0,0,100.0
2006020305,23,3781,0.0,30,27,4,0,3,90.0
2006020305,17,3768,0.0,30,26,6,1,4,86.66666667
2006020306,20,3572,0.0,25,23,5,1,2,92.0
2006020306,22,3596,0.0,24,23,9,0,1,95.83333333
2006020307,28,3600,0.0,44,39,9,0,5,88.63636364
2006020307,24,3600,0.0,23,23,1,0,0,100.0
2006020308,10,3547,0.0,27,22,6,2,5,81.48148148
2006020308,7,3580,0.0,36,32,8,1,4,88.88888889
2006020309,9,3879,0.0,26,24,0,0,2,92.30769231
2006020309,4,3879,0.0,35,32,8,0,3,91.42857143
2006020310,11,3596,2.0,26,24,1,1,2,92.30769231
2006020310,15,3574,2.0,32,28,6,0,4,87.5
2006020311,19,3879,0.0,32,29,9,1,3,90.625
2006020311,29,3894,0.0,38,35,3,1,3,92.10526316
2006020312,30,3574,2.0,34,31,6,3,3,91.17647059
2006020312,8,3597,0.0,38,36,8,0,2,94.73684211
2006020313,12,3541,0.0,47,44,7,2,3,93.61702128
2006020313,2,3600,0.0,15,13,4,0,2,86.66666667
2006020314,6,2700,2.0,18,16,7,1,2,88.88888889
2006020314,6,1200,0.0,7,6,3,0,1,85.71428571
2006020314,5,3855,0.0,31,28,7,1,3,90.32258065
2006020315,14,3597,0.0,35,31,6,1,4,88.57142857
2006020315,13,3569,0.0,33,28,11,0,5,84.84848485
2006020316,18,3543,0.0,26,25,6,0,1,96.15384615
2006020316,25,3600,0.0,17,17,3,1,0,100.0
2006020317,24,3896,0.0,43,41,6,1,2,95.34883721
2006020317,21,3898,2.0,32,30,6,0,2,93.75
2006020318,16,3507,0.0,39,36,10,1,3,92.30769231
2006020318,20,3600,0.0,26,25,6,2,1,96.15384615
2006020319,1,3600,0.0,27,24,1,1,3,88.88888889
2006020319,27,3600,0.0,15,14,4,0,1,93.33333333
2006020320,26,1731,0.0,12,7,1,0,5,58.33333333
2006020320,26,1869,0.0,8,7,2,0,1,87.5
2006020320,28,3600,0.0,27,24,3,2,3,88.88888889
2006020321,23,3155,0.0,24,19,9,0,5,79.16666667
2006020321,23,443,0.0,4,3,2,0,1,75.0
2006020321,18,1200,0.0,13,13,2,0,0,100.0
2006020321,18,2398,0.0,21,21,3,1,0,100.0
2006020322,12,3597,2.0,26,25,4,3,1,96.15384615
2006020322,6,1756,0.0,15,13,1,0,2,86.66666667
2006020322,6,1799,0.0,25,22,5,4,3,88.0
2006020323,29,3515,0.0,22,19,3,2,3,86.36363636
2006020323,4,3585,0.0,41,39,11,2,2,95.12195122
2006020324,5,3423,0.0,29,26,1,5,3,89.65517241
2006020324,2,3600,2.0,37,36,8,1,1,97.2972973
2006020325,27,2815,0.0,26,22,3,0,4,84.61538462
2006020325,27,783,0.0,3,3,1,0,0,100.0
2006020325,30,3580,0.0,28,28,5,0,0,100.0
2006020326,1,3526,2.0,36,33,18,1,3,91.66666667
2006020326,24,3589,0.0,25,23,3,0,2,92.0
2006020327,10,3600,0.0,23,22,4,0,1,95.65217391
2006020327,15,3595,0.0,28,21,2,1,7,75.0
2006020328,9,3572,2.0,37,33,0,2,4,89.18918919
2006020328,13,3600,0.0,32,26,7,0,6,81.25
2006020329,19,3886,0.0,43,41,10,1,2,95.34883721
2006020329,17,3880,0.0,19,17,2,0,2,89.47368421
2006020330,8,3899,0.0,30,29,5,1,1,96.66666667
2006020330,7,3894,0.0,30,28,3,0,2,93.33333333
2006020331,11,3745,0.0,33,30,3,0,3,90.90909091
2006020331,14,3687,0.0,25,23,0,0,2,92.0
2006020332,26,3548,0.0,23,19,6,2,4,82.60869565
2006020332,25,3588,0.0,25,22,3,0,3,88.0
2006020333,16,2400,0.0,17,15,4,0,2,88.23529412
2006020333,16,1200,0.0,7,4,2,0,3,57.14285714
2006020333,22,3578,0.0,28,27,3,0,1,96.42857143
2006020334,6,3600,0.0,28,27,6,1,1,96.42857143
2006020334,10,3517,2.0,25,22,2,0,3,88.0
2006020335,4,3581,2.0,31,29,3,4,2,93.5483871
2006020335,8,3530,0.0,26,22,5,0,4,84.61538462
2006020336,15,3564,0.0,29,26,6,2,3,89.65517241
2006020336,2,3597,0.0,34,33,3,10,1,97.05882353
2006020337,13,3546,0.0,28,27,2,0,1,96.42857143
2006020337,11,3600,0.0,37,37,9,1,0,100.0
2006020338,30,1200,0.0,10,8,1,0,2,80.0
2006020338,30,2400,0.0,23,20,2,0,3,86.95652174
2006020338,29,3592,0.0,22,19,4,1,3,86.36363636
2006020339,3,3895,0.0,29,28,12,2,1,96.55172414
2006020339,5,3835,0.0,30,28,10,1,2,93.33333333
2006020340,27,3600,0.0,26,25,7,0,1,96.15384615
2006020340,19,3580,0.0,24,22,3,0,2,91.66666667
2006020341,17,3600,0.0,27,21,5,0,6,77.77777778
2006020341,18,3593,0.0,34,32,2,0,2,94.11764706
2006020342,23,3600,0.0,39,35,9,0,4,89.74358974
2006020342,21,3597,0.0,29,28,2,1,1,96.55172414
2006020343,20,3523,0.0,35,32,7,0,3,91.42857143
2006020343,26,3600,0.0,23,22,6,1,1,95.65217391
2006020344,1,3540,2.0,26,25,3,0,1,96.15384615
2006020344,28,3600,0.0,24,24,2,0,0,100.0
2006020345,9,3561,0.0,18,15,4,0,3,83.33333333
2006020345,14,3597,0.0,23,22,1,0,1,95.65217391
2006020346,7,3655,0.0,27,25,4,2,2,92.59259259
2006020346,3,3691,0.0,31,28,10,1,3,90.32258065
2006020347,20,3529,0.0,38,34,8,1,4,89.47368421
2006020347,24,3600,0.0,22,19,5,2,3,86.36363636
2006020348,25,3511,0.0,29,27,1,3,2,93.10344828
2006020348,17,3600,0.0,21,20,2,0,1,95.23809524
2006020349,1,3900,0.0,28,26,3,0,2,92.85714286
2006020349,26,3894,0.0,22,20,1,1,2,90.90909091
2006020350,11,3771,0.0,34,30,9,0,4,88.23529412
2006020350,3,3775,0.0,30,25,1,0,5,83.33333333
2006020351,2,3531,2.0,28,25,3,0,3,89.28571429
2006020351,5,3600,0.0,35,33,2,3,2,94.28571429
2006020352,9,3600,0.0,30,29,9,1,1,96.66666667
2006020352,12,3600,0.0,36,32,9,3,4,88.88888889
2006020353,6,3600,0.0,46,45,12,0,1,97.82608696
2006020353,10,3542,0.0,23,20,7,0,3,86.95652174
2006020354,13,3900,0.0,39,39,4,1,0,100.0
2006020354,8,3888,0.0,36,36,5,0,0,100.0
2006020355,15,3600,0.0,50,48,25,0,2,96.0
2006020355,14,1366,0.0,6,5,0,2,1,83.33333333
2006020355,14,2189,0.0,13,10,4,0,3,76.92307692
2006020356,28,3600,0.0,29,29,0,0,0,100.0
2006020356,19,3526,0.0,27,25,0,1,2,92.59259259
2006020357,21,3600,0.0,37,32,5,1,5,86.48648649
2006020357,20,3590,0.0,25,23,8,0,2,92.0
2006020358,24,3706,0.0,22,20,6,1,2,90.90909091
2006020358,22,3737,0.0,26,23,3,1,3,88.46153846
2006020359,29,3547,0.0,33,32,10,3,1,96.96969697
2006020359,23,3600,0.0,24,24,10,1,0,100.0
2006020360,18,3600,2.0,26,24,0,0,2,92.30769231
2006020360,4,3527,0.0,29,26,2,0,3,89.65517241
2006020361,28,3600,0.0,16,15,3,0,1,93.75
2006020361,30,3520,0.0,31,29,7,1,2,93.5483871
2006020362,25,3518,0.0,28,26,1,2,2,92.85714286
2006020362,16,3595,0.0,21,20,6,0,1,95.23809524
2006020363,14,3898,0.0,25,22,4,1,3,88.0
2006020363,6,3900,0.0,34,31,9,1,3,91.17647059
2006020364,25,2398,0.0,14,10,2,0,4,71.42857143
2006020364,25,1126,0.0,9,9,1,1,0,100.0
2006020364,15,3600,0.0,38,35,4,0,3,92.10526316
2006020365,8,3545,0.0,48,44,10,2,4,91.66666667
2006020365,12,3600,0.0,27,25,5,1,2,92.59259259
2006020366,10,3582,0.0,27,22,3,1,5,81.48148148
2006020366,11,3600,0.0,36,36,11,4,0,100.0
2006020367,13,2039,0.0,11,10,3,0,1,90.90909091
2006020367,13,1561,0.0,17,12,0,1,5,70.58823529
2006020367,9,3599,0.0,31,31,3,0,0,100.0
2006020368,4,3597,0.0,41,39,8,3,2,95.12195122
2006020368,2,3550,0.0,23,20,3,1,3,86.95652174
2006020369,18,3579,0.0,42,38,8,1,4,90.47619048
2006020369,19,329,0.0,0,0,0,0,0,
2006020369,19,3200,0.0,17,12,0,0,5,70.58823529
2006020370,21,3593,0.0,24,21,0,1,3,87.5
2006020370,22,1807,0.0,9,8,1,0,1,88.88888889
2006020370,22,1793,0.0,20,14,0,0,6,70.0
2006020371,26,3023,0.0,28,24,1,0,4,85.71428571
2006020371,26,566,0.0,5,2,0,0,3,40.0
2006020371,27,3600,0.0,35,31,2,0,4,88.57142857
2006020372,24,3597,0.0,24,23,3,0,1,95.83333333
2006020372,23,3537,2.0,30,28,7,2,2,93.33333333
2006020373,5,1835,0.0,8,4,0,1,4,50.0
2006020373,5,1764,0.0,19,18,4,1,1,94.73684211
2006020373,1,3598,0.0,25,23,7,0,2,92.0
2006020374,3,3889,0.0,19,16,0,0,3,84.21052632
2006020374,7,3894,0.0,39,36,9,1,3,92.30769231
2006020375,17,3600,0.0,20,20,1,0,0,100.0
2006020375,30,3600,0.0,23,20,3,0,3,86.95652174
2006020376,19,375,0.0,3,2,0,0,1,66.66666667
2006020376,19,3166,0.0,27,25,2,0,2,92.59259259
2006020376,16,3600,0.0,31,29,5,0,2,93.5483871
2006020377,29,3589,0.0,31,29,4,1,2,93.5483871
2006020377,20,3600,0.0,19,18,0,1,1,94.73684211
2006020378,24,3600,0.0,41,38,13,0,3,92.68292683
2006020378,26,3521,2.0,29,25,7,2,4,86.20689655
2006020379,10,3900,0.0,22,19,4,2,3,86.36363636
2006020379,8,3900,0.0,39,36,9,2,3,92.30769231
2006020380,14,486,0.0,7,4,2,0,3,57.14285714
2006020380,14,3103,0.0,18,16,2,1,2,88.88888889
2006020380,9,3593,0.0,36,34,9,1,2,94.44444444
2006020381,6,3600,0.0,30,25,4,2,5,83.33333333
2006020381,12,3591,0.0,19,17,5,1,2,89.47368421
2006020382,28,3597,0.0,19,17,1,1,2,89.47368421
2006020382,17,3594,0.0,35,32,8,0,3,91.42857143
2006020383,1,3900,0.0,25,22,2,3,3,88.0
2006020383,4,3897,0.0,32,29,1,2,3,90.625
2006020384,2,3600,0.0,37,34,10,3,3,91.89189189
2006020384,5,3509,0.0,35,30,9,5,5,85.71428571
2006020385,11,3600,0.0,28,27,9,4,1,96.42857143
2006020385,13,3581,0.0,24,22,3,0,2,91.66666667
2006020386,7,465,0.0,9,6,2,0,3,66.66666667
2006020386,7,3056,0.0,18,15,1,0,3,83.33333333
2006020386,15,3598,0.0,30,26,9,2,4,86.66666667
2006020387,16,3629,2.0,28,25,3,2,3,89.28571429
2006020387,18,3659,0.0,30,26,7,1,4,86.66666667
2006020388,29,3600,0.0,21,21,4,1,0,100.0
2006020388,22,1184,0.0,2,2,0,0,0,100.0
2006020388,22,2392,2.0,20,17,5,0,3,85.0
2006020389,30,3887,0.0,24,21,9,0,3,87.5
2006020389,25,3897,0.0,35,32,9,2,3,91.42857143
2006020390,21,1195,0.0,6,6,0,0,0,100.0
2006020390,21,2374,0.0,18,16,6,0,2,88.88888889
2006020390,23,3598,0.0,41,40,6,0,1,97.56097561
2006020391,2,3590,0.0,43,39,11,1,4,90.69767442
2006020391,3,2400,0.0,13,10,1,2,3,76.92307692
2006020391,3,1200,0.0,8,4,0,0,4,50.0
2006020392,26,3599,0.0,29,27,2,3,2,93.10344828
2006020392,24,2846,0.0,32,30,13,0,2,93.75
2006020392,24,699,0.0,9,8,0,0,1,88.88888889
2006020393,6,3600,0.0,39,34,5,5,5,87.17948718
2006020393,8,2177,0.0,14,12,0,0,2,85.71428571
2006020393,8,1378,0.0,16,12,2,0,4,75.0
2006020394,28,3477,0.0,13,12,3,1,1,92.30769231
2006020394,25,3600,2.0,25,25,3,1,0,100.0
2006020395,18,3534,0.0,42,39,11,0,3,92.85714286
2006020395,27,3600,0.0,21,19,5,0,2,90.47619048
2006020396,22,3600,0.0,36,36,7,1,0,100.0
2006020396,23,3596,0.0,18,14,1,0,4,77.77777778
2006020397,11,3600,0.0,19,17,0,0,2,89.47368421
2006020397,10,3578,0.0,36,32,14,0,4,88.88888889
2006020398,9,3596,0.0,26,24,7,0,2,92.30769231
2006020398,2,3510,0.0,35,31,2,1,4,88.57142857
2006020399,13,3600,0.0,27,25,8,2,2,92.59259259
2006020399,5,3527,0.0,30,27,7,2,3,90.0
2006020400,7,3600,0.0,30,29,5,0,1,96.66666667
2006020400,14,3575,0.0,25,21,1,0,4,84.0
2006020401,17,3589,0.0,25,24,5,0,1,96.0
2006020401,19,822,0.0,12,9,5,0,3,75.0
2006020401,19,2765,0.0,20,18,1,6,2,90.0
2006020402,16,3900,0.0,37,35,5,0,2,94.59459459
2006020402,30,3900,0.0,29,27,3,2,2,93.10344828
2006020403,29,3600,0.0,42,42,9,1,0,100.0
2006020403,21,3600,0.0,21,18,2,1,3,85.71428571
2006020404,12,3577,0.0,31,29,2,0,2,93.5483871
2006020404,20,3600,0.0,23,23,3,0,0,100.0
2006020405,9,3597,0.0,37,31,5,2,6,83.78378378
2006020405,15,3598,2.0,37,35,14,2,2,94.59459459
2006020406,8,3892,0.0,31,29,6,1,2,93.5483871
2006020406,1,3892,0.0,19,18,4,2,1,94.73684211
2006020407,27,3596,0.0,17,14,5,0,3,82.35294118
2006020407,25,3600,0.0,25,25,2,3,0,100.0
2006020408,12,3516,0.0,24,21,4,1,3,87.5
2006020408,22,3600,0.0,29,28,7,0,1,96.55172414
2006020409,18,3600,0.0,32,28,10,0,4,87.5
2006020409,24,3597,0.0,21,21,5,0,0,100.0
2006020410,10,3555,0.0,26,23,2,3,3,88.46153846
2006020410,6,3600,0.0,24,23,1,0,1,95.83333333
2006020411,5,3898,0.0,22,20,6,0,2,90.90909091
2006020411,3,3898,0.0,30,28,4,1,2,93.33333333
2006020412,8,3600,0.0,27,25,8,2,2,92.59259259
2006020412,2,3505,0.0,36,32,10,4,4,88.88888889
2006020413,11,1200,0.0,8,5,1,0,3,62.5
2006020413,11,2399,0.0,30,25,7,0,5,83.33333333
2006020413,14,3600,0.0,21,21,4,1,0,100.0
2006020414,7,3545,0.0,38,35,6,0,3,92.10526316
2006020414,13,3598,0.0,18,17,7,0,1,94.44444444
2006020415,19,3803,0.0,43,39,13,2,4,90.69767442
2006020415,17,3773,2.0,21,18,1,4,3,85.71428571
2006020416,20,3882,0.0,27,25,5,1,2,92.59259259
2006020416,30,3883,4.0,40,38,17,1,2,95.0
2006020417,27,3895,0.0,31,30,6,1,1,96.77419355
2006020417,16,3895,0.0,35,34,5,0,1,97.14285714
2006020418,18,3587,0.0,21,20,4,1,1,95.23809524
2006020418,26,3562,0.0,27,23,6,0,4,85.18518519
2006020419,21,3584,0.0,30,28,7,0,2,93.33333333
2006020419,28,3585,0.0,25,20,3,3,5,80.0
2006020420,24,3600,0.0,27,26,8,0,1,96.2962963
2006020420,15,3597,0.0,34,28,16,0,6,82.35294118
2006020421,4,3514,0.0,24,22,4,1,2,91.66666667
2006020421,1,3600,0.0,28,28,7,1,0,100.0
2006020422,22,3598,0.0,22,22,5,1,0,100.0
2006020422,25,3511,0.0,15,13,3,1,2,86.66666667
2006020423,12,3769,0.0,31,27,10,1,4,87.09677419
2006020423,23,3771,0.0,39,36,16,0,3,92.30769231
2006020424,1,3594,0.0,20,19,0,0,1,95.0
2006020424,6,1200,0.0,14,12,2,0,2,85.71428571
2006020424,6,2392,0.0,28,25,4,0,3,89.28571429
2006020425,7,3898,0.0,33,31,3,4,2,93.93939394
2006020425,8,3900,0.0,33,31,7,0,2,93.93939394
2006020426,3,3599,0.0,35,34,7,0,1,97.14285714
2006020426,9,3569,0.0,28,26,2,1,2,92.85714286
2006020427,13,3896,0.0,35,31,4,0,4,88.57142857
2006020427,2,3900,0.0,32,28,9,0,4,87.5
2006020428,15,3595,0.0,36,33,12,0,3,91.66666667
2006020428,4,3553,0.0,32,27,7,1,5,84.375
2006020429,5,3829,0.0,23,20,5,0,3,86.95652174
2006020429,11,3831,0.0,43,39,9,1,4,90.69767442
2006020430,10,2400,0.0,20,16,7,1,4,80.0
2006020430,10,1200,0.0,11,10,5,0,1,90.90909091
2006020430,17,3600,2.0,22,21,9,4,1,95.45454545
2006020431,24,3600,0.0,27,24,5,0,3,88.88888889
2006020431,14,3538,0.0,25,21,3,2,4,84.0
2006020432,29,3600,0.0,25,24,5,0,1,96.0
2006020432,19,3600,0.0,24,19,6,1,5,79.16666667
2006020433,16,3789,0.0,38,33,14,2,5,86.84210526
2006020433,30,3798,0.0,26,22,7,2,4,84.61538462
2006020434,25,3883,0.0,31,28,6,2,3,90.32258065
2006020434,27,3895,0.0,44,40,6,0,4,90.90909091
2006020435,23,1787,0.0,13,13,4,0,0,100.0
2006020435,23,1780,0.0,24,20,10,1,4,83.33333333
2006020435,20,3565,0.0,29,26,7,0,3,89.65517241
2006020436,21,3464,0.0,38,33,12,0,5,86.84210526
2006020436,26,3552,0.0,30,26,6,2,4,86.66666667
2006020437,18,3528,0.0,26,23,9,0,3,88.46153846
2006020437,28,3580,0.0,21,20,5,1,1,95.23809524
2006020438,9,1628,0.0,13,9,1,0,4,69.23076923
2006020438,9,1963,0.0,18,16,9,0,2,88.88888889
2006020438,29,2087,0.0,17,17,5,1,0,100.0
2006020438,29,1511,0.0,16,14,0,1,2,87.5
2006020439,13,3520,0.0,28,26,4,0,2,92.85714286
2006020439,3,3600,0.0,35,34,6,0,1,97.14285714
2006020440,22,3478,0.0,26,23,10,1,3,88.46153846
2006020440,16,3594,0.0,19,18,3,2,1,94.73684211
2006020441,5,3900,0.0,33,29,2,1,4,87.87878788
2006020441,15,3900,0.0,35,31,1,3,4,88.57142857
2006020442,12,3597,0.0,30,25,6,0,5,83.33333333
2006020442,21,3589,0.0,28,26,6,1,2,92.85714286
2006020443,27,3600,0.0,34,30,15,0,4,88.23529412
2006020443,28,3596,0.0,23,23,5,2,0,100.0
2006020444,7,3595,2.0,33,31,5,1,2,93.93939394
2006020444,1,3569,0.0,24,21,6,0,3,87.5
2006020445,3,3600,0.0,16,15,4,1,1,93.75
2006020445,4,3575,0.0,34,31,11,0,3,91.17647059
2006020446,14,3505,0.0,25,20,7,0,5,80.0
2006020446,10,2376,0.0,17,16,6,0,1,94.11764706
2006020446,10,1224,0.0,9,6,2,0,3,66.66666667
2006020447,6,3502,0.0,40,36,9,3,4,90.0
2006020447,8,3596,0.0,34,31,4,2,3,91.17647059
2006020448,24,3600,0.0,31,27,3,1,4,87.09677419
2006020448,13,3552,0.0,36,31,6,1,5,86.11111111
2006020449,9,3600,0.0,45,43,5,1,2,95.55555556
2006020449,17,3546,2.0,22,19,4,0,3,86.36363636
2006020450,16,3600,0.0,21,19,3,1,2,90.47619048
2006020450,19,3526,0.0,24,21,4,0,3,87.5
2006020451,22,3526,0.0,30,27,4,0,3,90.0
2006020451,18,3583,0.0,40,38,6,1,2,95.0
2006020452,29,3600,0.0,26,25,16,1,1,96.15384615
2006020452,25,3488,0.0,23,20,8,0,3,86.95652174
2006020453,30,2185,0.0,16,15,5,0,1,93.75
2006020453,30,1415,0.0,13,9,0,0,4,69.23076923
2006020453,20,3598,0.0,26,24,6,1,2,92.30769231
2006020454,27,2400,0.0,18,14,0,0,4,77.77777778
2006020454,27,1200,0.0,13,12,4,0,1,92.30769231
2006020454,23,3600,0.0,30,28,2,0,2,93.33333333
2006020455,28,3593,0.0,37,36,8,0,1,97.2972973
2006020455,26,3576,0.0,31,28,13,1,3,90.32258065
2006020456,24,3581,0.0,35,34,14,2,1,97.14285714
2006020456,11,3523,0.0,32,30,8,2,2,93.75
2006020457,4,3468,0.0,26,19,9,0,7,73.07692308
2006020457,4,132,0.0,3,2,0,0,1,66.66666667
2006020457,5,3244,0.0,22,18,2,4,4,81.81818182
2006020457,5,356,0.0,1,1,0,1,0,100.0
2006020458,19,77,0.0,1,1,0,0,0,100.0
2006020458,19,3523,0.0,45,41,6,0,4,91.11111111
2006020458,21,3600,0.0,26,25,5,3,1,96.15384615
2006020459,1,3584,0.0,44,40,14,0,4,90.90909091
2006020459,6,3588,0.0,29,26,6,0,3,89.65517241
2006020460,13,3551,0.0,16,14,2,0,2,87.5
2006020460,7,3600,0.0,33,32,10,2,1,96.96969697
2006020461,14,3564,0.0,19,16,1,1,3,84.21052632
2006020461,8,3600,0.0,43,41,6,0,2,95.34883721
2006020462,9,1686,0.0,19,19,2,0,0,100.0
2006020462,9,1914,0.0,14,8,0,0,6,57.14285714
2006020462,18,3600,0.0,22,22,1,0,0,100.0
2006020463,17,3596,0.0,31,29,3,0,2,93.5483871
2006020463,16,3558,0.0,26,23,2,2,3,88.46153846
2006020464,3,3600,0.0,45,43,20,1,2,95.55555556
2006020464,25,3507,0.0,19,15,3,2,4,78.94736842
2006020465,30,3600,0.0,25,22,7,3,3,88.0
2006020465,22,3594,0.0,25,24,3,2,1,96.0
2006020466,29,3856,0.0,29,25,1,2,4,86.20689655
2006020466,27,3900,0.0,25,21,3,2,4,84.0
2006020467,20,3574,0.0,27,24,17,1,3,88.88888889
2006020467,23,3600,0.0,22,21,11,1,1,95.45454545
2006020468,26,3600,0.0,36,34,3,1,2,94.44444444
2006020468,28,3526,0.0,31,27,3,1,4,87.09677419
2006020469,10,3578,0.0,32,29,8,2,3,90.625
2006020469,12,3528,0.0,25,21,7,1,4,84.0
2006020470,2,2400,0.0,29,24,10,2,5,82.75862069
2006020470,2,1185,0.0,6,4,2,0,2,66.66666667
2006020470,5,3600,0.0,32,28,9,1,4,87.5
2006020471,15,3576,0.0,30,28,4,0,2,93.33333333
2006020471,11,3606,0.0,33,30,6,0,3,90.90909091
2006020472,22,920,0.0,1,1,0,0,0,100.0
2006020472,22,2679,0.0,16,12,2,2,4,75.0
2006020472,21,3600,0.0,19,18,1,0,1,94.73684211
2006020473,17,3600,4.0,22,21,7,1,1,95.45454545
2006020473,1,3538,0.0,36,34,11,1,2,94.44444444
2006020474,25,3900,0.0,36,33,4,2,3,91.66666667
2006020474,26,3895,0.0,31,28,1,1,3,90.32258065
2006020475,13,3600,0.0,21,18,7,1,3,85.71428571
2006020475,6,3576,0.0,35,30,8,2,5,85.71428571
2006020476,9,3597,0.0,36,35,10,0,1,97.22222222
2006020476,7,3512,0.0,29,26,4,1,3,89.65517241
2006020477,3,1200,0.0,8,7,3,0,1,87.5
2006020477,3,2396,0.0,24,16,0,3,8,66.66666667
2006020477,10,3566,0.0,13,11,1,1,2,84.61538462
2006020478,5,3573,0.0,32,27,4,3,5,84.375
2006020478,8,3597,0.0,34,31,13,1,3,91.17647059
2006020479,11,3593,0.0,32,26,1,0,6,81.25
2006020479,2,3598,0.0,37,37,7,0,0,100.0
2006020480,4,3600,0.0,31,27,5,1,4,87.09677419
2006020480,15,3600,0.0,22,21,4,2,1,95.45454545
2006020481,16,3588,0.0,36,32,5,0,4,88.88888889
2006020481,29,2350,0.0,8,7,1,0,1,87.5
2006020481,29,1200,0.0,16,11,0,0,5,68.75
2006020482,12,3600,0.0,32,30,8,0,2,93.75
2006020482,14,3559,0.0,27,24,2,0,3,88.88888889
2006020483,19,3875,2.0,24,22,5,0,2,91.66666667
2006020483,18,3900,0.0,35,33,8,2,2,94.28571429
2006020484,20,3598,0.0,35,32,4,3,3,91.42857143
2006020484,27,3557,0.0,30,25,10,2,5,83.33333333
2006020485,30,3544,0.0,18,16,3,0,2,88.88888889
2006020485,23,3585,0.0,29,28,8,0,1,96.55172414
2006020486,24,3568,0.0,29,25,8,5,4,86.20689655
2006020486,28,3600,0.0,35,32,8,1,3,91.42857143
2006020487,18,3791,0.0,23,22,6,2,1,95.65217391
2006020487,19,3791,0.0,33,31,15,0,2,93.93939394
2006020488,1,3600,0.0,36,35,10,0,1,97.22222222
2006020488,3,3587,0.0,28,22,7,0,6,78.57142857
2006020489,21,3493,0.0,25,23,4,1,2,92.0
2006020489,16,3595,0.0,29,28,2,0,1,96.55172414
2006020490,17,2329,0.0,14,13,3,0,1,92.85714286
2006020490,17,1200,0.0,12,9,2,2,3,75.0
2006020490,29,3595,0.0,36,33,5,1,3,91.66666667
2006020491,20,3587,0.0,40,37,8,0,3,92.5
2006020491,24,3600,0.0,28,27,3,0,1,96.42857143
2006020492,8,3596,0.0,44,42,10,0,2,95.45454545
2006020492,7,3598,0.0,29,24,6,1,5,82.75862069
2006020493,2,3596,0.0,33,30,6,1,3,90.90909091
2006020493,3,3530,0.0,26,22,7,1,4,84.61538462
2006020494,12,3600,0.0,30,29,4,0,1,96.66666667
2006020494,4,3546,0.0,42,40,12,1,2,95.23809524
2006020495,19,1200,0.0,9,9,4,0,0,100.0
2006020495,19,2400,0.0,17,16,4,0,1,94.11764706
2006020495,5,1561,0.0,12,9,0,0,3,75.0
2006020495,5,2030,0.0,14,13,4,1,1,92.85714286
2006020496,14,3600,0.0,24,20,6,0,4,83.33333333
2006020496,15,3526,0.0,35,30,10,0,5,85.71428571
2006020497,13,3600,0.0,36,33,5,0,3,91.66666667
2006020497,10,2400,0.0,26,20,0,3,6,76.92307692
2006020497,10,1200,0.0,10,9,4,0,1,90.0
2006020498,6,3583,0.0,37,35,5,3,2,94.59459459
2006020498,9,1200,0.0,6,4,0,0,2,66.66666667
2006020498,9,2400,0.0,20,15,5,0,5,75.0
2006020499,11,3900,0.0,34,31,6,0,3,91.17647059
2006020499,1,3896,0.0,31,28,4,1,3,90.32258065
2006020500,23,3569,0.0,26,22,7,4,4,84.61538462
2006020500,30,3598,0.0,22,20,2,2,2,90.90909091
2006020501,21,3600,0.0,37,31,5,1,6,83.78378378
2006020501,22,3538,0.0,30,23,4,0,7,76.66666667
2006020502,20,3600,0.0,30,27,2,2,3,90.0
2006020502,26,3526,0.0,31,26,3,0,5,83.87096774
2006020503,29,2678,0.0,22,17,5,2,5,77.27272727
2006020503,17,3579,2.0,27,27,9,2,0,100.0
2006020504,18,3600,0.0,29,28,7,0,1,96.55172414
2006020504,16,3520,0.0,19,17,3,1,2,89.47368421
2006020505,25,1200,0.0,6,6,1,0,0,100.0
2006020505,25,2400,0.0,21,17,3,0,4,80.95238095
2006020505,24,3600,0.0,27,26,2,2,1,96.2962963
2006020506,23,3515,0.0,19,17,4,1,2,89.47368421
2006020506,6,3600,0.0,39,39,6,2,0,100.0
2006020507,5,3854,0.0,32,29,6,2,3,90.625
2006020507,11,3900,0.0,39,36,5,2,3,92.30769231
2006020508,4,3506,0.0,37,33,13,1,4,89.18918919
2006020508,8,3600,0.0,28,26,3,2,2,92.85714286
2006020509,14,3600,2.0,18,16,0,2,2,88.88888889
2006020509,9,3584,2.0,29,26,8,1,3,89.65517241
2006020510,3,3552,0.0,36,33,3,3,3,91.66666667
2006020510,13,3600,0.0,32,30,11,3,2,93.75
2006020511,26,3506,2.0,21,17,2,0,4,80.95238095
2006020511,19,3600,0.0,25,23,2,0,2,92.0
2006020512,7,3596,0.0,31,29,7,0,2,93.5483871
2006020512,18,1187,0.0,10,8,4,0,2,80.0
2006020512,18,2392,2.0,26,21,9,0,5,80.76923077
2006020513,20,3600,0.0,32,26,3,1,6,81.25
2006020513,21,3600,0.0,32,29,3,1,3,90.625
2006020514,22,3591,0.0,23,21,9,0,2,91.30434783
2006020514,27,3529,0.0,31,28,8,1,3,90.32258065
2006020515,25,3600,2.0,20,20,6,0,0,100.0
2006020515,28,3598,0.0,26,23,6,0,3,88.46153846
2006020516,1,3596,0.0,36,35,5,0,1,97.22222222
2006020516,15,3591,0.0,24,20,2,1,4,83.33333333
2006020517,2,3597,0.0,35,30,8,1,5,85.71428571
2006020517,12,3598,0.0,25,24,5,4,1,96.0
2006020518,23,3548,0.0,22,19,3,1,3,86.36363636
2006020518,29,1330,0.0,10,10,1,0,0,100.0
2006020518,29,2246,0.0,23,21,4,0,2,91.30434783
2006020519,30,3531,0.0,25,22,0,1,3,88.0
2006020519,17,3593,0.0,35,34,5,1,1,97.14285714
2006020520,10,3447,0.0,25,22,0,2,3,88.0
2006020520,16,3594,0.0,26,25,9,1,1,96.15384615
2006020521,9,3575,0.0,29,26,1,2,3,89.65517241
2006020521,4,3573,0.0,41,36,6,2,5,87.80487805
2006020522,8,3562,0.0,31,27,13,0,4,87.09677419
2006020522,6,3600,0.0,22,20,2,3,2,90.90909091
2006020523,15,3587,0.0,37,35,4,0,2,94.59459459
2006020523,10,3553,0.0,27,24,6,0,3,88.88888889
2006020524,29,3600,0.0,23,19,5,4,4,82.60869565
2006020524,2,3600,0.0,26,26,7,2,0,100.0
2006020525,1,3561,0.0,26,22,3,0,4,84.61538462
2006020525,11,3577,0.0,38,36,9,1,2,94.73684211
2006020526,3,3548,0.0,26,22,4,1,4,84.61538462
2006020526,14,2398,0.0,16,13,2,0,3,81.25
2006020526,14,1200,0.0,12,12,2,0,0,100.0
2006020527,12,3719,0.0,36,34,8,1,2,94.44444444
2006020527,13,3719,0.0,17,14,4,1,3,82.35294118
2006020528,7,3689,0.0,32,29,3,0,3,90.625
2006020528,19,3695,0.0,23,21,1,0,2,91.30434783
2006020529,26,1157,0.0,13,12,7,0,1,92.30769231
2006020529,26,2441,17.0,27,21,6,1,6,77.77777778
2006020529,18,3600,0.0,34,34,17,0,0,100.0
2006020530,17,3645,0.0,35,32,6,2,3,91.42857143
2006020530,30,3645,0.0,32,30,4,0,2,93.75
2006020531,22,3552,0.0,26,23,6,1,3,88.46153846
2006020531,25,3581,0.0,22,20,3,0,2,90.90909091
2006020532,16,3523,0.0,22,19,6,0,3,86.36363636
2006020532,21,3600,0.0,19,17,3,0,2,89.47368421
2006020533,24,3473,0.0,32,30,2,2,2,93.75
2006020533,27,3593,0.0,29,29,6,1,0,100.0
2006020534,20,3559,0.0,30,27,5,0,3,90.0
2006020534,28,3595,0.0,22,21,0,0,1,95.45454545
2006020535,15,450,0.0,6,2,0,0,4,33.33333333
2006020535,15,3149,0.0,33,31,14,1,2,93.93939394
2006020535,7,3557,0.0,26,23,5,0,3,88.46153846
2006020536,13,3588,0.0,29,26,5,0,3,89.65517241
2006020536,12,3599,0.0,27,25,2,0,2,92.59259259
2006020537,14,3591,0.0,29,27,7,1,2,93.10344828
2006020537,11,3600,0.0,25,24,4,0,1,96.0
2006020538,6,3786,0.0,42,37,5,1,5,88.0952381
2006020538,29,3749,0.0,26,22,6,1,4,84.61538462
2006020539,25,3533,0.0,24,22,2,1,2,91.66666667
2006020539,16,3600,0.0,21,20,1,1,1,95.23809524
2006020540,30,3549,0.0,36,32,4,0,4,88.88888889
2006020540,10,3585,0.0,21,18,5,0,3,85.71428571
2006020541,5,3600,0.0,29,26,7,0,3,89.65517241
2006020541,1,3593,0.0,26,26,5,3,0,100.0
2006020542,3,3509,0.0,38,36,8,0,2,94.73684211
2006020542,2,3588,0.0,28,28,1,3,0,100.0
2006020543,19,3900,0.0,29,27,5,2,2,93.10344828
2006020543,18,3890,0.0,32,30,5,0,2,93.75
2006020544,23,3599,0.0,27,26,10,0,1,96.2962963
2006020544,20,3600,0.0,28,25,5,1,3,89.28571429
2006020545,27,3900,0.0,37,34,5,0,3,91.89189189
2006020545,26,3851,0.0,30,27,1,0,3,90.0
2006020546,24,2184,0.0,17,14,4,1,3,82.35294118
2006020546,24,1416,0.0,4,4,2,0,0,100.0
2006020546,28,3510,0.0,30,26,8,0,4,86.66666667
2006020547,8,3600,0.0,31,30,6,0,1,96.77419355
2006020547,15,3538,0.0,26,23,4,2,3,88.46153846
2006020548,2,3519,0.0,29,27,5,1,2,93.10344828
2006020548,9,3596,0.0,18,18,1,1,0,100.0
2006020549,11,3600,0.0,37,35,17,1,2,94.59459459
2006020549,5,3526,0.0,30,27,3,3,3,90.0
2006020550,4,2400,0.0,24,22,6,0,2,91.66666667
2006020550,4,1157,0.0,9,8,3,0,1,88.88888889
2006020550,13,3600,0.0,24,23,6,0,1,95.83333333
2006020551,30,3598,0.0,33,30,9,0,3,90.90909091
2006020551,17,3600,0.0,32,31,3,5,1,96.875
2006020552,25,3591,0.0,32,28,3,0,4,87.5
2006020552,21,2512,0.0,22,17,6,1,5,77.27272727
2006020552,21,1043,0.0,5,5,0,0,0,100.0
2006020553,20,3766,0.0,24,18,6,2,6,75.0
2006020553,23,3763,0.0,36,31,7,0,5,86.11111111
2006020554,12,3595,0.0,26,22,3,1,4,84.61538462
2006020554,7,3586,0.0,30,29,6,3,1,96.66666667
2006020555,17,3600,0.0,25,21,4,2,4,84.0
2006020555,29,3582,2.0,35,29,2,1,6,82.85714286
2006020556,4,3600,0.0,45,42,11,1,3,93.33333333
2006020556,14,3545,0.0,26,22,1,1,4,84.61538462
2006020557,26,3591,0.0,39,35,14,1,4,89.74358974
2006020557,22,3498,0.0,37,31,11,1,6,83.78378378
2006020558,27,3600,0.0,29,27,2,1,2,93.10344828
2006020558,28,3566,0.0,23,20,2,1,3,86.95652174
2006020559,24,3556,0.0,26,23,7,1,3,88.46153846
2006020559,12,3600,0.0,27,25,7,2,2,92.59259259
2006020560,3,3544,0.0,28,27,4,2,1,96.42857143
2006020560,9,3587,0.0,27,27,8,0,0,100.0
2006020561,15,3533,0.0,34,30,5,1,4,88.23529412
2006020561,1,3582,0.0,35,32,8,0,3,91.42857143
2006020562,10,3600,0.0,30,26,11,2,4,86.66666667
2006020562,5,3598,0.0,31,30,6,1,1,96.77419355
2006020563,8,3544,0.0,28,25,1,1,3,89.28571429
2006020563,13,3600,0.0,33,32,3,2,1,96.96969697
2006020564,29,3689,0.0,24,20,9,1,4,83.33333333
2006020564,30,3679,0.0,29,26,5,2,3,89.65517241
2006020565,6,3600,0.0,40,37,7,4,3,92.5
2006020565,16,1200,0.0,7,4,0,0,3,57.14285714
2006020565,16,2345,0.0,13,12,5,0,1,92.30769231
2006020566,18,3565,0.0,29,26,7,0,3,89.65517241
2006020566,25,3600,2.0,20,19,5,1,1,95.0
2006020567,19,3600,0.0,32,30,6,0,2,93.75
2006020567,21,3543,0.0,19,16,0,0,3,84.21052632
2006020568,26,3486,0.0,28,24,7,2,4,85.71428571
2006020568,20,3600,0.0,36,32,6,2,4,88.88888889
2006020569,11,3595,0.0,31,28,8,3,3,90.32258065
2006020569,7,3600,0.0,30,29,4,1,1,96.66666667
2006020570,9,3759,0.0,45,43,6,3,2,95.55555556
2006020570,10,3753,0.0,34,31,5,2,3,91.17647059
2006020571,1,3600,2.0,29,29,4,0,0,100.0
2006020571,2,3594,0.0,35,34,9,2,1,97.14285714
2006020572,15,3590,0.0,35,31,16,2,4,88.57142857
2006020572,3,3579,0.0,23,22,10,1,1,95.65217391
2006020573,8,3505,0.0,41,38,7,0,3,92.68292683
2006020573,14,3588,0.0,13,12,0,1,1,92.30769231
2006020574,21,3600,0.0,22,20,8,2,2,90.90909091
2006020574,19,3600,0.0,33,33,5,1,0,100.0
2006020575,6,3600,0.0,25,20,2,2,5,80.0
2006020575,18,3600,0.0,38,38,7,2,0,100.0
2006020576,28,911,0.0,6,3,0,0,3,50.0
2006020576,28,2689,0.0,20,15,5,1,5,75.0
2006020576,27,3600,0.0,40,40,6,0,0,100.0
2006020577,23,3600,0.0,37,35,8,2,2,94.59459459
2006020577,22,3582,0.0,25,19,3,4,6,76.0
2006020578,24,3530,0.0,29,25,13,1,4,86.20689655
2006020578,30,3600,0.0,30,27,9,2,3,90.0
2006020579,26,872,0.0,4,4,0,0,0,100.0
2006020579,26,2728,0.0,32,26,3,1,6,81.25
2006020579,17,3600,0.0,30,28,4,0,2,93.33333333
2006020580,16,3525,0.0,23,21,2,3,2,91.30434783
2006020580,29,3594,0.0,22,21,6,0,1,95.45454545
2006020581,4,3600,2.0,42,40,7,0,2,95.23809524
2006020581,12,3541,0.0,18,14,0,0,4,77.77777778
2006020582,22,3502,0.0,24,20,12,1,4,83.33333333
2006020582,20,3600,0.0,24,22,8,2,2,91.66666667
2006020583,28,3600,0.0,23,21,5,0,2,91.30434783
2006020583,25,2925,0.0,19,18,3,0,1,94.73684211
2006020583,25,545,0.0,10,7,4,2,3,70.0
2006020584,11,3708,0.0,35,33,5,3,2,94.28571429
2006020584,9,3708,0.0,29,26,4,1,3,89.65517241
2006020585,27,3598,0.0,32,30,5,0,2,93.75
2006020585,15,3521,0.0,27,24,6,1,3,88.88888889
2006020586,21,3600,0.0,29,26,3,3,3,89.65517241
2006020586,18,3543,0.0,34,30,9,1,4,88.23529412
2006020587,2,3570,2.0,33,31,2,0,2,93.93939394
2006020587,7,3597,0.0,30,29,2,2,1,96.66666667
2006020588,6,3595,0.0,35,30,8,0,5,85.71428571
2006020588,10,3600,0.0,28,27,6,0,1,96.42857143
2006020589,16,3596,0.0,39,38,13,2,1,97.43589744
2006020589,19,3494,0.0,25,22,5,1,3,88.0
2006020590,14,3509,0.0,26,22,2,1,4,84.61538462
2006020590,8,3597,0.0,23,21,3,1,2,91.30434783
2006020591,3,3896,0.0,23,21,0,0,2,91.30434783
2006020591,1,3900,0.0,25,23,0,0,2,92.0
2006020592,4,3599,0.0,42,40,6,3,2,95.23809524
2006020592,2,3545,0.0,35,32,4,0,3,91.42857143
2006020593,12,3600,0.0,37,34,5,4,3,91.89189189
2006020593,5,3579,0.0,31,31,5,1,0,100.0
2006020594,24,3508,0.0,30,28,5,0,2,93.33333333
2006020594,17,3600,0.0,22,21,2,2,1,95.45454545
2006020595,11,3597,0.0,35,30,16,1,5,85.71428571
2006020595,30,3600,0.0,15,14,1,0,1,93.33333333
2006020596,23,3598,2.0,29,27,8,6,2,93.10344828
2006020596,20,3544,0.0,29,26,12,0,3,89.65517241
2006020597,13,3593,0.0,33,29,7,3,4,87.87878788
2006020597,22,3600,0.0,26,25,5,0,1,96.15384615
2006020598,7,3596,0.0,36,30,5,2,6,83.33333333
2006020598,9,3600,0.0,36,33,1,0,3,91.66666667
2006020599,25,3891,2.0,21,20,11,1,1,95.23809524
2006020599,23,3836,0.0,40,39,16,2,1,97.5
2006020600,29,3600,0.0,32,29,9,0,3,90.625
2006020600,26,3588,0.0,26,26,7,3,0,100.0
2006020601,10,3600,0.0,31,29,7,1,2,93.5483871
2006020601,6,726,0.0,8,6,1,1,2,75.0
2006020601,6,2874,0.0,31,23,1,2,8,74.19354839
2006020602,4,3544,0.0,29,26,5,0,3,89.65517241
2006020602,3,3581,0.0,24,22,3,1,2,91.66666667
2006020603,8,1872,0.0,15,14,2,0,1,93.33333333
2006020603,8,1728,0.0,20,16,4,2,4,80.0
2006020603,15,3595,0.0,28,27,6,1,1,96.42857143
2006020604,27,3595,0.0,29,29,2,3,0,100.0
2006020604,12,3478,0.0,28,26,1,1,2,92.85714286
2006020605,2,3519,0.0,26,22,8,0,4,84.61538462
2006020605,1,3600,0.0,43,40,6,1,3,93.02325581
2006020606,16,3562,0.0,19,17,5,2,2,89.47368421
2006020606,19,3600,0.0,28,28,6,2,0,100.0
2006020607,14,3592,0.0,31,29,5,1,2,93.5483871
2006020607,30,3549,0.0,24,21,1,1,3,87.5
2006020608,13,3870,0.0,29,24,5,1,5,82.75862069
2006020608,20,3848,0.0,42,38,7,3,4,90.47619048
2006020609,25,2386,0.0,17,13,3,3,4,76.47058824
2006020609,25,1500,0.0,13,12,0,0,1,92.30769231
2006020609,22,3812,0.0,35,30,5,1,5,85.71428571
2006020610,17,502,0.0,3,2,0,0,1,66.66666667
2006020610,17,3098,0.0,28,20,5,0,8,71.42857143
2006020610,28,680,0.0,12,9,1,0,3,75.0
2006020610,28,2901,0.0,18,17,3,1,1,94.44444444
2006020611,27,3748,0.0,22,18,7,1,4,81.81818182
2006020611,11,3751,0.0,31,26,7,2,5,83.87096774
2006020612,5,3587,0.0,33,31,6,1,2,93.93939394
2006020612,7,3559,0.0,26,23,6,0,3,88.46153846
2006020613,18,3600,0.0,38,35,5,0,3,92.10526316
2006020613,16,1273,0.0,13,9,2,0,4,69.23076923
2006020613,16,2324,0.0,17,13,3,1,4,76.47058824
2006020614,14,3507,0.0,32,28,2,0,4,87.5
2006020614,21,3600,0.0,28,26,1,0,2,92.85714286
2006020615,22,3684,0.0,24,21,3,1,3,87.5
2006020615,23,3684,0.0,28,26,4,0,2,92.85714286
2006020616,29,3566,2.0,36,33,5,2,3,91.66666667
2006020616,24,3549,0.0,33,29,6,1,4,87.87878788
2006020617,4,3559,0.0,26,22,4,4,4,84.61538462
2006020617,6,3600,0.0,32,29,8,2,3,90.625
2006020618,1,3600,0.0,35,33,7,1,2,94.28571429
2006020618,9,3533,0.0,29,26,4,0,3,89.65517241
2006020619,3,3600,0.0,24,21,5,0,3,87.5
2006020619,8,3557,0.0,34,30,8,4,4,88.23529412
2006020620,7,3600,0.0,35,32,8,2,3,91.42857143
2006020620,10,3495,0.0,29,25,3,3,4,86.20689655
2006020621,11,3882,0.0,37,34,17,1,3,91.89189189
2006020621,15,3880,0.0,22,20,6,2,2,90.90909091
2006020622,2,3598,2.0,27,23,3,3,4,85.18518519
2006020622,12,3596,0.0,35,33,7,0,2,94.28571429
2006020623,19,3519,0.0,24,21,3,0,3,87.5
2006020623,19,8,0.0,0,0,0,0,0,
2006020623,18,3595,0.0,37,35,15,0,2,94.59459459
2006020624,21,3900,0.0,25,24,5,0,1,96.0
2006020624,30,3900,0.0,27,26,5,1,1,96.2962963
2006020625,25,3548,0.0,20,17,4,0,3,85.0
2006020625,20,3600,0.0,33,31,3,0,2,93.93939394
2006020626,17,3559,0.0,33,30,8,0,3,90.90909091
2006020626,26,3599,0.0,34,32,4,0,2,94.11764706
2006020627,29,3600,0.0,33,28,13,1,5,84.84848485
2006020627,28,3587,0.0,19,17,2,0,2,89.47368421
2006020628,4,3594,0.0,43,37,13,0,6,86.04651163
2006020628,9,3600,0.0,21,20,2,2,1,95.23809524
2006020629,1,3595,0.0,28,28,1,0,0,100.0
2006020629,8,3600,0.0,37,34,11,1,3,91.89189189
2006020630,27,3590,0.0,34,32,7,2,2,94.11764706
2006020630,16,3498,0.0,17,13,1,0,4,76.47058824
2006020631,14,3900,0.0,22,20,3,1,2,90.90909091
2006020631,5,3900,0.0,29,27,8,1,2,93.10344828
2006020632,17,3488,0.0,26,23,2,3,3,88.46153846
2006020632,24,3593,0.0,35,33,12,0,2,94.28571429
2006020633,13,3900,0.0,29,26,3,0,3,89.65517241
2006020633,23,3900,0.0,36,33,2,2,3,91.66666667
2006020634,22,3673,2.0,35,34,4,0,1,97.14285714
2006020634,26,3614,0.0,29,27,4,2,2,93.10344828
2006020635,2,3589,0.0,31,28,6,2,3,90.32258065
2006020635,3,3469,0.0,26,21,2,1,5,80.76923077
2006020636,4,3590,0.0,31,25,4,0,6,80.64516129
2006020636,15,3600,0.0,33,31,9,0,2,93.93939394
2006020637,19,3885,0.0,22,19,4,0,3,86.36363636
2006020637,29,3895,0.0,24,21,4,0,3,87.5
2006020638,12,3600,0.0,30,29,1,1,1,96.66666667
2006020638,10,3561,2.0,28,25,7,0,3,89.28571429
2006020639,11,3497,0.0,34,30,8,2,4,88.23529412
2006020639,8,3600,0.0,30,28,7,1,2,93.33333333
2006020640,6,3576,0.0,35,31,4,0,4,88.57142857
2006020640,9,3596,0.0,25,23,1,2,2,92.0
2006020641,5,3561,0.0,24,21,3,1,3,87.5
2006020641,14,3595,0.0,31,29,7,1,2,93.5483871
2006020642,24,3792,0.0,24,19,3,1,5,79.16666667
2006020642,18,3792,0.0,31,27,3,2,4,87.09677419
2006020643,27,3600,0.0,31,29,6,0,2,93.5483871
2006020643,25,3554,0.0,27,23,4,1,4,85.18518519
2006020644,17,3889,0.0,25,22,6,0,3,88.0
2006020644,21,3890,0.0,43,40,10,1,3,93.02325581
2006020645,30,3589,0.0,25,22,5,1,3,88.0
2006020645,20,3600,0.0,26,26,8,1,0,100.0
2006020646,19,3600,0.0,26,24,2,0,2,92.30769231
2006020646,1,3529,0.0,23,20,1,0,3,86.95652174
2006020647,5,3600,0.0,39,34,3,2,5,87.17948718
2006020647,13,3587,0.0,25,23,4,0,2,92.0
2006020648,7,3595,0.0,35,34,3,3,1,97.14285714
2006020648,16,3549,0.0,29,27,11,0,2,93.10344828
2006020649,22,3600,0.0,34,32,4,0,2,94.11764706
2006020649,28,3558,0.0,16,13,5,0,3,81.25
2006020650,2,3900,0.0,42,38,2,0,4,90.47619048
2006020650,6,3897,0.0,35,31,2,1,4,88.57142857
2006020651,10,3600,0.0,24,22,4,0,2,91.66666667
2006020651,7,3507,0.0,28,24,3,0,4,85.71428571
2006020652,9,3600,0.0,42,38,7,2,4,90.47619048
2006020652,3,1950,0.0,27,23,0,0,4,85.18518519
2006020652,3,1611,0.0,5,4,0,0,1,80.0
2006020653,8,3600,0.0,36,34,3,2,2,94.44444444
2006020653,4,3485,0.0,26,22,7,1,4,84.61538462
2006020654,13,3556,0.0,26,21,3,1,5,80.76923077
2006020654,12,2397,0.0,31,28,5,0,3,90.32258065
2006020654,12,1187,0.0,7,6,0,0,1,85.71428571
2006020655,15,3533,0.0,25,20,4,0,5,80.0
2006020655,14,3600,0.0,22,18,1,0,4,81.81818182
2006020656,24,3600,0.0,18,17,2,2,1,94.44444444
2006020656,25,3600,2.0,24,19,5,0,5,79.16666667
2006020657,20,3600,0.0,30,27,6,2,3,90.0
2006020657,21,1675,0.0,9,7,3,0,2,77.77777778
2006020657,21,1921,0.0,17,12,1,2,5,70.58823529
2006020658,17,3586,0.0,16,15,6,0,1,93.75
2006020658,27,3576,0.0,45,40,13,4,5,88.88888889
2006020659,30,3592,0.0,26,24,2,0,2,92.30769231
2006020659,23,3600,0.0,38,33,9,2,5,86.84210526
2006020660,28,3598,0.0,24,22,3,0,2,91.66666667
2006020660,26,3577,0.0,30,26,4,0,4,86.66666667
2006020661,11,3518,0.0,34,32,10,2,2,94.11764706
2006020661,1,3600,4.0,26,25,1,0,1,96.15384615
2006020662,29,3519,0.0,24,22,3,0,2,91.66666667
2006020662,18,3591,0.0,22,22,3,0,0,100.0
2006020663,30,3600,0.0,34,32,8,3,2,94.11764706
2006020663,22,3517,0.0,26,23,5,0,3,88.46153846
2006020664,8,2189,0.0,8,6,0,1,2,75.0
2006020664,8,1411,0.0,25,19,3,0,6,76.0
2006020664,9,3597,0.0,40,37,6,1,3,92.5
2006020665,6,3470,0.0,38,35,9,1,3,92.10526316
2006020665,3,3596,0.0,25,24,4,2,1,96.0
2006020666,5,3586,0.0,18,15,1,2,3,83.33333333
2006020666,4,3576,0.0,38,34,8,0,4,89.47368421
2006020667,26,2400,0.0,20,15,6,0,5,75.0
2006020667,26,1157,0.0,5,4,0,1,1,80.0
2006020667,19,3600,0.0,32,27,6,2,5,84.375
2006020668,14,3600,0.0,34,32,4,2,2,94.11764706
2006020668,7,3550,0.0,23,20,5,2,3,86.95652174
2006020669,23,3593,0.0,36,35,13,2,1,97.22222222
2006020669,10,3592,2.0,21,15,9,1,6,71.42857143
2006020670,1,3820,0.0,28,27,3,1,1,96.42857143
2006020670,2,3757,0.0,30,28,4,0,2,93.33333333
2006020671,11,3887,0.0,27,24,5,0,3,88.88888889
2006020671,12,3888,0.0,26,23,5,1,3,88.46153846
2006020672,16,3450,0.0,31,26,9,0,5,83.87096774
2006020672,17,3573,0.0,36,33,4,3,3,91.66666667
2006020673,18,3600,0.0,40,39,12,2,1,97.5
2006020673,29,2047,0.0,5,4,0,0,1,80.0
2006020673,29,1553,0.0,12,9,1,0,3,75.0
2006020674,15,1200,0.0,13,11,4,0,2,84.61538462
2006020674,15,2400,0.0,41,36,7,1,5,87.80487805
2006020674,13,3600,0.0,17,14,1,0,3,82.35294118
2006020675,28,3600,0.0,30,29,10,0,1,96.66666667
2006020675,27,3596,0.0,20,16,0,1,4,80.0
2006020676,22,3525,0.0,21,18,6,0,3,85.71428571
2006020676,20,3600,0.0,22,21,4,0,1,95.45454545
2006020677,21,3900,0.0,40,38,7,1,2,95.0
2006020677,24,3900,0.0,17,15,2,1,2,88.23529412
2006020678,30,3894,0.0,41,38,11,2,3,92.68292683
2006020678,16,3900,0.0,27,24,9,0,3,88.88888889
2006020679,14,3598,0.0,36,33,9,2,3,91.66666667
2006020679,2,3530,2.0,24,20,5,3,4,83.33333333
2006020680,7,3900,0.0,37,35,4,1,2,94.59459459
2006020680,6,3900,0.0,36,34,2,0,2,94.44444444
2006020681,26,3518,0.0,25,22,8,0,3,88.0
2006020681,25,3600,0.0,21,20,5,0,1,95.23809524
2006020682,19,3886,0.0,43,39,13,0,4,90.69767442
2006020682,27,3889,0.0,26,22,2,3,4,84.61538462
2006020683,20,3563,0.0,33,29,4,0,4,87.87878788
2006020683,18,3598,0.0,23,20,1,2,3,86.95652174
2006020684,8,3578,0.0,39,37,3,3,2,94.87179487
2006020684,17,3597,0.0,23,23,3,0,0,100.0
2006020685,21,3539,0.0,42,39,10,0,3,92.85714286
2006020685,28,3568,0.0,27,26,1,2,1,96.2962963
2006020686,2,3600,0.0,22,17,6,0,5,77.27272727
2006020686,5,3600,0.0,33,31,7,1,2,93.93939394
2006020687,26,2287,0.0,20,17,2,0,3,85.0
2006020687,26,1313,0.0,9,6,0,0,3,66.66666667
2006020687,11,3600,0.0,30,28,2,0,2,93.33333333
2006020688,23,3564,0.0,30,30,5,1,0,100.0
2006020688,8,3590,0.0,24,20,6,2,4,83.33333333
2006020689,15,3595,0.0,34,29,4,2,5,85.29411765
2006020689,9,3600,0.0,30,28,3,1,2,93.33333333
2006020690,3,3552,0.0,32,31,7,0,1,96.875
2006020690,1,3597,0.0,26,26,0,1,0,100.0
2006020691,10,3571,0.0,23,21,0,0,2,91.30434783
2006020691,14,3573,0.0,27,24,0,0,3,88.88888889
2006020692,12,3702,0.0,20,18,2,1,2,90.0
2006020692,13,3707,0.0,27,24,7,0,3,88.88888889
2006020693,22,3594,0.0,29,28,14,1,1,96.55172414
2006020693,30,3570,2.0,18,16,3,1,2,88.88888889
2006020694,29,1994,0.0,13,12,1,0,1,92.30769231
2006020694,29,1752,0.0,15,12,1,0,3,80.0
2006020694,16,3751,0.0,18,13,1,0,5,72.22222222
2006020695,19,3589,0.0,32,30,6,0,2,93.75
2006020695,24,1832,0.0,13,9,4,1,4,69.23076923
2006020695,24,1698,0.0,6,5,1,0,1,83.33333333
2006020696,6,3572,2.0,31,26,4,1,5,83.87096774
2006020696,7,3600,0.0,28,25,4,0,3,89.28571429
2006020697,18,2228,0.0,19,16,2,1,3,84.21052632
2006020697,18,1292,0.0,8,6,1,0,2,75.0
2006020697,17,3600,0.0,17,14,1,0,3,82.35294118
2006020698,20,3591,0.0,23,20,6,1,3,86.95652174
2006020698,25,3600,0.0,20,18,2,0,2,90.0
2006020699,27,3559,0.0,29,25,3,1,4,86.20689655
2006020699,21,3600,0.0,32,29,5,0,3,90.625
2006020700,5,3891,0.0,44,40,10,1,4,90.90909091
2006020700,6,3883,2.0,35,31,8,0,4,88.57142857
2006020701,2,3600,2.0,31,29,7,3,2,93.5483871
2006020701,4,3525,0.0,36,32,7,0,4,88.88888889
2006020702,15,3600,0.0,36,34,2,0,2,94.44444444
2006020702,12,3563,0.0,28,25,4,0,3,89.28571429
2006020703,8,3600,0.0,45,44,4,0,1,97.77777778
2006020703,11,3600,0.0,33,29,6,1,4,87.87878788
2006020704,23,3600,0.0,35,34,12,1,1,97.14285714
2006020704,9,3528,0.0,14,12,0,0,2,85.71428571
2006020705,14,3896,0.0,28,26,5,1,2,92.85714286
2006020705,1,3900,0.0,28,26,7,1,2,92.85714286
2006020706,10,3600,0.0,41,39,4,1,2,95.12195122
2006020706,13,1151,0.0,5,5,0,0,0,100.0
2006020706,13,2400,0.0,14,11,4,0,3,78.57142857
2006020707,29,3597,0.0,26,22,0,0,4,84.61538462
2006020707,18,3589,0.0,33,33,8,0,0,100.0
2006020708,24,3599,0.0,20,16,1,0,4,80.0
2006020708,22,3600,2.0,24,23,4,1,1,95.83333333
2006020709,19,3600,0.0,35,34,12,2,1,97.14285714
2006020709,26,1094,0.0,10,8,0,1,2,80.0
2006020709,26,2388,0.0,18,17,3,1,1,94.44444444
2006020710,27,3566,0.0,32,28,4,1,4,87.5
2006020710,28,3581,0.0,25,23,2,2,2,92.0
2006020711,17,3489,0.0,27,24,4,1,3,88.88888889
2006020711,29,3583,0.0,42,41,4,3,1,97.61904762
2006020712,23,3896,0.0,36,33,5,0,3,91.66666667
2006020712,7,3877,0.0,28,25,5,1,3,89.28571429
2006020713,30,3600,0.0,24,24,5,0,0,100.0
2006020713,16,3597,0.0,26,23,4,0,3,88.46153846
2006020714,24,3512,0.0,22,19,9,0,3,86.36363636
2006020714,20,3600,0.0,24,22,4,0,2,91.66666667
2006020715,4,3890,0.0,38,35,9,0,3,92.10526316
2006020715,1,3851,0.0,23,20,2,2,3,86.95652174
2006020716,11,3599,0.0,30,29,3,0,1,96.66666667
2006020716,3,3575,0.0,31,29,2,0,2,93.5483871
2006020717,13,3583,0.0,18,17,2,0,1,94.44444444
2006020717,15,3523,0.0,41,38,20,1,3,92.68292683
2006020718,9,3587,0.0,18,18,3,1,0,100.0
2006020718,6,3493,0.0,38,36,15,4,2,94.73684211
2006020719,7,3556,0.0,31,27,5,0,4,87.09677419
2006020719,8,3588,0.0,27,24,3,1,3,88.88888889
2006020720,10,2390,0.0,21,16,10,0,5,76.19047619
2006020720,10,1200,0.0,9,6,3,0,3,66.66666667
2006020720,5,3592,0.0,28,26,7,1,2,92.85714286
2006020721,16,3574,0.0,34,29,6,1,5,85.29411765
2006020721,18,3592,0.0,30,27,4,2,3,90.0
2006020722,25,3900,0.0,26,25,0,1,1,96.15384615
2006020722,30,3481,0.0,23,22,2,0,1,95.65217391
2006020722,30,419,0.0,4,4,0,0,0,100.0
2006020723,14,3900,0.0,35,30,1,0,5,85.71428571
2006020723,12,3897,0.0,29,24,0,0,5,82.75862069
2006020724,17,3570,0.0,30,28,5,0,2,93.33333333
2006020724,21,3595,0.0,28,27,5,2,1,96.42857143
2006020725,20,3600,0.0,32,32,5,1,0,100.0
2006020725,22,981,0.0,7,7,2,0,0,100.0
2006020725,22,2619,4.0,16,12,2,0,4,75.0
2006020726,27,3589,0.0,30,28,14,0,2,93.33333333
2006020726,26,2600,2.0,24,23,5,1,1,95.83333333
2006020726,26,912,0.0,11,9,1,0,2,81.81818182
2006020727,19,3600,0.0,31,31,4,1,0,100.0
2006020727,28,3507,0.0,13,12,0,0,1,92.30769231
2006020728,15,3600,0.0,41,35,13,2,6,85.36585366
2006020728,12,3600,0.0,26,24,7,2,2,92.30769231
2006020729,7,3579,0.0,26,23,5,1,3,88.46153846
2006020729,29,3600,0.0,38,36,7,1,2,94.73684211
2006020730,2,335,0.0,5,2,0,0,3,40.0
2006020730,2,3444,0.0,28,26,4,0,2,92.85714286
2006020730,11,3766,0.0,33,29,1,0,4,87.87878788
2006020731,1,3597,0.0,28,28,5,0,0,100.0
2006020731,14,3565,0.0,24,23,5,1,1,95.83333333
2006020732,17,3669,2.0,20,18,2,0,2,90.0
2006020732,19,3669,0.0,29,28,3,2,1,96.55172414
2006020733,20,3897,0.0,41,40,2,3,1,97.56097561
2006020733,30,3900,0.0,24,23,0,0,1,95.83333333
2006020734,18,3600,0.0,31,30,7,0,1,96.77419355
2006020734,16,3577,0.0,30,28,0,0,2,93.33333333
2006020735,5,3894,0.0,35,32,2,3,3,91.42857143
2006020735,25,3900,0.0,27,24,1,1,3,88.88888889
2006020736,27,3900,0.0,27,23,4,2,4,85.18518519
2006020736,21,3900,0.0,29,25,7,1,4,86.20689655
2006020737,28,3585,0.0,21,20,2,1,1,95.23809524
2006020737,22,3566,0.0,38,33,9,0,5,86.84210526
2006020738,26,3703,2.0,39,37,3,1,2,94.87179487
2006020738,23,3708,0.0,43,40,8,0,3,93.02325581
2006020739,3,3600,0.0,18,17,0,0,1,94.44444444
2006020739,4,3541,0.0,35,33,11,0,2,94.28571429
2006020740,8,3600,0.0,29,25,5,0,4,86.20689655
2006020740,10,3600,0.0,28,27,8,2,1,96.42857143
2006020741,6,3531,0.0,35,33,2,0,2,94.28571429
2006020741,9,3577,0.0,30,29,6,0,1,96.66666667
2006020742,7,3551,0.0,31,26,6,2,5,83.87096774
2006020742,2,3600,0.0,30,27,4,0,3,90.0
2006020743,12,3600,0.0,23,16,3,2,7,69.56521739
2006020743,15,3573,0.0,37,34,11,0,3,91.89189189
2006020744,30,3550,0.0,22,19,9,0,3,86.36363636
2006020744,29,1430,0.0,16,15,3,0,1,93.75
2006020744,29,2169,0.0,21,20,7,2,1,95.23809524
2006020745,1,3544,0.0,31,28,0,0,3,90.32258065
2006020745,13,3600,0.0,32,30,2,0,2,93.75
2006020746,18,3600,0.0,29,26,3,1,3,89.65517241
2006020746,19,3540,0.0,23,18,4,2,5,78.26086957
2006020747,5,3600,0.0,24,22,4,2,2,91.66666667
2006020747,27,3600,0.0,32,25,8,0,7,78.125
2006020748,26,3538,0.0,31,27,1,0,4,87.09677419
2006020748,22,3600,0.0,35,32,7,1,3,91.42857143
2006020749,20,3773,0.0,40,36,14,0,4,90.0
2006020749,16,3744,0.0,22,19,5,4,3,86.36363636
2006020750,4,3593,0.0,38,37,6,1,1,97.36842105
2006020750,11,3551,0.0,23,21,2,1,2,91.30434783
2006020751,21,3600,0.0,41,38,1,1,3,92.68292683
2006020751,17,3554,0.0,12,11,1,0,1,91.66666667
2006020752,25,3586,0.0,28,24,6,0,4,85.71428571
2006020752,24,3600,0.0,31,30,8,1,1,96.77419355
2006020753,28,3500,0.0,23,21,3,2,2,91.30434783
2006020753,23,3600,0.0,39,38,11,0,1,97.43589744
2006020754,3,3600,0.0,30,29,4,0,1,96.66666667
2006020754,6,1601,0.0,15,12,5,0,3,80.0
2006020754,6,1999,0.0,14,11,3,0,3,78.57142857
2006020755,9,3488,0.0,28,25,5,0,3,89.28571429
2006020755,8,3600,0.0,27,26,6,1,1,96.2962963
2006020756,6,1200,0.0,12,11,0,1,1,91.66666667
2006020756,6,2400,0.0,23,17,3,1,6,73.91304348
2006020756,7,3600,2.0,26,25,6,0,1,96.15384615
2006020757,14,3900,0.0,32,29,10,0,3,90.625
2006020757,4,3885,0.0,33,30,10,0,3,90.90909091
2006020758,10,3596,0.0,29,28,3,0,1,96.55172414
2006020758,12,3475,0.0,37,34,6,1,3,91.89189189
2006020759,1,3886,0.0,40,36,6,0,4,90.0
2006020759,11,3897,0.0,40,36,4,2,4,90.0
2006020760,15,3528,0.0,38,35,12,0,3,92.10526316
2006020760,9,3600,0.0,37,35,16,2,2,94.59459459
2006020761,17,3777,0.0,19,16,1,1,3,84.21052632
2006020761,2,3777,0.0,35,31,6,0,4,88.57142857
2006020762,13,3600,0.0,25,22,6,0,3,88.0
2006020762,5,3600,0.0,32,32,5,0,0,100.0
2006020763,30,3594,0.0,31,29,3,0,2,93.5483871
2006020763,19,3574,0.0,29,25,6,1,4,86.20689655
2006020764,18,3550,0.0,35,31,8,0,4,88.57142857
2006020764,21,3600,0.0,37,34,5,0,3,91.89189189
2006020765,26,3584,0.0,33,29,3,2,4,87.87878788
2006020765,20,3600,2.0,36,35,7,1,1,97.22222222
2006020766,29,3900,0.0,37,35,2,1,2,94.59459459
2006020766,23,3900,0.0,28,26,2,0,2,92.85714286
2006020767,25,3848,2.0,17,15,5,1,2,88.23529412
2006020767,28,3891,0.0,28,26,4,1,2,92.85714286
2006020768,10,3579,0.0,38,37,4,2,1,97.36842105
2006020768,3,3582,0.0,28,26,3,0,2,92.85714286
2006020769,29,3599,0.0,37,32,9,0,5,86.48648649
2006020769,22,3577,0.0,22,20,2,0,2,90.90909091
2006020770,27,3549,0.0,40,38,6,4,2,95.0
2006020770,24,3586,0.0,25,24,2,0,1,96.0
2006020771,7,3600,2.0,34,33,9,4,1,97.05882353
2006020771,6,3524,0.0,28,25,3,0,3,89.28571429
2006020772,1,3815,0.0,36,31,8,0,5,86.11111111
2006020772,4,3843,0.0,35,29,8,3,6,82.85714286
2006020773,14,3600,0.0,31,31,5,0,0,100.0
2006020773,12,3588,0.0,20,16,0,1,4,80.0
2006020774,2,3600,0.0,32,30,6,1,2,93.75
2006020774,11,3586,0.0,30,26,6,0,4,86.66666667
2006020775,8,3893,0.0,33,29,8,0,4,87.87878788
2006020775,5,3900,0.0,44,40,14,1,4,90.90909091
2006020776,15,3589,4.0,32,26,6,0,6,81.25
2006020776,13,3592,2.0,30,27,7,1,3,90.0
2006020777,30,3599,0.0,30,27,1,2,3,90.0
2006020777,21,3567,0.0,36,32,5,0,4,88.88888889
2006020778,18,3528,0.0,31,28,3,1,3,90.32258065
2006020778,27,3600,0.0,30,28,7,0,2,93.33333333
2006020779,22,3532,0.0,33,29,10,4,4,87.87878788
2006020779,23,3591,0.0,32,29,7,2,3,90.625
2006020780,16,3657,0.0,33,31,11,1,2,93.93939394
2006020780,26,3653,0.0,31,28,10,1,3,90.32258065
2006020781,25,3600,0.0,20,18,5,0,2,90.0
2006020781,28,1200,0.0,8,6,0,0,2,75.0
2006020781,28,2297,0.0,8,6,3,0,2,75.0
2006020782,19,3570,0.0,28,24,5,2,4,85.71428571
2006020782,17,3600,0.0,27,24,4,3,3,88.88888889
2006020783,29,1542,0.0,8,7,4,1,1,87.5
2006020783,29,2058,0.0,16,11,2,1,5,68.75
2006020783,20,3570,0.0,22,20,5,2,2,90.90909091
2006020784,2,3580,0.0,30,28,11,1,2,93.33333333
2006020784,8,3531,0.0,27,23,5,0,4,85.18518519
2006020785,15,3583,0.0,19,18,5,1,1,94.73684211
2006020785,5,3600,0.0,30,30,5,1,0,100.0
2006020786,22,3598,0.0,39,37,10,0,2,94.87179487
2006020786,21,3515,0.0,28,25,6,3,3,89.28571429
2006020787,16,3472,0.0,31,27,4,0,4,87.09677419
2006020787,28,3581,0.0,22,20,1,2,2,90.90909091
2006020788,10,3900,0.0,32,30,7,2,2,93.75
2006020788,9,3900,0.0,38,36,5,2,2,94.73684211
2006020789,4,3181,0.0,33,32,3,1,1,96.96969697
2006020789,4,419,0.0,5,4,0,0,1,80.0
2006020789,11,3554,0.0,23,19,1,1,4,82.60869565
2006020790,7,3562,0.0,37,34,7,0,3,91.89189189
2006020790,1,3600,0.0,17,15,3,0,2,88.23529412
2006020791,3,3543,0.0,41,38,8,0,3,92.68292683
2006020791,14,3589,0.0,26,24,3,5,2,92.30769231
2006020792,26,3600,0.0,40,40,3,1,0,100.0
2006020792,13,841,0.0,6,3,1,0,3,50.0
2006020792,13,2755,0.0,17,13,1,0,4,76.47058824
2006020793,25,3494,0.0,19,17,0,1,2,89.47368421
2006020793,19,3600,0.0,22,22,1,1,0,100.0
2006020794,24,3600,0.0,20,17,7,0,3,85.0
2006020794,18,3594,0.0,36,36,4,3,0,100.0
2006020795,6,3704,0.0,37,34,14,1,3,91.89189189
2006020795,12,3689,0.0,33,29,7,0,4,87.87878788
2006020796,30,3597,0.0,29,29,2,0,0,100.0
2006020796,27,3553,0.0,30,29,6,2,1,96.66666667
2006020797,23,3472,0.0,42,38,16,3,4,90.47619048
2006020797,20,3600,0.0,28,25,5,0,3,89.28571429
2006020798,2,3900,0.0,31,30,4,0,1,96.77419355
2006020798,15,3900,0.0,32,31,7,1,1,96.875
2006020799,5,3696,0.0,29,25,2,1,4,86.20689655
2006020799,8,3719,0.0,34,31,10,0,3,91.17647059
2006020800,17,3600,0.0,20,17,0,0,3,85.0
2006020800,3,3532,0.0,26,22,4,0,4,84.61538462
2006020801,6,3900,0.0,34,32,4,0,2,94.11764706
2006020801,15,3897,0.0,24,22,1,0,2,91.66666667
2006020802,7,3888,0.0,30,27,3,1,3,90.0
2006020802,11,3900,2.0,28,25,4,1,3,89.28571429
2006020803,27,3600,0.0,28,28,2,1,0,100.0
2006020803,29,3600,0.0,27,24,6,1,3,88.88888889
2006020804,12,3597,0.0,26,25,4,0,1,96.15384615
2006020804,8,3555,0.0,34,32,2,2,2,94.11764706
2006020805,3,3882,0.0,21,19,2,1,2,90.47619048
2006020805,1,3900,0.0,30,28,6,3,2,93.33333333
2006020806,18,3566,0.0,25,22,4,1,3,88.0
2006020806,5,3567,0.0,26,25,4,3,1,96.15384615
2006020807,26,3900,0.0,29,27,4,1,2,93.10344828
2006020807,14,3900,0.0,31,29,1,0,2,93.5483871
2006020808,10,3593,0.0,20,19,6,0,1,95.0
2006020808,19,3521,0.0,16,14,1,0,2,87.5
2006020809,30,3600,0.0,35,31,7,1,4,88.57142857
2006020809,25,3112,0.0,15,15,1,1,0,100.0
2006020809,25,488,0.0,7,5,0,0,2,71.42857143
2006020810,13,3625,2.0,41,36,9,1,5,87.80487805
2006020810,21,3574,2.0,32,28,7,2,4,87.5
2006020811,16,3843,0.0,26,24,3,1,2,92.30769231
2006020811,20,3897,0.0,30,28,10,1,2,93.33333333
2006020812,23,3600,0.0,30,28,0,0,2,93.33333333
2006020812,22,3566,0.0,24,20,5,2,4,83.33333333
2006020813,24,3600,0.0,38,34,8,0,4,89.47368421
2006020813,28,3586,0.0,30,24,2,1,6,80.0
2006020814,9,3572,0.0,37,34,5,0,3,91.89189189
2006020814,7,3600,2.0,30,28,5,0,2,93.33333333
2006020815,4,3495,0.0,37,35,5,2,2,94.59459459
2006020815,2,3600,0.0,27,27,2,1,0,100.0
2006020816,27,3600,0.0,48,44,13,0,4,91.66666667
2006020816,17,3600,0.0,22,20,5,0,2,90.90909091
2006020817,16,3600,0.0,34,34,8,0,0,100.0
2006020817,23,3547,0.0,21,20,0,0,1,95.23809524
2006020818,28,3592,0.0,22,20,5,0,2,90.90909091
2006020818,24,3535,0.0,29,26,9,2,3,89.65517241
2006020819,12,3600,0.0,36,34,7,3,2,94.44444444
2006020819,6,3548,0.0,35,31,4,3,4,88.57142857
2006020820,5,3900,0.0,33,29,6,3,4,87.87878788
2006020820,4,3870,0.0,32,28,10,0,4,87.5
2006020821,26,3748,0.0,26,22,3,0,4,84.61538462
2006020821,15,3730,0.0,29,26,10,0,3,89.65517241
2006020822,20,3555,2.0,31,29,5,1,2,93.5483871
2006020822,29,3560,0.0,25,24,2,0,1,96.0
2006020823,8,3600,0.0,39,35,15,4,4,89.74358974
2006020823,9,3600,0.0,28,27,8,4,1,96.42857143
2006020824,2,3524,0.0,37,35,8,0,2,94.59459459
2006020824,1,3600,0.0,25,25,5,0,0,100.0
2006020825,17,3549,0.0,30,29,1,0,1,96.66666667
2006020825,19,1414,0.0,13,13,3,0,0,100.0
2006020825,19,2179,0.0,10,10,0,0,0,100.0
2006020826,10,3546,0.0,27,24,9,1,3,88.88888889
2006020826,18,3600,0.0,32,30,12,4,2,93.75
2006020827,13,3588,0.0,35,31,5,1,4,88.57142857
2006020827,30,3598,0.0,43,41,10,0,2,95.34883721
2006020828,11,3596,0.0,48,45,9,2,3,93.75
2006020828,21,1200,0.0,11,8,0,0,3,72.72727273
2006020828,21,2378,0.0,20,18,3,1,2,90.0
2006020829,14,1535,0.0,8,7,1,0,1,87.5
2006020829,14,2065,0.0,16,12,2,0,4,75.0
2006020829,3,3600,0.0,29,29,9,0,0,100.0
2006020830,16,3425,0.0,32,30,2,0,2,93.75
2006020830,22,3599,0.0,33,32,2,1,1,96.96969697
2006020831,24,3499,0.0,21,20,7,1,1,95.23809524
2006020831,25,3581,0.0,32,32,8,4,0,100.0
2006020832,2,3900,0.0,28,25,4,1,3,89.28571429
2006020832,6,3900,0.0,34,31,2,1,3,91.17647059
2006020833,20,3900,0.0,34,32,4,1,2,94.11764706
2006020833,7,3900,0.0,25,23,0,0,2,92.0
2006020834,5,3834,0.0,28,23,2,0,5,82.14285714
2006020834,10,3830,0.0,28,22,5,0,6,78.57142857
2006020835,9,3582,2.0,40,37,10,1,3,92.5
2006020835,8,3541,0.0,30,25,7,0,5,83.33333333
2006020836,19,3621,0.0,26,22,4,0,4,84.61538462
2006020836,4,3627,0.0,28,25,2,0,3,89.28571429
2006020837,3,3600,0.0,19,17,4,0,2,89.47368421
2006020837,15,3514,2.0,31,27,8,2,4,87.09677419
2006020838,27,1043,0.0,9,8,0,0,1,88.88888889
2006020838,27,2552,0.0,29,25,10,0,4,86.20689655
2006020838,13,3600,0.0,25,23,2,1,2,92.0
2006020839,26,3598,0.0,22,21,5,0,1,95.45454545
2006020839,18,3584,0.0,31,27,5,1,4,87.09677419
2006020840,12,605,0.0,8,5,1,0,3,62.5
2006020840,12,2974,0.0,21,19,6,1,2,90.47619048
2006020840,30,3581,0.0,26,22,3,1,4,84.61538462
2006020841,11,3515,0.0,33,30,7,2,3,90.90909091
2006020841,23,3597,0.0,29,27,7,0,2,93.10344828
2006020842,14,3596,0.0,22,21,1,0,1,95.45454545
2006020842,1,3516,0.0,27,23,3,0,4,85.18518519
2006020843,16,3600,0.0,28,24,3,1,4,85.71428571
2006020843,29,2797,0.0,17,15,2,0,2,88.23529412
2006020843,29,758,0.0,11,8,1,0,3,72.72727273
2006020844,21,1971,0.0,10,7,0,1,3,70.0
2006020844,21,1561,0.0,15,11,0,0,4,73.33333333
2006020844,25,1817,0.0,14,12,3,2,2,85.71428571
2006020844,25,1783,0.0,15,12,2,0,3,80.0
2006020845,20,2766,0.0,36,32,15,0,4,88.88888889
2006020845,20,834,0.0,14,11,0,2,3,78.57142857
2006020845,17,3592,0.0,20,16,2,0,4,80.0
2006020846,11,3600,0.0,32,27,9,1,5,84.375
2006020846,22,3595,2.0,30,29,6,5,1,96.66666667
2006020847,17,3600,0.0,33,27,8,1,6,81.81818182
2006020847,4,3596,0.0,32,31,12,1,1,96.875
2006020848,22,3590,0.0,22,20,2,1,2,90.90909091
2006020848,6,3600,0.0,32,32,4,3,0,100.0
2006020849,26,3546,0.0,29,27,6,2,2,93.10344828
2006020849,12,3571,0.0,22,21,7,0,1,95.45454545
2006020850,2,3900,0.0,41,39,3,0,2,95.12195122
2006020850,10,3900,0.0,20,18,1,1,2,90.0
2006020851,13,3596,0.0,29,29,4,3,0,100.0
2006020851,8,3549,0.0,25,24,4,0,1,96.0
2006020852,27,3520,0.0,27,22,2,0,5,81.48148148
2006020852,14,3600,0.0,26,23,2,0,3,88.46153846
2006020853,28,3590,0.0,23,18,4,0,5,78.26086957
2006020853,19,920,0.0,8,6,2,0,2,75.0
2006020853,19,2615,0.0,18,14,5,0,4,77.77777778
2006020854,24,3599,0.0,29,27,10,3,2,93.10344828
2006020854,21,3600,0.0,39,39,11,4,0,100.0
2006020855,11,3600,0.0,27,23,2,0,4,85.18518519
2006020855,20,3589,0.0,22,21,4,3,1,95.45454545
2006020856,19,3595,0.0,22,20,2,1,2,90.90909091
2006020856,29,3559,0.0,16,13,1,1,3,81.25
2006020857,13,3600,0.0,33,29,11,0,4,87.87878788
2006020857,9,3597,0.0,28,28,1,1,0,100.0
2006020858,8,1576,0.0,20,19,2,0,1,95.0
2006020858,8,1991,0.0,20,17,7,1,3,85.0
2006020858,1,3600,0.0,21,19,3,2,2,90.47619048
2006020859,16,3900,0.0,33,29,5,1,4,87.87878788
2006020859,5,3900,0.0,28,24,2,5,4,85.71428571
2006020860,28,2998,0.0,28,25,5,2,3,89.28571429
2006020860,28,602,0.0,5,3,0,0,2,60.0
2006020860,18,3600,0.0,22,22,0,1,0,100.0
2006020861,23,3840,0.0,32,30,6,1,2,93.75
2006020861,30,3860,0.0,34,31,11,3,3,91.17647059
2006020862,17,3600,0.0,18,17,2,0,1,94.44444444
2006020862,25,3560,0.0,31,29,1,1,2,93.5483871
2006020863,22,3662,0.0,31,29,1,1,2,93.5483871
2006020863,7,3662,0.0,28,27,2,1,1,96.42857143
2006020864,10,3597,0.0,36,34,8,0,2,94.44444444
2006020864,4,2577,0.0,20,19,8,0,1,95.0
2006020864,4,850,0.0,12,9,3,0,3,75.0
2006020865,3,3600,0.0,24,23,3,0,1,95.83333333
2006020865,12,3599,0.0,27,23,6,1,4,85.18518519
2006020866,6,3512,0.0,37,34,1,0,3,91.89189189
2006020866,2,3595,0.0,25,24,3,0,1,96.0
2006020867,15,3888,2.0,29,27,3,2,2,93.10344828
2006020867,14,3900,0.0,38,36,8,1,2,94.73684211
2006020868,21,1491,0.0,9,8,2,0,1,88.88888889
2006020868,21,2102,0.0,20,16,0,0,4,80.0
2006020868,20,3547,0.0,35,29,3,1,6,82.85714286
2006020869,24,3713,0.0,26,22,4,0,4,84.61538462
2006020869,27,3713,0.0,40,35,11,2,5,87.5
2006020870,28,3598,0.0,19,16,5,3,3,84.21052632
2006020870,29,3600,0.0,29,29,5,1,0,100.0
2006020871,5,3597,0.0,31,27,4,1,4,87.09677419
2006020871,1,3535,0.0,24,19,0,1,5,79.16666667
2006020872,18,3531,0.0,29,28,3,2,1,96.55172414
2006020872,19,3600,0.0,19,19,4,1,0,100.0
2006020873,23,3885,0.0,35,34,10,1,1,97.14285714
2006020873,16,3900,0.0,29,28,8,3,1,96.55172414
2006020874,4,3600,0.0,43,40,15,0,3,93.02325581
2006020874,3,2400,0.0,17,14,2,1,3,82.35294118
2006020874,3,1164,0.0,8,6,2,0,2,75.0
2006020875,6,3889,0.0,25,22,6,0,3,88.0
2006020875,7,3900,0.0,30,27,5,4,3,90.0
2006020876,22,3489,0.0,35,31,4,0,4,88.57142857
2006020876,10,3600,0.0,31,28,4,1,3,90.32258065
2006020877,12,3600,2.0,45,42,8,1,3,93.33333333
2006020877,8,3560,0.0,31,27,1,1,4,87.09677419
2006020878,11,3573,0.0,29,25,1,1,4,86.20689655
2006020878,9,3600,0.0,31,28,0,1,3,90.32258065
2006020879,1,3600,0.0,26,26,3,0,0,100.0
2006020879,2,3518,2.0,30,28,6,0,2,93.33333333
2006020880,14,3629,0.0,30,25,5,1,5,83.33333333
2006020880,13,3628,0.0,20,16,2,0,4,80.0
2006020881,30,3600,0.0,26,25,6,0,1,96.15384615
2006020881,18,3519,0.0,21,18,2,0,3,85.71428571
2006020882,17,3588,0.0,21,20,7,1,1,95.23809524
2006020882,27,3536,0.0,26,23,6,3,3,88.46153846
2006020883,21,3576,0.0,29,25,8,2,4,86.20689655
2006020883,20,3600,0.0,26,24,1,2,2,92.30769231
2006020884,24,3900,0.0,32,30,9,0,2,93.75
2006020884,26,3900,0.0,34,32,9,0,2,94.11764706
2006020885,16,3509,0.0,29,27,4,1,2,93.10344828
2006020885,3,3592,0.0,22,21,0,2,1,95.45454545
2006020886,15,3541,0.0,25,22,3,0,3,88.0
2006020886,5,3600,0.0,31,29,3,0,2,93.5483871
2006020887,28,3590,0.0,20,16,2,0,4,80.0
2006020887,25,3600,0.0,19,17,3,0,2,89.47368421
2006020888,8,3591,0.0,33,31,6,1,2,93.93939394
2006020888,29,3528,0.0,28,25,9,1,3,89.28571429
2006020889,30,1080,0.0,4,4,0,0,0,100.0
2006020889,30,2398,0.0,26,21,10,0,5,80.76923077
2006020889,19,3595,0.0,36,33,8,1,3,91.66666667
2006020890,26,3896,0.0,42,39,8,1,3,92.85714286
2006020890,24,3865,0.0,24,21,8,0,3,87.5
2006020891,21,3550,0.0,20,15,3,1,5,75.0
2006020891,23,3581,0.0,36,32,2,3,4,88.88888889
2006020892,5,3578,0.0,30,24,2,2,6,80.0
2006020892,2,3600,2.0,30,25,2,0,5,83.33333333
2006020893,27,3600,2.0,35,31,3,0,4,88.57142857
2006020893,18,3593,0.0,23,22,4,0,1,95.65217391
2006020894,6,3600,0.0,33,30,6,2,3,90.90909091
2006020894,4,3548,0.0,17,12,1,1,5,70.58823529
2006020895,4,2255,0.0,8,6,0,0,2,75.0
2006020895,4,1345,0.0,14,10,1,0,4,71.42857143
2006020895,7,3600,0.0,35,32,0,0,3,91.42857143
2006020896,6,3600,0.0,44,44,8,2,0,100.0
2006020896,10,2400,0.0,13,10,2,1,3,76.92307692
2006020896,10,1200,0.0,8,8,2,0,0,100.0
2006020897,11,3600,0.0,34,33,6,2,1,97.05882353
2006020897,12,3537,0.0,23,20,3,3,3,86.95652174
2006020898,15,3594,0.0,31,27,5,2,4,87.09677419
2006020898,8,3595,0.0,18,15,6,1,3,83.33333333
2006020899,22,3830,0.0,34,31,1,1,3,91.17647059
2006020899,9,3886,0.0,30,27,3,1,3,90.0
2006020900,3,3550,0.0,26,24,5,0,2,92.30769231
2006020900,1,3600,0.0,36,35,1,0,1,97.22222222
2006020901,13,3900,0.0,36,34,11,1,2,94.44444444
2006020901,14,3900,0.0,30,28,2,0,2,93.33333333
2006020902,29,3820,0.0,35,31,9,0,4,88.57142857
2006020902,19,3892,0.0,31,27,6,1,4,87.09677419
2006020903,25,3900,0.0,39,38,2,0,1,97.43589744
2006020903,30,3900,0.0,24,23,0,0,1,95.83333333
2006020904,20,3542,0.0,32,28,6,2,4,87.5
2006020904,21,3600,0.0,36,33,12,0,3,91.66666667
2006020905,23,3706,0.0,40,38,6,1,2,95.0
2006020905,24,3731,0.0,31,28,6,0,3,90.32258065
2006020906,28,3900,0.0,26,24,6,1,2,92.30769231
2006020906,15,3900,0.0,35,33,5,0,2,94.28571429
2006020907,16,3579,0.0,34,31,6,4,3,91.17647059
2006020907,17,3539,0.0,28,26,3,2,2,92.85714286
2006020908,9,2385,0.0,17,15,3,0,2,88.23529412
2006020908,9,1509,22.0,15,12,3,1,3,80.0
2006020908,7,2387,0.0,25,22,6,0,3,88.0
2006020908,7,1513,17.0,18,16,3,3,2,88.88888889
2006020909,1,3900,0.0,30,28,2,0,2,93.33333333
2006020909,3,3892,0.0,26,24,3,0,2,92.30769231
2006020910,4,3611,0.0,30,27,3,0,3,90.0
2006020910,12,3613,0.0,35,33,3,5,2,94.28571429
2006020911,14,3823,0.0,28,24,3,0,4,85.71428571
2006020911,11,3824,0.0,29,24,2,1,5,82.75862069
2006020912,22,3588,0.0,28,28,5,1,0,100.0
2006020912,29,3600,0.0,28,24,5,1,4,85.71428571
2006020913,10,3898,0.0,30,28,11,0,2,93.33333333
2006020913,2,3893,0.0,29,27,3,0,2,93.10344828
2006020914,5,3759,0.0,33,32,4,2,1,96.96969697
2006020914,13,3756,0.0,41,39,8,2,2,95.12195122
2006020915,8,3867,0.0,31,26,5,1,5,83.87096774
2006020915,18,3890,0.0,27,22,4,3,5,81.48148148
2006020916,28,3600,0.0,21,21,1,0,0,100.0
2006020916,16,3536,0.0,23,21,4,0,2,91.30434783
2006020917,30,3600,0.0,31,28,0,1,3,90.32258065
2006020917,21,3541,0.0,23,19,0,1,4,82.60869565
2006020918,20,3649,0.0,22,19,4,0,3,86.36363636
2006020918,27,3654,0.0,31,29,2,2,2,93.5483871
2006020919,23,3600,0.0,33,31,14,0,2,93.93939394
2006020919,26,3531,0.0,30,27,8,4,3,90.0
2006020920,22,3893,0.0,30,27,1,2,3,90.0
2006020920,17,3894,0.0,26,23,5,1,3,88.46153846
2006020921,6,3577,0.0,26,24,2,10,2,92.30769231
2006020921,14,581,0.0,7,5,2,0,2,71.42857143
2006020921,14,3019,0.0,16,12,9,0,4,75.0
2006020922,24,3600,0.0,21,17,2,1,4,80.95238095
2006020922,25,3600,0.0,25,24,8,0,1,96.0
2006020923,15,3600,0.0,31,29,7,0,2,93.5483871
2006020923,1,3531,0.0,30,26,8,2,4,86.66666667
2006020924,8,3573,0.0,31,28,3,2,3,90.32258065
2006020924,2,3595,0.0,22,20,4,1,2,90.90909091
2006020925,7,1899,0.0,21,19,3,0,2,90.47619048
2006020925,7,1683,0.0,16,12,3,1,4,75.0
2006020925,9,3589,0.0,36,31,6,1,5,86.11111111
2006020926,29,3600,0.0,42,40,3,2,2,95.23809524
2006020926,3,3560,0.0,25,22,0,0,3,88.0
2006020927,10,3600,2.0,24,22,3,0,2,91.66666667
2006020927,4,3600,0.0,30,25,3,0,5,83.33333333
2006020928,12,3593,0.0,29,28,0,3,1,96.55172414
2006020928,11,3483,0.0,27,24,3,1,3,88.88888889
2006020929,6,1200,0.0,19,16,4,1,3,84.21052632
2006020929,6,2400,0.0,33,29,8,1,4,87.87878788
2006020929,13,3600,0.0,27,25,8,0,2,92.59259259
2006020930,17,3702,2.0,29,25,8,0,4,86.20689655
2006020930,18,3727,0.0,44,41,11,2,3,93.18181818
2006020931,28,3533,0.0,22,16,1,2,6,72.72727273
2006020931,20,3600,0.0,37,33,6,1,4,89.18918919
2006020932,21,3900,0.0,39,34,11,1,5,87.17948718
2006020932,26,3858,0.0,30,25,8,0,5,83.33333333
2006020933,1,3600,0.0,25,23,0,0,2,92.0
2006020933,15,3538,0.0,29,26,7,1,3,89.65517241
2006020934,22,3573,0.0,26,23,0,0,3,88.46153846
2006020934,30,3600,0.0,20,19,5,0,1,95.0
2006020935,19,2388,0.0,11,7,0,0,4,63.63636364
2006020935,19,1100,0.0,5,5,2,0,0,100.0
2006020935,16,3600,0.0,23,22,6,3,1,95.65217391
2006020936,23,3857,0.0,36,34,10,0,2,94.44444444
2006020936,25,3806,0.0,18,17,2,1,1,94.44444444
2006020937,5,2098,0.0,9,7,1,0,2,77.77777778
2006020937,5,1498,0.0,15,12,3,2,3,80.0
2006020937,14,3600,0.0,18,17,3,0,1,94.44444444
2006020938,18,3898,0.0,34,31,3,0,3,91.17647059
2006020938,29,3888,0.0,25,22,4,1,3,88.0
2006020939,21,3576,0.0,41,36,10,1,5,87.80487805
2006020939,24,3598,0.0,26,23,4,1,3,88.46153846
2006020940,11,3597,0.0,24,22,4,0,2,91.66666667
2006020940,6,3575,0.0,20,17,0,0,3,85.0
2006020941,10,1944,0.0,16,11,1,0,5,68.75
2006020941,10,1557,0.0,8,8,2,1,0,100.0
2006020941,8,3600,0.0,36,32,5,0,4,88.88888889
2006020942,27,3600,0.0,33,28,7,2,5,84.84848485
2006020942,20,3593,0.0,32,30,1,2,2,93.75
2006020943,24,3600,0.0,42,40,3,1,2,95.23809524
2006020943,28,3554,0.0,19,16,3,0,3,84.21052632
2006020944,8,3547,0.0,26,23,6,0,3,88.46153846
2006020944,3,3600,0.0,19,19,1,0,0,100.0
2006020945,13,3893,0.0,33,28,6,2,5,84.84848485
2006020945,15,1200,0.0,15,11,3,0,4,73.33333333
2006020945,15,2693,0.0,18,17,1,1,1,94.44444444
2006020946,9,3600,0.0,25,23,2,1,2,92.0
2006020946,12,3534,0.0,34,31,3,0,3,91.17647059
2006020947,7,3598,0.0,28,27,3,0,1,96.42857143
2006020947,10,2400,0.0,11,7,2,0,4,63.63636364
2006020947,10,1200,0.0,17,15,4,0,2,88.23529412
2006020948,4,3869,0.0,39,33,0,1,6,84.61538462
2006020948,2,3868,0.0,34,29,5,1,5,85.29411765
2006020949,1,3600,0.0,31,31,9,0,0,100.0
2006020949,5,3506,0.0,25,24,8,1,1,96.0
2006020950,25,3695,0.0,20,19,2,0,1,95.0
2006020950,14,3688,0.0,28,26,3,0,2,92.85714286
2006020951,23,3600,0.0,20,17,1,1,3,85.0
2006020951,19,3596,0.0,26,25,4,0,1,96.15384615
2006020952,17,3598,0.0,25,24,3,4,1,96.0
2006020952,16,3600,2.0,28,24,5,0,4,85.71428571
2006020953,29,3550,0.0,23,20,2,0,3,86.95652174
2006020953,21,3600,0.0,23,21,6,0,2,91.30434783
2006020954,27,3600,0.0,26,26,2,2,0,100.0
2006020954,22,3588,0.0,32,29,2,0,3,90.625
2006020955,12,3515,0.0,26,24,2,3,2,92.30769231
2006020955,9,3596,0.0,27,27,12,0,0,100.0
2006020956,30,2700,0.0,22,21,4,0,1,95.45454545
2006020956,30,1200,0.0,5,5,2,0,0,100.0
2006020956,20,3889,0.0,29,28,4,1,1,96.55172414
2006020957,18,3897,0.0,30,27,8,2,3,90.0
2006020957,28,3897,0.0,32,29,9,1,3,90.625
2006020958,4,3872,0.0,37,34,7,3,3,91.89189189
2006020958,6,3887,0.0,55,51,10,2,4,92.72727273
2006020959,5,3896,0.0,35,32,2,2,3,91.42857143
2006020959,3,3875,0.0,33,30,2,0,3,90.90909091
2006020960,14,3898,0.0,27,23,6,0,4,85.18518519
2006020960,15,3849,0.0,29,25,10,2,4,86.20689655
2006020961,19,3617,0.0,27,25,1,0,2,92.59259259
2006020961,2,3625,2.0,39,36,7,1,3,92.30769231
2006020962,25,3719,0.0,36,34,7,2,2,94.44444444
2006020962,13,3727,0.0,34,33,6,0,1,97.05882353
2006020963,21,3600,0.0,24,23,2,0,1,95.83333333
2006020963,16,3526,0.0,31,26,0,0,5,83.87096774
2006020964,30,3600,0.0,30,30,4,3,0,100.0
2006020964,22,1200,0.0,8,6,3,0,2,75.0
2006020964,22,2384,0.0,19,16,1,1,3,84.21052632
2006020965,27,3534,0.0,29,25,4,0,4,86.20689655
2006020965,23,3600,0.0,24,21,0,0,3,87.5
2006020966,24,3797,0.0,21,17,5,0,4,80.95238095
2006020966,26,3797,0.0,30,27,9,1,3,90.0
2006020967,5,3532,0.0,26,23,5,3,3,88.46153846
2006020967,12,3593,0.0,24,22,4,0,2,91.66666667
2006020968,10,3900,0.0,25,22,6,0,3,88.0
2006020968,1,3885,0.0,28,25,2,3,3,89.28571429
2006020969,9,3498,0.0,24,20,4,1,4,83.33333333
2006020969,11,3600,0.0,23,21,1,0,2,91.30434783
2006020970,16,1847,0.0,19,17,7,3,2,89.47368421
2006020970,16,1753,0.0,18,14,6,1,4,77.77777778
2006020970,17,3598,0.0,19,17,3,1,2,89.47368421
2006020971,8,3563,0.0,29,22,8,0,7,75.86206897
2006020971,7,3594,0.0,32,27,4,1,5,84.375
2006020972,29,3900,0.0,24,22,4,0,2,91.66666667
2006020972,25,3869,0.0,24,22,1,0,2,91.66666667
2006020973,28,3533,0.0,25,22,10,1,3,88.0
2006020973,24,3595,0.0,31,30,9,0,1,96.77419355
2006020974,19,3900,0.0,34,32,4,0,2,94.11764706
2006020974,3,3900,0.0,27,25,3,1,2,92.59259259
2006020975,18,3488,0.0,28,25,4,0,3,89.28571429
2006020975,26,3600,0.0,33,27,8,0,6,81.81818182
2006020976,8,3520,2.0,36,33,9,2,3,91.66666667
2006020976,6,3600,0.0,32,31,6,2,1,96.875
2006020977,7,3600,0.0,27,26,9,0,1,96.2962963
2006020977,10,3539,0.0,29,26,3,0,3,89.65517241
2006020978,2,3592,0.0,29,27,8,0,2,93.10344828
2006020978,15,2698,0.0,23,18,9,0,5,78.26086957
2006020978,15,900,0.0,3,2,0,0,1,66.66666667
2006020979,14,3267,0.0,34,30,5,1,4,88.23529412
2006020979,14,321,0.0,2,0,0,0,2,0.0
2006020979,13,3594,0.0,33,31,6,1,2,93.93939394
2006020980,20,3568,0.0,34,32,6,2,2,94.11764706
2006020980,22,3600,0.0,35,31,6,0,4,88.57142857
2006020981,29,3581,0.0,35,32,8,1,3,91.42857143
2006020981,27,3545,0.0,27,23,7,2,4,85.18518519
2006020982,4,3900,0.0,38,35,13,3,3,92.10526316
2006020982,5,3900,2.0,34,31,11,1,3,91.17647059
2006020983,12,3476,0.0,25,22,3,0,3,88.0
2006020983,11,3588,0.0,36,35,4,3,1,97.22222222
2006020984,21,3761,0.0,34,31,1,0,3,91.17647059
2006020984,17,3761,0.0,27,23,4,1,4,85.18518519
2006020985,9,3896,0.0,25,22,3,1,3,88.0
2006020985,16,3900,0.0,33,30,2,0,3,90.90909091
2006020986,28,3598,0.0,26,26,5,0,0,100.0
2006020986,25,3600,0.0,18,14,4,0,4,77.77777778
2006020987,6,3584,0.0,27,26,2,0,1,96.2962963
2006020987,1,3565,0.0,29,26,3,0,3,89.65517241
2006020988,18,3884,0.0,35,33,6,0,2,94.28571429
2006020988,24,3900,0.0,14,12,1,1,2,85.71428571
2006020989,30,3900,0.0,35,32,1,1,3,91.42857143
2006020989,23,3897,0.0,31,28,7,0,3,90.32258065
2006020990,2,3900,2.0,57,56,17,1,1,98.24561404
2006020990,3,3879,0.0,30,29,10,1,1,96.66666667
2006020991,21,3597,0.0,21,21,4,1,0,100.0
2006020991,6,3600,0.0,29,28,3,1,1,96.55172414
2006020992,1,3707,0.0,44,39,6,2,5,88.63636364
2006020992,4,3697,0.0,41,37,8,0,4,90.24390244
2006020993,13,44,0.0,1,1,0,0,0,100.0
2006020993,13,3553,0.0,29,25,9,0,4,86.20689655
2006020993,11,3596,0.0,40,38,14,2,2,95.0
2006020994,15,3597,0.0,31,28,8,0,3,90.32258065
2006020994,10,3600,0.0,24,24,4,0,0,100.0
2006020995,5,2700,0.0,16,15,8,0,1,93.75
2006020995,5,1200,0.0,7,4,1,0,3,57.14285714
2006020995,9,3890,0.0,27,23,2,3,4,85.18518519
2006020996,18,3900,0.0,35,32,4,0,3,91.42857143
2006020996,17,3894,0.0,27,24,2,0,3,88.88888889
2006020997,20,3592,0.0,19,17,2,0,2,89.47368421
2006020997,19,3439,0.0,32,28,7,3,4,87.5
2006020998,28,3600,0.0,26,26,0,1,0,100.0
2006020998,30,2400,0.0,24,21,5,0,3,87.5
2006020998,30,1200,0.0,2,2,0,0,0,100.0
2006020999,26,3600,0.0,21,18,3,0,3,85.71428571
2006020999,16,3600,0.0,26,26,6,1,0,100.0
2006021000,14,3588,0.0,28,23,2,5,5,82.14285714
2006021000,23,3600,0.0,17,16,6,3,1,94.11764706
2006021001,21,3600,0.0,21,19,3,0,2,90.47619048
2006021001,7,3553,0.0,29,26,1,1,3,89.65517241
2006021002,26,3873,2.0,30,27,3,1,3,90.0
2006021002,29,3852,0.0,29,27,7,1,2,93.10344828
2006021003,14,3600,0.0,30,29,3,0,1,96.66666667
2006021003,22,3560,0.0,24,22,4,1,2,91.66666667
2006021004,27,3524,0.0,26,24,4,1,2,92.30769231
2006021004,24,3600,0.0,25,24,4,0,1,96.0
2006021005,30,3592,0.0,30,29,2,1,1,96.66666667
2006021005,6,3468,0.0,32,30,7,0,2,93.75
2006021006,13,3597,0.0,27,26,2,1,1,96.2962963
2006021006,4,3508,0.0,37,35,5,5,2,94.59459459
2006021007,8,1607,0.0,15,10,0,0,5,66.66666667
2006021007,8,1993,0.0,14,13,6,0,1,92.85714286
2006021007,11,3597,0.0,35,33,8,0,2,94.28571429
2006021008,10,3595,0.0,40,35,12,3,5,87.5
2006021008,9,3590,0.0,29,28,9,0,1,96.55172414
2006021009,3,3586,0.0,31,30,11,2,1,96.77419355
2006021009,2,3517,0.0,30,28,12,2,2,93.33333333
2006021010,1,3900,0.0,24,21,2,1,3,87.5
2006021010,5,3900,0.0,39,36,6,1,3,92.30769231
2006021011,25,3578,0.0,28,24,3,0,4,85.71428571
2006021011,19,3584,0.0,27,24,3,2,3,88.88888889
2006021012,20,3598,0.0,36,30,9,1,6,83.33333333
2006021012,18,3595,0.0,31,28,4,1,3,90.32258065
2006021013,23,3594,0.0,28,26,4,0,2,92.85714286
2006021013,27,3527,0.0,30,26,2,0,4,86.66666667
2006021014,12,3598,0.0,25,25,3,3,0,100.0
2006021014,15,3569,0.0,44,42,10,2,2,95.45454545
2006021015,25,3600,0.0,30,30,1,2,0,100.0
2006021015,29,3600,0.0,31,28,2,2,3,90.32258065
2006021016,26,3806,0.0,54,51,9,1,3,94.44444444
2006021016,17,3793,0.0,26,24,2,0,2,92.30769231
2006021017,30,3600,0.0,36,35,3,0,1,97.22222222
2006021017,7,2852,0.0,22,18,0,0,4,81.81818182
2006021017,7,748,0.0,9,8,0,0,1,88.88888889
2006021018,22,78,0.0,1,0,0,0,1,0.0
2006021018,22,3522,0.0,31,27,7,0,4,87.09677419
2006021018,24,3585,0.0,29,28,4,2,1,96.55172414
2006021019,23,3810,2.0,26,25,4,0,1,96.15384615
2006021019,28,3801,0.0,37,35,3,1,2,94.59459459
2006021020,6,3535,0.0,28,25,6,2,3,89.28571429
2006021020,4,3600,0.0,27,26,3,1,1,96.2962963
2006021021,3,3674,0.0,23,20,4,0,3,86.95652174
2006021021,5,3639,0.0,28,26,1,6,2,92.85714286
2006021022,1,3600,0.0,33,31,4,0,2,93.93939394
2006021022,7,3558,0.0,26,23,2,1,3,88.46153846
2006021023,9,3791,0.0,45,41,10,2,4,91.11111111
2006021023,10,3782,0.0,22,19,0,0,3,86.36363636
2006021024,15,3575,0.0,28,24,0,0,4,85.71428571
2006021024,2,3600,0.0,34,32,0,0,2,94.11764706
2006021025,11,3519,0.0,39,36,10,0,3,92.30769231
2006021025,13,3599,0.0,32,30,3,1,2,93.75
2006021026,8,3600,0.0,28,25,5,0,3,89.28571429
2006021026,19,1514,0.0,10,7,0,0,3,70.0
2006021026,19,2038,0.0,12,11,4,0,1,91.66666667
2006021027,29,3561,0.0,33,31,3,1,2,93.93939394
2006021027,18,3595,0.0,29,28,4,2,1,96.55172414
2006021028,14,3770,0.0,27,25,9,0,2,92.59259259
2006021028,20,3779,0.0,30,27,4,0,3,90.0
2006021029,16,3597,0.0,37,32,5,1,5,86.48648649
2006021029,27,1188,0.0,17,12,1,0,5,70.58823529
2006021029,27,2350,0.0,14,12,3,3,2,85.71428571
2006021030,12,1717,0.0,13,12,2,0,1,92.30769231
2006021030,12,2183,0.0,13,13,5,0,0,100.0
2006021030,3,3900,0.0,31,30,5,1,1,96.77419355
2006021031,6,3600,2.0,38,35,3,3,3,92.10526316
2006021031,17,3600,2.0,25,19,2,1,6,76.0
2006021032,21,3876,0.0,29,26,2,0,3,89.65517241
2006021032,30,3876,0.0,23,21,1,0,2,91.30434783
2006021033,26,3635,0.0,34,30,2,0,4,88.23529412
2006021033,25,3635,0.0,21,18,3,1,3,85.71428571
2006021034,23,3497,0.0,24,20,6,0,4,83.33333333
2006021034,24,3593,0.0,26,24,9,2,2,92.30769231
2006021035,22,3552,0.0,30,28,1,0,2,93.33333333
2006021035,28,3600,0.0,22,22,0,1,0,100.0
2006021036,15,2396,0.0,15,12,2,0,3,80.0
2006021036,15,1130,0.0,6,5,0,0,1,83.33333333
2006021036,11,3600,0.0,33,31,7,0,2,93.93939394
2006021037,19,3897,0.0,34,30,12,1,4,88.23529412
2006021037,20,3900,0.0,33,29,5,0,4,87.87878788
2006021038,4,3600,0.0,24,20,5,0,4,83.33333333
2006021038,27,3600,0.0,24,24,1,1,0,100.0
2006021039,22,3593,0.0,36,31,7,0,5,86.11111111
2006021039,26,3592,0.0,27,26,3,1,1,96.2962963
2006021040,9,3600,0.0,34,32,4,1,2,94.11764706
2006021040,3,3559,0.0,33,30,4,2,3,90.90909091
2006021041,13,3560,0.0,34,31,6,2,3,91.17647059
2006021041,12,3600,0.0,27,26,8,0,1,96.2962963
2006021042,14,3511,0.0,28,25,2,0,3,89.28571429
2006021042,10,3600,0.0,21,19,0,0,2,90.47619048
2006021043,2,941,0.0,8,8,1,0,0,100.0
2006021043,2,2607,0.0,32,27,11,2,5,84.375
2006021043,8,3564,0.0,27,24,6,0,3,88.88888889
2006021044,7,3861,0.0,38,34,5,2,4,89.47368421
2006021044,5,3883,0.0,19,15,1,0,4,78.94736842
2006021045,17,3600,2.0,31,29,8,0,2,93.5483871
2006021045,18,3597,0.0,30,25,5,1,5,83.33333333
2006021046,4,3489,0.0,33,30,5,1,3,90.90909091
2006021046,25,3600,0.0,19,17,4,1,2,89.47368421
2006021047,30,3864,0.0,24,22,4,0,2,91.66666667
2006021047,23,3857,0.0,29,26,1,0,3,89.65517241
2006021048,16,3600,0.0,35,28,5,0,7,80.0
2006021048,28,3593,0.0,19,18,2,2,1,94.73684211
2006021049,5,3600,0.0,25,25,5,0,0,100.0
2006021049,1,3600,0.0,22,19,0,1,3,86.36363636
2006021050,18,3589,0.0,34,31,2,3,3,91.17647059
2006021050,17,3600,0.0,29,27,8,0,2,93.10344828
2006021051,20,3554,0.0,42,39,7,1,3,92.85714286
2006021051,21,3600,0.0,19,17,4,1,2,89.47368421
2006021052,29,3898,0.0,38,34,7,1,4,89.47368421
2006021052,24,3900,0.0,27,23,6,1,4,85.18518519
2006021053,15,3900,0.0,39,36,9,0,3,92.30769231
2006021053,6,3865,0.0,34,31,4,2,3,91.17647059
2006021054,11,3519,0.0,36,33,1,3,3,91.66666667
2006021054,4,3600,0.0,39,37,2,0,2,94.87179487
2006021055,1,3598,0.0,40,38,2,2,2,95.0
2006021055,12,3508,0.0,25,22,6,0,3,88.0
2006021056,2,1004,0.0,8,8,0,0,0,100.0
2006021056,2,2596,0.0,28,23,7,0,5,82.14285714
2006021056,9,3594,0.0,30,28,2,2,2,93.33333333
2006021057,7,3600,0.0,45,42,5,1,3,93.33333333
2006021057,13,3599,0.0,20,15,1,0,5,75.0
2006021058,20,3581,14.0,26,23,8,0,3,88.46153846
2006021058,25,3593,0.0,32,30,11,0,2,93.75
2006021059,30,3600,0.0,23,22,5,0,1,95.65217391
2006021059,22,3539,0.0,27,25,1,2,2,92.59259259
2006021060,28,3600,0.0,21,20,6,0,1,95.23809524
2006021060,27,3599,0.0,27,22,2,0,5,81.48148148
2006021061,19,3669,0.0,37,34,4,1,3,91.89189189
2006021061,23,3669,0.0,22,20,1,0,2,90.90909091
2006021062,16,3882,0.0,27,24,7,0,3,88.88888889
2006021062,26,3900,0.0,27,24,4,1,3,88.88888889
2006021063,10,3594,0.0,33,28,8,2,5,84.84848485
2006021063,15,3587,0.0,35,34,11,3,1,97.14285714
2006021064,8,3588,0.0,30,25,2,1,5,83.33333333
2006021064,5,3600,0.0,28,25,8,0,3,89.28571429
2006021065,3,3708,0.0,22,20,3,1,2,90.90909091
2006021065,11,3738,0.0,39,38,9,0,1,97.43589744
2006021066,7,3595,0.0,37,35,9,4,2,94.59459459
2006021066,14,3515,0.0,20,17,0,1,3,85.0
2006021067,16,2182,0.0,17,12,3,1,5,70.58823529
2006021067,16,1418,0.0,9,9,2,0,0,100.0
2006021067,24,3600,0.0,33,31,10,2,2,93.93939394
2006021068,29,3532,0.0,23,21,5,1,2,91.30434783
2006021068,28,3596,0.0,35,35,8,3,0,100.0
2006021069,12,3594,0.0,20,18,5,1,2,90.0
2006021069,1,1689,0.0,12,8,1,0,4,66.66666667
2006021069,1,1911,0.0,18,15,6,1,3,83.33333333
2006021070,10,3900,0.0,31,29,8,0,2,93.5483871
2006021070,8,3900,0.0,39,37,7,1,2,94.87179487
2006021071,4,3577,0.0,33,30,7,2,3,90.90909091
2006021071,9,3600,0.0,30,28,3,1,2,93.33333333
2006021072,6,2706,0.0,28,25,5,0,3,89.28571429
2006021072,6,893,0.0,11,7,0,0,4,63.63636364
2006021072,3,3595,0.0,30,30,9,0,0,100.0
2006021073,2,3559,0.0,33,27,3,0,6,81.81818182
2006021073,13,3592,0.0,33,28,2,0,5,84.84848485
2006021074,25,3566,0.0,24,21,0,0,3,87.5
2006021074,18,3592,0.0,36,34,7,0,2,94.44444444
2006021075,19,3719,0.0,24,22,5,0,2,91.66666667
2006021075,22,3724,0.0,40,37,7,3,3,92.5
2006021076,30,3600,0.0,21,19,1,0,2,90.47619048
2006021076,20,3495,0.0,26,22,2,0,4,84.61538462
2006021077,21,3600,0.0,34,31,4,3,3,91.17647059
2006021077,27,3600,0.0,31,25,4,1,6,80.64516129
2006021078,17,3585,0.0,38,35,16,0,3,92.10526316
2006021078,23,3588,0.0,33,32,9,2,1,96.96969697
2006021079,29,1456,0.0,7,4,2,0,3,57.14285714
2006021079,29,2082,0.0,13,11,5,0,2,84.61538462
2006021079,26,3585,0.0,34,31,9,1,3,91.17647059
2006021080,14,2897,0.0,24,20,0,1,4,83.33333333
2006021080,14,699,0.0,5,2,0,0,3,40.0
2006021080,15,3600,0.0,31,30,7,0,1,96.77419355
2006021081,7,3860,0.0,31,27,2,1,4,87.09677419
2006021081,11,3862,0.0,38,35,9,1,3,92.10526316
2006021082,9,3892,0.0,19,16,4,1,3,84.21052632
2006021082,5,3896,0.0,35,32,4,2,3,91.42857143
2006021083,28,3619,0.0,40,36,8,0,4,90.0
2006021083,21,3608,0.0,24,21,3,1,3,87.5
2006021084,27,3790,0.0,28,23,7,1,5,82.14285714
2006021084,25,2311,2.0,10,9,2,2,1,90.0
2006021084,25,1538,0.0,10,7,0,0,3,70.0
2006021085,26,262,0.0,2,0,0,0,2,0.0
2006021085,26,3338,0.0,25,24,2,1,1,96.0
2006021085,24,3455,0.0,29,24,4,1,5,82.75862069
2006021086,5,3566,0.0,42,40,12,0,2,95.23809524
2006021086,3,3596,0.0,22,21,4,1,1,95.45454545
2006021087,23,3600,0.0,37,36,8,1,1,97.2972973
2006021087,22,3567,0.0,38,36,10,0,2,94.73684211
2006021088,6,3534,0.0,32,31,7,1,1,96.875
2006021088,8,3578,0.0,30,30,0,1,0,100.0
2006021089,13,3600,4.0,25,24,2,1,1,96.0
2006021089,4,3600,0.0,34,30,1,5,4,88.23529412
2006021090,16,3594,0.0,30,25,6,2,5,83.33333333
2006021090,29,3595,0.0,24,22,2,0,2,91.66666667
2006021091,1,3546,0.0,25,23,1,0,2,92.0
2006021091,10,3578,0.0,25,24,3,0,1,96.0
2006021092,2,3655,0.0,40,36,16,0,4,90.0
2006021092,14,3646,0.0,24,21,1,0,3,87.5
2006021093,9,3600,0.0,31,29,4,1,2,93.5483871
2006021093,19,3536,0.0,22,19,2,0,3,86.36363636
2006021094,27,3548,0.0,26,23,2,0,3,88.46153846
2006021094,30,3590,0.0,31,29,5,0,2,93.5483871
2006021095,17,3544,0.0,23,21,8,0,2,91.30434783
2006021095,20,3600,0.0,31,30,1,3,1,96.77419355
2006021096,15,3600,0.0,31,26,4,1,5,83.87096774
2006021096,7,3577,0.0,26,24,3,0,2,92.30769231
2006021097,4,3600,0.0,34,29,6,0,5,85.29411765
2006021097,3,3600,0.0,17,17,0,0,0,100.0
2006021098,28,3600,0.0,29,28,5,1,1,96.55172414
2006021098,16,3573,0.0,20,16,3,0,4,80.0
2006021099,21,3597,0.0,23,22,1,2,1,95.65217391
2006021099,22,1543,0.0,12,11,0,0,1,91.66666667
2006021099,22,2057,0.0,22,18,1,0,4,81.81818182
2006021100,18,3562,0.0,30,28,5,0,2,93.33333333
2006021100,23,3595,0.0,20,20,1,1,0,100.0
2006021101,25,3600,0.0,22,20,1,1,2,90.90909091
2006021101,26,3547,0.0,28,25,11,0,3,89.28571429
2006021102,8,3600,0.0,35,32,8,6,3,91.42857143
2006021102,6,3580,0.0,30,24,4,1,6,80.0
2006021103,15,3548,0.0,39,35,12,0,4,89.74358974
2006021103,12,1200,0.0,4,4,0,0,0,100.0
2006021103,12,2395,0.0,6,3,0,0,3,50.0
2006021104,28,3600,0.0,19,18,0,1,1,94.73684211
2006021104,11,1531,2.0,9,8,1,0,1,88.88888889
2006021104,11,2069,0.0,23,19,0,0,4,82.60869565
2006021105,5,3505,0.0,32,29,2,2,3,90.625
2006021105,2,3596,0.0,36,35,4,0,1,97.22222222
2006021106,1,3566,0.0,32,29,7,0,3,90.625
2006021106,14,3589,0.0,35,34,6,1,1,97.14285714
2006021107,9,3599,0.0,37,35,7,1,2,94.59459459
2006021107,13,1647,0.0,10,10,3,0,0,100.0
2006021107,13,1910,0.0,9,5,0,0,4,55.55555556
2006021108,29,3898,0.0,36,35,7,0,1,97.22222222
2006021108,17,3892,0.0,30,29,4,4,1,96.66666667
2006021109,19,3600,0.0,37,32,6,0,5,86.48648649
2006021109,30,3598,0.0,23,22,5,2,1,95.65217391
2006021110,24,3526,0.0,21,19,4,1,2,90.47619048
2006021110,27,3586,0.0,23,22,3,1,1,95.65217391
2006021111,10,3538,0.0,34,29,3,2,5,85.29411765
2006021111,7,3590,0.0,44,40,5,0,4,90.90909091
2006021112,26,3591,0.0,27,26,8,2,1,96.2962963
2006021112,16,3551,0.0,32,30,13,4,2,93.75
2006021113,18,3687,0.0,28,25,4,1,3,89.28571429
2006021113,20,3687,0.0,25,23,3,1,2,92.0
2006021114,21,3857,0.0,22,19,1,0,3,86.36363636
2006021114,22,3900,0.0,46,43,8,0,3,93.47826087
2006021115,25,3748,0.0,35,32,1,0,3,91.42857143
2006021115,24,3748,0.0,36,34,10,0,2,94.44444444
2006021116,3,3900,0.0,41,40,18,1,1,97.56097561
2006021116,6,3900,0.0,36,35,8,4,1,97.22222222
2006021117,2,3560,0.0,21,18,3,3,3,85.71428571
2006021117,4,3532,0.0,34,30,12,2,4,88.23529412
2006021118,11,3552,0.0,28,26,5,1,2,92.85714286
2006021118,5,3600,0.0,26,25,2,0,1,96.15384615
2006021119,17,3900,0.0,19,17,2,0,2,89.47368421
2006021120,7,1414,0.0,21,18,0,1,3,85.71428571
2006021120,7,2186,0.0,14,13,2,0,1,92.85714286
2006021120,10,3600,0.0,20,19,0,1,1,95.0
2006021121,15,3596,0.0,40,36,8,1,4,90.0
2006021121,8,3594,0.0,28,27,8,0,1,96.42857143
2006021122,28,1194,0.0,10,7,0,0,3,70.0
2006021122,28,2338,0.0,9,7,4,0,2,77.77777778
2006021122,12,3600,0.0,24,20,5,1,4,83.33333333
2006021123,9,3600,0.0,23,21,1,0,2,91.30434783
2006021123,14,2532,0.0,23,18,1,0,5,78.26086957
2006021123,14,1068,0.0,5,3,1,0,2,60.0
2006021124,1,3900,0.0,29,26,0,1,3,89.65517241
2006021124,13,3900,0.0,30,27,8,0,3,90.0
2006021125,26,3594,0.0,23,19,4,0,4,82.60869565
2006021125,30,3600,0.0,33,32,7,3,1,96.96969697
2006021126,25,3867,0.0,27,24,6,1,3,88.88888889
2006021126,27,3900,0.0,25,22,2,1,3,88.0
2006021127,18,3600,0.0,26,26,2,1,0,100.0
2006021127,22,3600,0.0,26,22,2,0,4,84.61538462
2006021128,3,3844,0.0,35,34,13,0,1,97.14285714
2006021128,2,3825,0.0,34,32,10,1,2,94.11764706
2006021129,6,1200,0.0,9,6,1,0,3,66.66666667
2006021129,6,2400,0.0,19,17,2,0,2,89.47368421
2006021129,5,3600,0.0,29,29,8,2,0,100.0
2006021130,19,3599,0.0,26,22,3,0,4,84.61538462
2006021130,29,3587,0.0,26,25,10,2,1,96.15384615
2006021131,20,3600,0.0,31,29,5,2,2,93.5483871
2006021131,16,3534,0.0,30,27,9,0,3,90.0
2006021132,21,2833,0.0,7,6,0,0,1,85.71428571
2006021132,21,1067,0.0,13,10,3,0,3,76.92307692
2006021132,23,3900,2.0,30,26,8,0,4,86.66666667
2006021133,24,3529,0.0,28,27,6,1,1,96.42857143
2006021133,17,3600,0.0,25,25,5,1,0,100.0
2006021134,5,3596,0.0,30,27,4,0,3,90.0
2006021134,15,3493,0.0,29,25,9,0,4,86.20689655
2006021135,13,3600,0.0,29,27,2,1,2,93.10344828
2006021135,14,1151,0.0,7,7,2,0,0,100.0
2006021135,14,2400,0.0,17,14,1,1,3,82.35294118
2006021136,12,1878,0.0,19,14,2,1,5,73.68421053
2006021136,12,1719,0.0,13,12,2,2,1,92.30769231
2006021136,10,3600,0.0,27,26,1,2,1,96.2962963
2006021137,3,1787,0.0,15,11,0,0,4,73.33333333
2006021137,3,1813,0.0,10,8,2,0,2,80.0
2006021137,8,3595,0.0,32,28,7,0,4,87.5
2006021138,6,3600,0.0,34,32,9,5,2,94.11764706
2006021138,9,3518,0.0,17,14,4,1,3,82.35294118
2006021139,1,3600,0.0,25,23,1,0,2,92.0
2006021139,2,767,0.0,4,4,0,0,0,100.0
2006021139,2,2795,0.0,32,29,6,1,3,90.625
2006021140,29,3592,0.0,20,19,1,0,1,95.0
2006021140,19,1890,0.0,12,9,2,1,3,75.0
2006021140,19,1626,0.0,13,12,4,0,1,92.30769231
2006021141,22,3525,0.0,28,24,6,0,4,85.71428571
2006021141,18,3600,0.0,27,24,5,0,3,88.88888889
2006021142,20,3900,0.0,38,38,2,0,0,100.0
2006021142,30,3900,0.0,24,24,7,0,0,100.0
2006021143,27,3600,0.0,25,19,5,1,6,76.0
2006021143,25,3583,0.0,21,21,1,0,0,100.0
2006021144,23,3583,0.0,34,34,11,0,0,100.0
2006021144,21,3570,0.0,27,26,6,1,1,96.2962963
2006021145,26,3507,0.0,26,23,3,1,3,88.46153846
2006021145,28,3594,0.0,25,24,6,0,1,96.0
2006021146,1,3552,0.0,23,19,0,0,4,82.60869565
2006021146,7,3578,0.0,31,28,2,0,3,90.32258065
2006021147,12,3556,0.0,24,20,3,1,4,83.33333333
2006021147,4,3600,0.0,24,23,5,2,1,95.83333333
2006021148,11,3869,0.0,35,33,0,1,2,94.28571429
2006021148,13,3895,0.0,35,33,9,1,2,94.28571429
2006021149,24,3595,0.0,21,20,1,0,1,95.23809524
2006021149,16,3447,0.0,23,20,5,1,3,86.95652174
2006021150,5,3600,0.0,33,31,6,1,2,93.93939394
2006021150,6,3600,0.0,26,22,3,1,4,84.61538462
2006021151,10,3853,0.0,27,24,2,1,3,88.88888889
2006021151,11,3850,0.0,29,27,8,1,2,93.10344828
2006021152,24,3547,0.0,25,23,7,1,2,92.0
2006021152,29,3511,0.0,30,26,6,0,4,86.66666667
2006021153,22,3588,0.0,41,37,1,1,4,90.24390244
2006021153,19,3600,0.0,18,16,6,0,2,88.88888889
2006021154,17,3600,0.0,25,24,6,0,1,96.0
2006021154,18,3486,0.0,30,28,3,2,2,93.33333333
2006021155,20,3600,0.0,25,23,6,0,2,92.0
2006021155,30,3520,0.0,17,15,1,0,2,88.23529412
2006021155,30,80,0.0,2,0,0,0,2,0.0
2006021156,21,3596,0.0,23,20,3,1,3,86.95652174
2006021156,27,1852,0.0,4,4,0,0,0,100.0
2006021156,27,1669,0.0,14,10,2,0,4,71.42857143
2006021157,23,3600,0.0,34,32,5,0,2,94.11764706
2006021157,26,3530,0.0,21,18,3,0,3,85.71428571
2006021158,14,3595,0.0,28,26,0,1,2,92.85714286
2006021158,12,3600,0.0,29,25,4,0,4,86.20689655
2006021159,8,3561,0.0,36,32,3,1,4,88.88888889
2006021159,9,3600,0.0,28,26,7,0,2,92.85714286
2006021160,4,3561,0.0,23,21,6,0,2,91.30434783
2006021160,1,3598,0.0,15,14,2,1,1,93.33333333
2006021161,15,3719,0.0,35,32,4,1,3,91.42857143
2006021161,13,3720,0.0,32,30,10,0,2,93.75
2006021162,25,3891,0.0,34,31,3,0,3,91.17647059
2006021162,17,3900,0.0,24,21,2,2,3,87.5
2006021163,2,2373,0.0,18,17,6,1,1,94.44444444
2006021163,2,1200,0.0,12,7,2,2,5,58.33333333
2006021163,7,3551,0.0,29,25,4,0,4,86.20689655
2006021164,29,3512,0.0,25,22,4,0,3,88.0
2006021164,16,3600,0.0,32,31,4,0,1,96.875
2006021165,27,3499,0.0,25,21,7,1,4,84.0
2006021165,28,3570,4.0,27,25,13,2,2,92.59259259
2006021166,11,3588,0.0,27,25,4,4,2,92.59259259
2006021166,6,3588,0.0,40,37,9,0,3,92.5
2006021167,30,3548,0.0,32,30,10,0,2,93.75
2006021167,21,3594,0.0,24,23,3,0,1,95.83333333
2006021168,5,1870,0.0,17,16,4,0,1,94.11764706
2006021168,5,1909,0.0,20,16,5,2,4,80.0
2006021168,10,3835,0.0,36,32,9,0,4,88.88888889
2006021169,7,3570,0.0,19,15,1,0,4,78.94736842
2006021169,8,3596,0.0,25,22,3,1,3,88.0
2006021170,9,3586,0.0,23,21,5,2,2,91.30434783
2006021170,2,3576,0.0,46,42,10,4,4,91.30434783
2006021171,3,3600,0.0,37,33,4,0,4,89.18918919
2006021171,4,1834,0.0,12,11,0,1,1,91.66666667
2006021171,4,1635,0.0,22,17,1,2,5,77.27272727
2006021172,15,3578,0.0,28,24,2,0,4,85.71428571
2006021172,14,3600,0.0,25,23,3,0,2,92.0
2006021173,24,3625,0.0,22,20,3,3,2,90.90909091
2006021173,19,3610,0.0,27,24,2,1,3,88.88888889
2006021174,25,3579,0.0,26,24,6,0,2,92.30769231
2006021174,18,3600,0.0,35,31,7,0,4,88.57142857
2006021175,20,3600,0.0,34,32,10,1,2,94.11764706
2006021175,23,3517,0.0,18,15,4,3,3,83.33333333
2006021176,6,3487,0.0,24,21,3,1,3,87.5
2006021176,1,3600,0.0,18,17,0,2,1,94.44444444
2006021177,17,3600,0.0,32,31,7,0,1,96.875
2006021177,29,3588,0.0,25,21,2,1,4,84.0
2006021178,22,3558,0.0,20,18,1,1,2,90.0
2006021178,16,3595,0.0,20,19,6,0,1,95.0
2006021179,12,3689,2.0,31,28,10,0,3,90.32258065
2006021179,13,3690,2.0,37,33,9,5,4,89.18918919
2006021180,26,2395,0.0,23,18,5,2,5,78.26086957
2006021180,26,1200,0.0,6,5,3,1,1,83.33333333
2006021180,28,3591,0.0,20,18,6,1,2,90.0
2006021181,10,1482,0.0,16,12,2,0,4,75.0
2006021181,10,2118,0.0,9,6,0,0,3,66.66666667
2006021181,3,3600,0.0,27,25,5,0,2,92.59259259
2006021182,19,3600,0.0,30,28,0,1,2,93.33333333
2006021182,25,3548,0.0,23,20,1,0,3,86.95652174
2006021183,7,3590,0.0,23,22,11,0,1,95.65217391
2006021183,5,3573,0.0,26,22,5,1,4,84.61538462
2006021184,13,3560,0.0,17,16,3,0,1,94.11764706
2006021184,15,3596,0.0,27,27,4,1,0,100.0
2006021185,4,3735,0.0,33,30,7,1,3,90.90909091
2006021185,10,3712,0.0,25,23,7,0,2,92.0
2006021186,6,3600,0.0,30,28,11,1,2,93.33333333
2006021186,8,3600,0.0,29,29,4,0,0,100.0
2006021187,9,3900,0.0,28,27,3,0,1,96.42857143
2006021187,1,3900,0.0,23,22,5,2,1,95.65217391
2006021188,3,3894,0.0,34,32,7,1,2,94.11764706
2006021188,2,3900,0.0,38,36,9,1,2,94.73684211
2006021189,12,3524,0.0,30,27,1,0,3,90.0
2006021189,14,3600,0.0,25,23,3,0,2,92.0
2006021190,29,3593,0.0,22,20,7,2,2,90.90909091
2006021190,17,3594,2.0,35,35,10,2,0,100.0
2006021191,16,3887,0.0,31,29,7,2,2,93.5483871
2006021191,18,3884,0.0,26,24,1,2,2,92.30769231
2006021192,22,3600,0.0,26,23,3,0,3,88.46153846
2006021192,30,3600,0.0,25,25,9,2,0,100.0
2006021193,21,3600,0.0,21,18,4,1,3,85.71428571
2006021193,20,3529,0.0,23,19,5,0,4,82.60869565
2006021194,26,3566,0.0,31,28,9,0,3,90.32258065
2006021194,23,3600,0.0,17,15,1,1,2,88.23529412
2006021195,19,3595,0.0,33,31,9,0,2,93.93939394
2006021195,27,1200,0.0,6,6,0,0,0,100.0
2006021195,27,2400,0.0,22,17,0,1,5,77.27272727
2006021196,15,3600,0.0,32,30,3,3,2,93.75
2006021196,11,3530,0.0,26,23,4,0,3,88.46153846
2006021197,28,3900,0.0,39,37,3,0,2,94.87179487
2006021197,24,3894,0.0,31,29,3,0,2,93.5483871
2006021198,6,3590,0.0,33,29,1,1,4,87.87878788
2006021198,7,3590,0.0,22,20,4,3,2,90.90909091
2006021199,8,2400,0.0,25,22,5,0,3,88.0
2006021199,8,1068,0.0,8,8,1,0,0,100.0
2006021199,3,3587,0.0,26,25,7,0,1,96.15384615
2006021200,1,3542,0.0,36,34,6,4,2,94.44444444
2006021200,4,3523,0.0,33,30,6,1,3,90.90909091
2006021201,25,3664,0.0,28,26,5,1,2,92.85714286
2006021201,29,3664,0.0,20,19,4,1,1,95.0
2006021202,5,3596,0.0,37,35,12,3,2,94.59459459
2006021202,9,3590,0.0,27,24,6,0,3,88.88888889
2006021203,10,3467,0.0,26,22,0,2,4,84.61538462
2006021203,2,3599,0.0,30,28,5,0,2,93.33333333
2006021204,19,3501,0.0,26,22,2,0,4,84.61538462
2006021204,18,3596,0.0,22,21,3,2,1,95.45454545
2006021205,22,3600,0.0,29,26,2,0,3,89.65517241
2006021205,30,3600,0.0,22,22,2,0,0,100.0
2006021206,17,3897,0.0,21,19,0,0,2,90.47619048
2006021206,16,3891,0.0,58,56,8,2,2,96.55172414
2006021207,21,3586,0.0,18,17,2,1,1,94.44444444
2006021207,23,3476,0.0,30,27,8,0,3,90.0
2006021208,26,3527,0.0,38,35,6,1,3,92.10526316
2006021208,27,3597,0.0,21,19,3,0,2,90.47619048
2006021209,20,3513,0.0,42,38,9,0,4,90.47619048
2006021209,28,3600,2.0,32,29,7,1,3,90.625
2006021210,11,3597,0.0,33,32,10,1,1,96.96969697
2006021210,12,3596,0.0,28,24,6,3,4,85.71428571
2006021211,13,3600,0.0,22,20,0,0,2,90.90909091
2006021211,14,1014,0.0,12,8,1,0,4,66.66666667
2006021211,14,2586,0.0,20,17,2,0,3,85.0
2006021212,24,3900,0.0,30,29,9,0,1,96.66666667
2006021212,25,3842,0.0,22,21,3,0,1,95.45454545
2006021213,2,3594,0.0,30,28,3,0,2,93.33333333
2006021213,4,3510,0.0,31,28,10,4,3,90.32258065
2006021214,7,3594,0.0,26,26,5,1,0,100.0
2006021214,15,3502,0.0,24,22,3,2,2,91.66666667
2006021215,16,1200,0.0,15,15,7,0,0,100.0
2006021215,16,2400,0.0,24,17,7,2,7,70.83333333
2006021215,17,3598,0.0,21,19,3,4,2,90.47619048
2006021216,27,3567,2.0,35,32,12,0,3,91.42857143
2006021216,26,3600,2.0,26,24,4,0,2,92.30769231
2006021217,23,3634,2.0,30,27,8,0,3,90.0
2006021217,28,3604,0.0,30,26,5,6,4,86.66666667
2006021218,9,3589,2.0,32,29,5,0,3,90.625
2006021218,6,3600,0.0,28,22,5,1,6,78.57142857
2006021219,8,3525,0.0,35,29,10,0,6,82.85714286
2006021219,10,1654,0.0,20,16,7,0,4,80.0
2006021219,10,1943,0.0,6,5,1,0,1,83.33333333
2006021220,13,3867,0.0,53,48,10,0,5,90.56603774
2006021220,12,3876,0.0,39,35,1,1,4,89.74358974
2006021221,14,3900,0.0,43,41,5,0,2,95.34883721
2006021221,11,3900,0.0,36,34,9,0,2,94.44444444
2006021222,24,3591,0.0,45,42,11,2,3,93.33333333
2006021222,29,1128,0.0,6,6,0,0,0,100.0
2006021222,29,2383,0.0,19,15,3,1,4,78.94736842
2006021223,3,3550,0.0,30,28,7,1,2,93.33333333
2006021223,5,3600,0.0,29,28,6,1,1,96.55172414
2006021224,19,2400,0.0,23,20,10,0,3,86.95652174
2006021224,19,1200,0.0,8,6,0,0,2,75.0
2006021224,30,3591,0.0,25,24,2,1,1,96.0
2006021225,18,3600,0.0,31,29,8,0,2,93.5483871
2006021225,21,3566,0.0,31,28,4,1,3,90.32258065
2006021226,22,3594,0.0,30,28,11,0,2,93.33333333
2006021226,20,3539,0.0,29,26,5,1,3,89.65517241
2006021227,2,3900,0.0,24,22,3,0,2,91.66666667
2006021227,1,3824,0.0,27,25,3,0,2,92.59259259
2006021228,7,3538,2.0,33,29,3,2,4,87.87878788
2006021228,4,3580,0.0,30,27,5,3,3,90.0
2006021229,16,3569,0.0,33,30,2,0,3,90.90909091
2006021229,25,3595,0.0,24,22,2,1,2,91.66666667
2006021230,23,3563,0.0,26,24,8,1,2,92.30769231
2006021230,27,22,0.0,0,0,0,0,0,
2006021230,27,3577,0.0,24,23,5,0,1,95.83333333
2007020001,24,3507,0.0,20,17,8,2,3,85.0
2007020001,26,3599,0.0,27,26,11,0,1,96.2962963
2007020002,26,3598,0.0,25,21,2,0,4,84.0
2007020002,24,3600,0.0,23,22,2,0,1,95.65217391
2007020003,8,3665,0.0,31,29,7,0,2,93.5483871
2007020003,12,3661,0.0,40,37,11,0,3,92.5
2007020004,24,3900,0.0,42,40,9,0,2,95.23809524
2007020004,17,3887,2.0,15,13,2,1,2,86.66666667
2007020005,9,3777,0.0,29,26,6,1,3,89.65517241
2007020005,10,3777,0.0,30,26,5,3,4,86.66666667
2007020006,25,3531,0.0,23,19,2,0,4,82.60869565
2007020006,21,3600,0.0,34,31,4,1,3,91.17647059
2007020007,13,3600,0.0,25,20,5,0,5,80.0
2007020007,3,3600,0.0,29,27,2,0,2,93.10344828
2007020008,10,3521,0.0,29,26,8,0,3,89.65517241
2007020008,9,3591,0.0,43,41,7,1,2,95.34883721
2007020009,1,3579,0.0,23,21,4,1,2,91.30434783
2007020009,14,3578,0.0,27,26,7,0,1,96.2962963
2007020010,21,946,0.0,10,10,4,0,0,100.0
2007020010,21,2639,0.0,22,18,2,1,4,81.81818182
2007020010,18,3600,0.0,35,35,1,0,0,100.0
2007020011,16,3543,0.0,24,23,3,1,1,95.83333333
2007020011,30,3600,0.0,27,27,9,1,0,100.0
2007020012,4,3600,0.0,26,24,7,6,2,92.30769231
2007020012,20,3576,0.0,26,23,5,1,3,88.46153846
2007020013,28,3864,0.0,25,23,3,0,2,92.0
2007020013,22,3882,0.0,30,28,8,0,2,93.33333333
2007020014,19,3504,0.0,34,31,6,0,3,91.17647059
2007020014,27,3579,0.0,24,22,2,0,2,91.66666667
2007020015,5,1200,0.0,7,7,0,2,0,100.0
2007020015,5,2391,0.0,26,22,6,1,4,84.61538462
2007020015,12,3599,0.0,34,33,7,1,1,97.05882353
2007020016,24,3600,0.0,37,33,15,1,4,89.18918919
2007020016,29,3596,0.0,28,28,10,3,0,100.0
2007020017,2,3589,0.0,26,22,6,1,4,84.61538462
2007020017,7,3522,0.0,34,28,2,0,6,82.35294118
2007020018,15,3600,0.0,29,28,9,1,1,96.55172414
2007020018,11,3511,0.0,40,37,10,0,3,92.5
2007020019,6,3593,0.0,18,14,3,0,4,77.77777778
2007020019,25,3600,0.0,25,24,5,1,1,96.0
2007020020,28,3568,0.0,23,22,3,3,1,95.65217391
2007020020,23,3477,0.0,31,28,9,1,3,90.32258065
2007020021,4,3537,0.0,33,29,2,0,4,87.87878788
2007020021,22,3600,0.0,25,22,1,0,3,88.0
2007020022,8,3806,0.0,31,27,2,2,4,87.09677419
2007020022,10,3795,0.0,28,25,10,0,3,89.28571429
2007020023,3,3534,0.0,33,31,4,2,2,93.93939394
2007020023,9,3600,0.0,35,35,6,1,0,100.0
2007020024,7,3547,0.0,24,21,5,2,3,87.5
2007020024,2,3600,0.0,32,30,7,1,2,93.75
2007020025,12,3519,0.0,33,31,3,2,2,93.93939394
2007020025,15,3600,0.0,23,23,5,1,0,100.0
2007020026,1,3599,0.0,33,32,11,0,1,96.96969697
2007020026,13,3514,0.0,24,20,8,0,4,83.33333333
2007020027,24,3549,0.0,29,24,10,0,5,82.75862069
2007020027,5,3596,0.0,23,19,3,2,4,82.60869565
2007020028,11,3600,0.0,34,29,2,1,5,85.29411765
2007020028,14,3597,0.0,15,13,2,0,2,86.66666667
2007020029,25,3585,0.0,21,17,4,0,4,80.95238095
2007020029,18,3574,0.0,29,28,7,0,1,96.55172414
2007020030,29,3572,0.0,31,28,4,1,3,90.32258065
2007020030,30,3600,0.0,21,19,0,0,2,90.47619048
2007020031,17,3898,0.0,27,24,4,2,3,88.88888889
2007020031,16,3900,0.0,26,23,4,0,3,88.46153846
2007020032,23,3886,0.0,29,26,7,0,3,89.65517241
2007020032,20,3895,2.0,31,27,7,2,4,87.09677419
2007020033,6,3600,0.0,37,36,3,0,1,97.2972973
2007020033,27,3533,0.0,24,21,2,0,3,87.5
2007020034,19,1955,0.0,16,14,0,0,2,87.5
2007020034,19,1645,0.0,8,7,2,0,1,87.5
2007020034,26,3567,0.0,31,27,10,0,4,87.09677419
2007020035,28,2886,0.0,23,17,2,1,6,73.91304348
2007020035,28,707,0.0,2,2,1,0,0,100.0
2007020035,21,3600,0.0,26,24,10,4,2,92.30769231
2007020036,15,3600,0.0,31,30,5,1,1,96.77419355
2007020036,2,3547,0.0,12,10,1,0,2,83.33333333
2007020037,1,3575,0.0,36,33,4,1,3,91.66666667
2007020037,9,3600,0.0,29,27,0,0,2,93.10344828
2007020038,22,3538,0.0,34,31,7,1,3,91.17647059
2007020038,17,3596,0.0,20,18,3,1,2,90.0
2007020039,12,3600,0.0,28,27,4,5,1,96.42857143
2007020039,10,3600,0.0,39,32,6,4,7,82.05128205
2007020040,3,3538,2.0,30,28,6,3,2,93.33333333
2007020040,2,3600,0.0,37,36,3,0,1,97.2972973
2007020041,9,3582,0.0,29,28,5,2,1,96.55172414
2007020041,11,3479,0.0,36,33,9,0,3,91.66666667
2007020042,27,3595,0.0,33,30,1,1,3,90.90909091
2007020042,29,3600,0.0,32,32,12,0,0,100.0
2007020043,8,3600,0.0,28,26,4,0,2,92.85714286
2007020043,5,3539,0.0,35,32,1,1,3,91.42857143
2007020044,13,3536,0.0,23,21,2,0,2,91.30434783
2007020044,14,3587,0.0,31,30,9,0,1,96.77419355
2007020045,20,3539,0.0,28,24,0,0,4,85.71428571
2007020045,17,3579,0.0,21,19,2,1,2,90.47619048
2007020046,22,3465,0.0,26,24,1,1,2,92.30769231
2007020046,30,3588,0.0,21,21,6,0,0,100.0
2007020047,28,3569,0.0,17,16,0,1,1,94.11764706
2007020047,16,3517,0.0,32,30,5,4,2,93.75
2007020048,18,1870,0.0,18,14,3,1,4,77.77777778
2007020048,18,1717,0.0,14,14,5,0,0,100.0
2007020048,19,3600,0.0,20,19,1,1,1,95.0
2007020049,26,3593,0.0,27,22,8,0,5,81.48148148
2007020049,25,3598,0.0,33,32,9,3,1,96.96969697
2007020050,4,3600,0.0,27,25,6,0,2,92.59259259
2007020050,23,2344,0.0,17,13,5,0,4,76.47058824
2007020050,23,1194,0.0,13,9,4,1,4,69.23076923
2007020051,6,3527,0.0,30,28,3,0,2,93.33333333
2007020051,24,3600,0.0,19,18,1,0,1,94.73684211
2007020052,11,1200,0.0,8,7,2,0,1,87.5
2007020052,11,2383,2.0,20,15,10,1,5,75.0
2007020052,7,3586,0.0,20,20,7,1,0,100.0
2007020053,2,3600,0.0,42,34,4,5,8,80.95238095
2007020053,10,3600,0.0,31,30,4,4,1,96.77419355
2007020054,12,3591,0.0,30,27,6,2,3,90.0
2007020054,9,3580,0.0,31,27,4,1,4,87.09677419
2007020055,1,3598,0.0,31,28,7,0,3,90.32258065
2007020055,13,3600,0.0,29,29,7,0,0,100.0
2007020056,27,3575,0.0,39,36,5,0,3,92.30769231
2007020056,18,3472,0.0,23,18,1,0,5,78.26086957
2007020057,15,3481,0.0,41,38,14,4,3,92.68292683
2007020057,3,3599,0.0,25,24,1,1,1,96.0
2007020058,16,3600,0.0,36,34,5,3,2,94.44444444
2007020058,17,3548,2.0,29,26,18,0,3,89.65517241
2007020059,21,3600,0.0,23,19,3,0,4,82.60869565
2007020059,19,3600,0.0,25,24,4,0,1,96.0
2007020060,20,3798,0.0,26,24,2,2,2,92.30769231
2007020060,25,3800,0.0,26,23,3,0,3,88.46153846
2007020061,23,3600,0.0,30,28,2,2,2,93.33333333
2007020061,22,2202,0.0,8,6,0,0,2,75.0
2007020061,22,1392,0.0,11,8,0,0,3,72.72727273
2007020062,6,3593,0.0,31,25,6,0,6,80.64516129
2007020062,26,3543,0.0,30,23,10,1,7,76.66666667
2007020063,15,3600,0.0,53,46,13,1,7,86.79245283
2007020063,7,3580,0.0,26,23,5,4,3,88.46153846
2007020064,5,907,0.0,6,4,0,0,2,66.66666667
2007020064,5,2688,0.0,21,19,6,1,2,90.47619048
2007020064,10,3540,0.0,51,46,15,6,5,90.19607843
2007020065,12,3600,0.0,24,23,4,0,1,95.83333333
2007020065,8,3553,0.0,37,35,10,2,2,94.59459459
2007020066,9,3600,2.0,37,36,10,2,1,97.2972973
2007020066,3,3535,0.0,34,31,7,0,3,91.17647059
2007020067,2,3534,0.0,22,20,1,1,2,90.90909091
2007020067,4,3600,0.0,30,29,0,2,1,96.66666667
2007020068,1,3600,0.0,17,12,0,1,5,70.58823529
2007020068,11,3584,0.0,35,29,8,2,6,82.85714286
2007020069,14,2133,0.0,13,11,3,0,2,84.61538462
2007020069,14,1329,0.0,15,11,2,0,4,73.33333333
2007020069,13,3591,0.0,44,40,13,4,4,90.90909091
2007020070,20,3572,0.0,25,21,4,1,4,84.0
2007020070,18,2856,0.0,23,17,4,2,6,73.91304348
2007020070,18,743,0.0,7,6,0,0,1,85.71428571
2007020071,25,3638,0.0,40,38,9,0,2,95.0
2007020071,16,3575,0.0,18,17,4,0,1,94.44444444
2007020072,29,3586,0.0,26,21,5,0,5,80.76923077
2007020072,21,3596,0.0,25,24,6,1,1,96.0
2007020073,22,3594,0.0,22,18,4,0,4,81.81818182
2007020073,23,3599,0.0,28,27,8,1,1,96.42857143
2007020074,30,3600,0.0,29,27,7,2,2,93.10344828
2007020074,27,3573,0.0,26,23,5,2,3,88.46153846
2007020075,6,3600,0.0,27,26,6,2,1,96.2962963
2007020075,28,3569,0.0,20,18,3,0,2,90.0
2007020076,30,3598,0.0,37,37,15,0,0,100.0
2007020077,17,3600,0.0,28,27,10,2,1,96.42857143
2007020077,26,3594,0.0,30,26,5,0,4,86.66666667
2007020078,10,3895,0.0,42,37,13,5,5,88.0952381
2007020078,7,3894,0.0,25,21,6,1,4,84.0
2007020079,28,3571,0.0,26,24,6,0,2,92.30769231
2007020079,23,3600,0.0,34,30,6,2,4,88.23529412
2007020080,17,3452,0.0,28,23,8,1,5,82.14285714
2007020080,24,3508,0.0,35,32,19,0,3,91.42857143
2007020081,11,3600,0.0,33,29,5,2,4,87.87878788
2007020081,4,3600,0.0,31,31,7,1,0,100.0
2007020082,13,3841,0.0,37,36,8,0,1,97.2972973
2007020082,8,3900,0.0,25,24,4,1,1,96.0
2007020083,20,3900,0.0,35,31,2,1,4,88.57142857
2007020083,21,2529,0.0,17,17,4,0,0,100.0
2007020083,21,1371,0.0,12,8,1,0,4,66.66666667
2007020084,30,3900,0.0,29,26,9,0,3,89.65517241
2007020084,26,3895,0.0,31,28,5,3,3,90.32258065
2007020085,25,3893,0.0,35,33,5,2,2,94.28571429
2007020085,29,3873,0.0,30,28,2,0,2,93.33333333
2007020086,1,3600,0.0,30,26,9,2,4,86.66666667
2007020086,5,3545,0.0,35,30,9,0,5,85.71428571
2007020087,19,3600,0.0,29,28,3,0,1,96.55172414
2007020087,16,3573,0.0,26,23,1,1,3,88.46153846
2007020088,18,3487,0.0,31,28,1,1,3,90.32258065
2007020088,24,3600,0.0,29,28,4,2,1,96.55172414
2007020089,14,3600,0.0,24,20,0,1,4,83.33333333
2007020089,6,3600,0.0,36,35,2,0,1,97.22222222
2007020090,1,3586,0.0,18,14,4,1,4,77.77777778
2007020090,4,3600,0.0,38,38,10,3,0,100.0
2007020091,2,3589,0.0,29,27,6,0,2,93.10344828
2007020091,15,3599,2.0,21,16,4,0,5,76.19047619
2007020092,3,3559,0.0,28,23,4,2,5,82.14285714
2007020092,11,2908,0.0,27,24,11,1,3,88.88888889
2007020092,11,690,0.0,9,9,2,1,0,100.0
2007020093,13,3551,0.0,27,24,4,2,3,88.88888889
2007020093,10,3600,0.0,28,26,8,0,2,92.85714286
2007020094,8,3548,0.0,33,29,4,1,4,87.87878788
2007020094,9,3600,0.0,31,28,4,2,3,90.32258065
2007020095,26,1112,0.0,11,11,1,0,0,100.0
2007020095,26,2385,0.0,18,14,3,0,4,77.77777778
2007020095,20,3600,0.0,34,31,7,1,3,91.17647059
2007020096,22,3600,0.0,41,39,7,1,2,95.12195122
2007020096,27,3581,0.0,17,14,0,0,3,82.35294118
2007020097,17,3600,0.0,25,23,3,0,2,92.0
2007020097,28,3552,0.0,27,23,5,0,4,85.18518519
2007020098,29,3577,0.0,21,21,4,0,0,100.0
2007020098,7,3567,0.0,28,26,5,1,2,92.85714286
2007020099,12,3900,0.0,29,26,9,1,3,89.65517241
2007020099,5,3900,0.0,32,29,5,1,3,90.625
2007020100,21,3573,0.0,26,22,4,1,4,84.61538462
2007020100,16,3592,0.0,40,37,7,1,3,92.5
2007020101,26,3582,0.0,28,26,6,1,2,92.85714286
2007020101,23,3515,0.0,16,13,4,0,3,81.25
2007020102,3,3900,0.0,19,19,6,0,0,100.0
2007020102,6,3900,0.0,26,26,4,3,0,100.0
2007020103,16,3600,0.0,32,28,0,1,4,87.5
2007020103,10,3575,0.0,38,33,11,0,5,86.84210526
2007020104,7,3572,0.0,26,23,2,2,3,88.46153846
2007020104,8,3583,0.0,27,25,2,2,2,92.59259259
2007020105,13,3591,0.0,47,43,3,4,4,91.4893617
2007020105,9,3589,0.0,32,31,8,1,1,96.875
2007020106,1,3896,0.0,36,32,10,0,4,88.88888889
2007020106,2,3896,0.0,28,25,6,1,3,89.28571429
2007020107,12,3648,0.0,30,27,6,0,3,90.0
2007020107,4,3648,2.0,44,42,5,0,2,95.45454545
2007020108,5,3600,0.0,31,30,1,3,1,96.77419355
2007020108,15,3539,0.0,22,20,5,2,2,90.90909091
2007020109,11,1200,2.0,6,5,0,0,1,83.33333333
2007020109,11,2392,0.0,24,19,1,0,5,79.16666667
2007020109,14,3593,0.0,20,18,4,2,2,90.0
2007020110,24,1726,0.0,11,11,1,0,0,100.0
2007020110,24,1725,0.0,12,9,1,0,3,75.0
2007020110,25,3579,0.0,21,20,9,0,1,95.23809524
2007020111,30,3600,0.0,34,33,7,2,1,97.05882353
2007020111,19,3507,0.0,34,31,13,2,3,91.17647059
2007020112,22,3587,0.0,34,30,9,0,4,88.23529412
2007020112,20,3598,0.0,18,17,3,2,1,94.44444444
2007020113,17,3586,0.0,21,19,2,0,2,90.47619048
2007020113,27,3600,0.0,42,37,7,3,5,88.0952381
2007020114,18,3486,0.0,19,17,3,4,2,89.47368421
2007020114,28,3600,0.0,22,22,3,2,0,100.0
2007020115,23,3598,0.0,36,35,11,0,1,97.22222222
2007020115,29,3570,0.0,18,15,8,0,3,83.33333333
2007020116,21,3540,0.0,32,29,9,1,3,90.625
2007020116,30,3600,0.0,31,29,11,0,2,93.5483871
2007020117,23,3581,0.0,30,28,7,1,2,93.33333333
2007020117,12,3600,0.0,20,19,3,1,1,95.0
2007020118,6,3561,0.0,20,14,7,0,6,70.0
2007020118,8,3600,0.0,32,31,2,0,1,96.875
2007020119,28,3598,0.0,19,18,4,2,1,94.73684211
2007020119,20,1418,0.0,2,1,0,0,1,50.0
2007020119,20,2182,0.0,18,15,1,1,3,83.33333333
2007020120,3,3574,0.0,22,21,4,0,1,95.45454545
2007020120,5,3587,0.0,36,36,10,1,0,100.0
2007020121,11,3893,0.0,36,32,4,1,4,88.88888889
2007020121,10,3847,0.0,36,32,5,0,4,88.88888889
2007020122,29,3600,0.0,28,24,4,3,4,85.71428571
2007020122,16,3562,0.0,25,19,3,1,6,76.0
2007020123,24,3556,0.0,32,29,3,1,3,90.625
2007020123,19,3600,0.0,16,14,2,2,2,87.5
2007020124,21,3600,0.0,27,25,1,1,2,92.59259259
2007020124,22,3552,0.0,21,18,3,0,3,85.71428571
2007020125,18,1801,0.0,19,15,0,0,4,78.94736842
2007020125,18,1799,0.0,17,15,4,0,2,88.23529412
2007020125,26,3595,0.0,17,17,0,0,0,100.0
2007020126,14,3518,0.0,28,24,8,0,4,85.71428571
2007020126,15,3600,0.0,29,26,9,0,3,89.65517241
2007020127,7,3587,0.0,43,37,9,0,6,86.04651163
2007020127,12,3596,0.0,21,19,6,4,2,90.47619048
2007020128,4,3540,0.0,42,38,8,1,4,90.47619048
2007020128,13,3600,0.0,23,20,1,0,3,86.95652174
2007020129,23,3531,0.0,39,36,5,2,3,92.30769231
2007020129,17,3600,0.0,15,13,2,2,2,86.66666667
2007020130,30,3591,0.0,24,19,5,2,5,79.16666667
2007020130,20,3600,0.0,19,16,10,1,3,84.21052632
2007020131,16,3460,0.0,18,15,1,0,3,83.33333333
2007020131,6,3600,0.0,27,26,4,0,1,96.2962963
2007020132,1,3521,0.0,31,29,7,1,2,93.5483871
2007020132,3,3582,0.0,22,22,3,2,0,100.0
2007020133,19,3574,0.0,27,25,3,1,2,92.59259259
2007020133,29,3594,0.0,36,36,4,0,0,100.0
2007020134,10,3595,0.0,25,23,5,0,2,92.0
2007020134,5,3558,0.0,27,22,3,1,5,81.48148148
2007020135,4,3571,0.0,25,21,0,0,4,84.0
2007020135,14,3586,0.0,23,21,4,0,2,91.30434783
2007020136,11,3586,0.0,33,31,4,0,2,93.93939394
2007020136,18,3590,0.0,20,20,2,1,0,100.0
2007020137,30,3897,0.0,31,27,7,2,4,87.09677419
2007020137,22,3900,0.0,30,26,6,0,4,86.66666667
2007020138,27,3600,0.0,31,31,8,4,0,100.0
2007020138,24,3541,0.0,21,20,4,1,1,95.23809524
2007020139,25,3562,0.0,30,28,5,1,2,93.33333333
2007020139,26,3600,0.0,30,29,6,1,1,96.66666667
2007020140,23,3599,0.0,28,26,8,0,2,92.85714286
2007020140,15,3517,0.0,26,23,4,1,3,88.46153846
2007020141,8,3600,0.0,36,32,7,2,4,88.88888889
2007020141,12,1200,0.0,15,10,3,0,5,66.66666667
2007020141,12,2337,2.0,14,13,1,0,1,92.85714286
2007020142,7,3595,0.0,35,33,10,3,2,94.28571429
2007020142,13,3562,0.0,33,29,9,1,4,87.87878788
2007020143,28,2892,0.0,30,26,11,1,4,86.66666667
2007020143,28,708,0.0,9,8,0,0,1,88.88888889
2007020143,17,3600,0.0,11,10,0,0,1,90.90909091
2007020144,21,3614,0.0,41,39,10,0,2,95.12195122
2007020144,20,3621,0.0,22,19,3,0,3,86.36363636
2007020145,28,3529,0.0,18,16,4,1,2,88.88888889
2007020145,29,3596,0.0,17,16,2,2,1,94.11764706
2007020146,4,3600,0.0,39,38,3,0,1,97.43589744
2007020146,6,3528,0.0,28,26,3,3,2,92.85714286
2007020147,9,3598,0.0,32,31,3,1,1,96.875
2007020147,1,3506,0.0,26,23,3,1,3,88.46153846
2007020148,12,3600,0.0,31,28,4,1,3,90.32258065
2007020148,2,1919,0.0,12,10,4,0,2,83.33333333
2007020148,2,1668,0.0,14,8,1,1,6,57.14285714
2007020149,10,3583,0.0,33,32,4,0,1,96.96969697
2007020149,3,3498,0.0,22,19,2,1,3,86.36363636
2007020150,8,3900,0.0,23,20,4,0,3,86.95652174
2007020150,5,2624,0.0,13,13,2,0,0,100.0
2007020150,5,1249,0.0,15,12,4,0,3,80.0
2007020151,7,3859,0.0,34,31,6,0,3,91.17647059
2007020151,14,3844,0.0,26,22,3,0,4,84.61538462
2007020152,13,3594,0.0,33,29,10,0,4,87.87878788
2007020152,18,3590,0.0,27,24,6,1,3,88.88888889
2007020153,11,3595,4.0,31,29,10,1,2,93.5483871
2007020153,16,3500,0.0,22,19,4,1,3,86.36363636
2007020154,15,3537,0.0,18,14,7,0,4,77.77777778
2007020154,19,3600,0.0,26,23,9,1,3,88.46153846
2007020155,25,3591,0.0,31,28,5,0,3,90.32258065
2007020155,27,3519,0.0,25,20,6,1,5,80.0
2007020156,22,3600,0.0,31,27,2,0,4,87.09677419
2007020156,26,3580,0.0,35,34,5,0,1,97.14285714
2007020157,30,3600,0.0,30,27,2,0,3,90.0
2007020157,21,3600,0.0,22,21,3,2,1,95.45454545
2007020158,22,3892,0.0,32,30,4,3,2,93.75
2007020158,24,3900,0.0,22,20,6,1,2,90.90909091
2007020159,17,3600,0.0,29,27,4,0,2,93.10344828
2007020159,23,3500,0.0,32,29,4,2,3,90.625
2007020160,14,3573,0.0,35,32,11,0,3,91.42857143
2007020160,3,3595,0.0,22,21,3,1,1,95.45454545
2007020161,15,3600,0.0,33,32,9,1,1,96.96969697
2007020161,10,2764,0.0,17,14,4,1,3,82.35294118
2007020161,10,836,0.0,13,9,1,0,4,69.23076923
2007020162,28,3574,0.0,29,27,3,0,2,93.10344828
2007020162,25,3525,0.0,35,31,4,0,4,88.57142857
2007020163,5,3597,0.0,30,28,4,0,2,93.33333333
2007020163,30,3600,0.0,27,23,2,1,4,85.18518519
2007020164,11,3887,0.0,33,31,11,2,2,93.93939394
2007020164,8,3889,0.0,33,31,10,2,2,93.93939394
2007020165,27,3600,0.0,25,24,6,1,1,96.0
2007020165,19,3499,0.0,27,25,1,3,2,92.59259259
2007020166,18,3599,0.0,33,28,5,1,5,84.84848485
2007020166,20,3581,0.0,40,39,11,2,1,97.5
2007020167,17,3600,0.0,16,15,2,0,1,93.75
2007020167,22,3591,0.0,34,32,6,3,2,94.11764706
2007020168,14,396,0.0,3,2,1,0,1,66.66666667
2007020168,14,3204,0.0,27,22,2,1,5,81.48148148
2007020168,1,3600,0.0,22,21,4,2,1,95.45454545
2007020169,12,3583,0.0,32,28,3,3,4,87.5
2007020169,13,3600,0.0,30,28,2,1,2,93.33333333
2007020170,16,3600,0.0,23,19,2,0,4,82.60869565
2007020170,25,1716,0.0,8,6,0,0,2,75.0
2007020170,25,1859,0.0,21,18,4,1,3,85.71428571
2007020171,29,3600,0.0,34,33,9,0,1,97.05882353
2007020171,26,3526,0.0,35,32,8,1,3,91.42857143
2007020172,7,3825,0.0,24,20,5,1,4,83.33333333
2007020172,6,3837,0.0,30,27,1,1,3,90.0
2007020173,14,3600,2.0,32,28,7,3,4,87.5
2007020173,2,3597,0.0,28,28,3,1,0,100.0
2007020174,15,3530,0.0,28,26,6,3,2,92.85714286
2007020174,3,3600,0.0,31,31,8,0,0,100.0
2007020175,4,3569,0.0,41,36,5,3,5,87.80487805
2007020175,8,3595,0.0,19,17,5,0,2,89.47368421
2007020176,11,1631,0.0,8,7,0,0,1,87.5
2007020176,11,1923,0.0,19,15,1,0,4,78.94736842
2007020176,9,3600,0.0,19,15,2,0,4,78.94736842
2007020177,19,3587,0.0,25,23,2,2,2,92.0
2007020177,30,3520,0.0,28,25,8,0,3,89.28571429
2007020178,5,3530,0.0,33,30,6,1,3,90.90909091
2007020178,21,3593,0.0,28,26,3,3,2,92.85714286
2007020179,17,3599,0.0,27,26,11,0,1,96.2962963
2007020179,20,3587,0.0,26,22,5,1,4,84.61538462
2007020180,18,3590,0.0,29,29,5,1,0,100.0
2007020180,23,3600,0.0,15,12,1,2,3,80.0
2007020181,29,3900,0.0,34,33,10,3,1,97.05882353
2007020181,24,3886,0.0,20,19,5,1,1,95.0
2007020182,10,3544,0.0,21,18,4,0,3,85.71428571
2007020182,1,3600,0.0,28,26,10,1,2,92.85714286
2007020183,4,3561,0.0,26,24,0,0,2,92.30769231
2007020183,15,3541,2.0,29,26,15,0,3,89.65517241
2007020184,13,3600,0.0,28,26,4,0,2,92.85714286
2007020184,7,3477,0.0,24,20,0,1,4,83.33333333
2007020185,27,3594,2.0,35,35,4,2,0,100.0
2007020185,25,829,0.0,9,7,0,0,2,77.77777778
2007020185,25,2771,0.0,17,14,3,0,3,82.35294118
2007020186,18,3579,0.0,31,30,6,0,1,96.77419355
2007020186,22,3585,0.0,22,19,1,1,3,86.36363636
2007020187,26,3600,0.0,47,45,7,1,2,95.74468085
2007020187,28,3585,0.0,29,25,0,4,4,86.20689655
2007020188,10,3568,0.0,34,32,7,0,2,94.11764706
2007020188,8,3541,0.0,31,28,0,0,3,90.32258065
2007020189,6,3551,0.0,45,42,5,0,3,93.33333333
2007020189,9,3586,0.0,19,17,0,1,2,89.47368421
2007020190,5,3535,0.0,39,36,11,1,3,92.30769231
2007020190,2,1564,0.0,7,7,0,1,0,100.0
2007020190,2,2027,0.0,18,16,4,0,2,88.88888889
2007020191,1,3900,2.0,27,26,2,0,1,96.2962963
2007020191,3,3897,0.0,29,28,2,2,1,96.55172414
2007020192,13,3564,0.0,40,36,5,0,4,90.0
2007020192,12,3596,0.0,24,22,3,1,2,91.66666667
2007020193,11,3600,0.0,34,30,5,3,4,88.23529412
2007020193,14,3571,0.0,21,16,1,0,5,76.19047619
2007020194,20,3561,0.0,16,13,2,0,3,81.25
2007020194,30,3600,0.0,24,23,3,0,1,95.83333333
2007020195,16,3598,0.0,22,20,5,0,2,90.90909091
2007020195,19,3533,0.0,22,19,1,0,3,86.36363636
2007020196,24,3590,0.0,32,30,8,2,2,93.75
2007020196,27,3553,0.0,38,34,15,1,4,89.47368421
2007020197,23,3600,0.0,32,29,8,2,3,90.625
2007020197,21,3517,0.0,22,18,2,1,4,81.81818182
2007020198,28,3600,0.0,25,24,2,1,1,96.0
2007020198,26,3504,0.0,28,25,0,2,3,89.28571429
2007020199,19,3593,0.0,25,22,7,1,3,88.0
2007020199,29,3548,0.0,21,21,9,0,0,100.0
2007020200,9,3885,0.0,22,21,5,1,1,95.45454545
2007020200,6,3900,0.0,36,35,7,1,1,97.22222222
2007020201,18,3588,0.0,32,30,9,3,2,93.75
2007020201,16,1196,0.0,6,3,0,0,3,50.0
2007020201,16,2343,0.0,12,11,3,0,1,91.66666667
2007020202,5,3600,0.0,20,20,4,1,0,100.0
2007020202,1,992,0.0,6,6,2,0,0,100.0
2007020202,1,2608,0.0,24,19,6,1,5,79.16666667
2007020203,4,3591,0.0,45,43,10,0,2,95.55555556
2007020203,3,3600,0.0,30,30,4,1,0,100.0
2007020204,15,1079,0.0,9,9,3,0,0,100.0
2007020204,15,2521,2.0,24,19,7,0,5,79.16666667
2007020204,12,3598,0.0,35,35,7,3,0,100.0
2007020205,7,3548,0.0,18,17,3,1,1,94.44444444
2007020205,8,3600,0.0,29,29,1,1,0,100.0
2007020206,14,3538,0.0,30,26,14,0,4,86.66666667
2007020206,13,3600,0.0,27,24,4,6,3,88.88888889
2007020207,22,1199,0.0,8,5,3,0,3,62.5
2007020207,22,2399,0.0,18,16,3,0,2,88.88888889
2007020207,30,3587,0.0,24,22,2,1,2,91.66666667
2007020208,20,562,0.0,2,2,0,0,0,100.0
2007020208,20,3038,0.0,34,30,11,0,4,88.23529412
2007020208,21,3600,0.0,24,23,0,0,1,95.83333333
2007020209,25,3600,2.0,19,19,3,0,0,100.0
2007020209,24,1200,0.0,5,4,2,0,1,80.0
2007020209,24,2400,0.0,19,15,2,2,4,78.94736842
2007020210,3,3567,0.0,27,24,2,0,3,88.88888889
2007020210,2,3600,0.0,30,28,4,1,2,93.33333333
2007020211,15,3694,0.0,31,29,9,0,2,93.5483871
2007020211,11,3694,0.0,32,31,6,1,1,96.875
2007020212,10,1906,0.0,8,7,1,1,1,87.5
2007020212,10,1688,0.0,13,9,1,1,4,69.23076923
2007020212,9,3600,0.0,31,30,8,0,1,96.77419355
2007020213,6,3790,0.0,29,27,7,3,2,93.10344828
2007020213,7,3785,0.0,26,25,6,1,1,96.15384615
2007020214,4,3600,0.0,27,26,9,0,1,96.2962963
2007020214,5,3506,0.0,20,17,2,1,3,85.0
2007020215,13,3587,0.0,33,31,7,1,2,93.93939394
2007020215,14,3600,0.0,23,22,4,3,1,95.65217391
2007020216,18,3900,0.0,45,43,12,3,2,95.55555556
2007020216,17,3900,0.0,30,28,5,3,2,93.33333333
2007020217,29,3420,0.0,34,30,1,1,4,88.23529412
2007020217,16,3600,0.0,26,24,5,0,2,92.30769231
2007020218,22,3900,0.0,38,35,9,2,3,92.10526316
2007020218,21,3899,0.0,33,30,6,1,3,90.90909091
2007020219,27,3841,0.0,27,22,3,1,5,81.48148148
2007020219,24,2230,0.0,18,14,5,2,4,77.77777778
2007020219,24,1638,0.0,11,9,0,0,2,81.81818182
2007020220,25,3600,2.0,39,38,19,0,1,97.43589744
2007020220,28,3490,0.0,12,9,3,0,3,75.0
2007020221,8,3600,0.0,29,28,5,0,1,96.55172414
2007020221,6,3523,0.0,32,30,1,3,2,93.75
2007020222,4,2232,0.0,24,24,9,0,0,100.0
2007020222,4,1368,0.0,15,11,3,2,4,73.33333333
2007020222,1,3600,0.0,14,13,5,1,1,92.85714286
2007020223,5,3552,0.0,39,35,6,0,4,89.74358974
2007020223,3,3581,0.0,28,26,6,1,2,92.85714286
2007020224,14,3597,0.0,41,40,7,2,1,97.56097561
2007020224,12,3583,0.0,31,26,2,1,5,83.87096774
2007020225,15,3599,0.0,28,27,7,0,1,96.42857143
2007020225,9,3600,0.0,35,31,12,0,4,88.57142857
2007020226,23,3592,0.0,38,36,12,5,2,94.73684211
2007020226,20,3548,0.0,24,21,7,1,3,87.5
2007020227,25,3600,0.0,31,26,5,2,5,83.87096774
2007020227,27,3600,0.0,26,24,3,2,2,92.30769231
2007020228,10,3600,0.0,30,30,13,0,0,100.0
2007020228,7,3577,0.0,23,20,1,0,3,86.95652174
2007020229,11,3595,0.0,37,36,4,1,1,97.2972973
2007020229,13,3600,0.0,27,23,4,0,4,85.18518519
2007020230,29,3600,0.0,36,32,8,1,4,88.88888889
2007020230,17,3595,0.0,16,15,7,0,1,93.75
2007020231,19,3587,0.0,30,27,2,0,3,90.0
2007020231,16,3572,2.0,25,23,2,1,2,92.0
2007020232,21,3682,0.0,28,26,3,0,2,92.85714286
2007020232,23,3682,0.0,25,24,4,0,1,96.0
2007020233,28,3894,0.0,26,24,0,4,2,92.30769231
2007020233,24,3894,0.0,24,22,4,1,2,91.66666667
2007020234,8,3544,0.0,36,34,7,1,2,94.44444444
2007020234,9,3600,0.0,29,28,4,0,1,96.55172414
2007020235,7,3571,0.0,22,20,6,2,2,90.90909091
2007020235,6,3600,2.0,46,45,5,3,1,97.82608696
2007020236,3,3861,0.0,34,32,5,3,2,94.11764706
2007020236,10,3900,0.0,27,25,1,1,2,92.59259259
2007020237,1,3521,0.0,22,20,2,0,2,90.90909091
2007020237,2,3577,0.0,21,20,0,0,1,95.23809524
2007020238,5,3576,0.0,29,25,3,1,4,86.20689655
2007020238,4,3600,0.0,31,29,5,2,2,93.5483871
2007020239,14,3600,0.0,25,23,3,1,2,92.0
2007020239,15,3512,0.0,33,29,1,1,4,87.87878788
2007020240,12,3600,0.0,35,32,10,1,3,91.42857143
2007020240,11,3519,0.0,39,34,5,4,5,87.17948718
2007020241,29,161,0.0,2,2,0,0,0,100.0
2007020241,29,3739,0.0,27,24,9,1,3,88.88888889
2007020241,18,3887,0.0,39,36,7,2,3,92.30769231
2007020242,22,3600,0.0,39,37,14,1,2,94.87179487
2007020242,20,3600,0.0,35,31,7,1,4,88.57142857
2007020243,25,3749,0.0,34,28,5,0,6,82.35294118
2007020243,26,2400,0.0,21,17,2,0,4,80.95238095
2007020243,26,1354,0.0,4,3,2,0,1,75.0
2007020244,27,3593,0.0,28,24,3,2,4,85.71428571
2007020244,28,3600,0.0,23,22,2,2,1,95.65217391
2007020245,17,3537,0.0,27,24,9,1,3,88.88888889
2007020245,16,3595,0.0,32,30,10,1,2,93.75
2007020246,30,3575,0.0,25,22,8,0,3,88.0
2007020246,21,3592,0.0,27,25,0,2,2,92.59259259
2007020247,2,3516,2.0,17,14,2,3,3,82.35294118
2007020247,4,3600,0.0,26,24,4,1,2,92.30769231
2007020248,18,3600,0.0,30,29,3,1,1,96.66666667
2007020248,29,3520,0.0,30,27,6,0,3,90.0
2007020249,1,3589,0.0,25,23,7,0,2,92.0
2007020249,5,3600,0.0,21,18,6,1,3,85.71428571
2007020250,12,3596,0.0,31,28,2,4,3,90.32258065
2007020250,13,3560,0.0,36,32,8,1,4,88.88888889
2007020251,27,3600,0.0,28,23,3,0,5,82.14285714
2007020251,28,3587,0.0,25,25,3,0,0,100.0
2007020252,13,3625,0.0,33,30,6,0,3,90.90909091
2007020252,11,3548,0.0,21,19,1,2,2,90.47619048
2007020253,17,1435,0.0,4,4,0,0,0,100.0
2007020253,17,2151,0.0,12,8,6,0,4,66.66666667
2007020253,19,3600,0.0,30,27,3,2,3,90.0
2007020254,8,3609,0.0,40,37,12,1,3,92.5
2007020254,10,3635,0.0,25,21,2,3,4,84.0
2007020255,30,3591,0.0,28,25,4,1,3,89.28571429
2007020255,20,3600,0.0,28,26,8,1,2,92.85714286
2007020256,26,3900,0.0,33,30,4,6,3,90.90909091
2007020256,24,3900,0.0,32,29,6,0,3,90.625
2007020257,3,3600,0.0,24,22,5,3,2,91.66666667
2007020257,1,3534,0.0,23,19,2,0,4,82.60869565
2007020258,16,3512,0.0,21,17,1,0,4,80.95238095
2007020258,29,3600,0.0,18,16,1,0,2,88.88888889
2007020259,12,3600,0.0,28,22,2,2,6,78.57142857
2007020259,14,3600,0.0,29,28,6,2,1,96.55172414
2007020260,28,3900,0.0,29,26,7,1,3,89.65517241
2007020260,25,3900,0.0,25,22,4,0,3,88.0
2007020261,22,3888,0.0,29,29,3,3,0,100.0
2007020261,23,3900,0.0,19,19,5,0,0,100.0
2007020262,10,3596,0.0,27,22,2,0,5,81.48148148
2007020262,6,3600,0.0,36,34,10,1,2,94.44444444
2007020263,3,3900,0.0,23,20,3,4,3,86.95652174
2007020263,4,3900,0.0,29,26,5,0,3,89.65517241
2007020264,7,3553,0.0,34,31,12,2,3,91.17647059
2007020264,9,3600,0.0,37,35,7,1,2,94.59459459
2007020265,2,3529,0.0,27,24,6,0,3,88.88888889
2007020265,5,3556,0.0,28,26,1,2,2,92.85714286
2007020266,15,3510,0.0,25,23,2,1,2,92.0
2007020266,13,3600,0.0,27,26,5,0,1,96.2962963
2007020267,16,3588,0.0,37,32,6,0,5,86.48648649
2007020267,18,3610,0.0,31,27,1,0,4,87.09677419
2007020268,30,1200,0.0,14,14,2,0,0,100.0
2007020268,30,2393,0.0,26,24,6,2,2,92.30769231
2007020268,22,3500,0.0,25,21,6,1,4,84.0
2007020269,28,3600,0.0,15,15,1,1,0,100.0
2007020269,27,1897,0.0,12,9,3,0,3,75.0
2007020269,27,1703,0.0,18,15,2,1,3,83.33333333
2007020270,24,3600,0.0,29,26,5,0,3,89.65517241
2007020270,26,3586,0.0,31,26,5,0,5,83.87096774
2007020271,2,3600,0.0,26,26,3,0,0,100.0
2007020271,1,3528,0.0,26,25,4,0,1,96.15384615
2007020272,11,3593,0.0,31,31,7,0,0,100.0
2007020272,12,3541,0.0,24,22,5,2,2,91.66666667
2007020273,8,3600,0.0,28,24,1,1,4,85.71428571
2007020273,7,3600,0.0,37,36,2,0,1,97.2972973
2007020274,15,3509,0.0,23,19,3,1,4,82.60869565
2007020274,14,3585,0.0,30,28,8,0,2,93.33333333
2007020275,29,3589,0.0,22,20,6,1,2,90.90909091
2007020275,19,3600,0.0,30,28,6,3,2,93.33333333
2007020276,21,1852,0.0,15,10,0,0,5,66.66666667
2007020276,21,1733,0.0,11,10,0,0,1,90.90909091
2007020276,25,3594,0.0,18,17,4,0,1,94.44444444
2007020277,30,719,0.0,11,8,1,0,3,72.72727273
2007020277,30,2881,0.0,20,17,8,0,3,85.0
2007020277,23,3596,0.0,22,20,2,3,2,90.90909091
2007020278,27,3600,0.0,28,28,4,0,0,100.0
2007020278,26,3500,0.0,38,37,5,1,1,97.36842105
2007020279,9,3580,0.0,18,15,1,2,3,83.33333333
2007020279,10,3600,0.0,24,24,1,1,0,100.0
2007020280,6,3600,0.0,52,45,12,0,7,86.53846154
2007020280,8,3588,0.0,36,32,8,1,4,88.88888889
2007020281,1,3600,0.0,28,26,8,0,2,92.85714286
2007020281,4,1200,0.0,2,0,0,0,2,0.0
2007020281,4,2400,0.0,22,18,4,2,4,81.81818182
2007020282,13,3582,0.0,33,31,3,1,2,93.93939394
2007020282,12,3600,0.0,28,27,5,2,1,96.42857143
2007020283,16,3600,0.0,42,39,11,1,3,92.85714286
2007020283,17,3570,0.0,16,12,0,2,4,75.0
2007020284,3,3697,0.0,23,20,3,0,3,86.95652174
2007020284,5,3673,0.0,26,22,6,0,4,84.61538462
2007020285,19,3897,0.0,37,35,4,2,2,94.59459459
2007020285,18,3899,0.0,20,18,1,0,2,90.0
2007020286,20,3600,0.0,16,15,1,1,1,93.75
2007020286,22,3523,0.0,27,24,2,0,3,88.88888889
2007020287,24,3900,0.0,29,28,2,3,1,96.55172414
2007020287,28,3900,0.0,29,28,3,1,1,96.55172414
2007020288,17,3900,0.0,40,36,4,0,4,90.0
2007020288,29,3703,2.0,35,31,5,0,4,88.57142857
2007020288,29,187,0.0,0,0,0,0,0,
2007020289,21,3598,0.0,26,22,2,1,4,84.61538462
2007020289,30,3600,0.0,28,27,6,0,1,96.42857143
2007020290,20,3600,0.0,21,17,3,0,4,80.95238095
2007020290,23,3600,0.0,30,29,5,0,1,96.66666667
2007020291,2,3600,2.0,19,18,1,2,1,94.73684211
2007020291,3,3528,0.0,24,22,5,0,2,91.66666667
2007020292,13,3600,0.0,30,27,5,0,3,90.0
2007020292,15,3508,0.0,26,22,4,1,4,84.61538462
2007020293,14,3769,0.0,24,20,5,1,4,83.33333333
2007020293,11,3729,0.0,20,17,2,3,3,85.0
2007020294,9,3600,0.0,38,36,6,2,2,94.73684211
2007020294,8,3561,0.0,29,25,4,3,4,86.20689655
2007020295,18,3516,0.0,22,20,4,0,2,90.90909091
2007020295,19,3600,0.0,25,24,5,1,1,96.0
2007020296,26,3600,0.0,26,23,2,0,3,88.46153846
2007020296,25,3600,0.0,22,22,9,0,0,100.0
2007020297,6,3600,0.0,32,30,8,0,2,93.75
2007020297,10,3579,0.0,24,21,2,0,3,87.5
2007020298,21,3478,0.0,14,11,0,0,3,78.57142857
2007020298,20,3600,0.0,21,20,3,0,1,95.23809524
2007020299,23,3900,0.0,29,25,8,0,4,86.20689655
2007020299,22,3893,0.0,24,20,6,0,4,83.33333333
2007020300,9,3548,0.0,31,27,4,0,4,87.09677419
2007020300,7,3590,2.0,29,27,5,0,2,93.10344828
2007020301,8,3570,0.0,45,44,16,2,1,97.77777778
2007020301,2,3600,0.0,33,29,7,0,4,87.87878788
2007020302,11,3600,0.0,32,31,9,0,1,96.875
2007020302,15,3594,0.0,25,20,4,2,5,80.0
2007020303,4,3582,2.0,35,32,11,1,3,91.42857143
2007020303,12,3535,0.0,20,15,1,3,5,75.0
2007020304,13,3600,0.0,36,34,6,0,2,94.44444444
2007020304,29,3565,0.0,29,24,6,2,5,82.75862069
2007020305,1,3593,0.0,26,25,7,1,1,96.15384615
2007020305,5,3525,0.0,28,26,11,0,2,92.85714286
2007020306,3,3586,0.0,33,32,6,0,1,96.96969697
2007020306,14,3505,0.0,29,27,7,0,2,93.10344828
2007020307,19,3590,0.0,38,35,8,2,3,92.10526316
2007020307,17,3600,0.0,12,12,2,4,0,100.0
2007020308,23,3600,0.0,20,18,3,0,2,90.0
2007020308,30,3573,0.0,26,22,1,1,4,84.61538462
2007020309,24,3545,0.0,24,22,6,0,2,91.66666667
2007020309,25,3594,0.0,18,17,6,0,1,94.44444444
2007020310,26,3588,0.0,34,30,5,3,4,88.23529412
2007020310,27,3593,0.0,29,28,3,0,1,96.55172414
2007020311,5,3236,0.0,32,29,3,3,3,90.625
2007020311,5,655,0.0,4,2,0,0,2,50.0
2007020311,9,3900,0.0,25,20,9,0,5,80.0
2007020312,17,3572,2.0,29,26,7,0,3,89.65517241
2007020312,18,3594,0.0,30,28,13,2,2,93.33333333
2007020313,16,3599,0.0,31,30,9,1,1,96.77419355
2007020313,20,3538,0.0,14,12,1,1,2,85.71428571
2007020314,21,3585,0.0,16,14,3,0,2,87.5
2007020314,22,3542,2.0,31,28,11,0,3,90.32258065
2007020315,2,3566,0.0,25,23,2,0,2,92.0
2007020315,6,3570,0.0,26,25,0,2,1,96.15384615
2007020316,15,3715,0.0,25,22,6,0,3,88.0
2007020316,4,3712,0.0,35,31,2,2,4,88.57142857
2007020317,29,3600,0.0,32,32,11,1,0,100.0
2007020317,30,3597,0.0,29,25,6,2,4,86.20689655
2007020318,27,3889,0.0,26,23,3,1,3,88.46153846
2007020318,24,3900,0.0,38,35,6,0,3,92.10526316
2007020319,14,3554,0.0,22,18,2,0,4,81.81818182
2007020319,12,3600,0.0,28,25,2,2,3,89.28571429
2007020320,8,3546,0.0,31,28,7,1,3,90.32258065
2007020320,7,3584,0.0,32,30,10,0,2,93.75
2007020321,1,3600,0.0,22,22,4,0,0,100.0
2007020321,11,3557,0.0,26,24,1,0,2,92.30769231
2007020322,3,3884,0.0,35,33,3,3,2,94.28571429
2007020322,13,3899,0.0,30,28,8,0,2,93.33333333
2007020323,23,3520,0.0,29,26,4,3,3,89.65517241
2007020323,19,3600,0.0,26,25,8,0,1,96.15384615
2007020324,10,3583,0.0,23,21,2,0,2,91.30434783
2007020324,25,3600,0.0,19,18,5,0,1,94.73684211
2007020325,7,3600,0.0,24,24,4,0,0,100.0
2007020325,8,3554,0.0,34,32,3,0,2,94.11764706
2007020326,4,3600,0.0,29,26,3,2,3,89.65517241
2007020326,9,1671,0.0,25,22,4,0,3,88.0
2007020326,9,1840,0.0,16,15,4,1,1,93.75
2007020327,6,3537,0.0,29,27,5,0,2,93.10344828
2007020327,2,3590,0.0,21,20,3,0,1,95.23809524
2007020328,12,3544,0.0,33,29,2,2,4,87.87878788
2007020328,15,3592,0.0,37,35,6,0,2,94.59459459
2007020329,17,3896,0.0,28,26,8,0,2,92.85714286
2007020329,29,3868,0.0,25,23,4,0,2,92.0
2007020330,10,504,0.0,7,5,0,0,2,71.42857143
2007020330,10,3096,0.0,30,27,5,1,3,90.0
2007020330,27,3594,0.0,26,25,3,0,1,96.15384615
2007020331,11,3597,0.0,34,29,3,1,5,85.29411765
2007020331,5,3591,0.0,28,28,7,0,0,100.0
2007020332,1,3594,0.0,36,34,11,0,2,94.44444444
2007020332,14,3496,0.0,21,18,5,0,3,85.71428571
2007020333,30,3600,0.0,43,40,6,0,3,93.02325581
2007020333,18,3538,0.0,25,21,1,1,4,84.0
2007020334,20,3599,0.0,23,21,5,0,2,91.30434783
2007020334,21,3586,0.0,32,27,5,1,5,84.375
2007020335,16,3897,0.0,31,29,4,1,2,93.5483871
2007020335,22,3895,0.0,40,38,1,1,2,95.0
2007020336,26,3600,0.0,27,26,2,0,1,96.2962963
2007020336,28,3530,0.0,17,15,4,0,2,88.23529412
2007020337,25,3581,2.0,41,39,9,0,2,95.12195122
2007020337,3,3543,0.0,18,15,3,0,3,83.33333333
2007020338,20,3533,0.0,17,15,2,0,2,88.23529412
2007020338,19,3600,0.0,24,24,4,1,0,100.0
2007020339,26,3536,0.0,32,29,5,2,3,90.625
2007020339,24,3598,2.0,25,23,7,1,2,92.0
2007020340,16,3575,0.0,28,27,12,4,1,96.42857143
2007020340,23,3585,0.0,27,27,5,3,0,100.0
2007020341,25,3610,0.0,25,23,1,2,2,92.0
2007020341,2,3615,0.0,31,28,3,1,3,90.32258065
2007020342,6,3600,0.0,23,20,0,1,3,86.95652174
2007020342,4,2085,0.0,17,15,5,1,2,88.23529412
2007020342,4,1422,0.0,14,11,0,1,3,78.57142857
2007020343,7,3600,0.0,31,30,1,1,1,96.77419355
2007020343,15,3513,0.0,28,25,4,0,3,89.28571429
2007020344,29,1557,0.0,10,9,2,2,1,90.0
2007020344,29,1965,0.0,9,8,1,1,1,88.88888889
2007020344,22,3586,0.0,37,36,9,1,1,97.2972973
2007020345,20,2124,0.0,20,18,8,0,2,90.0
2007020345,20,1470,0.0,15,12,2,1,3,80.0
2007020345,17,3575,0.0,22,19,3,2,3,86.36363636
2007020346,8,3899,0.0,46,43,15,3,3,93.47826087
2007020346,10,3857,0.0,30,27,4,0,3,90.0
2007020347,24,2864,0.0,27,23,12,0,4,85.18518519
2007020347,24,736,0.0,6,6,1,0,0,100.0
2007020347,23,3600,0.0,26,26,3,1,0,100.0
2007020348,19,3568,0.0,23,20,0,0,3,86.95652174
2007020348,7,3559,0.0,32,28,0,1,4,87.5
2007020349,25,3520,0.0,25,22,5,1,3,88.0
2007020349,1,3573,0.0,21,19,7,0,2,90.47619048
2007020350,9,3889,0.0,22,20,8,1,2,90.90909091
2007020350,2,3884,2.0,37,35,12,0,2,94.59459459
2007020351,13,3891,0.0,33,32,9,1,1,96.96969697
2007020351,15,3877,0.0,29,28,5,1,1,96.55172414
2007020352,4,3600,0.0,41,40,6,1,1,97.56097561
2007020352,12,3519,0.0,34,31,4,1,3,91.17647059
2007020353,27,3524,0.0,28,25,2,0,3,89.28571429
2007020353,30,3592,0.0,22,21,2,0,1,95.45454545
2007020354,14,1200,0.0,7,5,2,0,2,71.42857143
2007020354,14,2400,0.0,10,7,1,0,3,70.0
2007020354,16,3600,0.0,22,21,5,3,1,95.45454545
2007020355,22,2400,0.0,36,32,5,0,4,88.88888889
2007020355,22,1047,0.0,7,7,3,1,0,100.0
2007020355,21,3600,0.0,13,11,3,1,2,84.61538462
2007020356,26,3900,0.0,36,34,10,0,2,94.44444444
2007020356,28,3900,0.0,31,29,8,1,2,93.5483871
2007020357,2,3517,0.0,31,27,6,0,4,87.09677419
2007020357,3,3579,0.0,24,22,7,3,2,91.66666667
2007020358,10,3600,0.0,20,18,1,0,2,90.0
2007020358,11,3535,0.0,25,21,1,0,4,84.0
2007020359,18,3600,0.0,32,27,2,0,5,84.375
2007020359,9,3520,0.0,35,29,4,0,6,82.85714286
2007020360,6,3595,0.0,35,32,6,0,3,91.42857143
2007020360,13,3528,0.0,38,34,1,0,4,89.47368421
2007020361,14,3481,0.0,39,35,1,2,4,89.74358974
2007020361,17,3600,0.0,23,21,2,0,2,91.30434783
2007020362,24,3588,0.0,39,38,13,0,1,97.43589744
2007020362,20,3554,0.0,25,22,1,1,3,88.0
2007020363,29,3558,0.0,21,19,2,1,2,90.47619048
2007020363,23,3597,0.0,26,26,2,0,0,100.0
2007020364,8,3600,0.0,29,25,6,1,4,86.20689655
2007020364,1,3600,0.0,27,27,12,1,0,100.0
2007020365,15,3465,0.0,19,15,5,1,4,78.94736842
2007020365,12,3570,0.0,34,31,10,0,3,91.17647059
2007020366,25,3600,0.0,28,24,1,2,4,85.71428571
2007020366,5,3593,0.0,23,22,1,0,1,95.65217391
2007020367,19,3741,2.0,26,23,4,2,3,88.46153846
2007020367,30,3725,0.0,24,22,2,1,2,91.66666667
2007020368,27,630,0.0,7,2,0,1,5,28.57142857
2007020368,27,2965,0.0,20,19,8,0,1,95.0
2007020368,16,3600,0.0,29,28,8,2,1,96.55172414
2007020369,24,2493,0.0,23,19,2,0,4,82.60869565
2007020369,24,1107,0.0,12,11,7,0,1,91.66666667
2007020369,22,3594,0.0,22,21,7,1,1,95.45454545
2007020370,21,3510,0.0,29,26,5,0,3,89.65517241
2007020370,28,3579,0.0,20,18,3,0,2,90.0
2007020371,3,3571,0.0,33,31,1,3,2,93.93939394
2007020371,9,1200,0.0,12,9,1,0,3,75.0
2007020371,9,2387,0.0,12,11,1,0,1,91.66666667
2007020372,12,3592,0.0,25,17,1,2,8,68.0
2007020372,7,3600,0.0,21,20,6,1,1,95.23809524
2007020373,5,3578,0.0,40,37,8,2,3,92.5
2007020373,10,3600,2.0,32,30,7,4,2,93.75
2007020374,18,819,0.0,6,4,0,0,2,66.66666667
2007020374,18,3025,0.0,20,18,2,0,2,90.0
2007020374,8,3898,0.0,44,40,5,5,4,90.90909091
2007020375,11,3600,0.0,33,33,3,4,0,100.0
2007020375,2,3598,0.0,30,26,7,1,4,86.66666667
2007020376,25,3586,0.0,19,18,2,1,1,94.73684211
2007020376,4,3600,0.0,30,26,7,1,4,86.66666667
2007020377,15,3600,0.0,25,24,4,0,1,96.0
2007020377,13,3545,0.0,43,41,6,2,2,95.34883721
2007020378,27,3562,0.0,39,36,4,1,3,92.30769231
2007020378,17,3600,0.0,26,24,1,0,2,92.30769231
2007020379,6,3600,0.0,28,24,6,2,4,85.71428571
2007020379,14,3600,0.0,29,28,5,0,1,96.55172414
2007020380,16,3425,0.0,26,23,2,0,3,88.46153846
2007020380,19,3594,0.0,18,17,0,0,1,94.44444444
2007020381,29,3723,0.0,36,33,10,1,3,91.66666667
2007020381,20,3723,0.0,26,22,0,1,4,84.61538462
2007020382,21,3600,0.0,19,17,3,0,2,89.47368421
2007020382,26,2713,0.0,29,26,8,0,3,89.65517241
2007020382,26,880,0.0,5,3,0,0,2,60.0
2007020383,11,3900,2.0,36,34,8,2,2,94.44444444
2007020383,1,3896,0.0,25,23,1,0,2,92.0
2007020384,23,3519,0.0,30,28,11,0,2,93.33333333
2007020384,30,3600,0.0,20,19,1,0,1,95.0
2007020385,22,3600,0.0,25,25,4,1,0,100.0
2007020385,24,3600,0.0,21,17,4,2,4,80.95238095
2007020386,6,3595,0.0,34,33,11,0,1,97.05882353
2007020386,2,3530,0.0,22,19,4,0,3,86.36363636
2007020387,12,3600,0.0,28,28,6,0,0,100.0
2007020387,3,3596,0.0,29,25,3,0,4,86.20689655
2007020388,25,3893,0.0,26,25,5,1,1,96.15384615
2007020388,29,3883,0.0,34,33,12,1,1,97.05882353
2007020389,27,3497,0.0,33,30,9,1,3,90.90909091
2007020389,5,3598,0.0,18,17,2,0,1,94.44444444
2007020390,28,3599,0.0,35,33,1,4,2,94.28571429
2007020390,21,3535,0.0,28,25,9,0,3,89.28571429
2007020391,22,3890,0.0,34,31,3,2,3,91.17647059
2007020391,26,3900,0.0,23,20,8,0,3,86.95652174
2007020392,17,3600,0.0,16,15,3,1,1,93.75
2007020392,8,3600,0.0,34,30,3,1,4,88.23529412
2007020393,18,3538,0.0,15,12,2,0,3,80.0
2007020393,10,3600,0.0,35,34,10,2,1,97.14285714
2007020394,9,3881,4.0,28,25,7,1,3,89.28571429
2007020394,14,3900,0.0,29,26,1,0,3,89.65517241
2007020395,19,3532,0.0,37,34,3,0,3,91.89189189
2007020395,20,3600,0.0,22,21,1,0,1,95.45454545
2007020396,6,266,0.0,3,2,0,0,1,66.66666667
2007020396,6,3530,0.0,31,28,4,0,3,90.32258065
2007020396,1,3796,0.0,26,23,6,2,3,88.46153846
2007020397,2,3891,0.0,24,21,8,1,3,87.5
2007020397,11,3895,0.0,33,30,9,1,3,90.90909091
2007020398,21,3539,0.0,31,26,2,0,5,83.87096774
2007020398,29,2400,0.0,25,22,1,3,3,88.0
2007020398,29,1200,0.0,11,10,4,0,1,90.90909091
2007020399,9,3584,0.0,25,21,0,0,4,84.0
2007020399,13,3155,0.0,27,24,7,0,3,88.88888889
2007020399,13,430,0.0,5,3,0,0,2,60.0
2007020400,4,3600,0.0,29,28,9,2,1,96.55172414
2007020400,30,3600,0.0,25,22,3,0,3,88.0
2007020401,23,3595,0.0,27,25,1,1,2,92.59259259
2007020401,16,3510,0.0,21,18,4,0,3,85.71428571
2007020402,28,3600,0.0,19,17,2,1,2,89.47368421
2007020402,25,3524,0.0,28,25,4,0,3,89.28571429
2007020403,5,3598,0.0,19,17,0,0,2,89.47368421
2007020403,22,3497,0.0,31,27,2,0,4,87.09677419
2007020404,26,3520,0.0,39,36,1,0,3,92.30769231
2007020404,27,3600,0.0,29,28,1,0,1,96.55172414
2007020405,7,3594,0.0,33,29,1,3,4,87.87878788
2007020405,24,3587,0.0,23,22,7,0,1,95.65217391
2007020406,8,3600,0.0,26,24,3,0,2,92.30769231
2007020406,6,3598,0.0,30,26,8,2,4,86.66666667
2007020407,10,3594,0.0,25,23,3,2,2,92.0
2007020407,3,2400,0.0,10,6,2,0,4,60.0
2007020407,3,1200,0.0,6,4,1,0,2,66.66666667
2007020408,12,3506,0.0,32,30,2,2,2,93.75
2007020408,14,3600,0.0,24,23,7,2,1,95.83333333
2007020409,23,3598,0.0,28,26,4,0,2,92.85714286
2007020409,18,3531,0.0,24,20,3,1,4,83.33333333
2007020410,5,3621,0.0,26,24,2,1,2,92.30769231
2007020410,5,279,0.0,2,2,0,2,0,100.0
2007020410,20,3900,0.0,35,33,8,0,2,94.28571429
2007020411,7,2400,0.0,19,15,5,1,4,78.94736842
2007020411,7,1200,0.0,14,10,0,0,4,71.42857143
2007020411,26,3592,0.0,17,15,2,0,2,88.23529412
2007020412,15,3558,0.0,22,19,5,1,3,86.36363636
2007020412,1,3600,0.0,24,22,7,1,2,91.66666667
2007020413,3,3548,0.0,21,18,1,0,3,85.71428571
2007020413,11,3600,0.0,32,30,2,0,2,93.75
2007020414,2,3528,0.0,40,38,7,0,2,95.0
2007020414,13,3590,0.0,25,25,5,1,0,100.0
2007020415,30,3600,0.0,34,29,1,1,5,85.29411765
2007020415,17,3594,2.0,19,19,4,0,0,100.0
2007020416,24,3600,0.0,42,39,3,0,3,92.85714286
2007020416,16,3534,0.0,21,17,8,0,4,80.95238095
2007020417,9,3600,0.0,25,23,9,0,2,92.0
2007020417,25,3489,0.0,19,16,5,1,3,84.21052632
2007020418,4,3510,0.0,32,30,3,3,2,93.75
2007020418,21,3600,0.0,29,28,7,1,1,96.55172414
2007020419,19,3584,0.0,28,25,7,0,3,89.28571429
2007020419,22,3431,2.0,31,27,6,2,4,87.09677419
2007020420,28,3600,0.0,27,27,2,1,0,100.0
2007020420,27,3536,0.0,26,25,0,0,1,96.15384615
2007020421,6,3600,0.0,26,25,6,3,1,96.15384615
2007020421,10,3530,0.0,20,18,3,2,2,90.0
2007020422,12,3600,0.0,36,35,5,0,1,97.22222222
2007020422,8,1199,0.0,6,5,0,2,1,83.33333333
2007020422,8,2400,0.0,30,26,5,1,4,86.66666667
2007020423,11,3600,0.0,27,21,5,0,6,77.77777778
2007020423,15,3596,0.0,26,23,2,0,3,88.46153846
2007020424,30,3598,0.0,32,31,3,1,1,96.875
2007020424,29,3565,0.0,26,24,10,0,2,92.30769231
2007020425,2,3872,2.0,34,32,5,5,2,94.11764706
2007020425,14,3799,0.0,33,30,14,2,3,90.90909091
2007020426,24,3600,0.0,33,29,14,0,4,87.87878788
2007020426,18,3586,0.0,23,21,3,2,2,91.30434783
2007020427,5,3884,0.0,36,35,11,2,1,97.22222222
2007020427,23,3900,0.0,33,32,4,1,1,96.96969697
2007020428,27,3600,0.0,24,22,6,0,2,91.66666667
2007020428,26,3544,0.0,21,18,5,1,3,85.71428571
2007020429,7,3600,0.0,22,21,7,0,1,95.45454545
2007020429,28,2392,0.0,25,21,1,1,4,84.0
2007020429,28,1200,0.0,9,6,3,0,3,66.66666667
2007020430,1,3630,0.0,29,28,3,0,1,96.55172414
2007020430,3,3624,0.0,17,17,4,2,0,100.0
2007020431,12,3600,0.0,38,33,10,3,5,86.84210526
2007020431,17,3600,0.0,17,15,4,3,2,88.23529412
2007020432,20,3600,0.0,37,35,8,3,2,94.59459459
2007020432,16,3540,0.0,29,26,8,1,3,89.65517241
2007020433,19,643,0.0,4,3,0,2,1,75.0
2007020433,19,2941,2.0,25,17,3,0,8,68.0
2007020433,21,3600,0.0,28,23,2,2,5,82.14285714
2007020434,6,3600,0.0,45,44,10,1,1,97.77777778
2007020434,7,3600,0.0,21,17,2,0,4,80.95238095
2007020435,1,3542,0.0,24,21,3,1,3,87.5
2007020435,15,3600,0.0,22,20,5,1,2,90.90909091
2007020436,24,3781,0.0,35,32,17,2,3,91.42857143
2007020436,29,3780,0.0,28,24,5,3,4,85.71428571
2007020437,14,1513,0.0,7,5,0,1,2,71.42857143
2007020437,14,2081,0.0,22,18,2,0,4,81.81818182
2007020437,10,3600,0.0,27,26,5,0,1,96.2962963
2007020438,17,3600,0.0,31,30,6,2,1,96.77419355
2007020438,18,3504,0.0,35,33,7,1,2,94.28571429
2007020439,22,546,0.0,6,3,1,0,3,50.0
2007020439,22,3294,0.0,24,22,3,2,2,91.66666667
2007020439,25,3837,0.0,21,17,2,2,4,80.95238095
2007020440,23,3484,0.0,31,27,6,0,4,87.09677419
2007020440,26,3600,0.0,29,27,8,0,2,93.10344828
2007020441,5,2396,0.0,25,20,7,0,5,80.0
2007020441,5,1200,0.0,15,12,7,0,3,80.0
2007020441,4,3591,0.0,22,20,4,2,2,90.90909091
2007020442,14,3890,0.0,30,28,4,1,2,93.33333333
2007020442,8,3900,0.0,31,29,4,0,2,93.5483871
2007020443,20,3871,0.0,33,32,2,0,1,96.96969697
2007020443,13,3900,0.0,35,34,3,0,1,97.14285714
2007020444,22,3893,0.0,24,20,3,2,4,83.33333333
2007020444,19,3900,0.0,29,25,5,1,4,86.20689655
2007020445,30,3600,0.0,30,26,3,0,4,86.66666667
2007020445,28,3600,0.0,37,36,3,1,1,97.2972973
2007020446,2,3522,0.0,41,36,10,0,5,87.80487805
2007020446,7,3534,0.0,31,28,9,0,3,90.32258065
2007020447,3,3816,0.0,35,30,7,2,5,85.71428571
2007020447,15,3821,0.0,23,19,4,0,4,82.60869565
2007020448,9,3267,0.0,31,31,4,2,0,100.0
2007020448,9,324,0.0,1,1,0,0,0,100.0
2007020448,12,3599,0.0,26,20,6,1,6,76.92307692
2007020449,6,3584,0.0,26,23,6,0,3,88.46153846
2007020449,11,3549,0.0,32,28,2,0,4,87.5
2007020450,21,3561,0.0,15,12,2,0,3,80.0
2007020450,29,3600,0.0,16,15,5,0,1,93.75
2007020451,26,2747,0.0,27,24,4,3,3,88.88888889
2007020451,26,846,0.0,9,6,0,1,3,66.66666667
2007020451,16,3600,2.0,28,25,5,1,3,89.28571429
2007020452,23,3583,0.0,35,33,4,2,2,94.28571429
2007020452,24,3488,0.0,20,17,7,0,3,85.0
2007020453,1,3600,0.0,20,19,1,0,1,95.0
2007020453,6,3556,0.0,27,25,2,2,2,92.59259259
2007020454,27,3536,0.0,33,30,0,2,3,90.90909091
2007020454,2,3600,2.0,36,34,9,2,2,94.44444444
2007020455,8,3577,0.0,31,30,5,1,1,96.77419355
2007020455,4,3600,0.0,23,19,5,1,4,82.60869565
2007020456,9,3578,0.0,27,26,2,1,1,96.2962963
2007020456,5,3582,0.0,25,22,1,2,3,88.0
2007020457,20,3600,2.0,31,25,6,2,6,80.64516129
2007020457,14,2765,0.0,25,21,5,0,4,84.0
2007020457,14,785,0.0,6,2,0,0,4,33.33333333
2007020458,22,3900,0.0,42,39,8,0,3,92.85714286
2007020458,17,3893,0.0,25,22,3,0,3,88.0
2007020459,21,3600,0.0,31,30,4,1,1,96.77419355
2007020459,18,3532,0.0,32,30,3,0,2,93.75
2007020460,13,3600,0.0,33,33,8,0,0,100.0
2007020460,19,3555,0.0,25,24,4,3,1,96.0
2007020461,26,2092,0.0,18,14,1,0,4,77.77777778
2007020461,26,1504,0.0,10,10,0,0,0,100.0
2007020461,25,3600,0.0,27,26,3,0,1,96.2962963
2007020462,23,1962,0.0,12,9,0,0,3,75.0
2007020462,23,1638,0.0,11,9,2,0,2,81.81818182
2007020462,28,3600,0.0,17,15,1,1,2,88.23529412
2007020463,7,3600,0.0,23,20,3,0,3,86.95652174
2007020463,15,3565,0.0,29,25,7,1,4,86.20689655
2007020464,20,3600,0.0,36,33,8,1,3,91.66666667
2007020464,12,3532,0.0,21,17,5,1,4,80.95238095
2007020465,10,3600,0.0,24,24,2,2,0,100.0
2007020465,11,3600,0.0,35,31,1,1,4,88.57142857
2007020466,30,3592,0.0,30,28,2,1,2,93.33333333
2007020466,24,1575,0.0,9,6,0,1,3,66.66666667
2007020466,24,2024,0.0,10,8,3,0,2,80.0
2007020467,27,3579,0.0,31,30,7,1,1,96.77419355
2007020467,1,3594,0.0,38,34,14,2,4,89.47368421
2007020468,29,3544,0.0,17,16,1,0,1,94.11764706
2007020468,6,3600,0.0,32,32,4,0,0,100.0
2007020469,16,3525,0.0,22,20,8,1,2,90.90909091
2007020469,7,3600,0.0,27,26,4,1,1,96.2962963
2007020470,10,3600,0.0,25,21,2,0,4,84.0
2007020470,8,3592,0.0,29,28,10,1,1,96.55172414
2007020471,11,1701,0.0,24,19,2,0,5,79.16666667
2007020471,11,1899,0.0,20,18,2,5,2,90.0
2007020471,9,3600,0.0,25,22,9,0,3,88.0
2007020472,5,3594,0.0,29,27,2,7,2,93.10344828
2007020472,2,3557,0.0,40,37,11,0,3,92.5
2007020473,12,3900,0.0,41,36,10,4,5,87.80487805
2007020473,4,3883,0.0,34,29,15,1,5,85.29411765
2007020474,13,3600,0.0,46,41,8,1,5,89.13043478
2007020474,17,3600,0.0,35,33,5,1,2,94.28571429
2007020475,15,3599,0.0,25,23,5,0,2,92.0
2007020475,14,3521,0.0,32,29,11,2,3,90.625
2007020476,18,3480,0.0,16,13,2,0,3,81.25
2007020476,21,3596,0.0,32,31,3,3,1,96.875
2007020477,23,3900,0.0,26,25,1,1,1,96.15384615
2007020477,22,3900,0.0,30,29,2,0,1,96.66666667
2007020478,30,3596,0.0,36,35,13,3,1,97.22222222
2007020478,26,3493,0.0,24,22,8,0,2,91.66666667
2007020479,25,3594,0.0,18,16,3,1,2,88.88888889
2007020479,28,3566,0.0,21,18,4,1,3,85.71428571
2007020480,4,3548,0.0,37,34,6,0,3,91.89189189
2007020480,1,3597,0.0,31,29,12,2,2,93.5483871
2007020481,27,3598,0.0,35,34,6,0,1,97.14285714
2007020481,3,3587,0.0,26,21,2,1,5,80.76923077
2007020482,20,3600,0.0,17,14,1,0,3,82.35294118
2007020482,19,3562,0.0,20,16,2,0,4,80.0
2007020483,13,3600,0.0,45,44,13,3,1,97.77777778
2007020483,16,3555,0.0,24,21,5,1,3,87.5
2007020484,28,3886,0.0,31,30,7,4,1,96.77419355
2007020484,24,3900,0.0,37,36,24,0,1,97.2972973
2007020485,15,3900,0.0,30,27,7,1,3,90.0
2007020485,17,3890,0.0,30,27,4,1,3,90.0
2007020486,21,3596,0.0,21,19,4,1,2,90.47619048
2007020486,26,3546,0.0,39,36,7,2,3,92.30769231
2007020487,9,3600,0.0,28,26,3,1,2,92.85714286
2007020487,6,3548,0.0,27,24,5,1,3,88.88888889
2007020488,5,3596,0.0,31,27,7,1,4,87.09677419
2007020488,3,3600,0.0,18,18,4,1,0,100.0
2007020489,27,3600,0.0,28,26,3,1,2,92.85714286
2007020489,4,3526,0.0,42,39,4,0,3,92.85714286
2007020490,10,3867,0.0,38,35,10,0,3,92.10526316
2007020490,12,3819,0.0,36,34,7,2,2,94.44444444
2007020491,14,2400,0.0,15,12,2,0,3,80.0
2007020491,14,1200,0.0,9,6,0,0,3,66.66666667
2007020491,11,3600,0.0,34,32,8,0,2,94.11764706
2007020492,20,3597,0.0,37,36,3,2,1,97.2972973
2007020492,29,3600,0.0,23,20,5,1,3,86.95652174
2007020493,13,3591,0.0,25,23,3,0,2,92.0
2007020493,8,3523,0.0,30,27,5,0,3,90.0
2007020494,18,3552,0.0,31,28,6,2,3,90.32258065
2007020494,30,3585,0.0,32,30,7,2,2,93.75
2007020495,25,3900,2.0,34,33,3,1,1,97.05882353
2007020495,22,3900,0.0,36,35,8,0,1,97.22222222
2007020496,1,3585,0.0,24,19,4,0,5,79.16666667
2007020496,23,3600,0.0,32,32,6,1,0,100.0
2007020497,24,3600,0.0,20,20,2,7,0,100.0
2007020497,28,3511,2.0,16,14,7,0,2,87.5
2007020498,7,3600,0.0,43,42,9,2,1,97.6744186
2007020498,2,3514,0.0,17,15,6,1,2,88.23529412
2007020499,26,3590,0.0,35,29,9,0,6,82.85714286
2007020499,17,3592,0.0,20,18,4,0,2,90.0
2007020500,18,323,0.0,2,0,0,0,2,0.0
2007020500,18,3277,0.0,28,25,4,1,3,89.28571429
2007020500,16,3600,0.0,21,19,5,0,2,90.47619048
2007020501,21,3811,0.0,38,36,4,0,2,94.73684211
2007020501,24,3811,0.0,12,11,0,0,1,91.66666667
2007020502,5,3900,0.0,41,37,6,4,4,90.24390244
2007020502,6,3896,0.0,29,25,7,1,4,86.20689655
2007020503,8,3591,0.0,37,35,10,0,2,94.59459459
2007020503,15,3587,0.0,21,16,4,2,5,76.19047619
2007020504,9,3512,0.0,45,42,10,0,3,93.33333333
2007020504,11,3600,0.0,30,28,1,1,2,93.33333333
2007020505,10,3578,0.0,21,19,5,0,2,90.47619048
2007020505,14,3595,0.0,32,31,5,0,1,96.875
2007020506,12,3531,0.0,41,36,8,3,5,87.80487805
2007020506,13,3597,0.0,33,29,4,0,4,87.87878788
2007020507,3,3124,0.0,18,12,5,0,6,66.66666667
2007020507,3,476,0.0,4,4,2,0,0,100.0
2007020507,30,3594,0.0,35,32,5,2,3,91.42857143
2007020508,17,3534,0.0,24,21,7,0,3,87.5
2007020508,19,3597,0.0,36,34,8,0,2,94.44444444
2007020509,25,3525,2.0,30,27,6,0,3,90.0
2007020509,23,3600,0.0,35,33,8,2,2,94.28571429
2007020510,27,3856,0.0,38,36,14,0,2,94.73684211
2007020510,28,3885,0.0,37,35,12,1,2,94.59459459
2007020511,26,3501,0.0,35,33,4,0,2,94.28571429
2007020511,29,3600,0.0,34,33,11,0,1,97.05882353
2007020512,4,3513,0.0,35,32,9,2,3,91.42857143
2007020512,7,3596,0.0,22,20,3,2,2,90.90909091
2007020513,2,3600,0.0,26,24,13,0,2,92.30769231
2007020513,5,3581,0.0,24,20,1,0,4,83.33333333
2007020514,3,3676,0.0,37,33,15,0,4,89.18918919
2007020514,21,3675,0.0,23,20,0,1,3,86.95652174
2007020515,25,3644,0.0,24,22,4,0,2,91.66666667
2007020515,20,3657,0.0,23,20,1,1,3,86.95652174
2007020516,1,3600,0.0,21,20,2,0,1,95.23809524
2007020516,22,3566,0.0,32,30,10,0,2,93.75
2007020517,19,3596,0.0,25,24,2,0,1,96.0
2007020517,6,3515,0.0,28,25,4,1,3,89.28571429
2007020518,16,3717,0.0,29,26,7,1,3,89.65517241
2007020518,9,3681,0.0,29,25,3,1,4,86.20689655
2007020519,15,3810,0.0,31,28,2,0,3,90.32258065
2007020519,2,3823,0.0,16,14,1,0,2,87.5
2007020520,7,3858,0.0,36,31,6,2,5,86.11111111
2007020520,4,3858,0.0,28,23,9,2,5,82.14285714
2007020521,8,3900,0.0,28,26,6,3,2,92.85714286
2007020521,11,3893,0.0,39,37,4,0,2,94.87179487
2007020522,10,3618,0.0,30,29,8,1,1,96.66666667
2007020522,13,3634,0.0,31,29,8,1,2,93.5483871
2007020523,12,3594,0.0,30,29,4,0,1,96.66666667
2007020523,14,3547,0.0,35,33,1,0,2,94.28571429
2007020524,26,3535,0.0,32,28,6,1,4,87.5
2007020524,18,3600,0.0,37,34,10,0,3,91.89189189
2007020525,17,3600,0.0,19,18,3,0,1,94.73684211
2007020525,30,3600,0.0,51,47,14,3,4,92.15686275
2007020526,23,3900,0.0,28,27,2,1,1,96.42857143
2007020526,27,3894,0.0,35,34,5,1,1,97.14285714
2007020527,24,3600,0.0,29,27,2,1,2,93.10344828
2007020527,28,3590,0.0,23,19,2,0,4,82.60869565
2007020528,6,3536,0.0,24,21,3,2,3,87.5
2007020528,5,3590,0.0,30,28,1,0,2,93.33333333
2007020529,18,3600,0.0,31,30,8,2,1,96.77419355
2007020529,29,3569,0.0,31,29,5,1,2,93.5483871
2007020530,11,3619,0.0,20,18,3,1,2,90.0
2007020530,19,3619,0.0,25,22,6,0,3,88.0
2007020531,9,3600,0.0,35,34,10,0,1,97.14285714
2007020531,3,3520,0.0,25,22,5,1,3,88.0
2007020532,22,3500,0.0,34,31,6,4,3,91.17647059
2007020532,16,3600,0.0,27,25,6,3,2,92.59259259
2007020533,23,3577,0.0,32,29,3,1,3,90.625
2007020533,21,3578,0.0,22,21,7,0,1,95.45454545
2007020534,1,3613,0.0,30,30,12,0,0,100.0
2007020534,20,3623,0.0,22,21,8,0,1,95.45454545
2007020535,8,3599,0.0,21,17,5,1,4,80.95238095
2007020535,25,3600,0.0,18,17,7,1,1,94.44444444
2007020536,9,3600,0.0,32,29,5,0,3,90.625
2007020536,7,3525,0.0,23,19,2,2,4,82.60869565
2007020537,10,3881,0.0,28,24,0,1,4,85.71428571
2007020537,2,2690,0.0,23,22,3,1,1,95.65217391
2007020537,2,1200,0.0,9,7,2,0,2,77.77777778
2007020538,12,3496,0.0,35,31,7,0,4,88.57142857
2007020538,3,3597,0.0,22,20,3,1,2,90.90909091
2007020539,14,3573,0.0,32,29,6,0,3,90.625
2007020539,15,3600,0.0,20,18,1,0,2,90.0
2007020540,11,3512,0.0,28,26,7,0,2,92.85714286
2007020540,29,3582,0.0,21,21,0,1,0,100.0
2007020541,18,2636,0.0,18,16,2,3,2,88.88888889
2007020541,18,938,0.0,3,1,1,0,2,33.33333333
2007020541,16,3600,0.0,32,30,7,0,2,93.75
2007020542,17,3600,0.0,20,20,4,0,0,100.0
2007020542,19,1657,0.0,16,12,3,0,4,75.0
2007020542,19,1938,0.0,11,10,0,0,1,90.90909091
2007020543,30,3600,0.0,33,25,4,2,8,75.75757576
2007020543,25,3600,0.0,17,14,4,1,3,82.35294118
2007020544,28,3564,0.0,31,29,5,0,2,93.5483871
2007020544,26,737,0.0,9,7,3,0,2,77.77777778
2007020544,26,2792,0.0,22,21,3,0,1,95.45454545
2007020545,10,3600,0.0,34,30,3,3,4,88.23529412
2007020545,4,3600,0.0,35,34,2,1,1,97.14285714
2007020546,13,3600,0.0,41,38,4,2,3,92.68292683
2007020546,11,3536,0.0,28,24,6,0,4,85.71428571
2007020547,2,3600,0.0,37,32,4,3,5,86.48648649
2007020547,9,3596,0.0,27,25,5,1,2,92.59259259
2007020548,15,1073,0.0,9,7,0,0,2,77.77777778
2007020548,15,2620,0.0,18,16,4,0,2,88.88888889
2007020548,5,3693,0.0,25,22,2,0,3,88.0
2007020549,8,3600,0.0,30,28,2,1,2,93.33333333
2007020549,14,2035,0.0,15,12,1,0,3,80.0
2007020549,14,1565,0.0,14,12,2,1,2,85.71428571
2007020550,29,3526,0.0,32,28,7,1,4,87.5
2007020550,18,3583,0.0,39,36,10,0,3,92.30769231
2007020551,17,3600,0.0,24,22,6,0,2,91.66666667
2007020551,21,3535,0.0,28,25,1,2,3,89.28571429
2007020552,24,3589,0.0,16,15,1,1,1,93.75
2007020552,22,3548,0.0,23,21,4,3,2,91.30434783
2007020553,30,3579,0.0,48,46,14,2,2,95.83333333
2007020553,27,3509,0.0,26,23,0,2,3,88.46153846
2007020554,20,781,0.0,0,0,0,0,0,
2007020554,20,2819,0.0,20,15,6,0,5,75.0
2007020554,23,3582,0.0,32,29,1,0,3,90.625
2007020555,7,3900,0.0,35,34,1,1,1,97.14285714
2007020555,1,3896,0.0,27,26,5,0,1,96.2962963
2007020556,6,3600,0.0,37,33,12,0,4,89.18918919
2007020556,12,3580,0.0,21,18,2,1,3,85.71428571
2007020557,8,3597,0.0,41,40,8,1,1,97.56097561
2007020557,13,2092,0.0,12,11,3,1,1,91.66666667
2007020557,13,1503,0.0,9,5,1,0,4,55.55555556
2007020558,28,3600,0.0,26,26,13,0,0,100.0
2007020558,19,3531,0.0,18,17,5,0,1,94.44444444
2007020559,4,3593,0.0,33,31,4,4,2,93.93939394
2007020559,14,3552,2.0,22,18,3,0,4,81.81818182
2007020560,26,3598,0.0,30,29,3,0,1,96.66666667
2007020560,21,3562,0.0,22,20,5,0,2,90.90909091
2007020561,3,3600,0.0,28,27,3,0,1,96.42857143
2007020561,10,1831,0.0,29,24,14,1,5,82.75862069
2007020561,10,1769,0.0,5,4,1,0,1,80.0
2007020562,15,3600,0.0,22,16,3,1,6,72.72727273
2007020562,9,3490,0.0,29,22,5,0,7,75.86206897
2007020563,1,3520,0.0,32,28,0,1,4,87.5
2007020563,2,3600,0.0,29,27,4,1,2,93.10344828
2007020564,6,2396,0.0,16,14,4,0,2,87.5
2007020564,6,1200,0.0,13,10,3,0,3,76.92307692
2007020564,11,3598,0.0,26,26,1,1,0,100.0
2007020565,12,2400,0.0,20,17,5,1,3,85.0
2007020565,12,1139,0.0,2,2,0,1,0,100.0
2007020565,29,3600,0.0,24,23,8,2,1,95.83333333
2007020566,7,3566,0.0,24,23,3,2,1,95.83333333
2007020566,5,3600,0.0,26,26,2,3,0,100.0
2007020567,28,3600,4.0,21,19,3,1,2,90.47619048
2007020567,18,3593,0.0,29,24,1,0,5,82.75862069
2007020568,22,3710,0.0,35,30,6,0,5,85.71428571
2007020568,30,3685,0.0,27,23,3,1,4,85.18518519
2007020569,19,3843,0.0,26,22,7,0,4,84.61538462
2007020569,25,3897,0.0,31,27,3,0,4,87.09677419
2007020570,17,3600,0.0,34,32,2,1,2,94.11764706
2007020570,27,3573,0.0,34,31,1,0,3,91.17647059
2007020571,24,3577,0.0,34,30,12,1,4,88.23529412
2007020571,20,3600,0.0,32,29,5,3,3,90.625
2007020572,4,3595,0.0,38,38,5,1,0,100.0
2007020572,13,3529,0.0,20,19,6,0,1,95.0
2007020573,8,3658,0.0,21,17,2,0,4,80.95238095
2007020573,3,3666,0.0,21,18,1,1,3,85.71428571
2007020574,26,3811,0.0,32,30,5,1,2,93.75
2007020574,16,3811,0.0,36,33,9,1,3,91.66666667
2007020575,24,3509,0.0,22,20,8,1,2,90.90909091
2007020575,23,3600,2.0,22,21,3,1,1,95.45454545
2007020576,11,3600,0.0,37,32,5,4,5,86.48648649
2007020576,6,3592,0.0,30,28,7,1,2,93.33333333
2007020577,22,3562,0.0,32,29,7,2,3,90.625
2007020577,29,3600,0.0,28,26,3,0,2,92.85714286
2007020578,19,3587,0.0,31,31,8,2,0,100.0
2007020578,17,3564,0.0,22,21,9,1,1,95.45454545
2007020579,28,3600,0.0,21,19,0,0,2,90.47619048
2007020579,30,3556,0.0,25,22,4,0,3,88.0
2007020580,2,3592,0.0,29,28,6,1,1,96.55172414
2007020580,12,2052,0.0,10,9,2,0,1,90.0
2007020580,12,1545,0.0,14,11,2,0,3,78.57142857
2007020581,21,3882,0.0,26,23,5,0,3,88.46153846
2007020581,27,3878,0.0,45,42,6,3,3,93.33333333
2007020582,18,3600,0.0,22,22,1,0,0,100.0
2007020582,25,3542,0.0,30,29,3,6,1,96.66666667
2007020583,23,3543,0.0,20,18,3,0,2,90.0
2007020583,20,3595,0.0,25,24,7,0,1,96.0
2007020584,5,3895,0.0,37,36,5,1,1,97.2972973
2007020584,7,3900,0.0,25,24,4,0,1,96.0
2007020585,9,454,0.0,8,5,0,0,3,62.5
2007020585,9,3100,0.0,17,15,3,0,2,88.23529412
2007020585,15,3583,0.0,34,31,2,0,3,91.17647059
2007020586,14,3858,0.0,29,26,2,1,3,89.65517241
2007020586,10,3900,0.0,33,30,3,1,3,90.90909091
2007020587,16,904,0.0,9,5,2,0,4,55.55555556
2007020587,16,2665,0.0,17,12,3,0,5,70.58823529
2007020587,26,3598,0.0,34,32,3,1,2,94.11764706
2007020588,13,3544,0.0,27,24,0,0,3,88.88888889
2007020588,1,3600,0.0,33,31,3,1,2,93.93939394
2007020589,11,3868,0.0,36,32,10,0,4,88.88888889
2007020589,12,3858,0.0,14,9,0,2,5,64.28571429
2007020590,25,3600,0.0,26,22,5,1,4,84.61538462
2007020590,17,3591,0.0,24,23,2,0,1,95.83333333
2007020591,22,3865,0.0,33,31,11,1,2,93.93939394
2007020591,19,1200,0.0,3,3,0,0,0,100.0
2007020591,19,2682,0.0,21,18,2,2,3,85.71428571
2007020592,27,3600,0.0,26,24,2,1,2,92.30769231
2007020592,21,3495,0.0,29,26,3,0,3,89.65517241
2007020593,3,3531,0.0,22,18,3,0,4,81.81818182
2007020593,20,3596,0.0,32,29,4,0,3,90.625
2007020594,29,3565,0.0,34,32,5,0,2,94.11764706
2007020594,24,3600,0.0,27,26,8,2,1,96.2962963
2007020595,15,3461,0.0,30,28,6,0,2,93.33333333
2007020595,6,3598,0.0,31,31,3,3,0,100.0
2007020596,13,3689,2.0,40,37,9,1,3,92.5
2007020596,2,3693,0.0,32,28,4,3,4,87.5
2007020597,14,3600,2.0,30,24,5,1,6,80.0
2007020597,8,3595,0.0,33,30,7,1,3,90.90909091
2007020598,10,3591,0.0,24,18,3,0,6,75.0
2007020598,5,3600,0.0,35,33,2,1,2,94.28571429
2007020599,22,3592,0.0,30,25,5,1,5,83.33333333
2007020599,18,3596,0.0,28,26,6,2,2,92.85714286
2007020600,25,2806,2.0,17,14,5,1,3,82.35294118
2007020600,25,794,0.0,4,1,0,1,3,25.0
2007020600,30,3600,0.0,28,25,1,0,3,89.28571429
2007020601,16,3577,0.0,22,19,5,0,3,86.36363636
2007020601,27,3600,0.0,27,25,3,2,2,92.59259259
2007020602,3,3600,0.0,19,16,5,0,3,84.21052632
2007020602,23,3600,0.0,28,28,7,4,0,100.0
2007020603,29,3598,0.0,33,30,6,0,3,90.90909091
2007020603,26,1952,0.0,16,15,1,0,1,93.75
2007020603,26,1565,0.0,12,9,2,0,3,75.0
2007020604,20,3806,0.0,36,34,4,2,2,94.44444444
2007020604,28,3806,0.0,20,17,2,3,3,85.0
2007020605,4,3600,0.0,26,23,5,0,3,88.46153846
2007020605,1,3600,0.0,36,36,5,1,0,100.0
2007020606,9,3600,0.0,39,36,0,0,3,92.30769231
2007020606,7,1849,0.0,16,13,4,0,3,81.25
2007020606,7,1712,0.0,11,9,0,0,2,81.81818182
2007020607,12,3590,0.0,26,23,2,1,3,88.46153846
2007020607,11,3543,2.0,33,29,11,1,4,87.87878788
2007020608,16,3540,0.0,32,30,8,3,2,93.75
2007020608,24,3600,0.0,21,20,3,0,1,95.23809524
2007020609,15,3687,0.0,27,23,6,2,4,85.18518519
2007020609,8,3647,0.0,29,24,2,0,5,82.75862069
2007020610,17,3590,0.0,22,22,1,1,0,100.0
2007020610,25,3538,2.0,22,20,4,0,2,90.90909091
2007020611,1,3531,2.0,25,21,1,1,4,84.0
2007020611,6,3599,0.0,45,42,5,4,3,93.33333333
2007020612,4,3600,0.0,56,54,12,0,2,96.42857143
2007020612,10,3560,0.0,32,29,4,1,3,90.625
2007020613,14,3797,0.0,27,23,2,0,4,85.18518519
2007020613,9,3792,0.0,19,16,0,0,3,84.21052632
2007020614,13,3600,2.0,31,28,7,0,3,90.32258065
2007020614,5,3597,0.0,35,35,1,3,0,100.0
2007020615,30,3600,0.0,30,26,2,1,4,86.66666667
2007020615,18,3600,0.0,30,29,0,1,1,96.66666667
2007020616,12,3499,0.0,19,18,5,0,1,94.73684211
2007020616,19,3600,0.0,27,27,3,1,0,100.0
2007020617,2,3725,0.0,39,37,5,1,2,94.87179487
2007020617,21,3725,0.0,24,23,2,1,1,95.83333333
2007020618,24,3900,0.0,34,32,5,2,2,94.11764706
2007020618,27,3895,0.0,31,29,8,2,2,93.5483871
2007020619,3,3838,0.0,25,23,7,1,2,92.0
2007020619,22,3874,0.0,31,29,5,0,2,93.5483871
2007020620,20,3600,0.0,34,30,10,1,4,88.23529412
2007020620,26,3518,0.0,26,21,3,1,5,80.76923077
2007020621,29,2400,0.0,15,13,1,1,2,86.66666667
2007020621,29,1142,0.0,4,3,0,0,1,75.0
2007020621,28,3597,0.0,23,21,5,1,2,91.30434783
2007020622,7,3506,0.0,29,25,4,3,4,86.20689655
2007020622,11,3600,0.0,39,37,7,1,2,94.87179487
2007020623,17,3600,0.0,20,19,2,0,1,95.0
2007020623,16,3558,2.0,28,25,3,0,3,89.28571429
2007020624,30,3536,0.0,30,27,5,3,3,90.0
2007020624,25,3600,0.0,19,18,2,2,1,94.73684211
2007020625,2,3589,0.0,33,29,7,0,4,87.87878788
2007020625,22,3583,0.0,35,35,3,2,0,100.0
2007020626,18,3564,0.0,37,32,4,0,5,86.48648649
2007020626,24,3593,0.0,22,20,1,0,2,90.90909091
2007020627,12,3595,0.0,19,19,3,0,0,100.0
2007020627,6,3534,0.0,28,27,0,3,1,96.42857143
2007020628,7,3895,0.0,30,29,4,0,1,96.66666667
2007020628,1,3900,0.0,24,23,0,0,1,95.83333333
2007020629,14,3597,0.0,34,31,6,0,3,91.17647059
2007020629,3,3554,0.0,25,21,7,1,4,84.0
2007020630,4,3600,0.0,28,27,9,0,1,96.42857143
2007020630,11,3593,0.0,29,25,2,1,4,86.20689655
2007020631,16,3795,0.0,38,34,5,4,4,89.47368421
2007020631,8,3796,0.0,28,25,5,0,3,89.28571429
2007020632,5,3592,2.0,28,27,3,2,1,96.42857143
2007020632,13,1609,0.0,12,12,1,1,0,100.0
2007020632,13,1991,0.0,23,20,4,0,3,86.95652174
2007020633,21,3524,0.0,25,24,4,0,1,96.0
2007020633,17,3600,0.0,19,19,0,2,0,100.0
2007020634,29,3600,0.0,31,25,1,0,6,80.64516129
2007020634,19,3598,0.0,18,17,2,1,1,94.44444444
2007020635,27,3596,0.0,31,30,9,1,1,96.77419355
2007020635,20,3596,0.0,31,28,10,0,3,90.32258065
2007020636,2,3900,0.0,45,43,8,0,2,95.55555556
2007020636,23,3897,0.0,28,26,0,2,2,92.85714286
2007020637,18,3600,0.0,28,28,5,0,0,100.0
2007020637,26,400,0.0,7,4,0,0,3,57.14285714
2007020637,26,3200,0.0,22,18,2,0,4,81.81818182
2007020638,21,3540,0.0,23,21,4,1,2,91.30434783
2007020638,15,3600,0.0,19,18,2,0,1,94.73684211
2007020639,25,3600,0.0,18,17,2,0,1,94.44444444
2007020639,16,3554,0.0,29,27,9,1,2,93.10344828
2007020640,10,3596,0.0,24,19,3,1,5,79.16666667
2007020640,24,3600,0.0,28,28,4,1,0,100.0
2007020641,8,3591,0.0,25,23,3,5,2,92.0
2007020641,6,3600,0.0,33,28,8,3,5,84.84848485
2007020642,4,3600,0.0,41,39,12,1,2,95.12195122
2007020642,3,3600,0.0,30,24,13,2,6,80.0
2007020643,1,3600,0.0,21,20,2,0,1,95.23809524
2007020643,12,3600,2.0,24,20,5,0,4,83.33333333
2007020644,13,3884,0.0,28,26,5,0,2,92.85714286
2007020644,11,3900,0.0,40,38,4,3,2,95.0
2007020645,7,3900,0.0,25,23,6,1,2,92.0
2007020645,9,3857,0.0,24,22,4,1,2,91.66666667
2007020646,5,3600,0.0,36,35,8,0,1,97.22222222
2007020646,14,3516,0.0,28,25,1,0,3,89.28571429
2007020647,30,2171,0.0,27,26,9,0,1,96.2962963
2007020647,30,1718,0.0,19,15,6,1,4,78.94736842
2007020647,17,3887,0.0,28,23,6,0,5,82.14285714
2007020648,25,3506,0.0,26,22,2,0,4,84.61538462
2007020648,19,3581,0.0,27,25,4,0,2,92.59259259
2007020649,27,1768,0.0,15,11,1,2,4,73.33333333
2007020649,27,1818,0.0,18,17,1,1,1,94.44444444
2007020649,22,3587,0.0,31,29,4,0,2,93.5483871
2007020650,10,1200,0.0,11,7,4,0,4,63.63636364
2007020650,10,2269,0.0,13,12,4,0,1,92.30769231
2007020650,26,3599,0.0,50,48,17,2,2,96.0
2007020651,23,3600,0.0,31,28,12,0,3,90.32258065
2007020651,28,3578,0.0,21,20,2,0,1,95.23809524
2007020652,19,3596,0.0,37,31,8,4,6,83.78378378
2007020652,29,3600,0.0,30,26,6,1,4,86.66666667
2007020653,30,3600,0.0,43,41,8,0,2,95.34883721
2007020653,16,3542,0.0,15,11,1,1,4,73.33333333
2007020654,2,3900,0.0,42,38,10,0,4,90.47619048
2007020654,20,3893,0.0,25,21,0,2,4,84.0
2007020655,27,3600,0.0,20,17,3,1,3,85.0
2007020655,23,3531,2.0,38,34,4,0,4,89.47368421
2007020656,6,3643,0.0,24,21,5,0,3,87.5
2007020656,4,3642,0.0,32,28,6,0,4,87.5
2007020657,25,3874,0.0,29,26,2,3,3,89.65517241
2007020657,26,3899,0.0,26,23,8,0,3,88.46153846
2007020658,1,3884,0.0,23,21,0,0,2,91.30434783
2007020658,7,3897,0.0,25,23,1,1,2,92.0
2007020659,17,3556,0.0,32,29,5,1,3,90.625
2007020659,9,3558,0.0,29,27,10,0,2,93.10344828
2007020660,8,1200,0.0,13,13,4,0,0,100.0
2007020660,8,2396,0.0,28,24,4,1,4,85.71428571
2007020660,3,3597,0.0,19,18,9,0,1,94.73684211
2007020661,21,3600,0.0,34,30,4,1,4,88.23529412
2007020661,12,3529,0.0,29,24,5,0,5,82.75862069
2007020662,5,3899,0.0,38,36,3,2,2,94.73684211
2007020662,11,3895,0.0,31,29,4,0,2,93.5483871
2007020663,14,3600,0.0,30,27,4,1,3,90.0
2007020663,13,3535,0.0,24,20,1,0,4,83.33333333
2007020664,18,3885,0.0,29,28,2,0,1,96.55172414
2007020664,29,3895,0.0,27,26,5,0,1,96.2962963
2007020665,10,3549,0.0,35,32,8,0,3,91.42857143
2007020665,28,3600,0.0,25,23,4,0,2,92.0
2007020666,4,3596,0.0,32,28,4,0,4,87.5
2007020666,15,2010,0.0,15,14,1,0,1,93.33333333
2007020666,15,1568,0.0,16,12,5,1,4,75.0
2007020667,21,3892,0.0,33,30,4,1,3,90.90909091
2007020667,13,3900,0.0,40,37,8,0,3,92.5
2007020668,23,3900,0.0,22,19,3,1,3,86.36363636
2007020668,19,3897,0.0,25,22,3,0,3,88.0
2007020669,27,3598,0.0,34,30,2,0,4,88.23529412
2007020669,30,3588,0.0,27,26,3,0,1,96.2962963
2007020670,2,3600,0.0,32,31,4,2,1,96.875
2007020670,9,3472,0.0,31,28,8,0,3,90.32258065
2007020671,16,3900,0.0,37,35,5,1,2,94.59459459
2007020671,18,3900,0.0,30,28,4,2,2,93.33333333
2007020672,20,3539,0.0,31,29,0,1,2,93.5483871
2007020672,22,3586,0.0,28,27,4,0,1,96.42857143
2007020673,28,3633,0.0,29,25,11,2,4,86.20689655
2007020673,24,3595,0.0,29,26,6,1,3,89.65517241
2007020674,3,3552,0.0,22,19,4,1,3,86.36363636
2007020674,5,3593,0.0,44,43,10,1,1,97.72727273
2007020675,8,3600,0.0,18,17,1,1,1,94.44444444
2007020675,2,3568,0.0,21,19,4,0,2,90.47619048
2007020676,9,3600,0.0,27,23,3,0,4,85.18518519
2007020676,15,3586,0.0,28,26,2,1,2,92.85714286
2007020677,23,3495,0.0,21,18,5,0,3,85.71428571
2007020677,29,3540,0.0,27,25,1,1,2,92.59259259
2007020678,12,2400,0.0,23,20,6,0,3,86.95652174
2007020678,12,1115,0.0,13,11,4,0,2,84.61538462
2007020678,10,3587,2.0,25,21,3,2,4,84.0
2007020679,21,3599,0.0,32,32,4,0,0,100.0
2007020679,14,3550,0.0,24,22,3,0,2,91.66666667
2007020680,11,3600,0.0,47,46,4,1,1,97.87234043
2007020680,17,1648,0.0,17,13,5,0,4,76.47058824
2007020680,17,1952,0.0,8,7,1,0,1,87.5
2007020681,20,1139,0.0,12,12,4,0,0,100.0
2007020681,20,2459,0.0,26,23,3,0,3,88.46153846
2007020681,18,3578,0.0,22,22,3,3,0,100.0
2007020682,26,3595,0.0,33,32,4,0,1,96.96969697
2007020682,22,3569,0.0,36,33,4,0,3,91.66666667
2007020683,28,3513,0.0,28,23,1,0,5,82.14285714
2007020683,27,3598,0.0,24,21,2,2,3,87.5
2007020684,25,3518,0.0,36,32,5,2,4,88.88888889
2007020684,24,3599,0.0,24,22,3,0,2,91.66666667
2007020685,2,3600,0.0,38,37,9,0,1,97.36842105
2007020685,1,3551,0.0,22,20,6,2,2,90.90909091
2007020686,7,3557,0.0,35,33,7,2,2,94.28571429
2007020686,3,3596,0.0,24,23,6,1,1,95.83333333
2007020687,13,3591,0.0,31,27,6,1,4,87.09677419
2007020687,4,3600,0.0,31,28,4,3,3,90.32258065
2007020688,20,3900,0.0,31,29,5,2,2,93.5483871
2007020688,30,3891,0.0,31,29,6,0,2,93.5483871
2007020689,19,1200,0.0,7,7,1,0,0,100.0
2007020689,19,2335,0.0,13,8,2,0,5,61.53846154
2007020689,16,3598,0.0,33,32,3,0,1,96.96969697
2007020690,10,3896,0.0,31,29,3,0,2,93.5483871
2007020690,6,3900,0.0,33,31,7,1,2,93.93939394
2007020691,22,3900,0.0,32,28,6,0,4,87.5
2007020691,15,3885,0.0,33,29,2,3,4,87.87878788
2007020692,8,3900,0.0,24,22,3,0,2,91.66666667
2007020692,11,3891,0.0,29,27,2,1,2,93.10344828
2007020693,12,3600,0.0,32,27,6,3,5,84.375
2007020693,9,3598,0.0,37,36,5,3,1,97.2972973
2007020694,23,3897,2.0,49,47,6,0,2,95.91836735
2007020694,17,3900,0.0,28,26,3,0,2,92.85714286
2007020695,24,3591,0.0,34,33,7,0,1,97.05882353
2007020695,18,3567,0.0,16,14,1,0,2,87.5
2007020696,29,3587,0.0,35,32,11,0,3,91.42857143
2007020696,27,3573,0.0,32,28,4,4,4,87.5
2007020697,25,3570,0.0,30,28,6,1,2,93.33333333
2007020697,28,3571,0.0,31,27,8,1,4,87.09677419
2007020698,13,3599,0.0,32,31,10,1,1,96.875
2007020698,1,3534,0.0,27,25,3,1,2,92.59259259
2007020699,22,435,0.0,3,2,0,0,1,66.66666667
2007020699,22,3165,0.0,33,27,4,0,6,81.81818182
2007020699,12,3600,0.0,18,16,1,2,2,88.88888889
2007020700,11,1961,0.0,28,21,10,0,7,75.0
2007020700,11,1639,0.0,21,18,5,0,3,85.71428571
2007020700,7,3600,0.0,24,23,8,0,1,95.83333333
2007020701,14,3600,0.0,27,27,1,0,0,100.0
2007020701,5,3600,0.0,34,31,8,1,3,91.17647059
2007020702,24,3600,0.0,27,25,2,2,2,92.59259259
2007020702,30,3586,0.0,27,23,2,0,4,85.18518519
2007020703,16,3900,0.0,23,22,3,0,1,95.65217391
2007020703,21,3900,0.0,23,22,7,0,1,95.65217391
2007020704,26,2397,0.0,30,25,7,0,5,83.33333333
2007020704,26,1200,0.0,5,4,0,2,1,80.0
2007020704,20,3592,0.0,38,37,13,1,1,97.36842105
2007020705,3,3897,0.0,39,36,15,3,3,92.30769231
2007020705,6,3890,0.0,28,25,4,2,3,89.28571429
2007020706,29,3545,0.0,14,11,1,0,3,78.57142857
2007020706,25,3563,0.0,30,29,2,0,1,96.66666667
2007020707,7,3525,0.0,23,19,5,1,4,82.60869565
2007020707,10,3600,0.0,28,26,2,3,2,92.85714286
2007020708,5,3600,0.0,31,31,2,1,0,100.0
2007020708,8,3529,0.0,25,24,5,0,1,96.0
2007020709,14,3594,0.0,25,25,4,3,0,100.0
2007020709,9,3501,0.0,25,24,3,1,1,96.0
2007020710,4,3600,0.0,31,28,3,2,3,90.32258065
2007020710,2,3579,0.0,32,27,5,1,5,84.375
2007020711,13,3597,0.0,35,30,4,0,5,85.71428571
2007020711,15,3600,0.0,28,25,7,0,3,89.28571429
2007020712,18,3600,0.0,26,24,3,0,2,92.30769231
2007020712,19,2106,0.0,15,11,0,0,4,73.33333333
2007020712,19,1494,0.0,12,11,3,0,1,91.66666667
2007020713,16,3897,0.0,39,38,5,1,1,97.43589744
2007020713,27,3900,0.0,24,23,6,0,1,95.83333333
2007020714,26,3600,0.0,46,43,5,3,3,93.47826087
2007020714,23,3518,0.0,24,20,5,1,4,83.33333333
2007020715,17,3587,2.0,18,15,4,0,3,83.33333333
2007020715,28,3579,0.0,28,22,9,1,6,78.57142857
2007020716,6,3591,0.0,31,30,9,0,1,96.77419355
2007020716,3,3574,0.0,20,17,6,1,3,85.0
2007020717,24,3569,0.0,26,22,1,0,4,84.61538462
2007020717,25,3586,0.0,20,18,4,2,2,90.0
2007020718,22,3600,0.0,31,29,7,0,2,93.5483871
2007020718,11,3546,0.0,24,20,3,3,4,83.33333333
2007020719,10,3559,0.0,32,29,8,0,3,90.625
2007020719,1,3600,0.0,36,34,4,0,2,94.44444444
2007020720,9,2391,0.0,14,10,5,0,4,71.42857143
2007020720,9,1200,0.0,7,5,1,2,2,71.42857143
2007020720,4,3591,0.0,26,25,1,5,1,96.15384615
2007020721,29,3564,0.0,27,24,5,1,3,88.88888889
2007020721,21,3600,0.0,27,26,4,0,1,96.2962963
2007020722,12,3645,0.0,25,23,2,0,2,92.0
2007020722,2,3652,0.0,29,26,0,0,3,89.65517241
2007020723,7,3600,0.0,33,27,2,2,6,81.81818182
2007020723,27,3600,0.0,21,19,3,1,2,90.47619048
2007020724,19,3522,0.0,26,21,3,0,5,80.76923077
2007020724,18,3600,0.0,34,31,5,0,3,91.17647059
2007020725,15,3893,0.0,15,10,2,0,5,66.66666667
2007020725,5,1662,0.0,13,9,0,0,4,69.23076923
2007020725,5,2197,2.0,17,16,4,0,1,94.11764706
2007020726,30,3599,0.0,40,38,4,3,2,95.0
2007020726,23,3501,0.0,25,22,11,2,3,88.0
2007020727,11,3600,0.0,39,35,8,1,4,89.74358974
2007020727,3,3600,0.0,14,14,1,3,0,100.0
2007020728,1,3600,0.0,27,24,5,1,3,88.88888889
2007020728,4,2073,0.0,20,15,5,0,5,75.0
2007020728,4,1527,0.0,16,14,6,0,2,87.5
2007020729,2,3595,0.0,47,44,12,2,3,93.61702128
2007020729,12,3548,0.0,30,25,9,6,5,83.33333333
2007020730,6,2400,0.0,17,13,2,0,4,76.47058824
2007020730,6,1197,0.0,7,3,1,0,4,42.85714286
2007020730,8,3594,0.0,31,29,6,1,2,93.5483871
2007020731,22,3522,0.0,22,18,5,0,4,81.81818182
2007020731,14,3600,0.0,28,25,4,2,3,89.28571429
2007020732,9,3547,0.0,40,35,9,0,5,87.5
2007020732,13,3597,0.0,46,43,5,1,3,93.47826087
2007020733,29,3600,0.0,33,31,10,1,2,93.93939394
2007020733,25,3534,0.0,29,26,3,2,3,89.65517241
2007020734,18,3600,0.0,38,38,6,3,0,100.0
2007020734,21,3600,0.0,29,25,2,1,4,86.20689655
2007020735,30,3545,0.0,37,35,5,1,2,94.59459459
2007020735,20,3574,0.0,24,23,3,1,1,95.83333333
2007020736,17,3598,0.0,27,27,3,0,0,100.0
2007020736,26,3595,0.0,27,24,3,0,3,88.88888889
2007020737,16,3580,0.0,23,20,7,0,3,86.95652174
2007020737,28,3600,0.0,30,28,7,0,2,93.33333333
2007020738,15,3577,0.0,24,21,4,1,3,87.5
2007020738,10,3600,0.0,32,30,2,0,2,93.75
2007020739,19,3900,0.0,30,28,5,1,2,93.33333333
2007020739,23,3898,0.0,28,26,6,2,2,92.85714286
2007020740,17,3600,0.0,25,24,2,1,1,96.0
2007020740,24,3518,0.0,33,31,5,0,2,93.93939394
2007020741,2,3600,2.0,30,26,3,1,4,86.66666667
2007020741,6,3600,0.0,29,28,1,0,1,96.55172414
2007020742,8,3600,0.0,13,10,2,2,3,76.92307692
2007020742,1,3538,0.0,32,28,13,1,4,87.5
2007020743,11,3900,0.0,33,32,9,0,1,96.96969697
2007020743,3,3892,0.0,18,17,1,1,1,94.44444444
2007020744,5,3542,0.0,33,29,8,0,4,87.87878788
2007020744,4,3600,0.0,24,21,2,3,3,87.5
2007020745,10,3503,0.0,20,18,0,1,2,90.0
2007020745,15,3593,0.0,32,31,8,2,1,96.875
2007020746,9,3600,0.0,25,21,3,0,4,84.0
2007020746,14,1200,0.0,14,11,1,0,3,78.57142857
2007020746,14,2400,0.0,12,7,0,0,5,58.33333333
2007020747,22,3831,0.0,35,32,5,0,3,91.42857143
2007020747,13,3900,0.0,40,37,6,2,3,92.5
2007020748,29,3600,0.0,30,30,5,2,0,100.0
2007020748,16,3550,0.0,27,26,8,3,1,96.2962963
2007020749,7,3600,2.0,26,25,6,2,1,96.15384615
2007020749,25,3528,0.0,19,17,1,0,2,89.47368421
2007020750,30,3600,0.0,30,28,3,0,2,93.33333333
2007020750,21,3477,0.0,37,34,2,2,3,91.89189189
2007020751,18,3850,0.0,30,26,1,0,4,86.66666667
2007020751,27,3868,0.0,32,29,3,0,3,90.625
2007020752,24,1777,0.0,18,15,6,1,3,83.33333333
2007020752,24,1807,0.0,13,13,3,0,0,100.0
2007020752,26,3600,0.0,32,31,5,1,1,96.875
2007020753,19,3600,0.0,26,22,5,0,4,84.61538462
2007020753,28,3597,2.0,18,17,2,0,1,94.44444444
2007020754,18,3465,0.0,28,25,1,0,3,89.28571429
2007020754,6,3600,0.0,38,37,1,2,1,97.36842105
2007020755,5,3600,0.0,25,23,5,1,2,92.0
2007020755,1,3524,0.0,27,23,6,0,4,85.18518519
2007020756,9,3600,0.0,25,23,4,0,2,92.0
2007020756,2,3564,0.0,25,21,5,0,4,84.0
2007020757,26,3871,0.0,40,37,10,0,3,92.5
2007020757,4,3854,0.0,31,29,3,3,2,93.5483871
2007020758,3,3540,0.0,27,24,6,0,3,88.88888889
2007020758,12,3600,0.0,35,34,8,0,1,97.14285714
2007020759,27,3597,0.0,24,22,3,1,2,91.66666667
2007020759,29,3531,0.0,27,24,3,0,3,88.88888889
2007020760,19,3584,0.0,25,23,4,1,2,92.0
2007020760,10,3525,0.0,19,16,4,1,3,84.21052632
2007020761,15,3600,0.0,40,36,8,0,4,90.0
2007020761,8,3597,0.0,35,35,2,1,0,100.0
2007020762,7,3562,0.0,25,23,2,1,2,92.0
2007020762,14,3509,0.0,26,22,8,1,4,84.61538462
2007020763,28,3600,0.0,13,13,3,0,0,100.0
2007020763,22,3516,0.0,38,36,9,4,2,94.73684211
2007020764,25,3600,0.0,32,29,13,0,3,90.625
2007020764,23,1496,0.0,12,9,1,0,3,75.0
2007020764,23,2028,0.0,11,10,1,1,1,90.90909091
2007020765,5,974,0.0,7,7,1,0,0,100.0
2007020765,5,2626,0.0,20,16,8,0,4,80.0
2007020765,11,3591,0.0,30,29,4,6,1,96.66666667
2007020766,7,3590,0.0,32,32,10,0,0,100.0
2007020766,13,3572,0.0,41,40,6,0,1,97.56097561
2007020767,27,3569,0.0,39,36,4,1,3,92.30769231
2007020767,17,3600,0.0,34,32,1,3,2,94.11764706
2007020768,24,1398,0.0,11,8,0,0,3,72.72727273
2007020768,24,2200,0.0,12,10,6,0,2,83.33333333
2007020768,30,3584,0.0,21,20,1,4,1,95.23809524
2007020769,16,3599,0.0,30,24,6,2,6,80.0
2007020769,21,2399,0.0,11,10,1,1,1,90.90909091
2007020769,21,1198,0.0,4,2,0,0,2,50.0
2007020770,28,3525,0.0,29,24,4,2,5,82.75862069
2007020770,20,3600,0.0,31,27,9,0,4,87.09677419
2007020771,26,3600,0.0,29,28,1,1,1,96.55172414
2007020771,2,3550,0.0,26,24,5,0,2,92.30769231
2007020772,3,3600,0.0,20,20,2,2,0,100.0
2007020772,4,1301,0.0,12,8,2,0,4,66.66666667
2007020772,4,2298,0.0,15,15,0,0,0,100.0
2007020773,8,3792,0.0,38,33,3,1,5,86.84210526
2007020773,15,3813,0.0,21,17,3,0,4,80.95238095
2007020774,10,3752,0.0,38,35,9,2,3,92.10526316
2007020774,12,3790,0.0,26,24,0,2,2,92.30769231
2007020775,6,3598,0.0,31,30,8,0,1,96.77419355
2007020775,9,3519,0.0,21,18,3,0,3,85.71428571
2007020776,23,3590,0.0,27,23,2,0,4,85.18518519
2007020776,14,3593,0.0,26,23,2,0,3,88.46153846
2007020777,29,2400,0.0,23,19,13,0,4,82.60869565
2007020777,29,1130,0.0,8,8,0,0,0,100.0
2007020777,18,3588,0.0,33,31,3,0,2,93.93939394
2007020778,3,3600,0.0,34,33,1,0,1,97.05882353
2007020778,1,3553,0.0,25,23,5,0,2,92.0
2007020779,7,2400,0.0,20,18,1,0,2,90.0
2007020779,7,1493,0.0,9,7,3,0,2,77.77777778
2007020779,11,3855,0.0,33,29,3,0,4,87.87878788
2007020780,23,3886,0.0,43,40,5,0,3,93.02325581
2007020780,13,3898,0.0,32,29,6,2,3,90.625
2007020781,21,3539,2.0,35,34,9,0,1,97.14285714
2007020781,17,3600,0.0,15,15,1,0,0,100.0
2007020782,24,3900,0.0,20,20,3,1,0,100.0
2007020782,19,3900,0.0,30,30,7,1,0,100.0
2007020783,25,3600,0.0,33,32,4,0,1,96.96969697
2007020783,22,3596,0.0,21,18,5,0,3,85.71428571
2007020784,2,3600,0.0,32,28,10,2,4,87.5
2007020784,8,3600,0.0,30,29,5,0,1,96.66666667
2007020785,17,3600,0.0,23,22,4,0,1,95.65217391
2007020785,6,3600,0.0,32,29,8,1,3,90.625
2007020786,9,3600,0.0,26,22,7,0,4,84.61538462
2007020786,10,3600,0.0,21,19,0,2,2,90.47619048
2007020787,26,2349,0.0,24,19,2,1,5,79.16666667
2007020787,26,1200,0.0,3,2,0,0,1,66.66666667
2007020787,1,3600,0.0,26,23,4,0,3,88.46153846
2007020788,24,3589,0.0,25,22,4,0,3,88.0
2007020788,4,3600,0.0,27,27,4,2,0,100.0
2007020789,11,3600,0.0,36,36,2,0,0,100.0
2007020789,15,3534,0.0,12,11,0,0,1,91.66666667
2007020790,30,3600,0.0,34,33,5,2,1,97.05882353
2007020790,29,3600,0.0,20,16,0,0,4,80.0
2007020791,12,3584,0.0,29,25,6,0,4,86.20689655
2007020791,5,3600,0.0,28,27,4,3,1,96.42857143
2007020792,13,3595,0.0,46,44,6,2,2,95.65217391
2007020792,14,3548,0.0,32,29,3,0,3,90.625
2007020793,27,3850,0.0,37,34,4,1,3,91.89189189
2007020793,18,3850,0.0,37,35,3,0,2,94.59459459
2007020794,21,3594,0.0,32,28,4,1,4,87.5
2007020794,19,3531,0.0,23,18,2,0,5,78.26086957
2007020795,25,3600,2.0,32,31,11,0,1,96.875
2007020795,20,3542,0.0,24,22,1,2,2,91.66666667
2007020796,16,3900,0.0,40,38,12,3,2,95.0
2007020796,28,3896,0.0,21,19,4,2,2,90.47619048
2007020797,3,3600,0.0,28,25,2,2,3,89.28571429
2007020797,8,3550,0.0,30,25,3,1,5,83.33333333
2007020798,5,3622,0.0,25,21,4,1,4,84.0
2007020798,1,3637,2.0,34,31,16,2,3,91.17647059
2007020799,27,3803,0.0,36,33,2,0,3,91.66666667
2007020799,21,3803,0.0,33,29,3,0,4,87.87878788
2007020800,20,3600,2.0,28,23,3,0,5,82.14285714
2007020800,22,3597,2.0,24,24,7,3,0,100.0
2007020801,7,3595,0.0,32,30,1,0,2,93.75
2007020801,6,3597,0.0,28,24,10,0,4,85.71428571
2007020802,24,3600,0.0,25,25,0,0,0,100.0
2007020802,2,3600,0.0,26,23,6,0,3,88.46153846
2007020803,26,3596,2.0,41,39,6,3,2,95.12195122
2007020803,3,3548,0.0,31,27,6,1,4,87.09677419
2007020804,4,3566,0.0,25,23,0,3,2,92.0
2007020804,11,3531,0.0,36,33,7,2,3,91.66666667
2007020805,15,3744,0.0,31,28,4,0,3,90.32258065
2007020805,29,2122,0.0,24,23,0,0,1,95.83333333
2007020805,29,1626,0.0,13,10,1,0,3,76.92307692
2007020806,13,3592,0.0,24,24,4,0,0,100.0
2007020806,10,1899,0.0,11,7,2,2,4,63.63636364
2007020806,10,1699,0.0,15,11,1,0,4,73.33333333
2007020807,9,3523,0.0,26,22,2,1,4,84.61538462
2007020807,8,3597,0.0,29,26,2,1,3,89.65517241
2007020808,12,3551,0.0,34,33,3,0,1,97.05882353
2007020808,18,3600,0.0,31,31,2,1,0,100.0
2007020809,17,3697,0.0,26,24,4,0,2,92.30769231
2007020809,30,3689,0.0,38,35,5,1,3,92.10526316
2007020810,14,3600,0.0,25,21,0,0,4,84.0
2007020810,19,3549,0.0,24,19,2,1,5,79.16666667
2007020811,23,3900,0.0,34,32,4,0,2,94.11764706
2007020811,25,3890,0.0,24,22,1,0,2,91.66666667
2007020812,27,3900,0.0,38,35,2,0,3,92.10526316
2007020812,20,3860,0.0,23,20,0,1,3,86.95652174
2007020813,1,3900,0.0,22,20,3,0,2,90.90909091
2007020813,7,3900,0.0,26,24,3,0,2,92.30769231
2007020814,15,3600,0.0,34,31,7,2,3,91.17647059
2007020814,4,3548,0.0,27,23,1,1,4,85.18518519
2007020815,16,3466,0.0,27,23,6,0,4,85.18518519
2007020815,22,3590,0.0,41,40,18,0,1,97.56097561
2007020816,21,3595,0.0,31,30,3,0,1,96.77419355
2007020816,28,3510,0.0,24,22,4,1,2,91.66666667
2007020817,24,3600,0.0,33,32,2,0,1,96.96969697
2007020817,3,3488,0.0,19,15,2,0,4,78.94736842
2007020818,23,3583,0.0,28,27,2,5,1,96.42857143
2007020818,11,3510,0.0,28,26,5,1,2,92.85714286
2007020819,10,3600,0.0,36,34,12,1,2,94.44444444
2007020819,8,3552,0.0,27,24,1,0,3,88.88888889
2007020820,13,3561,0.0,34,29,4,1,5,85.29411765
2007020820,9,3595,0.0,33,29,2,1,4,87.87878788
2007020821,2,3527,0.0,27,23,5,1,4,85.18518519
2007020821,5,3600,0.0,32,29,4,0,3,90.625
2007020822,26,3600,0.0,29,26,5,0,3,89.65517241
2007020822,17,3503,0.0,25,20,5,0,5,80.0
2007020823,14,3658,0.0,19,18,1,0,1,94.73684211
2007020823,18,3650,0.0,25,23,0,0,2,92.0
2007020824,25,3597,0.0,25,25,1,0,0,100.0
2007020824,30,3523,0.0,26,25,12,0,1,96.15384615
2007020825,16,3600,0.0,27,26,9,0,1,96.2962963
2007020825,20,3565,0.0,27,25,6,0,2,92.59259259
2007020826,29,3600,0.0,27,26,12,0,1,96.2962963
2007020826,27,3482,0.0,33,31,4,0,2,93.93939394
2007020827,24,3600,0.0,35,34,16,2,1,97.14285714
2007020827,1,3543,0.0,24,22,4,1,2,91.66666667
2007020828,12,3600,0.0,34,33,8,2,1,97.05882353
2007020828,15,3551,0.0,23,21,3,6,2,91.30434783
2007020829,6,3895,0.0,23,21,6,1,2,91.30434783
2007020829,7,3888,0.0,37,35,5,0,2,94.59459459
2007020830,29,3709,0.0,22,20,4,0,2,90.90909091
2007020830,28,3709,2.0,32,31,5,4,1,96.875
2007020831,3,3600,0.0,31,31,4,0,0,100.0
2007020831,4,3525,0.0,33,31,4,0,2,93.93939394
2007020832,26,3558,0.0,36,32,11,0,4,88.88888889
2007020832,5,3592,0.0,28,26,12,0,2,92.85714286
2007020833,17,3662,0.0,25,22,0,2,3,88.0
2007020833,10,3662,0.0,34,32,2,0,2,94.11764706
2007020834,2,3736,0.0,18,14,1,1,4,77.77777778
2007020834,30,3754,0.0,29,26,2,0,3,89.65517241
2007020835,13,3600,0.0,41,38,12,4,3,92.68292683
2007020835,6,3584,0.0,27,21,4,1,6,77.77777778
2007020836,8,3315,0.0,25,22,3,2,3,88.0
2007020836,8,285,0.0,4,1,0,0,3,25.0
2007020836,9,3594,0.0,34,33,9,2,1,97.05882353
2007020837,12,2081,0.0,20,14,3,1,6,70.0
2007020837,12,1519,0.0,6,6,0,1,0,100.0
2007020837,1,3600,0.0,23,22,3,0,1,95.65217391
2007020838,14,3686,0.0,22,20,2,0,2,90.90909091
2007020838,11,3686,0.0,28,27,1,0,1,96.42857143
2007020839,22,3549,0.0,29,26,8,0,3,89.65517241
2007020839,20,3598,0.0,15,14,1,1,1,93.33333333
2007020840,19,1674,0.0,8,6,0,0,2,75.0
2007020840,19,1926,0.0,15,11,0,2,4,73.33333333
2007020840,25,3574,0.0,29,27,3,0,2,93.10344828
2007020841,21,3600,0.0,25,23,3,2,2,92.0
2007020841,23,1200,0.0,2,1,0,0,1,50.0
2007020841,23,2400,0.0,22,17,2,0,5,77.27272727
2007020842,18,3600,0.0,27,23,7,1,4,85.18518519
2007020842,28,3600,0.0,13,10,1,1,3,76.92307692
2007020843,4,3548,0.0,25,21,2,0,4,84.0
2007020843,5,3600,0.0,30,27,3,0,3,90.0
2007020844,3,3592,2.0,24,21,1,3,3,87.5
2007020844,15,3623,2.0,33,31,9,0,2,93.93939394
2007020845,24,3560,0.0,29,27,9,0,2,93.10344828
2007020845,17,3518,0.0,19,16,2,1,3,84.21052632
2007020846,26,3900,0.0,33,31,5,1,2,93.93939394
2007020846,29,3900,0.0,34,32,4,0,2,94.11764706
2007020847,30,3900,0.0,21,20,1,0,1,95.23809524
2007020847,19,3900,0.0,25,24,3,1,1,96.0
2007020848,13,3547,0.0,31,26,3,1,5,83.87096774
2007020848,7,3600,0.0,25,22,1,1,3,88.0
2007020849,18,3600,0.0,33,30,4,0,3,90.90909091
2007020849,27,807,0.0,8,5,0,1,3,62.5
2007020849,27,2726,0.0,19,17,0,2,2,89.47368421
2007020850,16,3894,0.0,34,32,4,1,2,94.11764706
2007020850,23,3880,0.0,18,16,4,0,2,88.88888889
2007020851,27,3535,0.0,44,42,9,1,2,95.45454545
2007020851,25,3575,0.0,20,19,0,0,1,95.0
2007020852,12,3600,0.0,34,32,2,4,2,94.11764706
2007020852,6,3533,0.0,23,20,4,0,3,86.95652174
2007020853,4,3550,0.0,47,43,7,3,4,91.4893617
2007020853,2,3590,0.0,29,26,9,2,3,89.65517241
2007020854,7,3597,0.0,26,25,3,2,1,96.15384615
2007020854,9,3600,0.0,39,34,5,3,5,87.17948718
2007020855,8,3529,0.0,36,33,2,0,3,91.66666667
2007020855,14,3600,0.0,21,19,0,2,2,90.47619048
2007020856,17,2977,0.0,19,18,8,0,1,94.73684211
2007020856,17,529,0.0,4,1,0,0,3,25.0
2007020856,18,3594,0.0,42,40,13,1,2,95.23809524
2007020857,26,3445,0.0,34,30,4,2,4,88.23529412
2007020857,19,3600,0.0,27,25,8,0,2,92.59259259
2007020858,24,3600,0.0,33,32,6,0,1,96.96969697
2007020858,21,3549,0.0,29,27,3,0,2,93.10344828
2007020859,30,1073,0.0,12,10,1,1,2,83.33333333
2007020859,30,2400,0.0,11,9,0,0,2,81.81818182
2007020859,22,3600,0.0,40,38,8,1,2,95.0
2007020860,20,3832,0.0,43,40,8,0,3,93.02325581
2007020860,28,3875,0.0,18,14,2,0,4,77.77777778
2007020861,10,3513,0.0,20,19,3,0,1,95.0
2007020861,7,3587,0.0,35,35,10,0,0,100.0
2007020862,9,3726,2.0,31,28,9,2,3,90.32258065
2007020862,1,3734,0.0,25,23,5,1,2,92.0
2007020863,15,3898,0.0,28,26,3,0,2,92.85714286
2007020863,11,3877,0.0,41,39,4,0,2,95.12195122
2007020864,16,3582,0.0,26,24,6,0,2,92.30769231
2007020864,29,290,0.0,3,2,0,0,1,66.66666667
2007020864,29,3310,0.0,28,22,3,0,6,78.57142857
2007020865,6,3593,0.0,21,20,6,2,1,95.23809524
2007020865,5,3533,0.0,33,31,3,0,2,93.93939394
2007020866,8,3694,0.0,36,35,11,0,1,97.22222222
2007020866,13,3666,0.0,37,35,12,1,2,94.59459459
2007020867,14,3600,0.0,30,27,1,0,3,90.0
2007020867,4,3536,0.0,28,23,8,0,5,82.14285714
2007020868,5,3531,2.0,46,42,8,2,4,91.30434783
2007020868,12,3600,0.0,22,20,3,1,2,90.90909091
2007020869,2,3564,0.0,31,27,10,1,4,87.09677419
2007020869,10,3534,0.0,28,24,3,2,4,85.71428571
2007020870,16,3600,0.0,25,24,3,0,1,96.0
2007020870,18,762,0.0,7,4,0,0,3,57.14285714
2007020870,18,2836,0.0,13,10,1,0,3,76.92307692
2007020871,19,3600,0.0,40,39,6,0,1,97.5
2007020871,21,1292,0.0,7,4,0,1,3,57.14285714
2007020871,21,2276,0.0,16,16,0,1,0,100.0
2007020872,25,3569,0.0,26,22,5,0,4,84.61538462
2007020872,27,3599,0.0,34,32,6,1,2,94.11764706
2007020873,30,3895,0.0,28,24,2,4,4,85.71428571
2007020873,23,3900,0.0,26,22,5,0,4,84.61538462
2007020874,22,3593,0.0,30,28,3,2,2,93.33333333
2007020874,28,3527,0.0,18,15,5,1,3,83.33333333
2007020875,11,3840,0.0,33,30,3,1,3,90.90909091
2007020875,1,3893,0.0,32,29,4,2,3,90.625
2007020876,15,3557,0.0,28,25,8,0,3,89.28571429
2007020876,13,3600,0.0,32,30,9,3,2,93.75
2007020877,29,3600,0.0,21,20,1,0,1,95.23809524
2007020877,17,1722,0.0,10,9,2,0,1,90.0
2007020877,17,1872,0.0,13,9,2,0,4,69.23076923
2007020878,25,3571,0.0,22,20,2,6,2,90.90909091
2007020878,24,3532,0.0,20,17,10,1,3,85.0
2007020879,20,3600,0.0,25,19,6,0,6,76.0
2007020879,26,3600,0.0,42,39,7,0,3,92.85714286
2007020880,7,745,0.0,11,7,0,0,4,63.63636364
2007020880,7,2854,0.0,21,20,8,1,1,95.23809524
2007020880,3,3600,0.0,30,29,2,0,1,96.66666667
2007020881,6,3809,0.0,36,32,4,0,4,88.88888889
2007020881,10,3819,0.0,27,24,3,1,3,88.88888889
2007020882,4,3518,0.0,20,19,5,1,1,95.0
2007020882,8,3600,0.0,34,34,13,1,0,100.0
2007020883,1,3600,0.0,39,37,8,1,2,94.87179487
2007020883,9,3517,0.0,29,26,4,2,3,89.65517241
2007020884,11,3600,0.0,49,45,9,5,4,91.83673469
2007020884,2,3591,4.0,10,9,3,0,1,90.0
2007020885,13,3553,0.0,32,27,2,1,5,84.375
2007020885,12,2003,0.0,13,10,5,1,3,76.92307692
2007020885,12,1597,0.0,11,10,0,1,1,90.90909091
2007020886,15,3600,0.0,41,39,7,0,2,95.12195122
2007020886,14,3560,0.0,35,32,4,0,3,91.42857143
2007020887,19,3640,0.0,44,42,16,0,2,95.45454545
2007020887,18,3640,0.0,19,18,3,1,1,94.73684211
2007020888,26,1128,0.0,16,15,4,0,1,93.75
2007020888,26,2400,0.0,21,18,6,0,3,85.71428571
2007020888,27,3600,0.0,25,22,1,0,3,88.0
2007020889,22,3465,2.0,25,22,5,0,3,88.0
2007020889,23,3574,0.0,26,24,3,0,2,92.30769231
2007020890,5,3600,0.0,37,36,10,0,1,97.2972973
2007020890,7,3543,0.0,24,21,2,0,3,87.5
2007020891,28,3538,0.0,32,30,6,0,2,93.75
2007020891,3,3592,0.0,30,29,0,0,1,96.66666667
2007020892,21,3496,0.0,27,25,3,2,2,92.59259259
2007020892,16,3600,0.0,22,21,9,0,1,95.45454545
2007020893,17,3528,0.0,31,30,7,2,1,96.77419355
2007020893,25,3593,0.0,28,28,4,0,0,100.0
2007020894,29,3600,0.0,28,23,5,0,5,82.14285714
2007020894,19,3600,2.0,19,18,3,1,1,94.73684211
2007020895,8,3600,0.0,37,34,14,0,3,91.89189189
2007020895,4,3593,0.0,32,28,11,1,4,87.5
2007020896,18,3895,0.0,28,23,1,0,5,82.14285714
2007020896,30,3878,0.0,28,24,4,1,4,85.71428571
2007020897,20,1200,0.0,10,10,3,0,0,100.0
2007020897,20,2400,0.0,26,22,3,0,4,84.61538462
2007020897,24,3600,0.0,25,23,1,3,2,92.0
2007020898,12,3591,0.0,31,26,4,0,5,83.87096774
2007020898,1,3600,0.0,22,21,2,0,1,95.45454545
2007020899,28,576,0.0,1,1,0,0,0,100.0
2007020899,28,2983,0.0,20,17,7,1,3,85.0
2007020899,2,3600,0.0,30,28,8,6,2,93.33333333
2007020900,17,3600,0.0,18,18,6,0,0,100.0
2007020900,21,3600,0.0,40,36,10,0,4,90.0
2007020901,27,3600,0.0,34,34,6,0,0,100.0
2007020901,26,3595,0.0,29,25,0,0,4,86.20689655
2007020902,6,3900,0.0,47,45,10,2,2,95.74468085
2007020902,12,3882,0.0,38,36,3,1,2,94.73684211
2007020903,29,3546,0.0,25,22,6,0,3,88.0
2007020903,10,3600,0.0,27,26,3,3,1,96.2962963
2007020904,3,3900,0.0,32,27,4,2,5,84.375
2007020904,8,836,0.0,11,8,0,0,3,72.72727273
2007020904,8,3061,0.0,22,20,6,0,2,90.90909091
2007020905,4,3894,0.0,35,33,5,0,2,94.28571429
2007020905,9,3887,2.0,25,23,4,2,2,92.0
2007020906,13,3568,2.0,32,29,6,1,3,90.625
2007020906,5,3600,0.0,29,27,7,2,2,93.10344828
2007020907,22,3535,0.0,28,23,1,0,5,82.14285714
2007020907,18,3598,0.0,36,32,2,0,4,88.88888889
2007020908,23,3797,0.0,22,20,7,0,2,90.90909091
2007020908,30,3791,0.0,37,34,6,0,3,91.89189189
2007020909,16,3510,0.0,36,32,5,1,4,88.88888889
2007020909,19,3600,0.0,20,19,4,2,1,95.0
2007020910,20,3600,0.0,25,24,6,1,1,96.0
2007020910,27,3461,0.0,34,31,8,3,3,91.17647059
2007020911,14,3732,0.0,46,42,9,1,4,91.30434783
2007020911,7,3701,0.0,25,22,4,2,3,88.0
2007020912,28,3520,0.0,20,17,2,2,3,85.0
2007020912,1,3600,0.0,32,30,4,1,2,93.75
2007020913,2,3900,0.0,30,28,2,0,2,93.33333333
2007020913,15,3900,0.0,19,17,2,0,2,89.47368421
2007020914,30,3589,0.0,30,27,1,0,3,90.0
2007020914,16,3600,0.0,38,38,4,0,0,100.0
2007020915,20,3600,0.0,31,29,4,2,2,93.5483871
2007020915,25,3534,0.0,18,15,1,0,3,83.33333333
2007020916,21,3883,0.0,22,20,10,0,2,90.90909091
2007020916,24,3887,0.0,28,26,4,1,2,92.85714286
2007020917,14,3573,0.0,28,27,2,1,1,96.42857143
2007020917,2,3600,0.0,32,32,9,1,0,100.0
2007020918,28,3600,0.0,27,26,0,1,1,96.2962963
2007020918,4,3600,0.0,40,37,5,0,3,92.5
2007020919,11,3531,0.0,46,41,7,0,5,89.13043478
2007020919,12,3600,0.0,28,25,1,0,3,89.28571429
2007020920,7,3600,0.0,35,34,8,0,1,97.14285714
2007020920,10,3496,0.0,22,18,0,1,4,81.81818182
2007020921,5,3600,0.0,21,17,4,0,4,80.95238095
2007020921,8,3522,0.0,30,25,6,0,5,83.33333333
2007020922,29,3900,0.0,29,27,4,0,2,93.10344828
2007020922,9,3900,0.0,24,22,1,2,2,91.66666667
2007020923,6,2400,0.0,12,8,0,1,4,66.66666667
2007020923,6,1495,0.0,15,15,2,3,0,100.0
2007020923,13,3900,0.0,48,44,7,0,4,91.66666667
2007020924,23,3900,0.0,51,49,13,0,2,96.07843137
2007020924,18,3900,0.0,30,28,8,1,2,93.33333333
2007020925,19,1597,0.0,9,8,3,0,1,88.88888889
2007020925,19,2003,0.0,19,15,4,2,4,78.94736842
2007020925,26,3600,0.0,33,32,2,0,1,96.96969697
2007020926,22,1171,0.0,10,9,0,0,1,90.0
2007020926,22,2398,0.0,28,25,5,2,3,89.28571429
2007020926,25,3586,0.0,22,20,6,0,2,90.90909091
2007020927,17,3520,0.0,26,25,7,1,1,96.15384615
2007020927,20,3600,0.0,38,38,12,2,0,100.0
2007020928,21,3899,0.0,29,27,2,0,2,93.10344828
2007020928,27,3843,0.0,29,27,6,1,2,93.10344828
2007020929,19,3632,0.0,29,27,8,2,2,93.10344828
2007020929,24,3628,0.0,17,16,8,0,1,94.11764706
2007020930,2,3506,0.0,42,38,8,0,4,90.47619048
2007020930,1,3600,0.0,21,19,4,0,2,90.47619048
2007020931,9,3896,0.0,35,32,7,0,3,91.42857143
2007020931,5,3889,0.0,28,24,0,2,4,85.71428571
2007020932,16,3703,0.0,39,34,3,0,5,87.17948718
2007020932,26,1874,0.0,19,18,0,0,1,94.73684211
2007020932,26,1697,0.0,17,12,3,0,5,70.58823529
2007020933,15,3600,0.0,42,36,14,0,6,85.71428571
2007020933,12,3596,0.0,34,31,4,0,3,91.17647059
2007020934,3,3600,0.0,29,26,4,2,3,89.65517241
2007020934,7,3527,0.0,35,31,5,2,4,88.57142857
2007020935,11,3515,0.0,25,22,3,1,3,88.0
2007020935,10,3600,0.0,25,24,6,1,1,96.0
2007020936,29,3548,0.0,31,31,9,0,0,100.0
2007020936,8,3593,0.0,22,19,0,2,3,86.36363636
2007020937,13,3759,0.0,41,40,8,4,1,97.56097561
2007020937,4,3817,0.0,25,23,5,1,2,92.0
2007020938,6,3598,0.0,28,25,6,0,3,89.28571429
2007020938,14,3591,0.0,28,23,9,2,5,82.14285714
2007020939,25,3587,0.0,27,24,7,2,3,88.88888889
2007020939,18,1200,0.0,11,9,2,0,2,81.81818182
2007020939,18,2400,0.0,18,14,3,0,4,77.77777778
2007020940,17,3597,0.0,35,31,4,1,4,88.57142857
2007020940,23,3589,0.0,29,28,5,0,1,96.55172414
2007020941,20,3599,0.0,39,38,13,0,1,97.43589744
2007020941,30,3511,0.0,16,14,3,0,2,87.5
2007020942,28,3866,0.0,21,20,6,2,1,95.23809524
2007020942,5,3900,0.0,37,36,8,3,1,97.2972973
2007020943,1,3850,0.0,38,37,2,0,1,97.36842105
2007020943,15,3850,0.0,31,29,7,0,2,93.5483871
2007020944,13,3600,0.0,29,24,5,0,5,82.75862069
2007020944,3,3600,0.0,23,23,4,1,0,100.0
2007020945,21,3537,0.0,20,17,2,0,3,85.0
2007020945,22,3598,0.0,29,27,5,0,2,93.10344828
2007020946,19,3471,0.0,20,18,6,2,2,90.0
2007020946,27,3600,0.0,35,35,12,3,0,100.0
2007020947,16,682,0.0,3,2,0,0,1,66.66666667
2007020947,16,2918,6.0,25,20,5,0,5,80.0
2007020947,24,3598,0.0,32,29,8,1,3,90.625
2007020948,4,3900,0.0,29,26,4,0,3,89.65517241
2007020948,7,3900,0.0,35,32,5,2,3,91.42857143
2007020949,10,3599,0.0,31,31,5,2,0,100.0
2007020949,9,1200,0.0,6,6,0,0,0,100.0
2007020949,9,2400,0.0,21,16,7,2,5,76.19047619
2007020950,9,3562,2.0,28,25,0,1,3,89.28571429
2007020950,6,3595,0.0,22,22,5,1,0,100.0
2007020951,5,3594,0.0,52,50,9,3,2,96.15384615
2007020951,2,3593,0.0,21,17,6,1,4,80.95238095
2007020952,30,3600,0.0,26,22,0,0,4,84.61538462
2007020952,15,3600,0.0,35,34,5,0,1,97.14285714
2007020953,1,3689,0.0,36,34,5,0,2,94.44444444
2007020953,12,3696,0.0,24,23,2,1,1,95.83333333
2007020954,11,3589,0.0,33,28,5,3,5,84.84848485
2007020954,8,3600,0.0,27,26,2,1,1,96.2962963
2007020955,25,3583,0.0,28,27,1,0,1,96.42857143
2007020955,19,3513,0.0,21,18,0,3,3,85.71428571
2007020956,21,3763,0.0,29,27,4,1,2,93.10344828
2007020956,20,3782,0.0,34,31,8,1,3,91.17647059
2007020957,17,3900,0.0,29,26,3,1,3,89.65517241
2007020957,22,3844,0.0,43,40,10,2,3,93.02325581
2007020958,18,2090,0.0,19,14,2,0,5,73.68421053
2007020958,18,1510,0.0,14,11,3,1,3,78.57142857
2007020958,7,3104,0.0,26,24,6,3,2,92.30769231
2007020958,7,496,0.0,7,5,1,0,2,71.42857143
2007020959,28,3543,0.0,19,17,2,1,2,89.47368421
2007020959,29,3600,0.0,32,28,7,0,4,87.5
2007020960,30,3600,2.0,33,31,8,0,2,93.93939394
2007020960,14,3515,0.0,27,24,0,6,3,88.88888889
2007020961,10,3891,0.0,40,37,7,2,3,92.5
2007020961,13,3900,0.0,37,34,2,1,3,91.89189189
2007020962,27,3528,0.0,25,24,1,0,1,96.0
2007020962,16,3600,0.0,32,32,0,0,0,100.0
2007020963,21,3838,0.0,31,29,7,0,2,93.5483871
2007020963,23,3882,0.0,26,24,9,1,2,92.30769231
2007020964,5,2251,0.0,18,16,3,0,2,88.88888889
2007020964,5,1341,0.0,13,10,1,0,3,76.92307692
2007020964,6,3600,0.0,28,27,5,1,1,96.42857143
2007020965,9,3600,0.0,38,35,5,3,3,92.10526316
2007020965,4,3593,2.0,33,32,2,2,1,96.96969697
2007020966,3,3600,0.0,28,26,6,2,2,92.85714286
2007020966,12,3526,0.0,28,24,6,1,4,85.71428571
2007020967,2,3645,0.0,23,19,4,1,4,82.60869565
2007020967,11,3654,0.0,37,32,1,0,5,86.48648649
2007020968,27,3590,0.0,42,41,4,2,1,97.61904762
2007020968,19,3525,0.0,28,26,4,1,2,92.85714286
2007020969,16,2006,0.0,12,10,4,1,2,83.33333333
2007020969,16,1594,0.0,13,8,0,0,5,61.53846154
2007020969,25,3597,0.0,29,25,11,3,4,86.20689655
2007020970,26,3521,0.0,27,22,5,1,5,81.48148148
2007020970,22,3592,0.0,26,22,3,0,4,84.61538462
2007020971,15,3600,0.0,18,18,4,1,0,100.0
2007020971,1,3600,0.0,29,25,5,0,4,86.20689655
2007020972,8,3600,0.0,33,31,8,0,2,93.93939394
2007020972,7,3600,0.0,33,27,2,0,6,81.81818182
2007020973,30,3600,0.0,34,32,7,0,2,94.11764706
2007020973,13,3528,0.0,25,22,4,1,3,88.0
2007020974,28,3600,2.0,22,20,5,0,2,90.90909091
2007020974,17,3535,0.0,22,19,3,0,3,86.36363636
2007020975,10,3718,0.0,27,24,8,0,3,88.88888889
2007020975,14,3718,0.0,25,23,1,0,2,92.0
2007020976,29,3667,0.0,23,21,9,1,2,91.30434783
2007020976,23,3658,0.0,33,30,4,1,3,90.90909091
2007020977,20,2396,0.0,14,13,3,2,1,92.85714286
2007020977,20,1200,0.0,11,9,1,1,2,81.81818182
2007020977,24,3599,0.0,23,22,3,1,1,95.65217391
2007020978,11,3900,0.0,35,33,3,2,2,94.28571429
2007020978,6,3900,0.0,28,26,7,0,2,92.85714286
2007020979,4,3600,0.0,34,33,4,0,1,97.05882353
2007020979,2,3554,0.0,30,27,0,1,3,90.0
2007020980,5,3539,0.0,30,25,4,2,5,83.33333333
2007020980,9,3598,0.0,29,25,5,2,4,86.20689655
2007020981,1,3557,0.0,25,23,8,0,2,92.0
2007020981,8,3600,0.0,32,31,1,2,1,96.875
2007020982,10,3594,0.0,28,26,4,1,2,92.85714286
2007020982,15,3537,0.0,25,22,2,1,3,88.0
2007020983,14,3600,2.0,33,28,10,0,5,84.84848485
2007020983,12,3595,2.0,23,22,1,0,1,95.65217391
2007020984,18,3593,0.0,25,24,7,4,1,96.0
2007020984,25,3507,0.0,28,25,7,3,3,89.28571429
2007020985,28,3585,0.0,24,24,9,0,0,100.0
2007020985,19,3405,0.0,34,32,6,3,2,94.11764706
2007020986,26,3529,0.0,27,23,4,0,4,85.18518519
2007020986,21,3600,0.0,25,23,7,1,2,92.0
2007020987,20,3596,0.0,17,16,2,0,1,94.11764706
2007020987,27,3506,0.0,28,25,1,2,3,89.28571429
2007020988,17,3599,0.0,24,22,6,1,2,91.66666667
2007020988,7,3523,0.0,39,35,12,0,4,89.74358974
2007020989,13,3596,0.0,53,53,6,2,0,100.0
2007020989,2,3522,0.0,30,29,0,0,1,96.66666667
2007020990,4,1311,0.0,14,10,1,0,4,71.42857143
2007020990,4,2589,0.0,21,21,2,0,0,100.0
2007020990,3,1180,0.0,8,5,1,1,3,62.5
2007020990,3,2687,0.0,18,17,0,0,1,94.44444444
2007020991,11,3900,0.0,34,32,5,2,2,94.11764706
2007020991,5,3900,0.0,33,31,9,0,2,93.93939394
2007020992,23,611,0.0,2,2,0,0,0,100.0
2007020992,23,2982,0.0,26,22,4,0,4,84.61538462
2007020992,16,3600,0.0,10,9,1,0,1,90.0
2007020993,26,3818,0.0,35,33,4,1,2,94.28571429
2007020993,30,3799,0.0,28,27,11,1,1,96.42857143
2007020994,29,3900,0.0,29,26,4,0,3,89.65517241
2007020994,22,3900,0.0,38,35,8,1,3,92.10526316
2007020995,6,2190,0.0,24,17,7,0,7,70.83333333
2007020995,6,1410,0.0,10,7,3,0,3,70.0
2007020995,15,1131,0.0,5,5,2,0,0,100.0
2007020995,15,2385,0.0,22,20,7,0,2,90.90909091
2007020996,9,3549,0.0,31,28,7,3,3,90.32258065
2007020996,24,3600,0.0,25,24,4,2,1,96.0
2007020997,8,3554,0.0,39,33,6,3,6,84.61538462
2007020997,28,3599,0.0,31,27,7,1,4,87.09677419
2007020998,13,3622,0.0,40,40,4,2,0,100.0
2007020998,6,3615,0.0,32,31,6,2,1,96.875
2007020999,2,3892,0.0,30,27,0,3,3,90.0
2007020999,3,3900,0.0,18,15,1,0,3,83.33333333
2007021000,7,3596,2.0,21,19,1,2,2,90.47619048
2007021000,4,843,0.0,3,3,0,0,0,100.0
2007021000,4,2757,0.0,18,13,3,0,5,72.22222222
2007021001,1,3600,0.0,42,41,9,2,1,97.61904762
2007021001,10,3517,0.0,25,21,5,0,4,84.0
2007021002,5,3600,0.0,35,35,3,3,0,100.0
2007021002,14,3530,0.0,22,21,1,0,1,95.45454545
2007021003,16,3600,0.0,30,28,8,0,2,93.33333333
2007021003,30,3547,0.0,33,30,6,1,3,90.90909091
2007021004,26,3528,0.0,31,28,7,0,3,90.32258065
2007021004,19,3596,0.0,32,30,2,1,2,93.75
2007021005,23,3529,0.0,31,29,7,2,2,93.5483871
2007021005,21,3578,2.0,27,26,2,1,1,96.2962963
2007021006,29,3538,0.0,19,18,2,0,1,94.73684211
2007021006,20,3595,0.0,39,39,8,3,0,100.0
2007021007,18,3598,0.0,30,29,3,1,1,96.66666667
2007021007,22,2400,0.0,12,10,2,1,2,83.33333333
2007021007,22,1195,0.0,12,9,0,0,3,75.0
2007021008,15,3600,0.0,26,25,3,0,1,96.15384615
2007021008,7,3521,0.0,23,20,0,1,3,86.95652174
2007021009,12,3600,0.0,24,21,0,0,3,87.5
2007021009,11,1574,0.0,15,13,0,0,2,86.66666667
2007021009,11,2019,0.0,22,18,3,0,4,81.81818182
2007021010,19,3539,0.0,31,28,2,5,3,90.32258065
2007021010,17,3598,0.0,19,18,3,0,1,94.73684211
2007021011,24,3451,0.0,27,25,12,1,2,92.59259259
2007021011,16,3597,0.0,19,19,5,2,0,100.0
2007021012,27,3600,0.0,21,20,4,2,1,95.23809524
2007021012,25,3529,0.0,16,14,1,3,2,87.5
2007021013,9,3777,0.0,30,27,6,0,3,90.0
2007021013,28,3785,0.0,19,17,7,1,2,89.47368421
2007021014,10,3567,0.0,29,27,9,1,2,93.10344828
2007021014,6,1910,0.0,23,18,8,0,5,78.26086957
2007021014,6,1690,0.0,17,14,6,0,3,82.35294118
2007021015,3,3591,0.0,27,26,3,2,1,96.2962963
2007021015,2,3570,0.0,27,24,8,1,3,88.88888889
2007021016,14,3518,0.0,25,22,7,0,3,88.0
2007021016,4,3598,0.0,20,18,0,1,2,90.0
2007021017,30,3584,0.0,28,25,3,2,3,89.28571429
2007021017,12,3600,0.0,28,26,7,1,2,92.85714286
2007021018,5,1200,0.0,19,16,2,0,3,84.21052632
2007021018,5,2391,0.0,22,21,1,3,1,95.45454545
2007021018,13,3600,0.0,27,25,7,1,2,92.59259259
2007021019,24,3536,0.0,30,29,9,0,1,96.66666667
2007021019,21,3600,0.0,27,27,6,0,0,100.0
2007021020,8,3600,0.0,39,37,5,1,2,94.87179487
2007021020,27,3558,0.0,20,16,4,1,4,80.0
2007021021,18,3231,0.0,33,30,9,0,3,90.90909091
2007021021,18,369,0.0,11,8,6,1,3,72.72727273
2007021021,23,3546,0.0,23,21,3,2,2,91.30434783
2007021022,9,3475,0.0,31,30,7,1,1,96.77419355
2007021022,26,3600,0.0,40,40,1,1,0,100.0
2007021023,14,3842,0.0,33,31,10,0,2,93.93939394
2007021023,1,3842,0.0,22,21,3,1,1,95.45454545
2007021024,22,3713,0.0,31,30,4,1,1,96.77419355
2007021024,29,3654,0.0,17,15,2,1,2,88.23529412
2007021025,30,3899,0.0,26,24,6,1,2,92.30769231
2007021025,11,3872,10.0,39,37,11,0,2,94.87179487
2007021026,28,3593,0.0,19,17,2,0,2,89.47368421
2007021026,16,3547,0.0,23,20,3,0,3,86.95652174
2007021027,18,3732,0.0,30,29,10,1,1,96.66666667
2007021027,20,3720,0.0,36,34,7,2,2,94.44444444
2007021028,15,3586,0.0,28,26,12,0,2,92.85714286
2007021028,6,3600,0.0,24,23,4,3,1,95.83333333
2007021029,8,3600,0.0,37,35,6,0,2,94.59459459
2007021029,26,3563,0.0,22,18,1,0,4,81.81818182
2007021030,1,3598,0.0,43,42,7,1,1,97.6744186
2007021030,10,3543,0.0,31,29,4,1,2,93.5483871
2007021031,2,3600,2.0,27,23,7,0,4,85.18518519
2007021031,4,3600,0.0,33,32,7,1,1,96.96969697
2007021032,7,3770,0.0,35,31,8,0,4,88.57142857
2007021032,12,3768,0.0,30,27,5,1,3,90.0
2007021033,11,3877,0.0,43,40,11,2,3,93.02325581
2007021033,13,3876,0.0,27,25,7,0,2,92.59259259
2007021034,25,3542,0.0,27,25,3,1,2,92.59259259
2007021034,21,3565,0.0,26,25,2,1,1,96.15384615
2007021035,9,3571,0.0,35,33,5,4,2,94.28571429
2007021035,27,3595,0.0,32,28,3,5,4,87.5
2007021036,19,3478,0.0,28,25,7,0,3,89.28571429
2007021036,23,3584,0.0,25,23,3,0,2,92.0
2007021037,6,3900,0.0,35,35,4,0,0,100.0
2007021037,3,3900,0.0,29,29,4,0,0,100.0
2007021038,5,3581,0.0,38,36,12,2,2,94.73684211
2007021038,15,3591,0.0,25,22,5,0,3,88.0
2007021039,18,3506,0.0,33,29,11,2,4,87.87878788
2007021039,17,3598,2.0,23,20,3,1,3,86.95652174
2007021040,14,3570,2.0,24,20,1,3,4,83.33333333
2007021040,29,3597,0.0,27,24,7,0,3,88.88888889
2007021041,22,3775,0.0,38,33,7,1,5,86.84210526
2007021041,16,3781,0.0,25,19,2,4,6,76.0
2007021042,28,3900,0.0,23,21,2,1,2,91.30434783
2007021042,30,3862,0.0,26,24,0,0,2,92.30769231
2007021043,21,2400,0.0,21,18,6,0,3,85.71428571
2007021043,21,1200,0.0,5,5,0,0,0,100.0
2007021043,25,3592,0.0,19,19,5,0,0,100.0
2007021044,8,3600,0.0,37,34,13,1,3,91.89189189
2007021044,24,3575,0.0,21,20,3,1,1,95.23809524
2007021045,3,3900,0.0,21,19,6,0,2,90.47619048
2007021045,7,3900,0.0,26,24,3,0,2,92.30769231
2007021046,19,1198,0.0,11,8,3,0,3,72.72727273
2007021046,19,2376,0.0,18,15,4,1,3,83.33333333
2007021046,20,3597,2.0,32,29,4,2,3,90.625
2007021047,23,3634,0.0,18,17,2,1,1,94.44444444
2007021047,26,3646,2.0,40,38,9,0,2,95.0
2007021048,21,3593,0.0,24,22,4,0,2,91.66666667
2007021048,11,2399,0.0,23,18,1,0,5,78.26086957
2007021048,11,1200,0.0,6,6,0,0,0,100.0
2007021049,4,3844,0.0,55,51,14,1,4,92.72727273
2007021049,10,3772,0.0,25,22,2,1,3,88.0
2007021050,1,3594,0.0,33,29,5,0,4,87.87878788
2007021050,8,3600,0.0,38,38,8,0,0,100.0
2007021051,6,3565,0.0,24,21,3,2,3,87.5
2007021051,9,3600,0.0,29,28,5,2,1,96.55172414
2007021052,2,3596,0.0,44,36,8,0,8,81.81818182
2007021052,14,3600,0.0,24,20,2,0,4,83.33333333
2007021053,16,3564,0.0,46,44,8,0,2,95.65217391
2007021053,17,3600,0.0,20,19,1,0,1,95.0
2007021054,28,3600,0.0,27,26,7,1,1,96.2962963
2007021054,18,3484,0.0,42,40,9,0,2,95.23809524
2007021055,19,3895,0.0,24,20,3,0,4,83.33333333
2007021055,22,3889,0.0,31,28,2,0,3,90.32258065
2007021056,24,3900,0.0,39,37,5,0,2,94.87179487
2007021056,27,3890,2.0,37,35,5,0,2,94.59459459
2007021057,10,3588,0.0,20,18,3,0,2,90.0
2007021057,4,3560,0.0,31,28,5,0,3,90.32258065
2007021058,20,3537,2.0,34,31,12,0,3,91.17647059
2007021058,15,3600,0.0,26,24,4,1,2,92.30769231
2007021059,7,2999,0.0,32,26,5,0,6,81.25
2007021059,7,597,0.0,4,3,0,0,1,75.0
2007021059,5,3600,0.0,32,29,3,1,3,90.625
2007021060,2,3575,0.0,31,28,3,0,3,90.32258065
2007021060,13,3600,0.0,29,27,0,0,2,93.10344828
2007021061,12,3591,0.0,25,25,1,1,0,100.0
2007021061,16,3600,0.0,32,29,6,1,3,90.625
2007021062,23,2146,0.0,12,12,2,1,0,100.0
2007021062,23,1425,0.0,19,15,5,0,4,78.94736842
2007021062,24,3595,0.0,31,30,10,0,1,96.77419355
2007021063,14,3600,0.0,36,35,7,0,1,97.22222222
2007021063,6,3555,0.0,25,23,0,0,2,92.0
2007021064,20,3592,0.0,31,26,2,0,5,83.87096774
2007021064,11,3600,0.0,32,28,0,0,4,87.5
2007021065,9,3579,0.0,28,28,7,1,0,100.0
2007021065,8,3596,0.0,24,21,1,2,3,87.5
2007021066,25,3530,0.0,30,26,6,0,4,86.66666667
2007021066,17,3600,0.0,19,16,3,1,3,84.21052632
2007021067,26,3581,0.0,38,37,9,0,1,97.36842105
2007021067,18,3520,0.0,29,26,2,0,3,89.65517241
2007021068,1,3884,0.0,37,34,5,1,3,91.89189189
2007021068,30,3900,0.0,30,27,3,0,3,90.0
2007021069,22,2095,0.0,18,16,5,1,2,88.88888889
2007021069,22,1495,0.0,14,11,0,0,3,78.57142857
2007021069,21,3599,0.0,24,23,7,0,1,95.83333333
2007021070,23,3600,0.0,45,43,6,1,2,95.55555556
2007021070,27,3599,0.0,24,24,5,0,0,100.0
2007021071,11,3600,0.0,37,33,2,1,4,89.18918919
2007021071,15,3597,0.0,12,11,0,0,1,91.66666667
2007021072,16,3599,0.0,32,29,9,1,3,90.625
2007021072,29,792,0.0,6,3,0,1,3,50.0
2007021072,29,2808,0.0,19,16,1,1,3,84.21052632
2007021073,12,819,0.0,7,3,0,0,4,42.85714286
2007021073,12,2774,2.0,24,21,10,0,3,87.5
2007021073,7,3600,0.0,28,27,2,6,1,96.42857143
2007021074,3,3510,0.0,30,27,3,2,3,90.0
2007021074,13,3596,0.0,34,32,6,0,2,94.11764706
2007021075,19,3600,0.0,27,23,9,0,4,85.18518519
2007021075,28,3600,0.0,21,20,4,0,1,95.23809524
2007021076,4,3737,0.0,36,33,5,0,3,91.66666667
2007021076,6,3707,0.0,26,24,3,2,2,92.30769231
2007021077,18,3600,0.0,35,34,8,0,1,97.14285714
2007021077,17,3549,0.0,26,24,4,1,2,92.30769231
2007021078,1,3600,0.0,26,24,8,1,2,92.30769231
2007021078,21,3551,0.0,27,23,2,1,4,85.18518519
2007021079,7,3600,0.0,32,30,4,0,2,93.75
2007021079,10,3456,0.0,19,14,1,1,5,73.68421053
2007021080,2,3600,0.0,29,26,1,0,3,89.65517241
2007021080,8,3591,0.0,30,30,1,1,0,100.0
2007021081,3,3575,0.0,29,27,11,1,2,93.10344828
2007021081,14,3592,0.0,20,20,1,1,0,100.0
2007021082,26,3473,0.0,29,27,7,1,2,93.10344828
2007021082,30,3589,0.0,24,24,3,1,0,100.0
2007021083,23,3600,0.0,38,35,4,0,3,92.10526316
2007021083,25,1200,0.0,12,9,2,0,3,75.0
2007021083,25,2338,2.0,18,17,0,0,1,94.44444444
2007021084,22,3600,0.0,40,38,6,1,2,95.0
2007021084,27,3579,0.0,36,32,4,0,4,88.88888889
2007021085,19,3600,0.0,33,28,3,0,5,84.84848485
2007021085,24,3591,0.0,40,38,2,2,2,95.0
2007021086,4,2145,0.0,28,24,6,0,4,85.71428571
2007021086,4,1455,0.0,8,5,0,0,3,62.5
2007021086,5,3600,0.0,25,24,5,2,1,96.0
2007021087,6,3900,0.0,33,32,4,3,1,96.96969697
2007021087,15,3898,0.0,40,39,8,0,1,97.5
2007021088,9,3585,0.0,32,27,11,2,5,84.375
2007021088,12,3595,0.0,17,16,4,2,1,94.11764706
2007021089,17,1613,0.0,7,7,0,0,0,100.0
2007021089,17,1914,0.0,10,6,1,1,4,60.0
2007021089,29,3600,0.0,46,43,8,0,3,93.47826087
2007021090,20,3599,0.0,36,34,15,0,2,94.44444444
2007021090,16,1021,0.0,5,5,0,1,0,100.0
2007021090,16,2376,0.0,22,18,1,0,4,81.81818182
2007021091,11,3517,0.0,25,22,3,0,3,88.0
2007021091,13,3598,0.0,30,29,5,0,1,96.66666667
2007021092,22,3900,2.0,49,48,10,0,1,97.95918367
2007021092,28,3890,0.0,23,22,1,1,1,95.65217391
2007021093,21,3515,0.0,28,26,5,2,2,92.85714286
2007021093,30,3597,0.0,30,29,8,1,1,96.66666667
2007021094,27,3470,0.0,28,25,7,3,3,89.28571429
2007021094,23,3600,0.0,26,25,7,0,1,96.15384615
2007021095,10,3587,0.0,28,27,6,1,1,96.42857143
2007021095,2,3558,0.0,25,23,6,2,2,92.0
2007021096,5,3600,0.0,30,25,2,0,5,83.33333333
2007021096,3,3600,0.0,24,22,2,0,2,91.66666667
2007021097,11,183,0.0,0,0,0,0,0,
2007021097,11,3380,0.0,47,44,4,3,3,93.61702128
2007021097,4,3599,0.0,19,17,1,2,2,89.47368421
2007021098,20,3600,0.0,38,35,5,0,3,92.10526316
2007021098,29,3600,0.0,18,18,1,0,0,100.0
2007021099,19,3900,0.0,30,27,10,1,3,90.0
2007021099,8,3890,0.0,28,25,3,1,3,89.28571429
2007021100,15,3600,0.0,26,24,3,0,2,92.30769231
2007021100,18,2604,0.0,12,12,0,1,0,100.0
2007021100,18,880,0.0,8,5,3,0,3,62.5
2007021101,27,1200,0.0,11,8,4,0,3,72.72727273
2007021101,27,2365,0.0,24,20,1,0,4,83.33333333
2007021101,22,3600,0.0,34,30,6,1,4,88.23529412
2007021102,28,3599,0.0,30,29,6,0,1,96.66666667
2007021102,26,3528,0.0,23,21,1,0,2,91.30434783
2007021103,14,3497,0.0,31,25,3,0,6,80.64516129
2007021103,7,3600,0.0,19,15,2,2,4,78.94736842
2007021104,3,3900,0.0,18,17,2,1,1,94.44444444
2007021104,1,3900,0.0,21,20,6,0,1,95.23809524
2007021105,12,3584,0.0,34,31,4,0,3,91.17647059
2007021105,11,3569,0.0,33,28,2,0,5,84.84848485
2007021106,29,3585,0.0,27,24,10,3,3,88.88888889
2007021106,17,3600,0.0,23,22,11,1,1,95.65217391
2007021107,15,3600,0.0,42,37,8,0,5,88.0952381
2007021107,16,3592,0.0,25,25,3,2,0,100.0
2007021108,24,3595,2.0,21,20,2,1,1,95.23809524
2007021108,25,3581,0.0,17,15,2,1,2,88.23529412
2007021109,30,3867,0.0,33,30,4,1,3,90.90909091
2007021109,28,3832,0.0,24,21,1,1,3,87.5
2007021110,8,3600,0.0,36,34,5,0,2,94.44444444
2007021110,6,3528,0.0,30,26,6,2,4,86.66666667
2007021111,19,3550,0.0,24,21,6,0,3,87.5
2007021111,9,3599,0.0,26,24,2,2,2,92.30769231
2007021112,14,3532,0.0,23,19,0,1,4,82.60869565
2007021112,5,3600,0.0,21,19,4,2,2,90.47619048
2007021113,12,3900,0.0,37,36,12,4,1,97.2972973
2007021113,13,3877,0.0,42,41,1,2,1,97.61904762
2007021114,17,3600,0.0,29,26,4,0,3,89.65517241
2007021114,18,2105,0.0,22,19,7,1,3,86.36363636
2007021114,18,1451,0.0,13,11,2,1,2,84.61538462
2007021115,21,3553,0.0,28,26,3,1,2,92.85714286
2007021115,20,3600,0.0,16,15,0,2,1,93.75
2007021116,23,3600,0.0,34,33,10,0,1,97.05882353
2007021116,22,3600,0.0,21,17,1,3,4,80.95238095
2007021117,26,3886,0.0,40,35,7,2,5,87.5
2007021117,27,3811,0.0,36,31,12,0,5,86.11111111
2007021118,2,3600,0.0,35,34,8,2,1,97.14285714
2007021118,1,142,0.0,1,1,1,0,0,100.0
2007021118,1,3376,0.0,14,12,2,1,2,85.71428571
2007021119,3,3900,0.0,30,27,4,2,3,90.0
2007021119,4,3900,0.0,26,23,5,0,3,88.46153846
2007021120,10,3600,0.0,36,35,8,2,1,97.22222222
2007021120,7,3554,0.0,24,20,5,0,4,83.33333333
2007021121,15,3600,0.0,18,15,1,0,3,83.33333333
2007021121,11,3542,0.0,44,40,3,0,4,90.90909091
2007021122,30,3600,0.0,31,30,2,0,1,96.77419355
2007021122,23,3536,0.0,21,19,8,1,2,90.47619048
2007021123,24,3554,0.0,43,41,10,0,2,95.34883721
2007021123,28,3589,0.0,13,12,5,0,1,92.30769231
2007021124,16,3900,0.0,34,33,5,0,1,97.05882353
2007021124,18,3900,0.0,38,37,0,0,1,97.36842105
2007021125,26,3566,0.0,27,25,0,0,2,92.59259259
2007021125,25,3540,0.0,30,26,6,0,4,86.66666667
2007021126,21,869,0.0,8,5,0,0,3,62.5
2007021126,21,2712,0.0,20,17,7,0,3,85.0
2007021126,22,3600,0.0,34,29,2,0,5,85.29411765
2007021127,6,3892,0.0,31,29,3,1,2,93.5483871
2007021127,8,3895,0.0,35,33,6,1,2,94.28571429
2007021128,10,3600,0.0,36,32,6,1,4,88.88888889
2007021128,9,3510,0.0,34,29,6,1,5,85.29411765
2007021129,14,3540,0.0,25,22,1,1,3,88.0
2007021129,13,3600,0.0,37,35,7,0,2,94.59459459
2007021130,17,3588,0.0,12,11,1,0,1,91.66666667
2007021130,29,3593,0.0,21,17,3,3,4,80.95238095
2007021131,1,827,0.0,9,6,4,0,3,66.66666667
2007021131,1,2773,0.0,19,15,3,0,4,78.94736842
2007021131,5,3600,0.0,25,24,4,1,1,96.0
2007021132,30,3545,0.0,31,26,5,2,5,83.87096774
2007021132,20,3585,0.0,33,29,3,2,4,87.87878788
2007021133,24,3600,0.0,31,30,11,1,1,96.77419355
2007021133,27,3576,0.0,15,13,2,0,2,86.66666667
2007021134,19,3648,0.0,31,27,8,0,4,87.09677419
2007021134,16,3654,0.0,29,26,0,3,3,89.65517241
2007021135,2,3596,0.0,26,22,6,2,4,84.61538462
2007021135,4,3600,0.0,33,32,8,2,1,96.96969697
2007021136,5,3600,0.0,36,32,12,2,4,88.88888889
2007021136,2,3600,0.0,29,28,12,2,1,96.55172414
2007021137,9,1200,0.0,14,11,2,0,3,78.57142857
2007021137,9,2350,0.0,18,14,6,0,4,77.77777778
2007021137,8,3597,0.0,36,31,12,1,5,86.11111111
2007021138,20,405,0.0,2,2,0,0,0,100.0
2007021138,20,3117,0.0,23,21,7,1,2,91.30434783
2007021138,21,3597,0.0,23,23,4,2,0,100.0
2007021139,30,2079,0.0,23,21,4,0,2,91.30434783
2007021139,30,1470,0.0,10,7,0,0,3,70.0
2007021139,22,3600,0.0,34,31,6,0,3,91.17647059
2007021140,9,3581,0.0,32,29,5,0,3,90.625
2007021140,7,3525,0.0,30,25,2,2,5,83.33333333
2007021141,5,3600,0.0,31,31,3,2,0,100.0
2007021141,1,3551,0.0,19,18,2,0,1,94.73684211
2007021142,4,3736,0.0,32,31,5,0,1,96.875
2007021142,3,3722,0.0,25,23,0,1,2,92.0
2007021143,15,3900,0.0,27,25,4,3,2,92.59259259
2007021143,12,3900,0.0,44,42,8,0,2,95.45454545
2007021144,6,3600,0.0,30,28,0,0,2,93.33333333
2007021144,10,3408,0.0,29,24,5,0,5,82.75862069
2007021145,13,3550,0.0,25,23,3,1,2,92.0
2007021145,14,3600,0.0,35,34,6,1,1,97.14285714
2007021146,29,789,0.0,5,5,0,0,0,100.0
2007021146,29,2802,0.0,19,16,5,1,3,84.21052632
2007021146,18,3600,0.0,36,36,11,0,0,100.0
2007021147,17,3600,0.0,18,17,3,2,1,94.44444444
2007021147,19,3540,0.0,32,30,4,1,2,93.75
2007021148,23,3505,0.0,40,37,9,1,3,92.5
2007021148,20,3595,0.0,34,32,11,0,2,94.11764706
2007021149,28,1158,0.0,10,9,0,0,1,90.0
2007021149,28,2638,0.0,26,22,6,2,4,84.61538462
2007021149,27,3803,0.0,34,30,0,0,4,88.23529412
2007021150,16,3596,0.0,36,32,9,0,4,88.88888889
2007021150,29,3597,0.0,17,17,0,1,0,100.0
2007021151,22,3481,0.0,21,18,2,2,3,85.71428571
2007021151,30,3600,0.0,33,32,3,0,1,96.96969697
2007021152,23,1697,0.0,14,13,0,1,1,92.85714286
2007021152,23,1891,0.0,23,18,3,0,5,78.26086957
2007021152,21,3598,0.0,31,28,6,0,3,90.32258065
2007021153,26,3862,0.0,40,39,9,0,1,97.5
2007021153,24,3878,0.0,32,31,7,2,1,96.875
2007021154,10,3490,0.0,34,30,3,1,4,88.23529412
2007021154,6,3600,0.0,32,30,1,1,2,93.75
2007021155,1,3513,0.0,31,28,1,0,3,90.32258065
2007021155,3,3588,0.0,34,32,2,0,2,94.11764706
2007021156,7,3886,0.0,28,25,4,3,3,89.28571429
2007021156,9,3900,0.0,40,37,5,1,3,92.5
2007021157,2,3530,0.0,29,26,4,0,3,89.65517241
2007021157,5,3587,0.0,28,27,4,2,1,96.42857143
2007021158,15,3730,0.0,26,23,2,0,3,88.46153846
2007021158,14,3747,0.0,32,28,0,0,4,87.5
2007021159,11,3591,0.0,45,43,12,1,2,95.55555556
2007021159,13,3585,0.0,27,25,5,0,2,92.59259259
2007021160,27,3600,0.0,33,29,1,1,4,87.87878788
2007021160,26,3588,0.0,38,38,6,0,0,100.0
2007021161,25,3776,4.0,27,24,6,1,3,88.88888889
2007021161,28,3767,0.0,25,23,6,3,2,92.0
2007021162,4,3900,0.0,33,29,5,4,4,87.87878788
2007021162,1,3900,2.0,32,28,8,0,4,87.5
2007021163,11,3579,0.0,35,28,6,5,7,80.0
2007021163,12,3600,0.0,26,25,11,1,1,96.15384615
2007021164,18,3600,0.0,43,43,4,1,0,100.0
2007021164,29,3520,0.0,25,23,5,0,2,92.0
2007021165,8,3764,0.0,38,35,9,1,3,92.10526316
2007021165,7,3818,0.0,29,25,2,2,4,86.20689655
2007021166,19,3761,0.0,39,36,8,1,3,92.30769231
2007021166,17,3730,0.0,21,17,2,0,4,80.95238095
2007021167,23,1592,0.0,9,9,3,0,0,100.0
2007021167,23,2008,0.0,21,17,6,2,4,80.95238095
2007021167,30,3600,0.0,28,28,5,0,0,100.0
2007021168,22,3900,0.0,36,32,4,0,4,88.88888889
2007021168,21,3829,0.0,31,27,1,1,4,87.09677419
2007021169,28,3597,0.0,24,23,1,1,1,95.83333333
2007021169,24,3492,0.0,27,24,5,0,3,88.88888889
2007021170,9,3600,0.0,31,27,8,0,4,87.09677419
2007021170,6,3593,0.0,34,34,3,0,0,100.0
2007021171,25,3600,0.0,14,12,1,0,2,85.71428571
2007021171,26,1200,0.0,10,8,0,0,2,80.0
2007021171,26,2400,0.0,25,20,6,0,5,80.0
2007021172,8,3600,0.0,37,33,10,1,4,89.18918919
2007021172,10,3600,0.0,24,22,4,4,2,91.66666667
2007021173,4,3900,0.0,30,27,3,0,3,90.0
2007021173,2,3889,0.0,54,51,2,7,3,94.44444444
2007021174,15,3595,0.0,32,32,11,2,0,100.0
2007021174,13,3593,0.0,33,30,6,2,3,90.90909091
2007021175,12,3512,0.0,21,19,3,1,2,90.47619048
2007021175,14,3599,0.0,39,38,7,0,1,97.43589744
2007021176,16,3600,0.0,34,31,3,0,3,91.17647059
2007021176,19,3528,0.0,19,15,2,0,4,78.94736842
2007021177,22,3596,0.0,32,31,4,0,1,96.875
2007021177,20,3544,0.0,21,19,1,0,2,90.47619048
2007021178,6,3634,0.0,30,28,4,0,2,93.33333333
2007021178,7,3632,0.0,18,17,4,3,1,94.44444444
2007021179,3,3600,0.0,20,17,5,1,3,85.0
2007021179,5,3593,0.0,27,26,8,1,1,96.2962963
2007021180,18,3801,0.0,36,35,10,4,1,97.22222222
2007021180,17,3780,0.0,22,22,3,3,0,100.0
2007021181,21,3750,0.0,20,17,3,0,3,85.0
2007021181,30,3781,0.0,26,24,1,0,2,92.30769231
2007021182,29,3887,0.0,33,29,10,1,4,87.87878788
2007021182,16,3900,0.0,35,31,4,0,4,88.57142857
2007021183,25,3867,0.0,32,30,8,2,2,93.75
2007021183,24,3897,0.0,25,23,7,0,2,92.0
2007021184,27,3545,0.0,32,29,2,0,3,90.625
2007021184,28,3600,0.0,20,19,1,1,1,95.0
2007021185,20,1991,0.0,20,18,8,2,2,90.0
2007021185,20,1606,0.0,13,9,0,0,4,69.23076923
2007021185,23,3592,0.0,29,27,5,5,2,93.10344828
2007021186,5,3689,0.0,27,25,0,0,2,92.59259259
2007021186,3,3706,0.0,22,21,4,0,1,95.45454545
2007021187,11,3600,0.0,36,36,9,1,0,100.0
2007021187,14,3560,0.0,23,22,2,5,1,95.65217391
2007021188,1,3629,0.0,22,21,3,0,1,95.45454545
2007021188,2,3629,0.0,47,45,7,3,2,95.74468085
2007021189,12,3600,0.0,39,35,10,0,4,89.74358974
2007021189,15,3600,0.0,22,21,2,1,1,95.45454545
2007021190,13,3588,0.0,33,31,5,3,2,93.93939394
2007021190,11,3528,0.0,33,30,4,0,3,90.90909091
2007021191,7,3900,0.0,22,19,0,0,3,86.36363636
2007021191,10,3900,0.0,41,38,2,0,3,92.68292683
2007021192,8,3599,0.0,32,32,8,0,0,100.0
2007021192,9,3574,0.0,27,24,4,5,3,88.88888889
2007021193,18,3297,0.0,10,10,0,0,0,100.0
2007021193,18,406,0.0,7,4,0,0,3,57.14285714
2007021193,19,1200,0.0,8,8,0,0,0,100.0
2007021193,19,2503,0.0,18,14,1,0,4,77.77777778
2007021194,20,3592,0.0,30,28,3,0,2,93.33333333
2007021194,22,3546,0.0,17,14,3,0,3,82.35294118
2007021195,21,3597,0.0,29,27,7,0,2,93.10344828
2007021195,23,3470,0.0,20,16,4,2,4,80.0
2007021196,26,3600,0.0,34,29,9,0,5,85.29411765
2007021196,28,3598,0.0,18,16,3,1,2,88.88888889
2007021197,6,3900,0.0,25,23,3,0,2,92.0
2007021197,1,3900,0.0,27,25,7,0,2,92.59259259
2007021198,14,3600,2.0,32,26,6,0,6,81.25
2007021198,12,3600,0.0,25,23,3,1,2,92.0
2007021199,4,3519,0.0,29,25,2,0,4,86.20689655
2007021199,5,3600,0.0,29,27,4,3,2,93.10344828
2007021200,17,3120,0.0,22,19,8,0,3,86.36363636
2007021200,17,472,0.0,6,3,1,0,3,50.0
2007021200,16,3596,0.0,28,26,10,3,2,92.85714286
2007021201,3,3600,0.0,25,25,1,2,0,100.0
2007021201,2,3574,0.0,35,32,10,0,3,91.42857143
2007021202,14,3571,0.0,39,36,6,3,3,92.30769231
2007021202,15,3600,0.0,19,18,4,2,1,94.73684211
2007021203,9,3596,0.0,28,26,9,1,2,92.85714286
2007021203,10,3600,0.0,37,29,9,2,8,78.37837838
2007021204,7,3486,0.0,25,22,2,2,3,88.0
2007021204,8,3600,0.0,28,27,5,3,1,96.42857143
2007021205,29,3600,0.0,39,36,7,2,3,92.30769231
2007021205,17,3600,0.0,22,20,4,0,2,90.90909091
2007021206,19,3533,0.0,30,27,2,1,3,90.0
2007021206,18,3600,0.0,29,27,1,0,2,93.10344828
2007021207,20,3537,0.0,26,23,7,0,3,88.46153846
2007021207,30,3600,0.0,27,26,5,1,1,96.2962963
2007021208,22,3570,0.0,38,37,17,1,1,97.36842105
2007021208,23,3539,0.0,21,19,3,2,2,90.47619048
2007021209,25,3599,0.0,23,21,2,0,2,91.30434783
2007021209,27,3554,0.0,35,32,5,0,3,91.42857143
2007021210,28,3522,0.0,26,23,7,0,3,88.46153846
2007021210,26,3600,0.0,34,32,0,2,2,94.11764706
2007021211,2,3900,0.0,51,48,22,2,3,94.11764706
2007021211,3,3899,0.0,32,29,5,2,3,90.625
2007021212,1,487,0.0,1,1,0,0,0,100.0
2007021212,1,3113,0.0,36,33,3,1,3,91.66666667
2007021212,4,3587,0.0,22,22,4,1,0,100.0
2007021213,13,2400,0.0,28,26,7,0,2,92.85714286
2007021213,13,1200,0.0,18,17,1,0,1,94.44444444
2007021213,12,3514,0.0,17,13,0,1,4,76.47058824
2007021214,6,3591,0.0,18,17,3,0,1,94.44444444
2007021214,9,3500,0.0,29,27,3,1,2,93.10344828
2007021215,18,1834,0.0,12,9,0,1,3,75.0
2007021215,18,1764,0.0,8,8,0,0,0,100.0
2007021215,16,3600,0.0,30,29,2,0,1,96.66666667
2007021216,27,3600,0.0,32,30,5,0,2,93.75
2007021216,25,3548,0.0,20,17,1,0,3,85.0
2007021217,29,3600,0.0,25,22,2,0,3,88.0
2007021217,19,3600,0.0,25,25,3,0,0,100.0
2007021218,24,3600,0.0,31,28,4,0,3,90.32258065
2007021218,26,3529,0.0,26,22,2,0,4,84.61538462
2007021219,7,3600,0.0,17,17,1,0,0,100.0
2007021219,6,3583,0.0,27,25,4,2,2,92.59259259
2007021220,10,3600,0.0,36,33,13,0,3,91.66666667
2007021220,8,3590,0.0,27,26,4,1,1,96.2962963
2007021221,13,3600,0.0,38,35,8,1,3,92.10526316
2007021221,15,3598,0.0,26,25,3,1,1,96.15384615
2007021222,14,3548,0.0,23,20,5,0,3,86.95652174
2007021222,11,3600,0.0,31,30,5,0,1,96.77419355
2007021223,20,3600,0.0,28,27,3,1,1,96.42857143
2007021223,23,2400,0.0,19,15,0,1,4,78.94736842
2007021223,23,1196,0.0,9,6,0,0,3,66.66666667
2007021224,3,3836,0.0,27,25,6,0,2,92.59259259
2007021224,1,3900,0.0,19,17,2,0,2,89.47368421
2007021225,5,3561,0.0,21,20,4,4,1,95.23809524
2007021225,4,3600,2.0,20,20,7,1,0,100.0
2007021226,16,3600,0.0,38,34,4,1,4,89.47368421
2007021226,17,3588,0.0,28,27,3,0,1,96.42857143
2007021227,19,3600,0.0,36,35,7,2,1,97.22222222
2007021227,29,3555,0.0,18,15,4,0,3,83.33333333
2007021228,30,3900,0.0,36,33,3,0,3,91.66666667
2007021228,21,3900,0.0,37,34,6,1,3,91.89189189
2007021229,28,2347,0.0,15,11,3,1,4,73.33333333
2007021229,28,1200,0.0,7,7,5,0,0,100.0
2007021229,25,3588,0.0,34,32,9,3,2,94.11764706
2007021230,27,3900,0.0,43,41,0,0,2,95.34883721
2007021230,24,3900,0.0,34,32,3,0,2,94.11764706
2008020001,3,3600,0.0,21,20,8,1,1,95.23809524
2008020001,14,3570,0.0,41,39,11,1,2,95.12195122
2008020002,5,3874,0.0,35,32,5,2,3,91.42857143
2008020002,9,3875,0.0,30,26,9,0,4,86.66666667
2008020003,14,3551,0.0,39,37,5,3,2,94.87179487
2008020003,3,3600,0.0,19,18,4,1,1,94.73684211
2008020004,9,3589,0.0,31,30,8,1,1,96.77419355
2008020004,5,3571,0.0,27,24,8,3,3,88.88888889
2008020005,10,3600,0.0,37,35,4,1,2,94.59459459
2008020005,17,3550,0.0,29,26,3,0,3,89.65517241
2008020006,6,3581,0.0,39,35,7,0,4,89.74358974
2008020006,21,3551,0.0,20,15,1,1,5,75.0
2008020007,20,3598,0.0,23,17,9,2,6,73.91304348
2008020007,23,3600,0.0,25,25,7,3,0,100.0
2008020008,24,3597,0.0,41,37,15,0,4,90.24390244
2008020008,28,3600,0.0,29,28,5,1,1,96.55172414
2008020009,2,3575,2.0,29,27,3,0,2,93.10344828
2008020009,1,3589,0.0,26,25,5,1,1,96.15384615
2008020010,16,3574,0.0,29,25,5,2,4,86.20689655
2008020010,3,3600,0.0,32,30,2,2,2,93.75
2008020011,13,3567,0.0,23,18,1,1,5,78.26086957
2008020011,12,3583,0.0,33,29,5,2,4,87.87878788
2008020012,8,3900,0.0,36,35,8,1,1,97.22222222
2008020012,7,3888,0.0,28,27,3,0,1,96.42857143
2008020013,15,1830,0.0,14,11,3,0,3,78.57142857
2008020013,15,1770,0.0,17,13,5,0,4,76.47058824
2008020013,11,3600,2.0,43,39,10,4,4,90.69767442
2008020014,18,3598,0.0,22,17,3,0,5,77.27272727
2008020014,19,3600,0.0,22,20,0,0,2,90.90909091
2008020015,29,3875,0.0,31,27,14,1,4,87.09677419
2008020015,25,3872,0.0,27,22,3,1,5,81.48148148
2008020016,8,3597,0.0,25,24,4,1,1,96.0
2008020016,10,1200,0.0,11,11,3,1,0,100.0
2008020016,10,2400,0.0,23,17,8,0,6,73.91304348
2008020017,17,3600,0.0,22,20,4,2,2,90.90909091
2008020017,9,3532,0.0,41,38,5,1,3,92.68292683
2008020018,19,3563,0.0,33,29,2,2,4,87.87878788
2008020018,2,3600,0.0,26,24,5,0,2,92.30769231
2008020019,3,3600,0.0,28,25,5,1,3,89.28571429
2008020019,4,2590,0.0,13,13,5,1,0,100.0
2008020019,4,973,0.0,14,10,1,0,4,71.42857143
2008020020,16,3527,0.0,34,30,8,1,4,88.23529412
2008020020,15,3600,0.0,21,19,5,0,2,90.47619048
2008020021,11,217,0.0,1,1,0,1,0,100.0
2008020021,11,3609,0.0,38,35,7,1,3,92.10526316
2008020021,13,3833,0.0,33,31,10,0,2,93.93939394
2008020022,1,3858,0.0,15,14,2,0,1,93.33333333
2008020022,5,3862,0.0,49,47,13,1,2,95.91836735
2008020023,12,3872,2.0,29,26,7,1,3,89.65517241
2008020023,14,3851,0.0,46,42,8,2,4,91.30434783
2008020024,25,3487,0.0,32,29,8,1,3,90.625
2008020024,18,3569,0.0,20,19,4,0,1,95.0
2008020025,6,3556,0.0,26,22,3,0,4,84.61538462
2008020025,30,3600,0.0,37,34,7,1,3,91.89189189
2008020026,23,3834,2.0,29,25,4,0,4,86.20689655
2008020026,20,3828,0.0,34,29,8,0,5,85.29411765
2008020027,29,3444,0.0,30,27,4,1,3,90.0
2008020027,27,3600,0.0,29,28,4,1,1,96.55172414
2008020028,26,3600,0.0,41,38,10,0,3,92.68292683
2008020028,28,3592,0.0,13,12,3,1,1,92.30769231
2008020029,21,3582,0.0,19,16,2,1,3,84.21052632
2008020029,22,3600,0.0,33,31,9,0,2,93.93939394
2008020030,27,3599,2.0,35,33,7,1,2,94.28571429
2008020030,24,3557,0.0,24,20,6,0,4,83.33333333
2008020031,28,3599,0.0,21,21,6,2,0,100.0
2008020031,26,3531,0.0,19,18,4,0,1,94.73684211
2008020032,19,3900,0.0,39,35,7,0,4,89.74358974
2008020032,10,3900,0.0,26,22,5,0,4,84.61538462
2008020033,7,3600,0.0,24,23,1,3,1,95.83333333
2008020033,2,3600,0.0,35,28,6,1,7,80.0
2008020034,1,3514,0.0,23,20,4,0,3,86.95652174
2008020034,3,3597,0.0,27,26,5,1,1,96.2962963
2008020035,8,3600,0.0,32,29,6,2,3,90.625
2008020035,4,3562,0.0,26,22,5,0,4,84.61538462
2008020036,23,1200,0.0,10,10,0,2,0,100.0
2008020036,23,2400,0.0,25,20,2,1,5,80.0
2008020036,15,3584,0.0,10,9,1,0,1,90.0
2008020037,17,3594,0.0,28,27,4,2,1,96.42857143
2008020037,12,3551,0.0,35,33,8,0,2,94.28571429
2008020038,18,3900,0.0,25,23,4,0,2,92.0
2008020038,16,3894,0.0,27,25,4,2,2,92.59259259
2008020039,4,3882,0.0,28,25,6,1,3,89.28571429
2008020039,5,3880,0.0,30,28,9,0,2,93.33333333
2008020040,30,3600,0.0,26,24,7,0,2,92.30769231
2008020040,11,3475,0.0,26,22,12,0,4,84.61538462
2008020041,21,3553,0.0,35,30,8,0,5,85.71428571
2008020041,20,3600,0.0,29,25,6,0,4,86.20689655
2008020042,24,3538,2.0,22,17,6,0,5,77.27272727
2008020042,26,3560,0.0,26,23,9,0,3,88.46153846
2008020043,29,2897,0.0,24,19,1,2,5,79.16666667
2008020043,29,703,0.0,1,1,0,0,0,100.0
2008020043,28,3600,0.0,33,31,8,1,2,93.93939394
2008020044,7,3592,0.0,20,19,5,0,1,95.0
2008020044,3,3468,0.0,19,16,5,1,3,84.21052632
2008020045,6,3865,0.0,28,25,5,1,3,89.28571429
2008020045,8,3900,0.0,34,31,11,3,3,91.17647059
2008020046,27,3597,0.0,30,26,3,1,4,86.66666667
2008020046,16,3600,0.0,30,29,11,0,1,96.66666667
2008020047,18,3565,0.0,27,22,2,5,5,81.48148148
2008020047,25,3589,0.0,19,15,1,1,4,78.94736842
2008020048,22,3598,0.0,35,33,3,0,2,94.28571429
2008020048,24,3514,0.0,28,25,4,0,3,89.28571429
2008020049,1,3600,0.0,25,25,4,1,0,100.0
2008020049,11,3512,0.0,35,34,3,2,1,97.14285714
2008020050,15,3588,0.0,26,23,7,0,3,88.46153846
2008020050,5,3516,0.0,30,26,3,0,4,86.66666667
2008020051,2,3641,0.0,36,33,8,0,3,91.66666667
2008020051,14,3645,0.0,36,32,14,3,4,88.88888889
2008020052,30,3587,0.0,26,24,5,0,2,92.30769231
2008020052,13,1200,0.0,12,10,4,1,2,83.33333333
2008020052,13,2390,0.0,22,18,4,0,4,81.81818182
2008020053,23,3627,0.0,35,32,3,1,3,91.42857143
2008020053,17,3615,0.0,29,25,2,0,4,86.20689655
2008020054,25,1200,0.0,5,4,0,1,1,80.0
2008020054,25,2400,0.0,18,13,2,1,5,72.22222222
2008020054,19,3600,0.0,30,29,4,0,1,96.66666667
2008020055,4,3600,0.0,34,29,8,1,5,85.29411765
2008020055,21,3582,0.0,18,16,8,1,2,88.88888889
2008020056,27,3600,0.0,26,20,4,0,6,76.92307692
2008020056,9,3600,0.0,37,34,0,1,3,91.89189189
2008020057,10,3894,0.0,32,32,8,1,0,100.0
2008020057,3,3878,0.0,21,21,7,0,0,100.0
2008020058,18,2623,0.0,20,18,4,0,2,90.0
2008020058,18,866,0.0,8,5,0,0,3,62.5
2008020058,29,3286,0.0,27,24,6,0,3,88.88888889
2008020058,29,314,0.0,3,3,0,0,0,100.0
2008020059,23,3589,0.0,31,26,4,0,5,83.87096774
2008020059,7,3598,0.0,25,23,5,0,2,92.0
2008020060,22,3575,0.0,29,26,7,0,3,89.65517241
2008020060,20,3563,0.0,35,31,6,0,4,88.57142857
2008020061,28,3600,0.0,20,16,7,1,4,80.0
2008020061,24,3600,0.0,38,38,13,2,0,100.0
2008020062,12,3801,0.0,24,20,1,2,4,83.33333333
2008020062,26,3801,0.0,26,23,2,2,3,88.46153846
2008020063,21,3600,0.0,30,26,4,0,4,86.66666667
2008020063,25,3512,0.0,22,17,5,0,5,77.27272727
2008020064,27,3550,0.0,33,29,1,1,4,87.87878788
2008020064,8,3600,0.0,29,28,1,1,1,96.55172414
2008020065,6,3600,0.0,23,21,3,0,2,91.30434783
2008020065,9,3546,0.0,27,23,3,3,4,85.18518519
2008020066,10,3600,0.0,25,21,3,1,4,84.0
2008020066,5,3600,0.0,27,26,9,2,1,96.2962963
2008020067,1,3900,0.0,27,24,7,1,3,88.88888889
2008020067,15,3896,0.0,37,34,7,1,3,91.89189189
2008020068,7,3900,0.0,37,35,9,0,2,94.59459459
2008020068,11,3896,0.0,30,28,9,2,2,93.33333333
2008020069,2,3511,0.0,36,34,10,0,2,94.44444444
2008020069,13,3600,0.0,31,31,3,0,0,100.0
2008020070,3,3623,0.0,45,40,4,1,5,88.88888889
2008020070,17,3623,0.0,32,28,4,1,4,87.5
2008020071,30,3900,0.0,32,32,6,0,0,100.0
2008020071,14,3900,0.0,21,21,3,1,0,100.0
2008020072,29,2074,0.0,19,17,6,2,2,89.47368421
2008020072,29,1526,0.0,11,7,1,0,4,63.63636364
2008020072,18,3598,0.0,26,23,3,0,3,88.46153846
2008020073,16,3885,0.0,29,26,6,1,3,89.65517241
2008020073,19,3842,0.0,26,23,4,0,3,88.46153846
2008020074,20,3554,0.0,27,24,3,2,3,88.88888889
2008020074,22,3600,0.0,33,31,9,1,2,93.93939394
2008020075,4,3685,0.0,45,40,14,0,5,88.88888889
2008020075,28,3684,0.0,17,13,0,0,4,76.47058824
2008020076,23,3490,0.0,26,22,6,0,4,84.61538462
2008020076,16,3594,0.0,30,28,3,2,2,93.33333333
2008020077,12,3598,0.0,33,32,5,0,1,96.96969697
2008020077,24,3558,0.0,23,21,5,1,2,91.30434783
2008020078,5,3900,0.0,36,35,7,1,1,97.22222222
2008020078,6,3897,0.0,32,31,3,1,1,96.875
2008020079,25,3598,0.0,29,28,1,0,1,96.55172414
2008020079,3,3564,0.0,27,25,5,0,2,92.59259259
2008020080,13,3559,0.0,33,31,6,2,2,93.93939394
2008020080,8,3572,0.0,36,35,2,0,1,97.22222222
2008020081,21,3597,0.0,29,26,8,1,3,89.65517241
2008020081,26,2398,0.0,14,10,2,0,4,71.42857143
2008020081,26,1153,0.0,2,2,0,0,0,100.0
2008020082,6,3884,0.0,30,28,4,1,2,93.33333333
2008020082,7,3884,0.0,32,30,7,0,2,93.75
2008020083,24,3900,0.0,38,36,4,0,2,94.73684211
2008020083,10,0,0.0,0,0,0,0,0,
2008020083,10,3879,0.0,21,19,2,0,2,90.47619048
2008020084,23,3542,0.0,32,29,3,0,3,90.625
2008020084,29,3600,0.0,25,23,6,0,2,92.0
2008020085,11,3671,0.0,38,35,8,0,3,92.10526316
2008020085,14,3691,0.0,33,31,5,1,2,93.93939394
2008020086,15,3527,0.0,28,26,6,1,2,92.85714286
2008020086,20,3571,0.0,31,30,5,4,1,96.77419355
2008020087,13,3568,0.0,42,41,13,2,1,97.61904762
2008020087,9,3515,0.0,21,18,4,0,3,85.71428571
2008020088,25,1783,0.0,12,10,0,1,2,83.33333333
2008020088,25,1817,0.0,17,14,3,0,3,82.35294118
2008020088,1,3600,0.0,21,21,8,0,0,100.0
2008020089,28,3900,0.0,29,23,3,0,6,79.31034483
2008020089,4,1200,0.0,15,11,4,0,4,73.33333333
2008020089,4,2674,0.0,20,18,2,0,2,90.0
2008020090,17,3600,0.0,24,21,5,0,3,87.5
2008020090,19,3443,0.0,34,30,3,1,4,88.23529412
2008020091,22,3600,0.0,30,27,3,2,3,90.0
2008020091,16,3600,0.0,23,23,1,1,0,100.0
2008020092,10,3595,0.0,28,26,6,1,2,92.85714286
2008020092,6,3582,0.0,36,33,16,1,3,91.66666667
2008020093,25,3600,0.0,27,24,6,1,3,88.88888889
2008020093,2,3588,0.0,29,24,4,0,5,82.75862069
2008020094,12,3557,0.0,34,31,3,0,3,91.17647059
2008020094,5,3600,0.0,25,24,1,0,1,96.0
2008020095,20,3600,0.0,38,35,14,4,3,92.10526316
2008020095,18,3526,0.0,26,22,3,2,4,84.61538462
2008020096,7,3643,0.0,33,30,0,2,3,90.90909091
2008020096,30,3644,0.0,24,20,3,1,4,83.33333333
2008020097,22,3600,0.0,25,21,5,0,4,84.0
2008020097,21,3589,0.0,26,25,2,3,1,96.15384615
2008020098,15,3538,0.0,34,32,7,2,2,94.11764706
2008020098,27,3597,0.0,32,31,7,3,1,96.875
2008020099,24,3600,0.0,30,27,9,1,3,90.0
2008020099,9,3539,0.0,32,28,11,0,4,87.5
2008020100,4,3600,0.0,26,23,3,0,3,88.46153846
2008020100,1,3597,0.0,27,22,4,1,5,81.48148148
2008020101,3,3597,0.0,26,25,5,4,1,96.15384615
2008020101,29,3530,0.0,32,29,8,3,3,90.625
2008020102,28,3525,0.0,35,31,5,1,4,88.57142857
2008020102,13,3600,0.0,50,47,10,1,3,94.0
2008020103,11,3570,0.0,45,41,8,3,4,91.11111111
2008020103,17,3600,0.0,33,30,7,0,3,90.90909091
2008020104,26,3600,0.0,15,15,2,0,0,100.0
2008020104,19,2400,0.0,17,15,4,2,2,88.23529412
2008020104,19,1200,0.0,12,10,1,0,2,83.33333333
2008020105,11,3534,0.0,33,28,9,1,5,84.84848485
2008020105,6,3600,0.0,32,28,4,0,4,87.5
2008020106,9,3574,0.0,38,35,14,0,3,92.10526316
2008020106,10,3600,0.0,24,22,1,1,2,91.66666667
2008020107,24,3576,0.0,51,47,13,0,4,92.15686275
2008020107,8,1439,0.0,12,8,0,0,4,66.66666667
2008020107,8,2058,0.0,13,11,2,2,2,84.61538462
2008020108,12,3600,4.0,60,57,14,0,3,95.0
2008020108,2,1196,0.0,12,10,0,2,2,83.33333333
2008020108,2,2367,0.0,16,14,3,0,2,87.5
2008020109,5,3900,2.0,44,42,11,1,2,95.45454545
2008020109,3,3875,0.0,29,27,0,2,2,93.10344828
2008020110,1,3824,0.0,33,30,2,3,3,90.90909091
2008020110,4,3824,0.0,31,29,4,2,2,93.5483871
2008020111,28,3597,0.0,22,22,4,0,0,100.0
2008020111,14,3600,0.0,45,42,9,1,3,93.33333333
2008020112,26,768,0.0,15,12,3,0,3,80.0
2008020112,26,2782,0.0,12,10,0,1,2,83.33333333
2008020112,18,3600,0.0,30,26,2,1,4,86.66666667
2008020113,29,1524,0.0,14,13,4,1,1,92.85714286
2008020113,29,2036,0.0,9,8,1,0,1,88.88888889
2008020113,30,3589,0.0,26,25,2,1,1,96.15384615
2008020114,15,3730,0.0,33,28,8,2,5,84.84848485
2008020114,25,3706,0.0,30,24,2,0,6,80.0
2008020115,17,3900,0.0,41,36,12,1,5,87.80487805
2008020115,16,3892,2.0,44,39,6,4,5,88.63636364
2008020116,13,3600,0.0,31,27,8,1,4,87.09677419
2008020116,19,2673,0.0,12,12,2,0,0,100.0
2008020116,19,917,0.0,5,5,3,0,0,100.0
2008020117,7,3900,0.0,29,28,4,0,1,96.55172414
2008020117,21,3900,0.0,30,29,2,1,1,96.66666667
2008020118,22,3600,0.0,30,24,7,1,6,80.0
2008020118,23,3592,0.0,28,25,5,2,3,89.28571429
2008020119,20,3599,0.0,24,23,5,0,1,95.83333333
2008020119,27,3575,0.0,35,32,4,1,3,91.42857143
2008020120,9,3600,0.0,27,25,12,3,2,92.59259259
2008020120,7,3600,0.0,28,23,8,3,5,82.14285714
2008020121,3,3580,0.0,30,28,10,0,2,93.33333333
2008020121,2,3573,0.0,39,35,8,2,4,89.74358974
2008020122,24,3578,0.0,32,30,4,2,2,93.75
2008020122,29,3527,0.0,24,21,4,1,3,87.5
2008020123,16,3521,0.0,18,15,4,0,3,83.33333333
2008020123,30,3587,0.0,36,34,7,1,2,94.44444444
2008020124,6,3798,0.0,27,27,0,1,0,100.0
2008020124,22,3798,0.0,36,35,4,0,1,97.22222222
2008020125,17,3890,0.0,19,16,9,0,3,84.21052632
2008020125,26,3890,0.0,37,34,6,2,3,91.89189189
2008020126,18,3892,0.0,32,29,5,0,3,90.625
2008020126,15,3891,0.0,26,23,12,1,3,88.46153846
2008020127,4,3600,0.0,24,24,7,0,0,100.0
2008020127,11,3594,0.0,31,24,6,1,7,77.41935484
2008020128,14,3598,0.0,39,37,9,0,2,94.87179487
2008020128,10,3510,0.0,25,22,6,0,3,88.0
2008020129,12,3900,0.0,25,23,12,2,2,92.0
2008020129,8,3900,2.0,33,31,5,2,2,93.93939394
2008020130,21,3538,0.0,30,27,2,1,3,90.0
2008020130,20,3600,0.0,22,22,4,0,0,100.0
2008020131,6,3591,0.0,31,31,1,0,0,100.0
2008020131,23,3523,0.0,30,29,7,0,1,96.66666667
2008020132,5,3539,0.0,34,32,9,1,2,94.11764706
2008020132,28,3600,0.0,11,10,0,1,1,90.90909091
2008020133,10,3900,0.0,31,26,8,0,5,83.87096774
2008020133,1,3897,2.0,48,43,5,0,5,89.58333333
2008020134,30,2343,0.0,20,19,6,1,1,95.0
2008020134,30,1192,0.0,13,10,2,0,3,76.92307692
2008020134,25,3600,0.0,21,19,2,1,2,90.47619048
2008020135,17,3697,0.0,34,29,7,0,5,85.29411765
2008020135,24,3699,0.0,38,34,9,1,4,89.47368421
2008020136,14,3599,0.0,31,29,7,0,2,93.5483871
2008020136,7,3600,0.0,40,35,3,1,5,87.5
2008020137,11,3509,0.0,33,30,4,2,3,90.90909091
2008020137,3,3600,0.0,29,27,11,4,2,93.10344828
2008020138,2,3877,0.0,28,25,5,0,3,89.28571429
2008020138,4,3877,0.0,36,34,2,0,2,94.44444444
2008020139,9,3600,0.0,26,25,4,0,1,96.15384615
2008020139,13,3546,0.0,31,29,4,1,2,93.5483871
2008020140,22,3517,0.0,25,22,6,0,3,88.0
2008020140,18,3600,2.0,28,27,2,1,1,96.42857143
2008020141,8,3592,0.0,29,28,14,1,1,96.55172414
2008020141,30,3529,0.0,21,19,6,1,2,90.47619048
2008020142,12,3600,0.0,19,19,0,0,0,100.0
2008020142,19,3505,0.0,29,28,7,0,1,96.55172414
2008020142,19,6,0.0,0,0,0,0,0,
2008020143,29,3600,0.0,32,30,5,0,2,93.75
2008020143,21,2400,0.0,14,10,0,0,4,71.42857143
2008020143,21,1122,0.0,3,3,0,0,0,100.0
2008020144,6,3529,0.0,38,35,11,0,3,92.10526316
2008020144,20,3586,0.0,31,29,7,0,2,93.5483871
2008020145,5,3590,0.0,29,26,4,1,3,89.65517241
2008020145,27,3588,0.0,28,27,9,3,1,96.42857143
2008020146,23,3569,0.0,28,28,11,0,0,100.0
2008020146,26,3600,0.0,18,14,7,0,4,77.77777778
2008020147,17,3557,0.0,33,29,4,2,4,87.87878788
2008020147,28,3600,0.0,27,25,3,0,2,92.59259259
2008020148,25,3594,0.0,32,27,4,1,5,84.375
2008020148,16,3600,0.0,23,21,2,1,2,91.30434783
2008020149,23,3900,0.0,37,31,11,3,6,83.78378378
2008020149,24,2078,0.0,13,9,0,1,4,69.23076923
2008020149,24,1800,0.0,16,14,6,0,2,87.5
2008020150,22,3600,0.0,34,33,8,2,1,97.05882353
2008020150,12,3575,0.0,31,29,1,1,2,93.5483871
2008020151,25,3570,2.0,25,20,5,0,5,80.0
2008020151,6,3600,0.0,36,35,9,4,1,97.22222222
2008020152,15,3600,0.0,27,22,9,0,5,81.48148148
2008020152,7,3597,0.0,29,29,11,2,0,100.0
2008020153,3,3600,0.0,35,30,5,1,5,85.71428571
2008020153,10,3600,0.0,20,18,5,1,2,90.0
2008020154,11,1200,0.0,6,6,2,0,0,100.0
2008020154,11,2400,2.0,26,20,3,1,6,76.92307692
2008020154,1,2002,0.0,15,14,1,0,1,93.33333333
2008020154,1,1598,0.0,5,5,0,0,0,100.0
2008020155,8,3600,0.0,31,27,5,0,4,87.09677419
2008020155,2,3546,0.0,32,27,5,2,5,84.375
2008020156,16,3893,0.0,51,48,12,0,3,94.11764706
2008020156,29,3893,0.0,24,21,5,1,3,87.5
2008020157,9,3900,0.0,34,32,4,0,2,94.11764706
2008020157,14,3896,0.0,31,29,3,1,2,93.5483871
2008020158,13,3900,0.0,32,30,7,1,2,93.75
2008020158,18,3884,0.0,26,24,3,1,2,92.30769231
2008020159,5,3591,0.0,22,19,2,1,3,86.36363636
2008020159,19,3453,0.0,27,22,6,0,5,81.48148148
2008020160,30,3600,0.0,27,25,5,0,2,92.59259259
2008020160,27,3545,0.0,33,30,3,5,3,90.90909091
2008020161,20,3600,0.0,36,34,15,2,2,94.44444444
2008020161,26,3518,0.0,21,18,1,3,3,85.71428571
2008020162,22,3585,0.0,26,22,4,2,4,84.61538462
2008020162,4,3568,0.0,28,23,4,2,5,82.14285714
2008020163,10,3488,0.0,29,24,8,0,5,82.75862069
2008020163,12,3600,0.0,33,29,2,3,4,87.87878788
2008020164,13,3539,0.0,30,26,3,0,4,86.66666667
2008020164,11,3592,0.0,21,18,1,0,3,85.71428571
2008020165,28,3600,0.0,36,33,2,0,3,91.66666667
2008020165,21,3533,0.0,29,24,3,0,5,82.75862069
2008020166,20,3538,0.0,37,34,5,4,3,91.89189189
2008020166,24,3600,0.0,36,34,9,0,2,94.44444444
2008020167,17,3600,0.0,27,25,8,0,2,92.59259259
2008020167,23,3511,0.0,23,20,3,1,3,86.95652174
2008020168,7,3595,2.0,24,24,10,0,0,100.0
2008020168,1,3410,0.0,30,28,6,0,2,93.33333333
2008020169,29,3792,0.0,29,25,1,0,4,86.20689655
2008020169,2,3771,0.0,34,31,5,0,3,91.17647059
2008020170,21,3595,0.0,37,31,3,1,6,83.78378378
2008020170,16,3566,0.0,26,24,3,1,2,92.30769231
2008020171,2,3600,0.0,36,35,4,1,1,97.22222222
2008020171,3,3485,0.0,19,17,2,3,2,89.47368421
2008020172,12,3702,0.0,42,38,5,0,4,90.47619048
2008020172,10,3712,0.0,24,19,2,0,5,79.16666667
2008020173,15,3853,0.0,44,42,8,0,2,95.45454545
2008020173,9,3860,0.0,27,26,2,2,1,96.2962963
2008020174,27,3600,0.0,29,27,4,1,2,93.10344828
2008020174,20,3552,0.0,22,18,4,1,4,81.81818182
2008020175,18,3600,0.0,39,35,12,0,4,89.74358974
2008020175,23,3595,0.0,24,24,7,3,0,100.0
2008020176,24,3640,0.0,35,35,8,0,0,100.0
2008020176,26,3640,0.0,27,26,6,0,1,96.2962963
2008020177,30,3600,0.0,49,46,10,0,3,93.87755102
2008020177,28,3560,2.0,24,23,1,2,1,95.83333333
2008020178,14,3876,0.0,38,35,2,1,3,92.10526316
2008020178,1,3900,0.0,27,24,2,1,3,88.88888889
2008020179,22,3541,0.0,38,33,7,0,5,86.84210526
2008020179,29,3586,0.0,26,22,4,2,4,84.61538462
2008020180,19,3501,0.0,26,22,1,1,4,84.61538462
2008020180,24,3600,0.0,32,30,5,0,2,93.75
2008020181,10,3537,0.0,34,30,6,1,4,88.23529412
2008020181,6,3600,0.0,36,34,8,0,2,94.44444444
2008020182,14,3590,9.0,35,30,8,0,5,85.71428571
2008020182,3,3568,0.0,38,36,4,2,2,94.73684211
2008020183,12,3589,0.0,33,30,6,0,3,90.90909091
2008020183,15,3600,2.0,34,32,4,0,2,94.11764706
2008020184,2,3541,2.0,27,23,4,0,4,85.18518519
2008020184,11,3600,0.0,27,24,10,0,3,88.88888889
2008020185,4,3515,0.0,24,21,3,1,3,87.5
2008020185,9,3600,0.0,18,17,1,0,1,94.44444444
2008020186,22,1584,0.0,14,14,8,0,0,100.0
2008020186,22,1983,0.0,20,15,0,2,5,75.0
2008020186,5,3575,0.0,31,27,6,1,4,87.09677419
2008020187,30,3600,0.0,36,35,12,2,1,97.22222222
2008020187,21,3486,0.0,20,17,3,3,3,85.0
2008020188,18,2330,0.0,19,16,4,0,3,84.21052632
2008020188,18,1200,0.0,10,6,2,0,4,60.0
2008020188,20,3600,2.0,29,23,5,2,6,79.31034483
2008020189,27,3552,0.0,32,31,6,1,1,96.875
2008020189,23,3540,0.0,28,28,3,3,0,100.0
2008020190,13,3523,0.0,32,29,5,1,3,90.625
2008020190,26,3600,0.0,15,13,7,0,2,86.66666667
2008020191,19,3896,0.0,43,39,10,1,4,90.69767442
2008020191,28,3898,0.0,29,25,6,2,4,86.20689655
2008020192,9,3534,0.0,30,28,4,0,2,93.33333333
2008020192,12,3594,0.0,23,22,7,1,1,95.65217391
2008020193,8,3885,0.0,28,25,9,0,3,89.28571429
2008020193,29,3890,0.0,37,34,4,1,3,91.89189189
2008020194,11,3648,0.0,32,28,5,0,4,87.5
2008020194,7,3646,0.0,26,21,4,0,5,80.76923077
2008020195,25,3600,0.0,30,28,3,1,2,93.33333333
2008020195,24,1552,0.0,13,9,2,0,4,69.23076923
2008020195,24,2048,0.0,13,12,3,0,1,92.30769231
2008020196,7,3596,0.0,40,37,4,0,3,92.5
2008020196,6,3600,0.0,33,32,5,1,1,96.96969697
2008020197,8,3600,0.0,41,35,5,0,6,85.36585366
2008020197,10,3600,0.0,20,17,5,2,3,85.0
2008020198,5,3900,0.0,22,19,1,3,3,86.36363636
2008020198,2,3898,0.0,32,29,6,0,3,90.625
2008020199,14,3597,0.0,36,35,9,3,1,97.22222222
2008020199,4,3544,0.0,22,20,5,0,2,90.90909091
2008020200,3,3553,0.0,27,25,5,1,2,92.59259259
2008020200,15,3591,0.0,29,28,5,2,1,96.55172414
2008020201,1,3564,0.0,31,28,7,0,3,90.32258065
2008020201,17,3600,0.0,25,24,6,0,1,96.0
2008020202,20,3586,0.0,28,25,10,2,3,89.28571429
2008020202,29,3592,0.0,23,22,4,0,1,95.65217391
2008020203,18,3541,0.0,20,19,9,0,1,95.0
2008020203,21,3587,0.0,26,26,10,2,0,100.0
2008020204,13,3490,0.0,39,35,12,0,4,89.74358974
2008020204,27,3600,0.0,27,26,2,0,1,96.2962963
2008020205,30,3598,0.0,29,27,5,0,2,93.10344828
2008020205,23,3591,0.0,29,29,6,0,0,100.0
2008020206,25,3565,0.0,33,31,2,0,2,93.93939394
2008020206,28,3600,0.0,24,23,5,2,1,95.83333333
2008020207,19,10,0.0,0,0,0,0,0,
2008020207,19,3483,0.0,30,26,6,1,4,86.66666667
2008020207,26,3600,0.0,27,24,6,0,3,88.88888889
2008020208,11,3600,0.0,37,35,10,0,2,94.59459459
2008020208,12,3600,0.0,22,17,2,0,5,77.27272727
2008020209,22,3595,0.0,38,37,8,1,1,97.36842105
2008020209,1,3545,0.0,28,26,3,0,2,92.85714286
2008020210,20,3589,0.0,27,21,6,4,6,77.77777778
2008020210,16,3600,0.0,23,22,10,2,1,95.65217391
2008020211,28,3592,0.0,29,26,7,1,3,89.65517241
2008020211,27,3600,0.0,32,30,6,1,2,93.75
2008020212,13,3588,0.0,45,44,14,1,1,97.77777778
2008020212,24,3487,0.0,26,23,6,0,3,88.46153846
2008020213,22,3900,0.0,42,40,9,1,2,95.23809524
2008020213,3,3890,0.0,31,29,8,1,2,93.5483871
2008020214,14,3600,0.0,30,26,4,0,4,86.66666667
2008020214,15,3600,0.0,36,34,10,1,2,94.44444444
2008020215,4,3600,0.0,36,35,8,2,1,97.22222222
2008020215,2,3589,0.0,31,29,6,2,2,93.5483871
2008020216,5,3772,0.0,34,28,3,2,6,82.35294118
2008020216,17,3829,0.0,34,27,8,0,7,79.41176471
2008020217,9,3599,0.0,31,27,13,2,4,87.09677419
2008020217,8,3599,0.0,28,28,7,1,0,100.0
2008020218,10,3532,0.0,32,28,1,0,4,87.5
2008020218,20,3600,0.0,32,29,9,0,3,90.625
2008020219,25,3896,0.0,26,24,3,0,2,92.30769231
2008020219,26,3900,0.0,21,19,5,0,2,90.47619048
2008020220,18,3748,0.0,57,54,17,1,3,94.73684211
2008020220,28,3713,0.0,29,25,1,4,4,86.20689655
2008020221,19,3218,0.0,25,24,5,0,1,96.0
2008020221,19,318,0.0,7,4,0,0,3,57.14285714
2008020221,7,3594,0.0,33,30,1,2,3,90.90909091
2008020222,3,3559,0.0,32,30,8,1,2,93.75
2008020222,1,2400,0.0,25,21,4,0,4,84.0
2008020222,1,1200,0.0,17,16,6,1,1,94.11764706
2008020223,15,1200,0.0,14,13,4,0,1,92.85714286
2008020223,15,2400,0.0,13,13,2,0,0,100.0
2008020223,12,3594,0.0,37,32,6,0,5,86.48648649
2008020224,27,3600,0.0,33,31,4,1,2,93.93939394
2008020224,29,3550,0.0,29,25,4,3,4,86.20689655
2008020225,14,3585,2.0,31,27,8,1,4,87.09677419
2008020225,13,3586,0.0,24,24,6,1,0,100.0
2008020226,6,3867,0.0,32,31,11,0,1,96.875
2008020226,16,3839,0.0,39,38,13,3,1,97.43589744
2008020227,21,3888,0.0,32,31,9,0,1,96.875
2008020227,23,3900,0.0,34,33,8,2,1,97.05882353
2008020228,8,3600,2.0,31,25,3,0,6,80.64516129
2008020228,6,3600,0.0,28,27,2,0,1,96.42857143
2008020229,2,3600,0.0,30,29,10,0,1,96.66666667
2008020229,9,3497,0.0,31,28,10,3,3,90.32258065
2008020230,4,3900,0.0,31,27,1,1,4,87.09677419
2008020230,5,1500,0.0,11,11,0,0,0,100.0
2008020230,5,2386,0.0,24,20,4,2,4,83.33333333
2008020231,17,3600,0.0,18,15,3,0,3,83.33333333
2008020231,14,3509,0.0,39,35,11,3,4,89.74358974
2008020232,27,3582,0.0,32,28,8,2,4,87.5
2008020232,30,3589,0.0,24,24,6,1,0,100.0
2008020233,26,3600,0.0,26,24,1,1,2,92.30769231
2008020233,25,3521,0.0,29,26,7,1,3,89.65517241
2008020234,10,3598,0.0,25,23,8,1,2,92.0
2008020234,22,3589,0.0,28,23,4,1,5,82.14285714
2008020235,20,2400,0.0,26,24,6,1,2,92.30769231
2008020235,20,1200,0.0,20,16,3,0,4,80.0
2008020235,28,3595,0.0,24,23,2,1,1,95.83333333
2008020236,1,3555,0.0,26,24,1,0,2,92.30769231
2008020236,15,3600,0.0,33,32,6,0,1,96.96969697
2008020237,29,3600,0.0,37,36,9,0,1,97.2972973
2008020237,7,887,0.0,2,2,0,0,0,100.0
2008020237,7,2713,0.0,23,17,5,3,6,73.91304348
2008020238,12,3494,0.0,25,22,11,1,3,88.0
2008020238,11,3600,0.0,29,27,7,0,2,93.10344828
2008020239,17,3600,0.0,27,25,2,0,2,92.59259259
2008020239,13,1297,0.0,13,11,1,0,2,84.61538462
2008020239,13,2274,0.0,19,18,5,0,1,94.73684211
2008020240,19,3705,0.0,35,32,9,1,3,91.42857143
2008020240,16,3735,0.0,30,26,9,0,4,86.66666667
2008020241,18,3737,0.0,35,32,9,0,3,91.42857143
2008020241,24,3733,0.0,35,31,8,0,4,88.57142857
2008020242,4,3600,0.0,25,24,8,0,1,96.0
2008020242,8,3559,0.0,31,29,0,2,2,93.5483871
2008020243,15,3838,0.0,33,28,6,1,5,84.84848485
2008020243,1,3900,0.0,30,25,0,1,5,83.33333333
2008020244,9,3499,0.0,31,28,4,0,3,90.32258065
2008020244,2,3600,0.0,40,38,2,3,2,95.0
2008020245,6,3897,0.0,31,29,8,0,2,93.5483871
2008020245,3,3857,0.0,25,23,4,0,2,92.0
2008020246,10,1778,0.0,6,6,0,0,0,100.0
2008020246,10,1711,0.0,9,5,2,0,4,55.55555556
2008020246,23,3600,0.0,30,28,8,0,2,93.33333333
2008020247,7,3580,0.0,24,20,7,1,4,83.33333333
2008020247,5,3600,2.0,23,21,3,0,2,91.30434783
2008020248,29,3900,0.0,30,28,3,1,2,93.33333333
2008020248,30,3892,0.0,26,24,0,1,2,92.30769231
2008020249,25,3600,0.0,27,25,4,1,2,92.59259259
2008020249,27,3577,0.0,19,16,5,1,3,84.21052632
2008020250,21,3811,0.0,35,33,7,0,2,94.28571429
2008020250,22,3896,0.0,32,30,6,0,2,93.75
2008020251,18,3567,0.0,34,33,2,0,1,97.05882353
2008020251,26,3594,0.0,21,19,2,1,2,90.47619048
2008020252,14,3890,0.0,30,28,8,0,2,93.33333333
2008020252,12,3893,0.0,28,26,7,0,2,92.85714286
2008020253,8,3898,0.0,26,24,5,3,2,92.30769231
2008020253,19,3900,0.0,26,24,6,0,2,92.30769231
2008020254,11,3519,0.0,32,28,4,0,4,87.5
2008020254,4,3600,0.0,32,29,2,0,3,90.625
2008020255,28,3596,0.0,33,28,1,2,5,84.84848485
2008020255,16,3528,0.0,31,25,5,0,6,80.64516129
2008020256,26,3600,0.0,26,24,2,0,2,92.30769231
2008020256,24,3599,0.0,29,29,9,0,0,100.0
2008020257,23,3855,0.0,35,34,6,4,1,97.14285714
2008020257,2,3874,0.0,32,31,6,2,1,96.875
2008020258,9,3900,0.0,27,26,3,0,1,96.2962963
2008020258,3,3900,0.0,28,27,5,1,1,96.42857143
2008020259,6,3600,0.0,30,28,11,0,2,93.33333333
2008020259,10,3541,0.0,22,19,2,0,3,86.36363636
2008020260,22,3582,0.0,41,37,12,0,4,90.24390244
2008020260,17,3600,2.0,21,21,7,0,0,100.0
2008020261,28,3588,0.0,33,32,17,2,1,96.96969697
2008020261,18,3598,0.0,32,28,7,2,4,87.5
2008020262,30,3900,0.0,25,24,5,0,1,96.0
2008020262,5,3900,2.0,25,24,1,0,1,96.0
2008020263,8,3537,0.0,48,46,9,1,2,95.83333333
2008020263,12,3570,0.0,29,28,4,0,1,96.55172414
2008020264,22,3600,0.0,39,37,11,0,2,94.87179487
2008020264,29,3598,0.0,19,12,4,1,7,63.15789474
2008020265,13,3888,0.0,52,49,5,1,3,94.23076923
2008020265,14,3900,0.0,36,33,7,1,3,91.66666667
2008020266,16,3900,0.0,38,36,4,1,2,94.73684211
2008020266,27,3890,0.0,40,38,4,1,2,95.0
2008020267,21,3562,0.0,50,47,11,0,3,94.0
2008020267,20,3588,0.0,23,22,2,1,1,95.65217391
2008020268,7,2475,0.0,20,13,3,0,7,65.0
2008020268,7,1124,0.0,3,3,2,0,0,100.0
2008020268,6,3582,0.0,29,25,3,1,4,86.20689655
2008020269,23,3600,0.0,42,39,13,2,3,92.85714286
2008020269,3,1531,0.0,17,12,6,0,5,70.58823529
2008020269,3,1953,0.0,15,15,3,1,0,100.0
2008020270,15,3600,0.0,32,28,6,0,4,87.5
2008020270,24,3087,0.0,27,24,7,1,3,88.88888889
2008020270,24,433,0.0,6,3,1,0,3,50.0
2008020271,13,3488,0.0,19,16,6,0,3,84.21052632
2008020271,1,3594,0.0,24,23,2,1,1,95.83333333
2008020272,5,3600,0.0,23,21,5,1,2,91.30434783
2008020272,11,3551,0.0,31,28,8,0,3,90.32258065
2008020273,8,3900,0.0,25,23,5,0,2,92.0
2008020273,9,3900,0.0,21,19,0,0,2,90.47619048
2008020274,23,3600,0.0,30,28,2,1,2,93.33333333
2008020274,30,3545,0.0,27,24,6,2,3,88.88888889
2008020275,16,3599,2.0,34,31,2,1,3,91.17647059
2008020275,25,3536,0.0,29,24,7,0,5,82.75862069
2008020276,20,3600,0.0,18,18,0,1,0,100.0
2008020276,21,3524,0.0,33,32,11,0,1,96.96969697
2008020277,17,3600,0.0,34,31,8,1,3,91.17647059
2008020277,22,610,0.0,10,7,1,0,3,70.0
2008020277,22,2924,0.0,25,24,5,1,1,96.0
2008020278,15,3528,0.0,31,28,6,0,3,90.32258065
2008020278,26,3600,0.0,21,19,4,1,2,90.47619048
2008020279,13,3474,0.0,39,35,4,2,4,89.74358974
2008020279,6,3600,0.0,32,30,9,0,2,93.75
2008020280,2,3598,0.0,33,28,9,1,5,84.84848485
2008020280,1,3582,0.0,27,25,5,0,2,92.59259259
2008020281,27,3548,0.0,32,28,2,0,4,87.5
2008020281,12,3592,0.0,28,26,5,1,2,92.85714286
2008020282,4,3600,0.0,40,40,11,0,0,100.0
2008020282,7,3586,0.0,24,22,5,1,2,91.66666667
2008020283,18,3588,0.0,24,20,1,1,4,83.33333333
2008020283,14,3598,2.0,35,34,14,2,1,97.14285714
2008020284,24,3653,0.0,28,25,10,1,3,89.28571429
2008020284,19,3759,0.0,28,26,5,1,2,92.85714286
2008020285,23,3306,0.0,18,17,1,0,1,94.44444444
2008020285,23,294,0.0,1,1,1,0,0,100.0
2008020285,5,3553,0.0,18,16,1,0,2,88.88888889
2008020286,3,3600,0.0,36,32,8,2,4,88.88888889
2008020286,9,3600,2.0,19,18,1,0,1,94.73684211
2008020287,2,3581,0.0,37,35,2,0,2,94.59459459
2008020287,7,3539,0.0,25,22,7,0,3,88.0
2008020288,16,3649,0.0,38,34,5,1,4,89.47368421
2008020288,10,3649,0.0,36,31,3,0,5,86.11111111
2008020289,6,3900,0.0,35,33,4,0,2,94.28571429
2008020289,8,3898,0.0,27,25,4,0,2,92.59259259
2008020290,27,3686,0.0,34,30,5,2,4,88.23529412
2008020290,4,3684,0.0,28,25,9,0,3,89.28571429
2008020291,29,3581,0.0,15,15,0,0,0,100.0
2008020291,11,3560,0.0,30,29,5,2,1,96.66666667
2008020292,19,3600,0.0,32,31,9,0,1,96.875
2008020292,30,3497,0.0,26,24,4,0,2,92.30769231
2008020293,24,3900,0.0,32,31,6,0,1,96.875
2008020293,25,3890,0.0,24,23,5,0,1,95.83333333
2008020294,17,3593,0.0,33,31,6,0,2,93.93939394
2008020294,20,3546,0.0,36,32,6,0,4,88.88888889
2008020295,21,3900,0.0,30,27,6,2,3,90.0
2008020295,26,3895,0.0,29,26,6,3,3,89.65517241
2008020296,15,3600,0.0,28,21,7,0,7,75.0
2008020296,28,3587,0.0,21,19,1,1,2,90.47619048
2008020297,18,3569,0.0,26,24,7,0,2,92.30769231
2008020297,12,3600,0.0,30,25,6,0,5,83.33333333
2008020298,1,3590,0.0,29,26,4,0,3,89.65517241
2008020298,14,1701,0.0,17,15,0,0,2,88.23529412
2008020298,14,1899,0.0,28,23,2,1,5,82.14285714
2008020299,27,3548,0.0,35,32,3,1,3,91.42857143
2008020299,3,3600,0.0,36,35,1,0,1,97.22222222
2008020300,25,3525,0.0,25,21,1,0,4,84.0
2008020300,4,3600,0.0,25,22,7,0,3,88.0
2008020301,2,3900,0.0,26,23,5,0,3,88.46153846
2008020301,8,3889,0.0,24,22,1,1,2,91.66666667
2008020302,12,3513,0.0,22,19,0,0,3,86.36363636
2008020302,13,3600,0.0,29,27,1,0,2,93.10344828
2008020303,15,3537,0.0,33,29,7,0,4,87.87878788
2008020303,30,3600,0.0,28,25,8,0,3,89.28571429
2008020304,17,3753,0.0,24,21,6,0,3,87.5
2008020304,23,3751,0.0,34,32,5,1,2,94.11764706
2008020305,21,1200,0.0,5,4,0,1,1,80.0
2008020305,21,2388,0.0,19,16,2,0,3,84.21052632
2008020305,24,3600,0.0,30,29,3,1,1,96.66666667
2008020306,19,3894,0.0,47,47,13,2,0,100.0
2008020306,18,3900,0.0,17,17,2,2,0,100.0
2008020307,11,3599,0.0,35,32,9,0,3,91.42857143
2008020307,10,3591,0.0,30,24,2,0,6,80.0
2008020308,26,1793,0.0,17,15,6,0,2,88.23529412
2008020308,26,1807,0.0,18,14,2,1,4,77.77777778
2008020308,20,3600,0.0,25,23,3,1,2,92.0
2008020309,6,3535,0.0,23,20,3,0,3,86.95652174
2008020309,7,3600,0.0,29,27,2,0,2,93.10344828
2008020310,5,1767,0.0,14,11,3,0,3,78.57142857
2008020310,5,1833,0.0,11,11,1,0,0,100.0
2008020310,2,3543,0.0,29,25,9,2,4,86.20689655
2008020311,11,3498,0.0,33,28,4,0,5,84.84848485
2008020311,15,3600,0.0,18,15,2,0,3,83.33333333
2008020312,4,3597,0.0,28,27,6,1,1,96.42857143
2008020312,12,3500,0.0,26,24,3,2,2,92.30769231
2008020313,27,3582,0.0,40,38,15,4,2,95.0
2008020313,29,3527,0.0,25,22,3,2,3,88.0
2008020314,3,3900,0.0,29,27,4,0,2,93.10344828
2008020314,14,3874,0.0,35,33,3,2,2,94.28571429
2008020315,1,3841,0.0,38,36,10,0,2,94.73684211
2008020315,13,2586,0.0,25,24,7,1,1,96.0
2008020315,13,1200,0.0,12,10,1,0,2,83.33333333
2008020316,8,3600,0.0,33,32,2,1,1,96.96969697
2008020316,17,3515,0.0,25,22,5,1,3,88.0
2008020317,25,3600,2.0,28,25,5,0,3,89.28571429
2008020317,30,3563,0.0,30,26,4,1,4,86.66666667
2008020318,19,3470,0.0,28,25,4,0,3,89.28571429
2008020318,21,3600,0.0,22,21,3,0,1,95.45454545
2008020319,26,3600,2.0,23,22,4,0,1,95.65217391
2008020319,22,3551,0.0,29,27,8,2,2,93.10344828
2008020320,16,2376,0.0,25,24,5,0,1,96.0
2008020320,16,1269,0.0,15,13,0,1,2,86.66666667
2008020320,28,3645,0.0,26,24,4,0,2,92.30769231
2008020321,10,3898,0.0,35,34,1,0,1,97.14285714
2008020321,9,3900,0.0,26,25,7,0,1,96.15384615
2008020322,20,3587,0.0,30,27,4,0,3,90.0
2008020322,23,3525,0.0,33,29,4,0,4,87.87878788
2008020323,2,782,0.0,8,5,1,0,3,62.5
2008020323,2,2818,0.0,31,27,4,0,4,87.09677419
2008020323,6,3572,0.0,24,22,5,0,2,91.66666667
2008020324,12,3833,0.0,26,24,2,3,2,92.30769231
2008020324,4,3833,0.0,30,27,3,0,3,90.0
2008020325,14,3537,0.0,32,29,5,1,3,90.625
2008020325,30,3598,0.0,37,35,10,0,2,94.59459459
2008020326,21,3528,0.0,20,18,3,0,2,90.0
2008020326,27,3600,0.0,38,37,5,2,1,97.36842105
2008020327,16,3533,0.0,21,20,1,1,1,95.23809524
2008020327,24,3600,0.0,26,26,3,1,0,100.0
2008020328,8,3596,0.0,30,27,2,1,3,90.0
2008020328,15,3600,0.0,28,28,0,0,0,100.0
2008020329,5,3567,0.0,32,28,2,1,4,87.5
2008020329,7,3600,0.0,30,27,5,1,3,90.0
2008020330,18,3699,0.0,25,22,2,0,3,88.0
2008020330,11,3704,0.0,26,22,4,0,4,84.61538462
2008020331,3,3900,0.0,41,38,6,5,3,92.68292683
2008020331,13,3897,0.0,46,43,11,1,3,93.47826087
2008020332,29,3577,0.0,34,30,9,3,4,88.23529412
2008020332,17,3596,0.0,16,13,3,0,3,81.25
2008020333,28,3593,0.0,27,25,10,0,2,92.59259259
2008020333,25,1200,0.0,11,10,2,0,1,90.90909091
2008020333,25,2400,0.0,19,14,2,0,5,73.68421053
2008020334,22,3600,0.0,29,27,7,0,2,93.10344828
2008020334,19,3475,0.0,22,18,3,0,4,81.81818182
2008020335,16,3583,0.0,27,23,3,0,4,85.18518519
2008020335,26,3600,0.0,24,22,2,1,2,91.66666667
2008020336,17,1914,0.0,10,9,0,0,1,90.0
2008020336,17,1679,0.0,9,6,0,0,3,66.66666667
2008020336,6,3600,0.0,30,29,3,0,1,96.66666667
2008020337,4,3522,0.0,27,23,5,0,4,85.18518519
2008020337,10,3594,0.0,30,28,4,0,2,93.33333333
2008020338,7,3529,0.0,34,31,9,3,3,91.17647059
2008020338,8,3590,0.0,28,26,7,2,2,92.85714286
2008020339,9,3562,0.0,24,21,2,0,3,87.5
2008020339,2,3596,0.0,21,19,2,2,2,90.47619048
2008020340,15,3599,2.0,31,28,9,1,3,90.32258065
2008020340,29,3600,0.0,26,26,7,0,0,100.0
2008020341,1,3590,0.0,34,31,6,0,3,91.17647059
2008020341,5,3600,0.0,30,29,11,2,1,96.66666667
2008020342,30,3600,0.0,27,25,5,1,2,92.59259259
2008020342,18,3600,0.0,29,23,8,0,6,79.31034483
2008020343,14,2350,0.0,21,20,3,2,1,95.23809524
2008020343,14,1200,0.0,10,7,0,1,3,70.0
2008020343,21,3600,0.0,20,17,4,1,3,85.0
2008020344,28,3600,0.0,20,18,4,0,2,90.0
2008020344,27,326,0.0,2,0,0,0,2,0.0
2008020344,27,3237,0.0,21,20,5,0,1,95.23809524
2008020345,23,3585,0.0,31,28,4,0,3,90.32258065
2008020345,20,3600,0.0,18,17,1,0,1,94.44444444
2008020346,13,3600,0.0,37,37,14,1,0,100.0
2008020346,3,2157,0.0,23,20,4,2,3,86.95652174
2008020346,3,1398,0.0,7,6,1,0,1,85.71428571
2008020347,19,3582,0.0,30,28,6,0,2,93.33333333
2008020347,11,3538,0.0,46,43,4,0,3,93.47826087
2008020348,22,3575,0.0,26,22,6,1,4,84.61538462
2008020348,25,3600,0.0,28,25,0,2,3,89.28571429
2008020349,24,3580,0.0,37,36,4,1,1,97.2972973
2008020349,12,2400,0.0,14,11,2,1,3,78.57142857
2008020349,12,1200,0.0,13,12,4,0,1,92.30769231
2008020350,18,3600,0.0,30,30,1,1,0,100.0
2008020350,7,3493,0.0,27,25,2,0,2,92.59259259
2008020351,23,1176,0.0,11,11,5,1,0,100.0
2008020351,23,2324,0.0,18,15,5,0,3,83.33333333
2008020351,29,3596,0.0,32,30,7,1,2,93.75
2008020352,24,2400,0.0,38,37,8,0,1,97.36842105
2008020352,24,1137,0.0,9,8,0,0,1,88.88888889
2008020352,17,3594,0.0,16,15,1,0,1,93.75
2008020353,21,3600,0.0,17,12,1,0,5,70.58823529
2008020353,30,1172,0.0,5,5,0,0,0,100.0
2008020353,30,2388,0.0,26,20,3,0,6,76.92307692
2008020354,10,3588,0.0,33,32,6,0,1,96.96969697
2008020354,26,3538,0.0,29,27,6,0,2,93.10344828
2008020355,14,3720,0.0,32,28,4,2,4,87.5
2008020355,4,3712,0.0,38,35,14,0,3,92.10526316
2008020356,13,3588,0.0,26,23,5,0,3,88.46153846
2008020356,15,3578,0.0,21,17,1,0,4,80.95238095
2008020357,11,3526,0.0,32,28,2,0,4,87.5
2008020357,8,3600,0.0,26,22,4,1,4,84.61538462
2008020358,25,3600,0.0,37,36,2,5,1,97.2972973
2008020358,20,3536,0.0,22,20,6,0,2,90.90909091
2008020359,26,3550,0.0,25,22,3,0,3,88.0
2008020359,27,3600,0.0,34,32,1,3,2,94.11764706
2008020360,10,3588,0.0,30,25,3,2,5,83.33333333
2008020360,28,3581,0.0,31,29,7,0,2,93.5483871
2008020361,11,3591,0.0,34,29,1,0,5,85.29411765
2008020361,9,3595,0.0,23,22,4,2,1,95.65217391
2008020362,5,3900,0.0,27,25,2,0,2,92.59259259
2008020362,3,3899,0.0,31,29,3,1,2,93.5483871
2008020363,19,3468,0.0,37,34,7,2,3,91.89189189
2008020363,30,3600,0.0,22,22,5,0,0,100.0
2008020364,24,3544,0.0,40,37,6,0,3,92.5
2008020364,16,3592,0.0,32,30,5,1,2,93.75
2008020365,25,3575,0.0,21,17,2,0,4,80.95238095
2008020365,22,3600,0.0,25,23,5,3,2,92.0
2008020366,3,3600,0.0,39,33,3,0,6,84.61538462
2008020366,8,3584,0.0,20,18,1,1,2,90.0
2008020367,1,3756,0.0,31,29,8,0,2,93.5483871
2008020367,4,3764,0.0,31,28,4,0,3,90.32258065
2008020368,2,3529,0.0,46,42,8,1,4,91.30434783
2008020368,15,3600,0.0,29,27,8,2,2,93.10344828
2008020369,5,3600,0.0,36,34,5,0,2,94.44444444
2008020369,12,3597,0.0,22,17,3,1,5,77.27272727
2008020370,6,3600,0.0,31,30,4,1,1,96.77419355
2008020370,14,3551,0.0,25,23,3,0,2,92.0
2008020371,7,3563,0.0,25,23,4,1,2,92.0
2008020371,13,3600,0.0,46,45,12,2,1,97.82608696
2008020372,23,2768,0.0,33,27,6,0,6,81.81818182
2008020372,23,764,0.0,5,5,0,0,0,100.0
2008020372,17,3599,0.0,25,20,0,0,5,80.0
2008020373,21,3550,0.0,24,21,1,0,3,87.5
2008020373,18,3600,0.0,21,19,2,1,2,90.47619048
2008020374,10,3600,2.0,26,20,1,1,6,76.92307692
2008020374,27,1200,0.0,9,9,7,0,0,100.0
2008020374,27,2397,0.0,9,6,0,0,3,66.66666667
2008020375,29,3546,0.0,22,19,5,1,3,86.36363636
2008020375,28,3598,0.0,31,29,2,0,2,93.5483871
2008020376,23,3600,0.0,17,16,2,0,1,94.11764706
2008020376,30,3558,0.0,31,29,3,0,2,93.5483871
2008020377,20,3738,0.0,25,22,11,1,3,88.0
2008020377,19,3741,0.0,30,26,6,0,4,86.66666667
2008020378,21,3842,0.0,24,23,3,0,1,95.83333333
2008020378,25,3896,0.0,27,26,4,0,1,96.2962963
2008020379,22,3900,0.0,36,32,4,0,4,88.88888889
2008020379,26,2700,0.0,31,30,3,2,1,96.77419355
2008020379,26,1200,0.0,13,10,3,0,3,76.92307692
2008020380,15,3600,0.0,20,19,8,1,1,95.0
2008020380,10,3504,0.0,30,28,3,1,2,93.33333333
2008020381,1,3631,0.0,26,25,6,2,1,96.15384615
2008020381,8,3630,0.0,31,29,3,0,2,93.5483871
2008020382,5,3560,0.0,31,28,1,0,3,90.32258065
2008020382,9,3600,0.0,19,17,1,0,2,89.47368421
2008020383,11,3596,0.0,29,28,4,1,1,96.55172414
2008020383,2,3600,2.0,17,12,3,1,5,70.58823529
2008020384,4,3814,0.0,36,35,5,0,1,97.22222222
2008020384,12,3814,2.0,31,29,5,1,2,93.5483871
2008020385,6,3600,0.0,27,27,5,1,0,100.0
2008020385,13,2833,0.0,27,24,5,0,3,88.88888889
2008020385,13,767,0.0,5,4,0,0,1,80.0
2008020386,16,3898,0.0,30,26,3,0,4,86.66666667
2008020386,17,3900,0.0,32,28,0,1,4,87.5
2008020387,7,3598,0.0,23,20,12,0,3,86.95652174
2008020387,14,3537,0.0,27,23,5,1,4,85.18518519
2008020388,30,3549,0.0,43,42,6,3,1,97.6744186
2008020388,18,3598,0.0,32,32,4,0,0,100.0
2008020389,27,3587,0.0,30,26,2,1,4,86.66666667
2008020389,19,3600,0.0,26,23,2,0,3,88.46153846
2008020390,22,3719,0.0,43,41,3,1,2,95.34883721
2008020390,28,3760,0.0,17,14,2,1,3,82.35294118
2008020391,29,3556,0.0,17,15,1,1,2,88.23529412
2008020391,26,3600,0.0,23,23,5,0,0,100.0
2008020392,15,3527,0.0,25,22,4,0,3,88.0
2008020392,12,3600,0.0,39,38,6,1,1,97.43589744
2008020393,20,3600,0.0,31,31,6,3,0,100.0
2008020393,3,3600,0.0,20,17,0,2,3,85.0
2008020394,27,3600,0.0,28,21,1,0,7,75.0
2008020394,16,3583,0.0,21,20,0,2,1,95.23809524
2008020395,23,3887,0.0,35,31,3,1,4,88.57142857
2008020395,21,3898,0.0,38,34,4,3,4,89.47368421
2008020396,29,3592,0.0,34,29,6,3,5,85.29411765
2008020396,24,3599,0.0,32,29,10,1,3,90.625
2008020397,14,3544,0.0,23,19,5,2,4,82.60869565
2008020397,6,3591,0.0,29,26,7,0,3,89.65517241
2008020398,2,3524,0.0,37,33,4,1,4,89.18918919
2008020398,10,3595,0.0,28,26,2,2,2,92.85714286
2008020399,13,3890,0.0,38,35,4,0,3,92.10526316
2008020399,9,3884,0.0,40,36,6,0,4,90.0
2008020400,7,3584,0.0,32,29,11,0,3,90.625
2008020400,5,3520,0.0,29,25,7,2,4,86.20689655
2008020401,18,3562,0.0,25,20,3,0,5,80.0
2008020401,19,3582,0.0,21,18,0,0,3,85.71428571
2008020402,2,3550,0.0,25,21,2,1,4,84.0
2008020402,4,3596,0.0,27,24,7,2,3,88.88888889
2008020403,20,3571,0.0,31,27,9,1,4,87.09677419
2008020403,8,3587,0.0,33,32,5,0,1,96.96969697
2008020404,23,3584,0.0,21,20,7,2,1,95.23809524
2008020404,18,3545,0.0,27,25,10,2,2,92.59259259
2008020405,14,3557,0.0,36,33,6,1,3,91.66666667
2008020405,7,3598,2.0,28,26,7,2,2,92.85714286
2008020406,5,3571,0.0,31,28,8,0,3,90.32258065
2008020406,1,3600,2.0,27,26,4,1,1,96.2962963
2008020407,6,3591,0.0,25,23,1,0,2,92.0
2008020407,15,3600,0.0,34,33,6,0,1,97.05882353
2008020408,3,3618,0.0,29,27,3,0,2,93.10344828
2008020408,11,3617,0.0,33,30,0,1,3,90.90909091
2008020409,20,3817,2.0,39,35,8,0,4,89.74358974
2008020409,17,3830,0.0,32,29,3,2,3,90.625
2008020410,9,3546,0.0,29,28,4,0,1,96.55172414
2008020410,16,3586,0.0,23,23,11,0,0,100.0
2008020411,27,3586,0.0,32,29,8,2,3,90.625
2008020411,25,3548,0.0,33,29,9,0,4,87.87878788
2008020412,26,3569,0.0,26,20,2,2,6,76.92307692
2008020412,21,3600,0.0,30,29,9,1,1,96.66666667
2008020413,19,2716,0.0,24,22,8,0,2,91.66666667
2008020413,19,805,0.0,11,10,2,0,1,90.90909091
2008020413,24,3597,0.0,28,26,9,0,2,92.85714286
2008020414,12,3890,0.0,37,32,9,1,5,86.48648649
2008020414,4,3891,0.0,31,26,10,1,5,83.87096774
2008020415,18,3900,0.0,36,35,7,0,1,97.22222222
2008020415,29,3896,0.0,26,25,2,1,1,96.15384615
2008020416,14,3600,0.0,32,31,7,1,1,96.875
2008020416,8,3501,0.0,22,19,7,0,3,86.36363636
2008020417,2,2400,0.0,19,14,4,1,5,73.68421053
2008020417,2,1200,0.0,19,15,9,0,4,78.94736842
2008020417,5,3585,0.0,26,24,4,2,2,92.30769231
2008020418,13,3600,0.0,41,41,4,0,0,100.0
2008020418,22,3510,0.0,15,14,1,1,1,93.33333333
2008020419,30,3590,0.0,32,29,11,0,3,90.625
2008020419,27,3600,0.0,31,30,10,1,1,96.77419355
2008020420,19,2393,0.0,24,20,5,1,4,83.33333333
2008020420,19,1200,0.0,8,6,2,0,2,75.0
2008020420,26,3598,0.0,28,26,4,0,2,92.85714286
2008020421,24,3466,0.0,27,25,2,0,2,92.59259259
2008020421,28,3600,0.0,31,31,2,2,0,100.0
2008020422,3,3590,0.0,34,26,3,2,8,76.47058824
2008020422,1,3600,0.0,36,31,9,0,5,86.11111111
2008020423,9,3600,0.0,34,29,7,0,5,85.29411765
2008020423,15,3600,0.0,33,32,6,1,1,96.96969697
2008020424,10,3597,0.0,25,24,2,0,1,96.0
2008020424,7,3566,0.0,33,31,5,2,2,93.93939394
2008020425,6,3600,0.0,33,30,3,1,3,90.90909091
2008020425,11,1048,0.0,5,2,0,0,3,40.0
2008020425,11,2552,0.0,20,16,4,0,4,80.0
2008020426,17,3591,0.0,23,21,8,1,2,91.30434783
2008020426,25,3591,0.0,38,37,5,0,1,97.36842105
2008020427,16,3600,0.0,21,18,5,1,3,85.71428571
2008020427,21,3507,0.0,30,26,3,1,4,86.66666667
2008020428,13,3895,0.0,37,35,8,0,2,94.59459459
2008020428,20,3897,0.0,29,27,3,1,2,93.10344828
2008020429,5,3600,0.0,27,21,5,4,6,77.77777778
2008020429,4,3600,0.0,26,23,4,0,3,88.46153846
2008020430,30,3586,0.0,42,40,13,2,2,95.23809524
2008020430,26,3593,0.0,34,33,7,2,1,97.05882353
2008020431,11,3495,0.0,29,25,6,0,4,86.20689655
2008020431,6,3588,0.0,22,20,1,1,2,90.90909091
2008020432,15,3600,0.0,33,32,7,3,1,96.96969697
2008020432,8,3593,0.0,26,24,2,1,2,92.30769231
2008020433,14,3543,0.0,32,31,10,4,1,96.875
2008020433,9,3590,0.0,24,24,4,3,0,100.0
2008020434,7,3600,0.0,22,20,0,0,2,90.90909091
2008020434,1,3478,0.0,34,30,2,0,4,88.23529412
2008020435,12,3895,0.0,29,27,3,2,2,93.10344828
2008020435,3,3900,0.0,31,29,8,0,2,93.5483871
2008020436,2,3528,0.0,35,32,1,0,3,91.42857143
2008020436,29,3597,0.0,25,24,7,0,1,96.0
2008020437,25,3578,0.0,37,35,2,3,2,94.59459459
2008020437,18,3600,0.0,27,27,5,1,0,100.0
2008020438,17,3837,0.0,28,24,3,0,4,85.71428571
2008020438,27,3890,0.0,38,34,3,3,4,89.47368421
2008020439,23,3600,0.0,29,26,4,0,3,89.65517241
2008020439,22,3585,0.0,23,23,2,1,0,100.0
2008020440,19,3527,0.0,38,33,15,1,5,86.84210526
2008020440,28,3586,0.0,33,29,11,0,4,87.87878788
2008020441,29,3542,0.0,30,28,6,0,2,93.33333333
2008020441,16,3600,0.0,32,31,5,4,1,96.875
2008020442,30,3490,0.0,34,30,12,3,4,88.23529412
2008020442,24,3600,0.0,28,26,4,3,2,92.85714286
2008020443,13,3526,0.0,30,25,6,1,5,83.33333333
2008020443,23,3600,0.0,21,18,2,1,3,85.71428571
2008020444,21,3600,0.0,36,34,9,1,2,94.44444444
2008020444,17,3525,0.0,27,24,4,0,3,88.88888889
2008020445,28,3885,0.0,28,26,4,0,2,92.85714286
2008020445,26,2286,0.0,14,13,0,0,1,92.85714286
2008020445,26,1599,0.0,11,10,0,1,1,90.90909091
2008020446,15,3889,0.0,39,35,6,0,4,89.74358974
2008020446,2,3889,0.0,40,35,5,0,5,87.5
2008020447,21,3587,0.0,24,19,1,0,5,79.16666667
2008020447,4,3598,0.0,31,29,5,0,2,93.5483871
2008020448,8,3566,0.0,27,24,12,0,3,88.88888889
2008020448,12,3574,0.0,24,22,3,2,2,91.66666667
2008020449,1,3900,0.0,27,25,0,0,2,92.59259259
2008020449,10,3900,0.0,27,25,6,0,2,92.59259259
2008020450,11,3600,0.0,29,28,5,1,1,96.55172414
2008020450,9,3571,2.0,24,21,2,3,3,87.5
2008020451,20,3600,0.0,31,28,5,0,3,90.32258065
2008020451,19,3589,0.0,31,25,6,0,6,80.64516129
2008020452,27,3819,0.0,30,28,3,1,2,93.33333333
2008020452,25,3819,0.0,23,22,6,1,1,95.65217391
2008020453,16,3592,0.0,33,31,9,1,2,93.93939394
2008020453,22,1654,0.0,23,19,3,1,4,82.60869565
2008020453,22,1946,0.0,21,16,3,1,5,76.19047619
2008020454,3,3600,0.0,20,19,3,0,1,95.0
2008020454,24,3569,0.0,29,27,4,0,2,93.10344828
2008020455,1,3600,0.0,26,23,6,0,3,88.46153846
2008020455,7,3510,0.0,30,25,8,1,5,83.33333333
2008020456,28,3743,0.0,32,30,3,1,2,93.75
2008020456,29,3763,0.0,48,47,5,0,1,97.91666667
2008020457,20,3828,0.0,27,25,4,0,2,92.59259259
2008020457,30,3828,0.0,30,27,7,3,3,90.0
2008020458,22,3538,0.0,27,24,8,1,3,88.88888889
2008020458,23,3568,0.0,24,22,6,0,2,91.66666667
2008020459,3,3814,2.0,41,39,4,1,2,95.12195122
2008020459,26,3793,0.0,30,27,3,0,3,90.0
2008020460,10,2109,0.0,16,12,1,1,4,75.0
2008020460,10,1455,0.0,11,7,1,0,4,63.63636364
2008020460,6,1198,0.0,13,13,1,0,0,100.0
2008020460,6,2400,2.0,23,18,4,0,5,78.26086957
2008020461,19,3414,0.0,29,25,3,0,4,86.20689655
2008020461,15,3599,2.0,31,29,5,1,2,93.5483871
2008020462,13,3856,0.0,37,35,3,0,2,94.59459459
2008020462,12,3856,0.0,20,19,1,1,1,95.0
2008020463,5,3600,0.0,31,28,2,1,3,90.32258065
2008020463,11,1677,0.0,13,8,0,0,5,61.53846154
2008020463,11,1847,0.0,6,6,1,0,0,100.0
2008020464,4,3561,0.0,31,26,9,0,5,83.87096774
2008020464,8,3600,0.0,31,29,2,1,2,93.5483871
2008020465,21,3900,0.0,38,37,2,1,1,97.36842105
2008020465,14,3900,10.0,35,34,7,0,1,97.14285714
2008020466,28,3600,0.0,28,22,5,0,6,78.57142857
2008020466,17,3600,0.0,24,24,2,2,0,100.0
2008020467,29,3897,0.0,17,12,2,1,5,70.58823529
2008020467,25,3900,0.0,28,23,0,0,5,82.14285714
2008020468,18,3528,0.0,27,25,1,1,2,92.59259259
2008020468,27,3600,0.0,31,30,6,0,1,96.77419355
2008020469,9,3600,0.0,26,21,5,1,5,80.76923077
2008020469,1,3600,0.0,25,24,5,2,1,96.0
2008020470,26,2581,0.0,14,10,0,0,4,71.42857143
2008020470,26,1019,0.0,8,7,3,0,1,87.5
2008020470,7,3600,0.0,40,40,1,1,0,100.0
2008020471,2,3600,0.0,39,35,7,1,4,89.74358974
2008020471,30,3600,0.0,16,15,2,1,1,93.75
2008020472,16,3623,0.0,34,32,6,0,2,94.11764706
2008020472,20,3618,0.0,31,28,6,2,3,90.32258065
2008020473,24,3896,0.0,53,51,23,4,2,96.22641509
2008020473,22,3878,0.0,36,34,11,3,2,94.44444444
2008020474,12,3540,0.0,35,32,2,2,3,91.42857143
2008020474,6,3600,0.0,34,32,2,1,2,94.11764706
2008020475,15,2400,0.0,13,10,1,1,3,76.92307692
2008020475,15,1200,0.0,15,11,4,0,4,73.33333333
2008020475,4,3598,0.0,48,47,19,2,1,97.91666667
2008020476,7,3862,0.0,46,42,10,0,4,91.30434783
2008020476,8,3873,0.0,34,31,4,0,3,91.17647059
2008020477,25,3810,0.0,33,28,9,2,5,84.84848485
2008020477,9,3784,0.0,29,25,3,4,4,86.20689655
2008020478,10,3575,0.0,23,20,4,0,3,86.95652174
2008020478,5,1197,0.0,7,5,3,0,2,71.42857143
2008020478,5,2400,0.0,33,28,3,0,5,84.84848485
2008020479,14,3544,0.0,30,26,7,1,4,86.66666667
2008020479,11,3600,0.0,39,36,8,0,3,92.30769231
2008020480,26,3573,0.0,35,30,4,3,5,85.71428571
2008020480,17,3591,0.0,26,22,4,0,4,84.61538462
2008020481,2,3515,0.0,28,27,2,0,1,96.42857143
2008020481,18,3600,0.0,23,23,0,0,0,100.0
2008020482,30,3545,0.0,23,20,1,1,3,86.95652174
2008020482,19,3587,0.0,26,24,10,0,2,92.30769231
2008020483,29,3474,0.0,24,22,3,0,2,91.66666667
2008020483,27,3600,0.0,33,33,2,0,0,100.0
2008020484,16,3597,0.0,31,30,9,2,1,96.77419355
2008020484,23,3560,0.0,33,31,4,0,2,93.93939394
2008020485,3,3558,0.0,30,27,9,0,3,90.0
2008020485,28,3600,0.0,34,32,6,0,2,94.11764706
2008020486,21,3578,0.0,23,21,10,0,2,91.30434783
2008020486,13,3599,0.0,23,23,2,0,0,100.0
2008020487,6,3581,2.0,32,29,6,0,3,90.625
2008020487,19,1200,0.0,5,4,0,0,1,80.0
2008020487,19,2400,0.0,23,18,3,1,5,78.26086957
2008020488,12,3703,0.0,28,26,4,0,2,92.85714286
2008020488,8,3703,0.0,27,24,2,0,3,88.88888889
2008020489,4,3877,0.0,26,24,5,0,2,92.30769231
2008020489,1,3874,0.0,29,27,1,2,2,93.10344828
2008020490,5,3640,0.0,35,32,16,0,3,91.42857143
2008020490,7,3643,0.0,22,18,0,1,4,81.81818182
2008020491,10,3593,0.0,21,19,1,1,2,90.47619048
2008020491,11,3566,0.0,37,32,8,1,5,86.48648649
2008020492,27,3567,0.0,27,23,5,0,4,85.18518519
2008020492,22,3587,0.0,29,27,5,2,2,93.10344828
2008020493,24,3516,0.0,26,22,11,0,4,84.61538462
2008020493,23,3600,0.0,27,24,9,1,3,88.88888889
2008020494,6,3599,0.0,25,25,2,0,0,100.0
2008020494,1,3579,0.0,23,22,6,0,1,95.65217391
2008020495,11,3600,0.0,25,23,7,0,2,92.0
2008020495,2,3539,0.0,26,23,6,0,3,88.46153846
2008020496,15,525,0.0,3,3,0,0,0,100.0
2008020496,15,3123,0.0,25,21,4,0,4,84.0
2008020496,3,3659,0.0,36,31,7,0,5,86.11111111
2008020497,9,3545,0.0,31,26,3,0,5,83.87096774
2008020497,4,3600,0.0,21,17,0,0,4,80.95238095
2008020498,26,3600,0.0,24,24,4,1,0,100.0
2008020498,29,3579,0.0,42,39,10,0,3,92.85714286
2008020499,25,3600,0.0,22,20,0,0,2,90.90909091
2008020499,10,1705,0.0,10,9,0,0,1,90.0
2008020499,10,1895,0.0,27,20,0,0,7,74.07407407
2008020500,14,3600,0.0,15,15,5,1,0,100.0
2008020500,5,3515,0.0,29,27,8,0,2,93.10344828
2008020501,18,3535,0.0,42,40,6,1,2,95.23809524
2008020501,13,3600,0.0,27,27,2,1,0,100.0
2008020502,19,3592,0.0,41,37,4,1,4,90.24390244
2008020502,17,3600,0.0,34,33,10,2,1,97.05882353
2008020503,12,3545,0.0,23,20,0,3,3,86.95652174
2008020503,30,3600,0.0,37,35,11,0,2,94.59459459
2008020504,27,3664,0.0,48,43,13,3,5,89.58333333
2008020504,21,3708,0.0,23,19,3,0,4,82.60869565
2008020505,24,3525,0.0,32,28,5,0,4,87.5
2008020505,20,3558,0.0,33,30,1,2,3,90.90909091
2008020506,23,2357,0.0,16,16,1,1,0,100.0
2008020506,23,1243,0.0,15,10,3,0,5,66.66666667
2008020506,28,3589,0.0,33,33,4,1,0,100.0
2008020507,5,3587,2.0,37,37,10,2,0,100.0
2008020507,1,3537,0.0,18,17,2,1,1,94.44444444
2008020508,10,3596,0.0,31,27,1,4,4,87.09677419
2008020508,2,3600,2.0,29,28,11,0,1,96.55172414
2008020509,7,3538,0.0,34,31,8,0,3,91.17647059
2008020509,15,3600,0.0,24,22,1,1,2,91.66666667
2008020510,12,3600,0.0,31,27,7,3,4,87.09677419
2008020510,11,3527,0.0,39,34,4,0,5,87.17948718
2008020511,14,3887,0.0,28,25,1,1,3,89.28571429
2008020511,13,1422,0.0,8,8,4,0,0,100.0
2008020511,13,2400,0.0,27,24,3,0,3,88.88888889
2008020512,17,3512,0.0,31,28,4,0,3,90.32258065
2008020512,18,3581,0.0,40,38,4,2,2,95.0
2008020513,4,3598,0.0,38,33,7,0,5,86.84210526
2008020513,16,3568,0.0,18,17,1,0,1,94.44444444
2008020514,22,3566,0.0,28,26,8,0,2,92.85714286
2008020514,23,3509,0.0,23,20,8,1,3,86.95652174
2008020515,27,3587,0.0,25,24,2,1,1,96.0
2008020515,26,3517,0.0,26,24,3,0,2,92.30769231
2008020516,2,3767,0.0,37,34,10,0,3,91.89189189
2008020516,7,3900,0.0,35,32,6,4,3,91.42857143
2008020517,8,3600,0.0,34,32,8,1,2,94.11764706
2008020517,5,3536,0.0,19,16,2,2,3,84.21052632
2008020518,6,3598,0.0,31,29,3,0,2,93.5483871
2008020518,12,3539,0.0,21,18,5,2,3,85.71428571
2008020519,4,3600,0.0,33,30,11,2,3,90.90909091
2008020519,29,3591,0.0,20,20,4,2,0,100.0
2008020520,1,3574,0.0,33,31,9,1,2,93.93939394
2008020520,3,3600,0.0,35,31,9,0,4,88.57142857
2008020521,13,3477,0.0,42,36,8,0,6,85.71428571
2008020521,14,3597,0.0,29,25,7,0,4,86.20689655
2008020522,24,3814,0.0,38,34,13,0,4,89.47368421
2008020522,25,3797,0.0,22,19,3,1,3,86.36363636
2008020523,28,3884,0.0,28,26,5,1,2,92.85714286
2008020523,19,3900,0.0,26,24,3,0,2,92.30769231
2008020524,17,3897,0.0,32,29,7,2,3,90.625
2008020524,21,3900,0.0,44,41,10,4,3,93.18181818
2008020525,26,3600,0.0,26,26,13,1,0,100.0
2008020525,27,3599,0.0,30,26,6,1,4,86.66666667
2008020526,9,3572,0.0,41,36,7,0,5,87.80487805
2008020526,20,3588,0.0,30,27,6,0,3,90.0
2008020527,6,3578,0.0,33,32,12,1,1,96.96969697
2008020527,11,3548,0.0,28,26,5,0,2,92.85714286
2008020528,24,3595,0.0,30,27,7,0,3,90.0
2008020528,19,3523,0.0,29,25,4,1,4,86.20689655
2008020529,16,3597,0.0,19,18,4,1,1,94.73684211
2008020529,30,3545,0.0,31,28,2,0,3,90.32258065
2008020530,10,3563,0.0,28,25,0,0,3,89.28571429
2008020530,15,3600,2.0,24,23,4,0,1,95.83333333
2008020531,18,1890,0.0,17,13,0,0,4,76.47058824
2008020531,18,1710,0.0,16,15,7,0,1,93.75
2008020531,22,3600,0.0,30,28,0,1,2,93.33333333
2008020532,9,3572,2.0,32,29,7,3,3,90.625
2008020532,23,3600,0.0,18,18,1,1,0,100.0
2008020533,2,3540,0.0,37,32,4,2,5,86.48648649
2008020533,3,3560,0.0,24,20,2,0,4,83.33333333
2008020534,8,3597,0.0,28,26,5,3,2,92.85714286
2008020534,13,2560,0.0,20,16,4,0,4,80.0
2008020534,13,974,0.0,8,8,3,0,0,100.0
2008020535,28,3600,0.0,29,28,6,2,1,96.55172414
2008020535,25,3571,0.0,18,16,6,2,2,88.88888889
2008020536,18,3598,0.0,21,16,1,0,5,76.19047619
2008020536,21,3591,0.0,26,25,5,0,1,96.15384615
2008020537,30,3530,0.0,29,27,5,1,2,93.10344828
2008020537,20,3600,0.0,24,23,8,1,1,95.83333333
2008020538,29,3600,0.0,24,24,6,0,0,100.0
2008020538,26,3495,0.0,24,23,3,0,1,95.83333333
2008020539,15,3593,0.0,33,31,5,1,2,93.93939394
2008020539,7,3576,0.0,30,27,8,1,3,90.0
2008020540,11,3629,0.0,47,43,9,0,4,91.4893617
2008020540,10,3633,0.0,32,29,6,1,3,90.625
2008020541,6,3592,0.0,34,32,7,3,2,94.11764706
2008020541,5,3600,0.0,40,35,11,0,5,87.5
2008020542,8,3884,0.0,22,21,6,3,1,95.45454545
2008020542,14,3900,0.0,30,29,6,0,1,96.66666667
2008020543,16,3600,0.0,39,35,12,3,4,89.74358974
2008020543,17,3599,0.0,36,36,16,0,0,100.0
2008020544,1,3600,0.0,31,28,1,1,3,90.32258065
2008020544,19,3459,0.0,26,22,3,0,4,84.61538462
2008020545,9,3583,0.0,22,20,0,0,2,90.90909091
2008020545,22,3509,0.0,25,22,3,0,3,88.0
2008020546,4,3600,0.0,31,29,2,1,2,93.5483871
2008020546,23,1200,0.0,9,7,0,0,2,77.77777778
2008020546,23,2321,0.0,20,19,1,0,1,95.0
2008020547,13,1145,0.0,13,12,5,0,1,92.30769231
2008020547,13,2389,0.0,22,19,2,0,3,86.36363636
2008020547,2,3598,0.0,29,27,6,3,2,93.10344828
2008020548,28,3654,0.0,32,29,3,1,3,90.625
2008020548,30,3689,2.0,34,32,3,0,2,94.11764706
2008020549,11,3561,0.0,28,25,5,0,3,89.28571429
2008020549,12,3600,0.0,21,20,2,1,1,95.23809524
2008020550,21,3590,0.0,29,26,4,0,3,89.65517241
2008020550,27,3600,0.0,29,28,4,0,1,96.55172414
2008020551,1,3576,0.0,43,40,10,0,3,93.02325581
2008020551,25,3600,0.0,27,25,4,0,2,92.59259259
2008020552,29,3600,0.0,27,27,11,0,0,100.0
2008020552,24,3451,0.0,29,27,7,2,2,93.10344828
2008020553,22,3538,0.0,36,31,10,0,5,86.11111111
2008020553,20,3589,0.0,32,28,7,1,4,87.5
2008020554,17,3600,0.0,37,33,5,1,4,89.18918919
2008020554,16,996,0.0,13,13,0,0,0,100.0
2008020554,16,2604,0.0,30,24,7,0,6,80.0
2008020555,5,3559,0.0,25,22,7,0,3,88.0
2008020555,6,3594,0.0,32,30,6,0,2,93.75
2008020556,7,3600,0.0,28,27,11,0,1,96.42857143
2008020556,10,3600,0.0,20,16,2,1,4,80.0
2008020557,14,3600,0.0,35,28,4,0,7,80.0
2008020557,15,3600,0.0,27,23,4,1,4,85.18518519
2008020558,23,3597,0.0,32,31,5,1,1,96.875
2008020558,18,3506,0.0,32,30,4,0,2,93.75
2008020559,8,1200,0.0,7,6,2,1,1,85.71428571
2008020559,8,2400,0.0,22,19,2,1,3,86.36363636
2008020559,1,3600,0.0,34,33,7,1,1,97.05882353
2008020560,19,3545,0.0,28,26,8,0,2,92.85714286
2008020560,19,28,0.0,1,1,0,0,0,100.0
2008020560,12,3600,0.0,31,30,2,0,1,96.77419355
2008020561,23,3892,0.0,37,34,4,0,3,91.89189189
2008020561,11,3900,0.0,38,35,3,0,3,92.10526316
2008020562,29,3558,0.0,24,23,7,0,1,95.83333333
2008020562,21,3598,0.0,30,24,7,0,6,80.0
2008020563,2,3464,0.0,33,28,5,0,5,84.84848485
2008020563,27,3600,0.0,33,29,1,0,4,87.87878788
2008020564,4,3900,0.0,27,23,3,1,4,85.18518519
2008020564,24,3900,0.0,32,28,7,1,4,87.5
2008020565,7,3595,0.0,31,29,8,2,2,93.5483871
2008020565,6,3521,0.0,25,21,3,1,4,84.0
2008020566,13,3600,2.0,30,29,3,3,1,96.66666667
2008020566,5,1200,0.0,12,9,5,0,3,75.0
2008020566,5,2400,0.0,12,9,3,0,3,75.0
2008020567,20,3575,0.0,26,24,8,2,2,92.30769231
2008020567,18,3594,0.0,26,23,3,1,3,88.46153846
2008020568,9,3530,2.0,30,27,6,0,3,90.0
2008020568,10,3585,0.0,31,30,7,3,1,96.77419355
2008020569,3,3547,0.0,31,29,7,1,2,93.5483871
2008020569,15,3600,0.0,22,21,2,2,1,95.45454545
2008020570,12,3600,0.0,19,17,3,0,2,89.47368421
2008020570,14,3511,0.0,28,25,3,0,3,89.28571429
2008020571,17,3883,0.0,35,33,10,0,2,94.28571429
2008020571,30,3900,2.0,37,35,3,1,2,94.59459459
2008020572,29,3600,0.0,27,22,5,0,5,81.48148148
2008020572,19,3590,0.0,22,20,5,2,2,90.90909091
2008020573,25,3578,0.0,19,15,3,0,4,78.94736842
2008020573,22,3561,2.0,39,38,6,1,1,97.43589744
2008020574,4,3900,0.0,31,30,9,1,1,96.77419355
2008020574,26,3900,0.0,32,31,6,2,1,96.875
2008020575,2,3565,0.0,46,42,2,1,4,91.30434783
2008020575,28,3600,0.0,24,21,1,0,3,87.5
2008020576,13,3891,0.0,45,40,8,0,5,88.88888889
2008020576,8,3893,0.0,35,30,3,2,5,85.71428571
2008020577,14,3593,0.0,28,27,2,0,1,96.42857143
2008020577,11,3579,0.0,35,31,1,1,4,88.57142857
2008020578,9,3703,0.0,35,31,9,3,4,88.57142857
2008020578,1,3703,0.0,20,17,4,0,3,85.0
2008020579,20,1163,0.0,7,7,2,0,0,100.0
2008020579,20,2400,0.0,28,24,3,0,4,85.71428571
2008020579,16,3598,0.0,36,34,7,0,2,94.44444444
2008020580,30,3595,0.0,33,33,4,4,0,100.0
2008020580,21,3600,0.0,37,35,8,0,2,94.59459459
2008020581,27,3522,0.0,34,32,8,1,2,94.11764706
2008020581,24,3594,0.0,29,29,12,0,0,100.0
2008020582,25,3900,0.0,35,33,1,0,2,94.28571429
2008020582,23,3889,0.0,36,34,5,0,2,94.44444444
2008020583,5,3562,0.0,25,22,6,2,3,88.0
2008020583,3,3600,0.0,27,27,11,0,0,100.0
2008020584,2,3536,0.0,26,23,5,1,3,88.46153846
2008020584,22,3599,0.0,27,25,2,1,2,92.59259259
2008020585,30,3600,0.0,28,28,2,1,0,100.0
2008020585,6,3527,0.0,24,23,9,0,1,95.83333333
2008020586,9,3557,0.0,25,22,5,0,3,88.0
2008020586,7,3600,0.0,33,31,2,1,2,93.93939394
2008020587,4,3896,0.0,34,33,7,0,1,97.05882353
2008020587,15,3898,0.0,34,33,8,1,1,97.05882353
2008020588,1,3360,0.0,28,25,3,0,3,89.28571429
2008020588,12,3600,0.0,28,26,2,0,2,92.85714286
2008020589,13,3600,0.0,26,24,4,1,2,92.30769231
2008020589,10,3476,0.0,34,30,4,2,4,88.23529412
2008020590,11,3557,0.0,29,26,6,0,3,89.65517241
2008020590,5,3600,0.0,28,27,4,0,1,96.42857143
2008020591,29,3559,0.0,39,37,10,1,2,94.87179487
2008020591,17,3589,0.0,23,23,2,0,0,100.0
2008020592,21,3600,0.0,23,22,2,0,1,95.65217391
2008020592,18,3600,0.0,21,19,3,1,2,90.47619048
2008020593,28,2314,0.0,10,9,0,2,1,90.0
2008020593,28,1286,0.0,18,14,0,0,4,77.77777778
2008020593,20,3598,0.0,28,26,8,2,2,92.85714286
2008020594,16,3595,0.0,22,22,13,1,0,100.0
2008020594,27,2400,0.0,28,26,9,2,2,92.85714286
2008020594,27,1200,0.0,13,9,0,0,4,69.23076923
2008020595,26,3531,0.0,25,23,5,0,2,92.0
2008020595,24,3556,0.0,18,17,3,0,1,94.44444444
2008020596,8,3600,0.0,39,36,3,0,3,92.30769231
2008020596,3,3502,0.0,24,19,3,0,5,79.16666667
2008020597,23,3577,0.0,25,23,5,1,2,92.0
2008020597,22,3551,0.0,21,18,2,0,3,85.71428571
2008020598,9,3545,0.0,21,16,2,0,5,76.19047619
2008020598,6,3600,0.0,30,26,0,0,4,86.66666667
2008020599,11,3600,0.0,29,29,10,0,0,100.0
2008020599,1,1200,0.0,5,4,4,0,1,80.0
2008020599,1,2400,0.0,19,16,2,1,3,84.21052632
2008020600,30,3540,0.0,23,20,0,4,3,86.95652174
2008020600,4,3600,0.0,28,27,9,0,1,96.42857143
2008020601,10,1200,0.0,8,7,0,1,1,87.5
2008020601,10,2400,0.0,21,16,6,0,5,76.19047619
2008020601,8,3600,0.0,32,30,4,5,2,93.75
2008020602,12,3553,0.0,30,27,3,0,3,90.0
2008020602,13,3600,0.0,33,31,0,0,2,93.93939394
2008020603,25,1200,0.0,15,13,3,1,2,86.66666667
2008020603,25,2400,0.0,18,14,1,0,4,77.77777778
2008020603,17,3598,0.0,23,22,2,1,1,95.65217391
2008020604,5,3552,0.0,34,30,3,2,4,88.23529412
2008020604,18,1409,0.0,7,5,0,0,2,71.42857143
2008020604,18,2191,0.0,18,17,1,0,1,94.44444444
2008020605,16,3508,0.0,32,30,8,0,2,93.75
2008020605,21,3600,0.0,44,43,0,4,1,97.72727273
2008020606,2,3600,0.0,41,36,11,1,5,87.80487805
2008020606,20,3600,0.0,26,24,5,0,2,92.30769231
2008020607,14,3566,0.0,27,24,4,0,3,88.88888889
2008020607,27,3599,2.0,24,22,3,1,2,91.66666667
2008020608,24,1237,0.0,10,8,1,2,2,80.0
2008020608,24,2272,0.0,16,14,3,0,2,87.5
2008020608,26,3598,0.0,27,24,13,0,3,88.88888889
2008020609,29,3600,0.0,45,45,16,1,0,100.0
2008020609,15,3592,0.0,23,20,9,0,3,86.95652174
2008020610,3,3900,0.0,33,32,0,0,1,96.96969697
2008020610,7,3900,0.0,44,43,6,0,1,97.72727273
2008020611,28,3600,2.0,26,25,7,1,1,96.15384615
2008020611,22,1200,0.0,10,7,0,1,3,70.0
2008020611,22,2397,0.0,21,20,5,0,1,95.23809524
2008020612,19,3600,0.0,22,18,0,0,4,81.81818182
2008020612,23,3600,0.0,36,30,3,0,6,83.33333333
2008020613,14,3583,0.0,32,29,8,0,3,90.625
2008020613,24,3528,0.0,19,15,2,0,4,78.94736842
2008020614,12,2190,0.0,20,18,1,1,2,90.0
2008020614,12,1407,0.0,12,9,3,0,3,75.0
2008020614,6,3593,0.0,30,29,4,0,1,96.66666667
2008020615,5,2400,0.0,25,21,0,0,4,84.0
2008020615,5,1121,0.0,7,6,2,0,1,85.71428571
2008020615,21,3600,0.0,24,21,0,0,3,87.5
2008020616,15,3578,0.0,35,30,11,0,5,85.71428571
2008020616,8,3600,0.0,35,31,7,0,4,88.57142857
2008020617,3,3600,0.0,33,33,7,1,0,100.0
2008020617,9,3480,0.0,27,25,1,0,2,92.59259259
2008020618,10,3574,0.0,29,26,2,5,3,89.65517241
2008020618,4,3589,0.0,42,41,7,0,1,97.61904762
2008020619,11,479,0.0,2,1,0,0,1,50.0
2008020619,11,3121,0.0,27,20,6,0,7,74.07407407
2008020619,13,3560,0.0,32,28,10,1,4,87.5
2008020620,7,3552,0.0,48,45,6,0,3,93.75
2008020620,17,3600,0.0,22,21,1,1,1,95.45454545
2008020621,30,3586,0.0,32,28,3,1,4,87.5
2008020621,29,3600,0.0,23,21,3,0,2,91.30434783
2008020622,16,3503,0.0,37,34,5,3,3,91.89189189
2008020622,18,3600,0.0,35,34,3,0,1,97.14285714
2008020623,25,3900,0.0,28,28,4,1,0,100.0
2008020623,27,3900,0.0,38,38,9,3,0,100.0
2008020624,28,3597,0.0,26,24,7,0,2,92.30769231
2008020624,23,3525,2.0,27,23,5,2,4,85.18518519
2008020625,1,3600,0.0,35,34,7,0,1,97.14285714
2008020625,26,3594,0.0,28,23,4,0,5,82.14285714
2008020626,18,3532,0.0,32,30,3,1,2,93.75
2008020626,16,3581,0.0,27,26,3,1,1,96.2962963
2008020627,19,3521,0.0,28,26,8,4,2,92.85714286
2008020627,22,3600,0.0,22,21,6,0,1,95.45454545
2008020628,1,3540,0.0,34,30,5,0,4,88.23529412
2008020628,24,3597,0.0,21,18,5,2,3,85.71428571
2008020629,17,3711,6.0,49,44,9,1,5,89.79591837
2008020629,25,3664,2.0,30,26,11,0,4,86.66666667
2008020630,14,3600,0.0,30,29,7,2,1,96.66666667
2008020630,26,1903,0.0,15,15,6,0,0,100.0
2008020630,26,1548,0.0,7,4,0,0,3,57.14285714
2008020631,8,3544,0.0,29,26,6,1,3,89.65517241
2008020631,6,3597,2.0,35,34,8,0,1,97.14285714
2008020632,3,3600,0.0,34,33,2,0,1,97.05882353
2008020632,2,3197,0.0,26,24,1,1,2,92.30769231
2008020632,2,310,0.0,3,3,0,0,0,100.0
2008020633,5,3600,0.0,29,27,0,1,2,93.10344828
2008020633,4,3553,0.0,26,22,2,0,4,84.61538462
2008020634,22,3597,0.0,36,34,2,2,2,94.44444444
2008020634,15,3492,0.0,22,18,4,1,4,81.81818182
2008020635,21,3543,0.0,27,23,4,0,4,85.18518519
2008020635,29,3600,0.0,26,23,2,0,3,88.46153846
2008020636,18,3600,0.0,17,17,4,1,0,100.0
2008020636,10,3567,0.0,23,21,3,1,2,91.30434783
2008020637,12,3600,0.0,40,35,14,0,5,87.5
2008020637,9,3581,0.0,24,23,2,0,1,95.83333333
2008020638,27,3598,0.0,34,28,6,0,6,82.35294118
2008020638,30,3587,0.0,24,21,0,2,3,87.5
2008020639,19,3559,0.0,34,31,5,2,3,91.17647059
2008020639,20,3600,0.0,28,27,2,1,1,96.42857143
2008020640,1,3600,0.0,29,26,3,0,3,89.65517241
2008020640,23,3337,0.0,21,19,1,0,2,90.47619048
2008020640,23,209,0.0,6,4,0,0,2,66.66666667
2008020641,14,3600,0.0,42,35,13,0,7,83.33333333
2008020641,28,3589,0.0,25,24,4,2,1,96.0
2008020642,15,3600,2.0,29,26,11,1,3,89.65517241
2008020642,5,3572,0.0,41,36,9,1,5,87.80487805
2008020643,9,3600,0.0,31,29,2,0,2,93.5483871
2008020643,11,3535,0.0,30,27,5,0,3,90.0
2008020644,7,3600,0.0,25,21,4,0,4,84.0
2008020644,16,3600,0.0,23,22,3,0,1,95.65217391
2008020645,17,3600,0.0,28,25,5,0,3,89.28571429
2008020645,24,3529,0.0,33,29,5,0,4,87.87878788
2008020646,6,3600,0.0,41,40,4,1,1,97.56097561
2008020646,2,3546,0.0,27,25,3,2,2,92.59259259
2008020647,10,3600,0.0,32,28,2,0,4,87.5
2008020647,12,3513,0.0,23,18,4,0,5,78.26086957
2008020648,18,3520,0.0,20,17,1,0,3,85.0
2008020648,8,3600,0.0,25,23,1,0,2,92.0
2008020649,4,3600,0.0,44,40,3,3,4,90.90909091
2008020649,14,3600,0.0,32,31,3,0,1,96.875
2008020650,22,3580,0.0,24,19,5,0,5,79.16666667
2008020650,30,3569,0.0,21,20,4,0,1,95.23809524
2008020651,21,3535,0.0,25,21,2,0,4,84.0
2008020651,19,3600,0.0,26,24,5,2,2,92.30769231
2008020652,7,3878,0.0,25,21,1,1,4,84.0
2008020652,25,3895,0.0,35,31,6,0,4,88.57142857
2008020653,27,3600,0.0,32,31,1,4,1,96.875
2008020653,23,3600,0.0,32,28,6,0,4,87.5
2008020654,17,3600,0.0,23,23,4,1,0,100.0
2008020654,26,3600,0.0,31,27,10,0,4,87.09677419
2008020655,20,3600,0.0,35,33,7,0,2,94.28571429
2008020655,28,3532,0.0,31,28,4,2,3,90.32258065
2008020656,1,3600,0.0,27,26,2,0,1,96.2962963
2008020656,29,3552,0.0,28,26,0,2,2,92.85714286
2008020657,24,3486,0.0,24,21,9,1,3,87.5
2008020657,5,3600,0.0,22,21,3,0,1,95.45454545
2008020658,10,3816,0.0,38,34,6,2,4,89.47368421
2008020658,11,1200,0.0,8,5,1,0,3,62.5
2008020658,11,2631,0.0,9,9,0,0,0,100.0
2008020659,4,3900,0.0,34,32,9,0,2,94.11764706
2008020659,13,3900,0.0,26,24,2,0,2,92.30769231
2008020660,3,3743,0.0,34,32,14,0,2,94.11764706
2008020660,16,3735,0.0,22,19,3,0,3,86.36363636
2008020661,22,3597,0.0,39,37,10,2,2,94.87179487
2008020661,21,3527,0.0,37,34,7,0,3,91.89189189
2008020662,26,3858,0.0,34,32,4,1,2,94.11764706
2008020662,25,3900,2.0,22,20,6,1,2,90.90909091
2008020663,12,3397,0.0,26,23,2,0,3,88.46153846
2008020663,7,3600,0.0,37,36,4,0,1,97.2972973
2008020664,8,3893,0.0,27,23,2,4,4,85.18518519
2008020664,9,3900,0.0,32,28,4,1,4,87.5
2008020665,1,3600,0.0,33,32,2,0,1,96.96969697
2008020665,2,3553,0.0,36,33,1,1,3,91.66666667
2008020666,6,3529,0.0,30,28,4,1,2,93.33333333
2008020666,15,3574,0.0,24,23,2,1,1,95.83333333
2008020667,13,1200,0.0,11,8,2,0,3,72.72727273
2008020667,13,2400,0.0,22,22,3,0,0,100.0
2008020667,14,3535,0.0,21,17,1,0,4,80.95238095
2008020668,11,3600,0.0,33,31,5,1,2,93.93939394
2008020668,18,648,0.0,4,1,0,0,3,25.0
2008020668,18,2952,0.0,28,24,3,2,4,85.71428571
2008020669,16,3683,0.0,28,27,11,0,1,96.42857143
2008020669,19,3672,0.0,21,19,2,0,2,90.47619048
2008020670,24,3600,0.0,30,30,6,0,0,100.0
2008020670,30,3598,0.0,34,31,2,1,3,91.17647059
2008020671,27,3598,0.0,32,29,3,1,3,90.625
2008020671,20,3559,0.0,26,22,2,1,4,84.61538462
2008020672,17,3528,0.0,41,35,8,1,6,85.36585366
2008020672,28,3594,0.0,34,29,7,0,5,85.29411765
2008020673,3,3600,0.0,23,20,6,0,3,86.95652174
2008020673,5,3600,0.0,33,33,4,2,0,100.0
2008020674,20,3592,0.0,39,33,11,1,6,84.61538462
2008020674,21,3599,0.0,41,39,8,0,2,95.12195122
2008020675,27,3525,0.0,28,23,2,1,5,82.14285714
2008020675,22,3598,0.0,28,25,2,0,3,89.28571429
2008020676,29,3900,0.0,30,25,4,0,5,83.33333333
2008020676,23,3900,0.0,28,23,2,1,5,82.14285714
2008020677,19,3113,0.0,24,21,3,0,3,87.5
2008020677,19,635,0.0,2,1,0,0,1,50.0
2008020677,6,3899,0.0,31,27,5,1,4,87.09677419
2008020678,15,3706,0.0,28,27,3,2,1,96.42857143
2008020678,2,3695,0.0,38,36,4,2,2,94.73684211
2008020679,12,3599,0.0,35,35,6,1,0,100.0
2008020679,10,3541,0.0,34,32,8,0,2,94.11764706
2008020680,25,3541,0.0,19,16,0,3,3,84.21052632
2008020680,14,3594,0.0,25,23,5,0,2,92.0
2008020681,7,3898,0.0,29,27,5,0,2,93.10344828
2008020681,13,3900,0.0,23,21,3,0,2,91.30434783
2008020682,30,3600,0.0,41,40,6,0,1,97.56097561
2008020682,16,3422,0.0,25,22,1,1,3,88.0
2008020683,1,3600,0.0,34,33,4,0,1,97.05882353
2008020683,18,3548,0.0,34,32,9,4,2,94.11764706
2008020684,24,3546,0.0,29,26,11,1,3,89.65517241
2008020684,3,3600,0.0,34,32,10,1,2,94.11764706
2008020685,8,1428,0.0,14,11,1,0,3,78.57142857
2008020685,8,2142,0.0,10,9,3,0,1,90.0
2008020685,11,3600,0.0,36,34,2,1,2,94.44444444
2008020686,15,3551,0.0,34,31,10,0,3,91.17647059
2008020686,9,3600,0.0,31,29,13,0,2,93.5483871
2008020687,12,3600,0.0,33,32,10,4,1,96.96969697
2008020687,5,3516,0.0,40,38,8,2,2,95.0
2008020688,26,3600,0.0,27,25,2,0,2,92.59259259
2008020688,30,1138,0.0,5,5,0,1,0,100.0
2008020688,30,2400,0.0,26,22,5,0,4,84.61538462
2008020689,29,3574,0.0,22,18,1,0,4,81.81818182
2008020689,22,3600,0.0,23,20,2,0,3,86.95652174
2008020690,17,3592,0.0,26,21,6,2,5,80.76923077
2008020690,27,3600,0.0,37,34,4,1,3,91.89189189
2008020691,23,3788,0.0,29,27,4,1,2,93.10344828
2008020691,28,3768,0.0,14,13,1,1,1,92.85714286
2008020692,8,3575,0.0,33,29,2,1,4,87.87878788
2008020692,1,3599,0.0,28,26,4,0,2,92.85714286
2008020693,24,875,0.0,7,5,0,0,2,71.42857143
2008020693,24,2646,0.0,7,7,0,1,0,100.0
2008020693,2,3600,0.0,40,39,11,0,1,97.5
2008020694,11,3519,0.0,32,28,3,2,4,87.5
2008020694,4,3596,0.0,31,28,5,2,3,90.32258065
2008020695,6,3892,0.0,34,31,7,1,3,91.17647059
2008020695,10,3891,0.0,30,27,3,0,3,90.0
2008020696,7,3504,0.0,26,21,2,0,5,80.76923077
2008020696,14,3599,0.0,34,31,9,1,3,91.17647059
2008020697,25,3596,0.0,28,27,1,0,1,96.42857143
2008020697,13,3499,0.0,24,21,2,0,3,87.5
2008020698,19,3600,0.0,21,21,5,0,0,100.0
2008020698,16,3501,0.0,29,27,8,0,2,93.10344828
2008020699,26,3600,0.0,41,36,8,1,5,87.80487805
2008020699,21,2043,0.0,13,11,0,0,2,84.61538462
2008020699,21,1501,0.0,15,11,0,0,4,73.33333333
2008020700,29,3894,0.0,31,27,7,3,4,87.09677419
2008020700,20,3888,0.0,33,29,6,2,4,87.87878788
2008020701,15,3715,0.0,28,25,6,1,3,89.28571429
2008020701,6,3712,0.0,36,34,14,2,2,94.44444444
2008020702,12,3571,0.0,31,28,6,2,3,90.32258065
2008020702,3,3600,0.0,35,33,8,0,2,94.28571429
2008020703,17,3781,0.0,23,20,2,0,3,86.95652174
2008020703,29,3806,0.0,23,21,0,0,2,91.30434783
2008020704,1,3600,0.0,22,21,5,2,1,95.45454545
2008020704,9,3595,0.0,27,23,7,2,4,85.18518519
2008020705,8,3579,0.0,24,19,5,0,5,79.16666667
2008020705,14,3585,0.0,34,31,7,4,3,91.17647059
2008020706,4,3493,0.0,27,24,10,0,3,88.88888889
2008020706,13,3600,0.0,35,33,6,2,2,94.28571429
2008020707,10,3600,0.0,21,15,1,0,6,71.42857143
2008020707,30,3600,0.0,28,27,0,3,1,96.42857143
2008020708,11,3544,0.0,33,31,6,1,2,93.93939394
2008020708,25,3598,0.0,25,25,3,2,0,100.0
2008020709,28,3600,0.0,31,31,3,1,0,100.0
2008020709,21,3577,0.0,37,35,3,0,2,94.59459459
2008020710,7,3567,0.0,38,36,14,1,2,94.73684211
2008020710,22,617,0.0,8,5,0,0,3,62.5
2008020710,22,2970,0.0,29,22,5,0,7,75.86206897
2008020711,24,3600,0.0,26,23,5,0,3,88.46153846
2008020711,27,3600,0.0,37,30,1,2,7,81.08108108
2008020712,3,3600,0.0,33,27,7,0,6,81.81818182
2008020712,5,3600,0.0,34,32,8,0,2,94.11764706
2008020713,7,3590,0.0,43,38,6,0,5,88.37209302
2008020713,20,3594,0.0,27,25,4,0,2,92.59259259
2008020714,16,3584,0.0,38,36,4,2,2,94.73684211
2008020714,24,3491,0.0,27,24,3,0,3,88.88888889
2008020715,18,3594,0.0,27,24,6,0,3,88.88888889
2008020715,23,3531,0.0,37,33,7,1,4,89.18918919
2008020716,1,3669,0.0,27,24,6,0,3,88.88888889
2008020716,6,3666,0.0,30,26,2,3,4,86.66666667
2008020717,14,3534,0.0,31,28,5,3,3,90.32258065
2008020717,12,3584,0.0,29,27,3,1,2,93.10344828
2008020718,2,3600,0.0,37,33,5,0,4,89.18918919
2008020718,11,2702,0.0,18,17,3,1,1,94.44444444
2008020718,11,797,0.0,15,11,0,0,4,73.33333333
2008020719,8,3595,0.0,36,31,3,0,5,86.11111111
2008020719,13,3588,0.0,36,35,6,0,1,97.22222222
2008020720,25,3567,0.0,24,22,5,1,2,91.66666667
2008020720,17,1200,0.0,12,9,2,0,3,75.0
2008020720,17,2318,0.0,11,10,2,0,1,90.90909091
2008020721,9,3585,0.0,23,22,0,3,1,95.65217391
2008020721,19,3561,0.0,29,27,6,2,2,93.10344828
2008020722,10,3600,0.0,20,16,2,0,4,80.0
2008020722,21,3600,0.0,30,23,6,0,7,76.66666667
2008020723,16,3558,0.0,25,21,1,0,4,84.0
2008020723,26,3598,0.0,33,31,3,0,2,93.93939394
2008020724,27,3507,0.0,28,27,4,1,1,96.42857143
2008020724,28,3600,2.0,24,24,9,2,0,100.0
2008020725,5,3840,0.0,43,39,9,0,4,90.69767442
2008020725,1,3833,0.0,16,13,2,0,3,81.25
2008020726,9,3529,0.0,26,25,4,2,1,96.15384615
2008020726,29,3580,0.0,17,17,9,0,0,100.0
2008020727,4,3600,0.0,42,41,20,3,1,97.61904762
2008020727,14,3181,0.0,30,24,1,4,6,80.0
2008020727,14,412,0.0,2,2,0,0,0,100.0
2008020728,18,3433,0.0,32,29,8,3,3,90.625
2008020728,20,3594,0.0,29,28,7,0,1,96.55172414
2008020729,30,2140,0.0,17,17,2,0,0,100.0
2008020729,30,1371,0.0,11,8,3,1,3,72.72727273
2008020729,22,3596,0.0,30,29,7,0,1,96.66666667
2008020730,17,3525,0.0,27,23,2,1,4,85.18518519
2008020730,15,3600,0.0,29,27,6,0,2,93.10344828
2008020731,3,3551,0.0,27,26,0,0,1,96.2962963
2008020731,6,3598,0.0,35,35,2,0,0,100.0
2008020732,26,3575,0.0,26,22,5,0,4,84.61538462
2008020732,8,3600,0.0,32,29,5,2,3,90.625
2008020733,24,3569,0.0,37,34,7,0,3,91.89189189
2008020733,21,3540,0.0,31,27,4,1,4,87.09677419
2008020734,5,3561,0.0,26,21,6,0,5,80.76923077
2008020734,10,3600,0.0,26,22,4,2,4,84.61538462
2008020735,13,3335,0.0,30,27,5,3,3,90.0
2008020735,2,3595,0.0,38,37,7,1,1,97.36842105
2008020736,25,3600,0.0,38,35,6,1,3,92.10526316
2008020736,29,2952,0.0,23,19,3,0,4,82.60869565
2008020736,29,643,0.0,8,5,0,0,3,62.5
2008020737,11,3600,0.0,40,38,3,2,2,95.0
2008020737,12,3597,0.0,19,19,5,3,0,100.0
2008020738,4,3569,0.0,35,31,7,4,4,88.57142857
2008020738,19,3595,0.0,36,36,10,3,0,100.0
2008020739,7,3566,0.0,28,28,8,2,0,100.0
2008020739,27,3468,0.0,21,19,1,0,2,90.47619048
2008020740,30,3712,0.0,40,37,13,1,3,92.5
2008020740,23,3645,0.0,27,23,8,1,4,85.18518519
2008020741,16,3592,0.0,34,32,11,0,2,94.11764706
2008020741,28,3498,2.0,29,25,1,1,4,86.20689655
2008020742,9,1335,0.0,16,12,1,0,4,75.0
2008020742,9,2177,0.0,13,11,3,0,2,84.61538462
2008020742,15,3596,0.0,38,34,4,2,4,89.47368421
2008020743,6,3596,0.0,28,27,6,1,1,96.42857143
2008020743,8,3576,0.0,22,20,4,0,2,90.90909091
2008020744,18,3600,2.0,33,32,1,0,1,96.96969697
2008020744,22,3495,0.0,29,27,4,3,2,93.10344828
2008020745,19,2019,0.0,13,13,0,0,0,100.0
2008020745,19,1873,0.0,8,5,2,1,3,62.5
2008020745,17,3900,0.0,33,30,10,0,3,90.90909091
2008020746,20,3539,0.0,42,38,6,0,4,90.47619048
2008020746,21,3600,0.0,39,36,3,1,3,92.30769231
2008020747,7,3539,0.0,37,34,4,2,3,91.89189189
2008020747,24,3597,0.0,23,21,3,0,2,91.30434783
2008020748,15,3600,0.0,34,32,6,2,2,94.11764706
2008020748,1,3565,0.0,25,21,1,0,4,84.0
2008020749,14,1789,0.0,16,13,3,0,3,81.25
2008020749,14,1706,0.0,11,11,2,1,0,100.0
2008020749,2,3593,0.0,30,29,8,0,1,96.66666667
2008020750,11,3900,0.0,40,39,3,1,1,97.5
2008020750,3,3854,0.0,22,21,4,0,1,95.45454545
2008020751,19,3600,0.0,35,33,6,1,2,94.28571429
2008020751,29,3563,0.0,21,18,7,0,3,85.71428571
2008020752,13,3769,0.0,34,31,4,0,3,91.17647059
2008020752,10,3801,0.0,31,27,0,1,4,87.09677419
2008020753,5,3530,0.0,35,31,5,0,4,88.57142857
2008020753,8,3600,0.0,25,23,6,0,2,92.0
2008020754,26,3600,0.0,29,29,5,0,0,100.0
2008020754,9,3523,0.0,26,25,6,2,1,96.15384615
2008020755,27,3514,0.0,24,22,3,1,2,91.66666667
2008020755,18,3594,0.0,30,29,5,2,1,96.66666667
2008020756,20,3483,0.0,32,29,7,1,3,90.625
2008020756,25,3600,0.0,25,24,4,2,1,96.0
2008020757,16,3600,0.0,21,20,3,0,1,95.23809524
2008020757,22,3452,0.0,41,38,5,0,3,92.68292683
2008020758,12,3544,0.0,24,20,4,0,4,83.33333333
2008020758,23,3586,0.0,27,24,4,0,3,88.88888889
2008020759,6,3572,0.0,26,25,4,0,1,96.15384615
2008020759,4,3532,0.0,33,30,8,0,3,90.90909091
2008020760,10,3592,0.0,32,27,9,0,5,84.375
2008020760,7,3600,0.0,16,16,2,0,0,100.0
2008020761,14,3874,0.0,35,31,11,1,4,88.57142857
2008020761,5,3868,0.0,24,21,4,1,3,87.5
2008020762,27,3600,0.0,33,28,5,1,5,84.84848485
2008020762,17,3597,0.0,27,23,3,0,4,85.18518519
2008020763,24,3592,0.0,24,22,3,1,2,91.66666667
2008020763,30,3600,0.0,34,34,5,1,0,100.0
2008020764,26,3589,0.0,45,41,2,0,4,91.11111111
2008020764,15,3500,0.0,35,30,4,4,5,85.71428571
2008020765,6,3878,0.0,22,19,1,0,3,86.36363636
2008020765,9,3900,0.0,30,27,5,0,3,90.0
2008020766,2,3518,0.0,29,26,4,0,3,89.65517241
2008020766,13,3600,0.0,22,20,3,0,2,90.90909091
2008020767,24,3533,0.0,33,30,1,0,3,90.90909091
2008020767,18,3600,0.0,30,28,1,1,2,93.33333333
2008020768,22,3900,0.0,34,33,3,0,1,97.05882353
2008020768,19,3898,0.0,23,22,6,0,1,95.65217391
2008020769,25,3505,0.0,21,18,0,2,3,85.71428571
2008020769,21,3600,0.0,24,22,2,0,2,91.66666667
2008020770,16,3600,0.0,31,29,9,4,2,93.5483871
2008020770,20,3537,0.0,32,28,3,2,4,87.5
2008020771,12,3900,0.0,40,37,7,0,3,92.5
2008020771,28,3900,0.0,29,26,6,0,3,89.65517241
2008020772,8,3575,0.0,22,19,1,0,3,86.36363636
2008020772,7,3575,0.0,37,35,4,3,2,94.59459459
2008020773,29,3570,0.0,24,21,0,1,3,87.5
2008020773,5,3600,0.0,34,33,10,0,1,97.05882353
2008020774,1,3591,0.0,32,31,3,2,1,96.875
2008020774,11,1886,0.0,7,7,2,0,0,100.0
2008020774,11,1683,0.0,24,19,6,2,5,79.16666667
2008020775,18,3600,0.0,22,22,2,0,0,100.0
2008020775,30,3535,0.0,26,24,8,1,2,92.30769231
2008020776,3,3600,0.0,39,29,8,0,10,74.35897436
2008020776,25,3579,0.0,22,20,1,2,2,90.90909091
2008020777,4,2580,2.0,22,22,2,0,0,100.0
2008020777,4,1197,0.0,15,12,2,0,3,80.0
2008020777,6,3780,0.0,30,26,1,1,4,86.66666667
2008020778,22,1200,2.0,16,11,5,0,5,68.75
2008020778,22,2400,0.0,19,16,5,0,3,84.21052632
2008020778,17,3600,0.0,26,23,2,1,3,88.46153846
2008020779,24,3600,0.0,27,26,4,0,1,96.2962963
2008020779,20,3552,0.0,25,23,8,1,2,92.0
2008020780,10,3600,0.0,33,31,13,0,2,93.93939394
2008020780,8,3596,0.0,41,36,6,2,5,87.80487805
2008020781,7,3900,0.0,42,40,3,0,2,95.23809524
2008020781,9,3847,0.0,30,28,1,0,2,93.33333333
2008020782,26,3592,0.0,26,25,4,2,1,96.15384615
2008020782,1,3521,0.0,32,29,7,0,3,90.625
2008020783,13,3508,0.0,38,36,6,1,2,94.73684211
2008020783,15,3600,0.0,21,20,5,0,1,95.23809524
2008020784,28,3693,0.0,20,17,0,1,3,85.0
2008020784,29,3693,0.0,30,28,6,0,2,93.33333333
2008020785,2,3579,0.0,28,27,8,1,1,96.42857143
2008020785,14,3599,0.0,28,28,8,2,0,100.0
2008020786,21,3600,0.0,23,19,4,0,4,82.60869565
2008020786,19,3600,0.0,24,23,5,0,1,95.83333333
2008020787,12,3590,0.0,32,30,12,0,2,93.75
2008020787,27,2400,0.0,28,24,4,1,4,85.71428571
2008020787,27,1200,0.0,13,10,0,0,3,76.92307692
2008020788,16,2398,2.0,17,13,3,0,4,76.47058824
2008020788,16,1196,0.0,9,6,5,0,3,66.66666667
2008020788,23,3600,0.0,39,36,5,2,3,92.30769231
2008020789,17,3591,0.0,25,25,5,0,0,100.0
2008020789,5,3600,0.0,29,26,5,0,3,89.65517241
2008020790,4,3597,0.0,31,29,2,2,2,93.5483871
2008020790,11,3497,0.0,23,20,0,4,3,86.95652174
2008020791,22,3886,0.0,39,37,4,0,2,94.87179487
2008020791,30,3900,0.0,30,28,4,0,2,93.33333333
2008020792,18,3583,2.0,21,18,4,2,3,85.71428571
2008020792,25,3600,0.0,26,25,6,0,1,96.15384615
2008020793,3,3511,0.0,30,28,5,1,2,93.33333333
2008020793,1,3597,0.0,27,27,5,0,0,100.0
2008020794,8,3600,0.0,41,35,3,0,6,85.36585366
2008020794,20,3600,0.0,24,22,5,0,2,91.66666667
2008020795,28,3600,0.0,30,28,8,0,2,93.33333333
2008020795,6,3542,0.0,30,26,0,1,4,86.66666667
2008020796,26,3900,0.0,25,22,3,0,3,88.0
2008020796,2,3900,0.0,39,36,7,1,3,92.30769231
2008020797,21,3600,0.0,30,27,1,1,3,90.0
2008020797,29,3574,0.0,31,31,3,2,0,100.0
2008020798,11,3599,0.0,41,40,10,3,1,97.56097561
2008020798,14,3551,0.0,23,21,5,2,2,91.30434783
2008020799,10,3668,0.0,38,33,9,1,5,86.84210526
2008020799,13,3665,0.0,39,35,5,0,4,89.74358974
2008020800,17,3590,0.0,21,18,3,3,3,85.71428571
2008020800,18,3561,0.0,50,46,14,1,4,92.0
2008020801,23,3600,0.0,28,24,2,2,4,85.71428571
2008020801,19,3529,0.0,29,24,4,0,5,82.75862069
2008020802,2,3586,0.0,49,46,8,0,3,93.87755102
2008020802,1,3600,0.0,25,23,4,1,2,92.0
2008020803,15,3900,0.0,32,28,6,1,4,87.5
2008020803,3,3877,0.0,30,26,0,1,4,86.66666667
2008020804,16,3600,0.0,37,36,3,0,1,97.2972973
2008020804,11,3527,0.0,27,25,3,0,2,92.59259259
2008020805,9,3600,0.0,32,31,22,2,1,96.875
2008020805,7,3516,0.0,23,20,4,2,3,86.95652174
2008020806,28,3900,0.0,36,35,6,1,1,97.22222222
2008020806,5,3892,0.0,37,36,2,2,1,97.2972973
2008020807,21,3544,0.0,26,23,5,1,3,88.46153846
2008020807,30,3569,4.0,22,20,5,1,2,90.90909091
2008020808,27,3600,0.0,33,33,3,0,0,100.0
2008020808,25,3541,0.0,29,28,4,0,1,96.55172414
2008020809,8,3600,0.0,27,20,3,0,7,74.07407407
2008020809,22,3600,0.0,38,36,12,1,2,94.73684211
2008020810,20,3655,0.0,40,37,8,1,3,92.5
2008020810,24,3654,0.0,23,21,7,0,2,91.30434783
2008020811,9,3600,0.0,36,34,5,1,2,94.44444444
2008020811,4,3600,0.0,23,18,1,1,5,78.26086957
2008020812,13,3581,0.0,42,42,14,0,0,100.0
2008020812,12,1830,0.0,10,9,3,0,1,90.0
2008020812,12,1770,0.0,13,9,0,0,4,69.23076923
2008020813,10,2480,0.0,19,17,2,0,2,89.47368421
2008020813,10,1003,0.0,12,8,2,0,4,66.66666667
2008020813,14,3600,0.0,25,21,0,1,4,84.0
2008020814,30,3600,0.0,43,39,9,0,4,90.69767442
2008020814,17,3600,0.0,23,21,4,1,2,91.30434783
2008020815,19,3900,0.0,34,31,8,0,3,91.17647059
2008020815,18,3821,0.0,27,24,3,0,3,88.88888889
2008020816,23,3600,0.0,28,25,2,1,3,89.28571429
2008020816,27,3526,0.0,32,28,6,0,4,87.5
2008020817,20,3595,0.0,36,36,6,0,0,100.0
2008020817,26,3553,0.0,19,18,2,0,1,94.73684211
2008020818,6,3553,0.0,18,17,1,1,1,94.44444444
2008020818,1,3600,0.0,31,31,2,3,0,100.0
2008020819,17,3535,0.0,25,22,4,2,3,88.0
2008020819,29,3600,0.0,34,32,4,0,2,94.11764706
2008020820,28,3888,0.0,35,30,5,1,5,85.71428571
2008020820,7,3818,0.0,35,30,3,3,5,85.71428571
2008020821,3,3900,0.0,43,42,7,0,1,97.6744186
2008020821,13,3900,0.0,35,34,2,0,1,97.14285714
2008020822,16,3455,0.0,23,22,7,0,1,95.65217391
2008020822,19,3600,0.0,22,22,6,2,0,100.0
2008020823,23,3511,0.0,30,28,4,1,2,93.33333333
2008020823,25,3600,0.0,33,32,7,1,1,96.96969697
2008020824,8,3600,0.0,48,46,9,0,2,95.83333333
2008020824,21,3551,0.0,22,19,2,0,3,86.36363636
2008020825,2,3587,0.0,34,29,1,0,5,85.29411765
2008020825,4,3586,0.0,39,38,5,1,1,97.43589744
2008020826,22,3900,0.0,41,39,9,0,2,95.12195122
2008020826,26,3775,0.0,21,19,9,0,2,90.47619048
2008020827,5,3600,0.0,41,35,4,2,6,85.36585366
2008020827,10,3597,0.0,27,25,6,0,2,92.59259259
2008020828,29,3596,0.0,27,26,3,1,1,96.2962963
2008020828,12,3593,0.0,19,15,3,1,4,78.94736842
2008020829,15,3592,0.0,32,31,6,2,1,96.875
2008020829,14,2400,0.0,20,18,3,1,2,90.0
2008020829,14,1200,0.0,12,9,0,0,3,75.0
2008020830,6,3877,0.0,31,29,8,0,2,93.5483871
2008020830,18,3889,0.0,25,23,3,2,2,92.0
2008020831,9,793,0.0,12,9,1,0,3,75.0
2008020831,9,2775,0.0,17,17,2,0,0,100.0
2008020831,30,1149,0.0,2,1,0,1,1,50.0
2008020831,30,2400,0.0,19,16,0,0,3,84.21052632
2008020832,25,1200,0.0,9,6,0,0,3,66.66666667
2008020832,25,2392,0.0,27,24,7,0,3,88.88888889
2008020832,16,3600,0.0,18,16,2,0,2,88.88888889
2008020833,20,3600,0.0,37,32,6,0,5,86.48648649
2008020833,27,3555,0.0,45,38,0,1,7,84.44444444
2008020834,28,3519,0.0,29,23,12,0,6,79.31034483
2008020834,1,3596,0.0,32,27,6,0,5,84.375
2008020835,4,3597,0.0,37,35,7,1,2,94.59459459
2008020835,3,1677,0.0,14,10,1,1,4,71.42857143
2008020835,3,1923,0.0,6,5,0,1,1,83.33333333
2008020836,15,3600,0.0,31,29,8,0,2,93.5483871
2008020836,13,3533,0.0,32,29,1,2,3,90.625
2008020837,21,3900,0.0,45,40,6,0,5,88.88888889
2008020837,17,3894,0.0,28,23,0,1,5,82.14285714
2008020838,12,3525,0.0,36,36,7,0,0,100.0
2008020838,7,1200,0.0,18,16,8,0,2,88.88888889
2008020838,7,2400,0.0,29,28,5,1,1,96.55172414
2008020839,11,3599,0.0,35,31,7,3,4,88.57142857
2008020839,24,1660,0.0,25,20,4,1,5,80.0
2008020839,24,1874,0.0,17,15,4,0,2,88.23529412
2008020840,8,3051,0.0,33,29,6,0,4,87.87878788
2008020840,8,481,0.0,1,1,0,0,0,100.0
2008020840,23,3598,0.0,27,25,0,2,2,92.59259259
2008020841,5,3900,0.0,30,28,0,1,2,93.33333333
2008020841,2,3900,0.0,37,35,5,2,2,94.59459459
2008020842,25,3900,2.0,43,41,8,0,2,95.34883721
2008020842,29,3900,0.0,22,20,3,1,2,90.90909091
2008020843,3,3536,0.0,33,31,6,0,2,93.93939394
2008020843,19,3600,0.0,20,19,4,1,1,95.0
2008020844,9,3600,0.0,24,24,4,2,0,100.0
2008020844,18,3530,0.0,24,22,2,3,2,91.66666667
2008020845,22,3600,0.0,29,28,10,0,1,96.55172414
2008020845,27,3523,0.0,28,26,3,0,2,92.85714286
2008020846,11,3890,0.0,45,39,11,1,6,86.66666667
2008020846,26,461,0.0,7,4,1,0,3,57.14285714
2008020846,26,3336,0.0,20,17,1,4,3,85.0
2008020847,6,3600,0.0,32,31,1,1,1,96.875
2008020847,12,3543,0.0,33,29,7,0,4,87.87878788
2008020848,7,3600,0.0,28,27,5,0,1,96.42857143
2008020848,10,3598,0.0,30,26,5,0,4,86.66666667
2008020849,16,3586,0.0,23,20,7,0,3,86.95652174
2008020849,14,3516,0.0,49,44,10,3,5,89.79591837
2008020850,1,3535,0.0,28,24,6,1,4,85.71428571
2008020850,13,3600,0.0,36,36,10,0,0,100.0
2008020851,9,3680,0.0,27,24,4,0,3,88.88888889
2008020851,21,3680,0.0,22,20,2,1,2,90.90909091
2008020852,23,3876,0.0,41,38,5,0,3,92.68292683
2008020852,20,3900,0.0,43,40,12,1,3,93.02325581
2008020853,22,3493,0.0,31,27,9,0,4,87.09677419
2008020853,28,3600,0.0,26,24,6,0,2,92.30769231
2008020854,2,3542,0.0,37,35,8,0,2,94.59459459
2008020854,3,3600,0.0,26,25,8,0,1,96.15384615
2008020855,19,2400,0.0,18,14,0,0,4,77.77777778
2008020855,19,1113,0.0,3,3,1,1,0,100.0
2008020855,29,3594,0.0,24,21,4,2,3,87.5
2008020856,8,3898,0.0,35,32,5,1,3,91.42857143
2008020856,15,3890,0.0,33,30,1,0,3,90.90909091
2008020857,18,3600,0.0,41,35,8,0,6,85.36585366
2008020857,17,3595,2.0,25,23,3,0,2,92.0
2008020858,26,3600,0.0,31,28,6,0,3,90.32258065
2008020858,24,3565,0.0,26,22,4,0,4,84.61538462
2008020859,12,3600,0.0,24,22,3,3,2,91.66666667
2008020859,2,3600,0.0,30,24,6,0,6,80.0
2008020860,7,3522,0.0,34,30,2,1,4,88.23529412
2008020860,4,3600,0.0,42,39,8,1,3,92.85714286
2008020861,8,3565,0.0,28,23,1,0,5,82.14285714
2008020861,5,3600,0.0,27,23,3,0,4,85.18518519
2008020862,29,3900,0.0,35,32,6,1,3,91.42857143
2008020862,10,3883,0.0,34,31,4,1,3,91.17647059
2008020863,23,3600,0.0,27,25,8,0,2,92.59259259
2008020863,9,3494,0.0,23,19,2,1,4,82.60869565
2008020864,1,3900,0.0,41,39,3,1,2,95.12195122
2008020864,14,3899,0.0,40,38,3,0,2,95.0
2008020865,16,3600,0.0,31,31,2,0,0,100.0
2008020865,13,3587,0.0,41,38,9,0,3,92.68292683
2008020866,19,3772,0.0,29,28,5,0,1,96.55172414
2008020866,18,3772,0.0,36,34,8,1,2,94.44444444
2008020867,20,3810,0.0,27,25,0,1,2,92.59259259
2008020867,30,3830,0.0,22,19,1,0,3,86.36363636
2008020868,22,3410,2.0,25,21,6,1,4,84.0
2008020868,25,3594,0.0,23,21,3,2,2,91.30434783
2008020869,11,3868,0.0,40,37,7,0,3,92.5
2008020869,27,3900,0.0,22,19,0,2,3,86.36363636
2008020870,26,3513,2.0,40,36,4,2,4,90.0
2008020870,28,3600,0.0,32,30,3,0,2,93.75
2008020871,21,3600,0.0,29,28,5,2,1,96.55172414
2008020871,15,3600,0.0,25,21,4,1,4,84.0
2008020872,14,3600,0.0,41,37,9,0,4,90.24390244
2008020872,12,3572,0.0,13,12,1,1,1,92.30769231
2008020873,24,3553,0.0,34,29,6,0,5,85.29411765
2008020873,17,3593,0.0,26,24,6,0,2,92.30769231
2008020874,5,3600,0.0,27,23,3,0,4,85.18518519
2008020874,4,3532,0.0,27,22,4,0,5,81.48148148
2008020875,9,1405,0.0,17,14,0,0,3,82.35294118
2008020875,9,2105,0.0,15,13,4,0,2,86.66666667
2008020875,8,3585,0.0,47,44,13,2,3,93.61702128
2008020876,16,3594,0.0,31,30,7,0,1,96.77419355
2008020876,25,3527,0.0,36,33,4,0,3,91.66666667
2008020877,27,3598,0.0,33,30,5,3,3,90.90909091
2008020877,26,3558,0.0,28,23,4,2,5,82.14285714
2008020878,11,3525,0.0,31,28,2,0,3,90.32258065
2008020878,28,3600,0.0,23,22,5,1,1,95.65217391
2008020879,3,3537,0.0,33,29,2,1,4,87.87878788
2008020879,7,2511,0.0,20,20,3,1,0,100.0
2008020879,7,1086,0.0,13,11,0,0,2,84.61538462
2008020880,23,3900,0.0,38,36,3,3,2,94.73684211
2008020880,10,3900,0.0,37,35,8,3,2,94.59459459
2008020881,1,3596,0.0,38,34,2,0,4,89.47368421
2008020881,2,3600,0.0,40,40,4,2,0,100.0
2008020882,6,3542,0.0,29,27,5,1,2,93.10344828
2008020882,13,3599,0.0,41,41,8,0,0,100.0
2008020883,24,3600,0.0,28,26,13,0,2,92.85714286
2008020883,29,3600,0.0,13,8,0,1,5,61.53846154
2008020884,17,3516,0.0,28,24,4,1,4,85.71428571
2008020884,30,3577,0.0,37,35,6,1,2,94.59459459
2008020885,18,3756,0.0,30,30,1,0,0,100.0
2008020885,19,3748,0.0,22,21,1,0,1,95.45454545
2008020886,20,3899,0.0,28,26,7,2,2,92.85714286
2008020886,22,3899,0.0,32,30,6,2,2,93.75
2008020887,5,1991,0.0,20,15,3,5,5,75.0
2008020887,5,1599,0.0,14,14,0,0,0,100.0
2008020887,15,3600,0.0,33,31,9,1,2,93.93939394
2008020888,21,3528,0.0,38,34,10,1,4,89.47368421
2008020888,12,3589,0.0,19,17,2,1,2,89.47368421
2008020889,6,3528,0.0,18,14,6,0,4,77.77777778
2008020889,14,3600,0.0,43,40,8,3,3,93.02325581
2008020890,10,3780,0.0,41,39,8,3,2,95.12195122
2008020890,3,3735,0.0,26,23,5,1,3,88.46153846
2008020891,30,3600,0.0,45,44,11,0,1,97.77777778
2008020891,16,3500,0.0,24,22,9,0,2,91.66666667
2008020892,28,3600,0.0,29,29,7,0,0,100.0
2008020892,25,3523,2.0,24,23,3,1,1,95.83333333
2008020893,13,3600,0.0,39,33,2,0,6,84.61538462
2008020893,6,3600,0.0,25,24,0,0,1,96.0
2008020894,24,3600,0.0,36,34,4,1,2,94.44444444
2008020894,7,3543,0.0,22,19,5,0,3,86.36363636
2008020895,4,3600,0.0,35,33,13,4,2,94.28571429
2008020895,15,3600,2.0,37,33,14,2,4,89.18918919
2008020896,21,3492,0.0,26,22,3,1,4,84.61538462
2008020896,11,3600,0.0,33,30,4,4,3,90.90909091
2008020897,23,3492,0.0,16,14,9,0,2,87.5
2008020897,8,3600,0.0,34,34,9,1,0,100.0
2008020898,12,2302,0.0,13,12,0,1,1,92.30769231
2008020898,12,1200,0.0,9,6,1,0,3,66.66666667
2008020898,9,3589,0.0,43,41,8,2,2,95.34883721
2008020899,16,3449,2.0,29,24,5,1,5,82.75862069
2008020899,18,3532,0.0,32,29,0,3,3,90.625
2008020900,26,3900,0.0,24,23,7,2,1,95.83333333
2008020900,30,3900,0.0,25,24,3,0,1,96.0
2008020901,27,3556,0.0,24,22,0,3,2,91.66666667
2008020901,19,3600,0.0,25,24,6,0,1,96.0
2008020902,29,3567,0.0,27,24,0,3,3,88.88888889
2008020902,20,3587,0.0,29,28,5,0,1,96.55172414
2008020903,14,3519,0.0,44,40,13,1,4,90.90909091
2008020903,22,3595,0.0,29,26,3,0,3,89.65517241
2008020904,26,3520,0.0,19,18,4,0,1,94.73684211
2008020904,4,3600,0.0,34,34,12,1,0,100.0
2008020905,3,3900,0.0,24,23,4,0,1,95.83333333
2008020905,10,3895,0.0,32,31,1,0,1,96.875
2008020906,2,3522,0.0,28,27,9,1,1,96.42857143
2008020906,5,3584,0.0,21,21,0,0,0,100.0
2008020907,28,3577,0.0,33,29,9,1,4,87.87878788
2008020907,17,3591,0.0,35,34,13,1,1,97.14285714
2008020908,24,1417,0.0,8,5,0,0,3,62.5
2008020908,24,2177,0.0,19,16,1,0,3,84.21052632
2008020908,6,3600,0.0,35,35,4,0,0,100.0
2008020909,21,3596,2.0,32,28,1,2,4,87.5
2008020909,1,3600,0.0,24,24,6,1,0,100.0
2008020910,10,3900,0.0,44,40,11,5,4,90.90909091
2008020910,2,3900,0.0,33,29,5,3,4,87.87878788
2008020911,13,3600,0.0,41,40,7,1,1,97.56097561
2008020911,3,3521,0.0,22,20,5,1,2,90.90909091
2008020912,11,3513,0.0,40,36,12,2,4,90.0
2008020912,15,3589,0.0,24,21,7,2,3,87.5
2008020913,7,3900,0.0,32,31,10,0,1,96.875
2008020913,12,3891,0.0,37,36,0,0,1,97.2972973
2008020914,28,3600,0.0,24,23,5,0,1,95.83333333
2008020914,9,3508,0.0,24,22,3,0,2,91.66666667
2008020915,27,3600,0.0,47,43,3,0,4,91.4893617
2008020915,18,3583,2.0,26,25,0,0,1,96.15384615
2008020916,19,3600,0.0,42,41,7,2,1,97.61904762
2008020916,25,3492,0.0,22,19,2,0,3,86.36363636
2008020917,29,3597,0.0,19,19,1,0,0,100.0
2008020917,22,3568,0.0,32,31,7,0,1,96.875
2008020918,8,3801,0.0,38,35,7,1,3,92.10526316
2008020918,4,3801,0.0,36,32,5,1,4,88.88888889
2008020919,26,3543,0.0,41,39,7,0,2,95.12195122
2008020919,17,3600,0.0,31,30,5,1,1,96.77419355
2008020920,5,3672,0.0,45,41,9,1,4,91.11111111
2008020920,16,1296,0.0,6,5,1,0,1,83.33333333
2008020920,16,2400,0.0,22,18,3,1,4,81.81818182
2008020921,30,3600,0.0,29,25,4,0,4,86.20689655
2008020921,20,3594,0.0,16,15,1,0,1,93.75
2008020922,14,3554,0.0,25,23,6,0,2,92.0
2008020922,23,3589,0.0,21,20,1,0,1,95.23809524
2008020923,15,3622,0.0,37,34,8,4,3,91.89189189
2008020923,6,3622,0.0,32,28,5,2,4,87.5
2008020924,13,3598,0.0,46,39,5,1,7,84.7826087
2008020924,1,3600,0.0,17,15,3,0,2,88.23529412
2008020925,24,3600,2.0,33,30,7,0,3,90.90909091
2008020925,25,3538,0.0,18,14,1,0,4,77.77777778
2008020926,28,3514,0.0,21,18,0,0,3,85.71428571
2008020926,8,3600,0.0,48,46,4,0,2,95.83333333
2008020927,10,3633,0.0,32,29,1,1,3,90.625
2008020927,9,3633,0.0,38,34,3,0,4,89.47368421
2008020928,7,3536,0.0,34,32,9,1,2,94.11764706
2008020928,2,3600,0.0,31,31,7,2,0,100.0
2008020929,21,2796,0.0,21,18,6,0,3,85.71428571
2008020929,21,804,0.0,9,6,1,0,3,66.66666667
2008020929,3,3600,0.0,24,23,2,2,1,95.83333333
2008020930,12,3524,0.0,31,27,3,0,4,87.09677419
2008020930,11,3596,0.0,35,32,7,1,3,91.42857143
2008020931,17,3009,0.0,14,10,1,0,4,71.42857143
2008020931,17,591,0.0,9,5,0,0,4,55.55555556
2008020931,18,3597,0.0,30,30,1,1,0,100.0
2008020932,19,3550,0.0,27,26,2,0,1,96.2962963
2008020932,27,3548,0.0,30,27,4,1,3,90.0
2008020933,30,3561,0.0,30,27,1,1,3,90.0
2008020933,22,3600,0.0,45,43,7,0,2,95.55555556
2008020934,4,3600,0.0,42,39,7,0,3,92.85714286
2008020934,1,3598,0.0,27,27,5,0,0,100.0
2008020935,13,3559,0.0,34,32,5,0,2,94.11764706
2008020935,15,2400,0.0,16,14,4,0,2,87.5
2008020935,15,1200,0.0,17,13,5,0,4,76.47058824
2008020936,26,3592,0.0,38,34,8,0,4,89.47368421
2008020936,16,3600,0.0,24,22,4,0,2,91.66666667
2008020937,5,3600,0.0,21,20,4,1,1,95.23809524
2008020937,25,3594,0.0,23,19,6,0,4,82.60869565
2008020938,14,3592,0.0,39,33,7,4,6,84.61538462
2008020938,20,1123,0.0,12,10,4,0,2,83.33333333
2008020938,20,2396,0.0,19,14,4,0,5,73.68421053
2008020939,29,3600,0.0,30,27,10,0,3,90.0
2008020939,23,3586,0.0,20,19,7,1,1,95.0
2008020940,21,3506,0.0,31,27,2,0,4,87.09677419
2008020940,2,3600,0.0,22,20,4,2,2,90.90909091
2008020941,4,3600,0.0,24,22,5,1,2,91.66666667
2008020941,6,3569,0.0,26,22,2,1,4,84.61538462
2008020942,12,3600,0.0,41,39,2,4,2,95.12195122
2008020942,15,3589,0.0,30,25,2,1,5,83.33333333
2008020943,13,3600,0.0,30,27,2,0,3,90.0
2008020943,11,3567,2.0,34,30,2,0,4,88.23529412
2008020944,26,3515,0.0,25,20,0,0,5,80.0
2008020944,29,3600,2.0,26,22,3,0,4,84.61538462
2008020945,1,3888,0.0,32,30,5,1,2,93.75
2008020945,10,3885,0.0,52,49,10,0,3,94.23076923
2008020946,20,3600,0.0,25,22,6,2,3,88.0
2008020946,9,1092,0.0,7,6,2,0,1,85.71428571
2008020946,9,2400,0.0,15,11,0,0,4,73.33333333
2008020947,5,3600,0.0,33,32,2,1,1,96.96969697
2008020947,14,3538,0.0,33,30,4,2,3,90.90909091
2008020948,22,3748,0.0,43,37,4,3,6,86.04651163
2008020948,18,3739,0.0,28,23,2,2,5,82.14285714
2008020949,24,3691,0.0,37,34,1,1,3,91.89189189
2008020949,16,3700,0.0,28,26,1,2,2,92.85714286
2008020950,17,3531,2.0,22,22,2,2,0,100.0
2008020950,19,3600,0.0,36,31,10,0,5,86.11111111
2008020951,30,3483,0.0,32,28,5,0,4,87.5
2008020951,23,3595,0.0,19,17,0,1,2,89.47368421
2008020952,25,3598,0.0,25,24,6,0,1,96.0
2008020952,28,3600,0.0,31,27,11,1,4,87.09677419
2008020953,8,3588,0.0,27,22,0,0,5,81.48148148
2008020953,7,3600,0.0,39,38,10,0,1,97.43589744
2008020954,17,3600,0.0,27,25,1,0,2,92.59259259
2008020954,21,3542,0.0,30,27,4,0,3,90.0
2008020955,27,3600,0.0,26,25,4,0,1,96.15384615
2008020955,6,3522,0.0,18,16,6,0,2,88.88888889
2008020956,3,3598,0.0,30,28,2,1,2,93.33333333
2008020956,2,3527,0.0,23,19,4,0,4,82.60869565
2008020957,20,3600,0.0,36,35,8,0,1,97.22222222
2008020957,4,1200,0.0,19,15,4,1,4,78.94736842
2008020957,4,2387,0.0,22,21,0,1,1,95.45454545
2008020958,10,3589,0.0,38,37,3,2,1,97.36842105
2008020958,15,23,0.0,0,0,0,0,0,
2008020958,15,3479,0.0,29,27,2,0,2,93.10344828
2008020959,22,3598,0.0,32,28,0,0,4,87.5
2008020959,9,3596,0.0,26,24,2,0,2,92.30769231
2008020960,5,3598,0.0,32,31,1,1,1,96.875
2008020960,13,3600,0.0,47,43,7,0,4,91.4893617
2008020961,29,3477,0.0,23,19,1,0,4,82.60869565
2008020961,18,3600,0.0,33,31,5,1,2,93.93939394
2008020962,25,3691,2.0,40,35,19,0,5,87.5
2008020962,26,1223,0.0,4,4,0,1,0,100.0
2008020962,26,2400,0.0,19,15,1,0,4,78.94736842
2008020963,30,3886,0.0,35,32,3,0,3,91.42857143
2008020963,28,3886,0.0,36,32,0,0,4,88.88888889
2008020964,20,3598,0.0,34,28,8,0,6,82.35294118
2008020964,12,3600,0.0,22,21,3,2,1,95.45454545
2008020965,27,3595,0.0,31,26,4,2,5,83.87096774
2008020965,7,3600,0.0,30,29,11,0,1,96.66666667
2008020966,8,3558,0.0,27,26,9,1,1,96.2962963
2008020966,11,3600,0.0,25,25,5,1,0,100.0
2008020967,19,3627,0.0,23,20,4,1,3,86.95652174
2008020967,14,3596,0.0,36,32,7,0,4,88.88888889
2008020968,25,3593,0.0,38,36,7,3,2,94.73684211
2008020968,24,3538,0.0,16,13,2,1,3,81.25
2008020969,16,3561,0.0,38,34,12,0,4,89.47368421
2008020969,6,3600,0.0,35,32,3,0,3,91.42857143
2008020970,1,1011,0.0,1,1,0,0,0,100.0
2008020970,1,2369,0.0,26,20,3,0,6,76.92307692
2008020970,2,3598,0.0,38,35,11,0,3,92.10526316
2008020971,30,1809,0.0,11,10,2,0,1,90.90909091
2008020971,30,1725,0.0,13,10,0,0,3,76.92307692
2008020971,26,3600,0.0,24,21,1,0,3,87.5
2008020972,22,3600,0.0,40,39,1,0,1,97.5
2008020972,10,3543,0.0,17,14,1,0,3,82.35294118
2008020973,7,3592,0.0,36,30,7,1,6,83.33333333
2008020973,9,3600,0.0,30,27,4,0,3,90.0
2008020974,18,3600,0.0,26,22,5,0,4,84.61538462
2008020974,4,3593,0.0,32,31,7,0,1,96.875
2008020975,19,3453,0.0,35,30,7,0,5,85.71428571
2008020975,13,3600,0.0,29,26,3,0,3,89.65517241
2008020976,29,3600,0.0,46,44,17,1,2,95.65217391
2008020976,17,2605,0.0,23,16,0,1,7,69.56521739
2008020976,17,995,0.0,5,4,0,1,1,80.0
2008020977,12,3597,0.0,25,22,2,0,3,88.0
2008020977,14,1787,0.0,22,16,4,0,6,72.72727273
2008020977,14,1798,0.0,15,12,0,2,3,80.0
2008020978,28,3474,0.0,29,26,13,1,3,89.65517241
2008020978,23,3593,0.0,29,28,3,3,1,96.55172414
2008020979,27,3462,0.0,26,23,2,3,3,88.46153846
2008020979,2,3600,0.0,42,40,13,0,2,95.23809524
2008020980,6,3507,0.0,30,26,4,2,4,86.66666667
2008020980,3,3600,0.0,39,36,4,2,3,92.30769231
2008020981,5,3868,0.0,32,29,6,0,3,90.625
2008020981,15,3868,0.0,22,19,2,1,3,86.36363636
2008020982,20,3595,0.0,20,15,6,2,5,75.0
2008020982,11,3600,0.0,29,27,4,1,2,93.10344828
2008020983,21,3600,0.0,25,24,5,1,1,96.0
2008020983,16,3583,0.0,29,24,8,0,5,82.75862069
2008020984,8,3600,0.0,31,30,8,0,1,96.77419355
2008020984,25,3492,0.0,19,16,4,1,3,84.21052632
2008020985,30,3600,0.0,38,36,4,1,2,94.73684211
2008020985,24,3491,0.0,25,22,5,1,3,88.0
2008020986,3,3457,0.0,35,33,8,0,2,94.28571429
2008020986,12,3600,0.0,28,28,6,0,0,100.0
2008020987,10,3516,0.0,26,24,4,1,2,92.30769231
2008020987,9,3600,0.0,26,25,0,0,1,96.15384615
2008020988,23,3519,0.0,22,19,7,0,3,86.36363636
2008020988,26,3598,0.0,22,20,4,0,2,90.90909091
2008020989,20,977,0.0,3,3,0,0,0,100.0
2008020989,20,2466,0.0,28,25,11,0,3,89.28571429
2008020989,1,3600,0.0,37,35,13,1,2,94.59459459
2008020990,7,2784,0.0,29,25,3,1,4,86.20689655
2008020990,7,816,0.0,4,3,0,0,1,75.0
2008020990,4,3571,0.0,29,27,3,0,2,93.10344828
2008020991,6,3546,0.0,33,32,4,2,1,96.96969697
2008020991,29,3570,0.0,35,35,4,0,0,100.0
2008020992,2,3603,0.0,28,25,3,2,3,89.28571429
2008020992,10,3650,0.0,30,28,11,1,2,93.33333333
2008020993,22,3700,0.0,26,22,1,2,4,84.61538462
2008020993,8,3686,0.0,32,29,2,0,3,90.625
2008020994,13,3900,0.0,50,47,13,0,3,94.0
2008020994,5,3898,0.0,21,18,3,0,3,85.71428571
2008020995,27,3809,0.0,43,40,0,0,3,93.02325581
2008020995,17,3808,0.0,25,23,0,0,2,92.0
2008020996,15,3740,0.0,28,27,0,1,1,96.42857143
2008020996,18,3740,0.0,44,42,6,2,2,95.45454545
2008020997,28,3814,0.0,29,25,3,0,4,86.20689655
2008020997,30,3814,0.0,23,18,6,0,5,78.26086957
2008020998,25,2880,0.0,19,17,3,0,2,89.47368421
2008020998,25,716,0.0,8,5,4,0,3,62.5
2008020998,19,3598,0.0,22,20,8,2,2,90.90909091
2008020999,11,3595,0.0,35,35,2,2,0,100.0
2008020999,21,3562,0.0,35,33,6,1,2,94.28571429
2008021000,14,3751,0.0,27,24,5,2,3,88.88888889
2008021000,9,3758,0.0,24,22,2,2,2,91.66666667
2008021001,12,3850,0.0,41,39,13,0,2,95.12195122
2008021001,16,3900,0.0,31,29,4,1,2,93.5483871
2008021002,23,3811,0.0,41,37,11,1,4,90.24390244
2008021002,24,3799,0.0,35,32,14,0,3,91.42857143
2008021003,9,3592,0.0,21,17,2,0,4,80.95238095
2008021003,6,3594,0.0,28,25,7,0,3,89.28571429
2008021004,13,3512,0.0,23,20,3,0,3,86.95652174
2008021004,7,3585,0.0,31,30,7,1,1,96.77419355
2008021005,27,3600,0.0,36,31,2,1,5,86.11111111
2008021005,1,3600,0.0,28,26,3,0,2,92.85714286
2008021006,15,3600,0.0,36,35,6,0,1,97.22222222
2008021006,4,3557,0.0,30,28,2,1,2,93.33333333
2008021007,5,3900,0.0,28,25,5,1,3,89.28571429
2008021007,29,3900,0.0,41,38,9,4,3,92.68292683
2008021008,14,3588,0.0,21,20,1,1,1,95.23809524
2008021008,10,3600,0.0,30,26,9,1,4,86.66666667
2008021009,2,3609,0.0,26,24,9,1,2,92.30769231
2008021009,8,3594,0.0,39,36,7,1,3,92.30769231
2008021010,20,3900,0.0,45,40,20,1,5,88.88888889
2008021010,17,3892,0.0,33,28,2,0,5,84.84848485
2008021011,3,3600,0.0,21,19,3,2,2,90.47619048
2008021011,18,3484,0.0,32,28,6,1,4,87.5
2008021012,28,3469,0.0,25,23,4,2,2,92.0
2008021012,19,3589,0.0,25,24,7,1,1,96.0
2008021013,12,3533,0.0,31,28,8,0,3,90.32258065
2008021013,25,3580,0.0,31,29,7,1,2,93.5483871
2008021014,30,3896,0.0,41,40,10,0,1,97.56097561
2008021014,21,3894,0.0,17,16,2,1,1,94.11764706
2008021015,11,3850,0.0,32,29,5,0,3,90.625
2008021015,22,3850,0.0,33,29,6,3,4,87.87878788
2008021016,29,3596,0.0,30,27,4,0,3,90.0
2008021016,16,3483,0.0,21,17,3,1,4,80.95238095
2008021017,26,3507,0.0,32,28,9,0,4,87.5
2008021017,23,3600,0.0,26,24,9,1,2,92.30769231
2008021018,2,3521,0.0,25,23,5,0,2,92.0
2008021018,6,3600,0.0,22,21,5,1,1,95.45454545
2008021019,3,3492,0.0,29,25,4,0,4,86.20689655
2008021019,4,3596,0.0,41,39,5,0,2,95.12195122
2008021020,17,3600,0.0,32,30,8,1,2,93.75
2008021020,19,2440,0.0,23,19,5,0,4,82.60869565
2008021020,19,1116,0.0,3,3,1,0,0,100.0
2008021021,9,3900,0.0,30,27,7,2,3,90.0
2008021021,5,3900,2.0,39,36,13,2,3,92.30769231
2008021022,11,3836,0.0,37,34,6,1,3,91.89189189
2008021022,7,3900,0.0,32,29,8,1,3,90.625
2008021023,20,963,0.0,7,6,0,0,1,85.71428571
2008021023,20,2479,0.0,22,16,3,0,6,72.72727273
2008021023,10,3600,0.0,35,29,3,3,6,82.85714286
2008021024,1,3600,0.0,23,22,3,0,1,95.65217391
2008021024,8,3600,0.0,48,45,11,0,3,93.75
2008021025,12,3873,0.0,31,27,4,1,4,87.09677419
2008021025,15,3900,0.0,32,28,7,1,4,87.5
2008021026,14,3900,0.0,37,34,5,1,3,91.89189189
2008021026,13,3894,0.0,27,24,6,0,3,88.88888889
2008021027,30,3743,0.0,29,26,3,2,3,89.65517241
2008021027,25,3741,0.0,30,28,3,1,2,93.33333333
2008021028,21,3642,0.0,20,18,3,1,2,90.0
2008021028,22,3642,0.0,30,27,2,0,3,90.0
2008021029,18,3600,0.0,18,18,2,0,0,100.0
2008021029,27,3569,0.0,32,31,2,1,1,96.875
2008021030,26,3894,0.0,39,38,12,0,1,97.43589744
2008021030,28,3900,2.0,24,23,2,4,1,95.83333333
2008021031,4,3588,0.0,39,35,16,1,4,89.74358974
2008021031,3,3565,0.0,25,24,12,0,1,96.0
2008021032,6,3522,0.0,33,28,7,0,5,84.84848485
2008021032,5,3600,0.0,25,21,4,0,4,84.0
2008021033,2,3600,0.0,42,40,14,1,2,95.23809524
2008021033,16,3317,2.0,19,15,6,0,4,78.94736842
2008021034,17,3579,0.0,23,23,2,0,0,100.0
2008021034,29,3596,0.0,30,26,10,1,4,86.66666667
2008021035,30,1189,0.0,6,6,0,0,0,100.0
2008021035,30,2400,0.0,29,25,9,0,4,86.20689655
2008021035,19,3583,0.0,22,19,0,1,3,86.36363636
2008021036,28,3598,0.0,34,34,10,0,0,100.0
2008021036,24,3549,0.0,30,29,9,0,1,96.66666667
2008021037,21,3541,0.0,23,19,1,2,4,82.60869565
2008021037,23,3591,0.0,20,18,4,1,2,90.0
2008021038,15,1618,0.0,6,5,0,1,1,83.33333333
2008021038,15,1979,0.0,19,15,6,0,4,78.94736842
2008021038,11,3598,0.0,50,49,10,0,1,98.0
2008021039,18,3599,0.0,29,26,4,0,3,89.65517241
2008021039,26,3509,0.0,30,26,2,1,4,86.66666667
2008021040,16,3540,0.0,30,27,7,0,3,90.0
2008021040,1,3590,0.0,32,30,5,0,2,93.75
2008021041,3,3894,0.0,29,26,7,1,3,89.65517241
2008021041,8,3900,0.0,42,39,4,0,3,92.85714286
2008021042,7,3511,0.0,36,32,10,1,4,88.88888889
2008021042,9,3600,0.0,13,11,1,0,2,84.61538462
2008021043,11,3596,0.0,31,25,5,3,6,80.64516129
2008021043,5,3600,0.0,20,18,4,2,2,90.0
2008021044,10,3887,0.0,22,19,5,0,3,86.36363636
2008021044,14,3895,0.0,39,36,13,0,3,92.30769231
2008021045,15,3596,0.0,19,19,5,0,0,100.0
2008021045,13,3547,0.0,26,24,0,0,2,92.30769231
2008021046,4,3528,0.0,48,45,5,0,3,93.75
2008021046,17,3594,0.0,26,24,0,0,2,92.30769231
2008021047,21,3900,0.0,29,27,5,0,2,93.10344828
2008021047,30,3894,0.0,26,24,3,0,2,92.30769231
2008021048,19,3897,0.0,34,33,4,0,1,97.05882353
2008021048,22,3884,0.0,32,31,6,0,1,96.875
2008021049,25,3421,2.0,25,21,1,2,4,84.0
2008021049,23,3588,0.0,26,24,8,0,2,92.30769231
2008021050,28,2373,0.0,11,10,0,0,1,90.90909091
2008021050,28,1200,0.0,9,6,0,0,3,66.66666667
2008021050,27,3597,0.0,36,33,4,0,3,91.66666667
2008021051,1,3582,0.0,32,28,7,0,4,87.5
2008021051,12,3599,0.0,43,41,8,2,2,95.34883721
2008021052,16,3749,0.0,28,24,10,2,4,85.71428571
2008021052,29,3758,0.0,27,24,8,1,3,88.88888889
2008021053,25,3542,0.0,31,29,7,0,2,93.5483871
2008021053,20,3600,0.0,19,18,6,0,1,94.73684211
2008021054,18,3634,0.0,31,27,5,0,4,87.09677419
2008021054,24,3633,0.0,24,21,1,0,3,87.5
2008021055,26,3860,0.0,26,24,5,1,2,92.30769231
2008021055,6,3850,0.0,38,35,6,1,3,92.10526316
2008021056,8,2189,0.0,24,23,0,1,1,95.83333333
2008021056,8,1348,0.0,15,11,1,0,4,73.33333333
2008021056,9,3600,0.0,32,28,3,0,4,87.5
2008021057,15,3593,0.0,28,26,3,0,2,92.85714286
2008021057,14,3597,0.0,30,25,4,0,5,83.33333333
2008021058,10,3499,0.0,42,39,2,1,3,92.85714286
2008021058,13,3600,2.0,38,37,9,0,1,97.36842105
2008021059,22,3596,0.0,27,26,4,0,1,96.2962963
2008021059,21,3600,0.0,24,16,2,2,8,66.66666667
2008021060,19,3404,0.0,21,18,1,0,3,85.71428571
2008021060,23,3600,0.0,30,30,6,0,0,100.0
2008021061,24,3888,0.0,28,26,6,2,2,92.85714286
2008021061,27,3900,0.0,27,25,2,1,2,92.59259259
2008021062,18,3899,0.0,38,36,2,0,2,94.73684211
2008021062,28,3868,0.0,26,24,3,0,2,92.30769231
2008021063,30,1733,0.0,18,17,6,0,1,94.44444444
2008021063,30,1862,0.0,11,8,0,0,3,72.72727273
2008021063,1,3600,0.0,35,35,13,0,0,100.0
2008021064,2,3591,0.0,37,32,5,0,5,86.48648649
2008021064,12,3600,0.0,32,28,0,1,4,87.5
2008021065,4,3598,0.0,43,39,9,1,4,90.69767442
2008021065,7,3600,0.0,31,25,1,2,6,80.64516129
2008021066,26,3593,0.0,26,22,4,0,4,84.61538462
2008021066,5,3600,0.0,25,24,6,0,1,96.0
2008021067,17,3586,0.0,34,31,9,0,3,91.17647059
2008021067,11,3600,0.0,38,32,8,1,6,84.21052632
2008021068,22,3900,0.0,43,39,9,1,4,90.69767442
2008021068,16,3895,0.0,31,27,1,0,4,87.09677419
2008021069,19,3600,0.0,35,33,9,0,2,94.28571429
2008021069,20,3536,0.0,28,25,6,2,3,89.28571429
2008021070,25,3567,0.0,29,25,4,2,4,86.20689655
2008021070,28,3592,0.0,25,23,5,1,2,92.0
2008021071,10,3600,0.0,28,26,3,0,2,92.85714286
2008021071,8,3600,0.0,37,32,13,1,5,86.48648649
2008021072,2,3600,0.0,26,21,5,1,5,80.76923077
2008021072,9,3600,0.0,22,20,4,0,2,90.90909091
2008021073,7,2394,0.0,19,15,0,2,4,78.94736842
2008021073,7,1134,0.0,11,11,3,0,0,100.0
2008021073,3,3600,0.0,40,37,5,0,3,92.5
2008021074,15,3545,0.0,29,26,5,1,3,89.65517241
2008021074,12,3600,0.0,32,31,6,2,1,96.875
2008021075,29,3595,0.0,23,22,4,0,1,95.65217391
2008021075,13,3552,0.0,36,34,0,0,2,94.44444444
2008021076,11,3900,0.0,29,26,8,0,3,89.65517241
2008021076,14,3900,0.0,36,33,7,1,3,91.66666667
2008021077,23,2388,0.0,23,20,5,0,3,86.95652174
2008021077,23,1200,0.0,10,9,5,0,1,90.0
2008021077,27,3590,0.0,36,35,9,4,1,97.22222222
2008021078,1,3600,0.0,30,26,5,0,4,86.66666667
2008021078,6,3600,0.0,42,41,11,0,1,97.61904762
2008021079,4,3589,0.0,28,27,2,1,1,96.42857143
2008021079,5,3559,0.0,19,17,5,0,2,89.47368421
2008021080,26,3576,0.0,30,28,10,0,2,93.33333333
2008021080,16,3600,0.0,15,14,1,2,1,93.33333333
2008021081,22,3588,0.0,36,33,8,1,3,91.66666667
2008021081,30,3600,0.0,31,31,6,1,0,100.0
2008021082,9,3586,0.0,29,28,3,0,1,96.55172414
2008021082,3,3496,0.0,22,20,1,0,2,90.90909091
2008021083,27,3599,0.0,30,24,3,2,6,80.0
2008021083,24,3600,0.0,28,26,8,2,2,92.85714286
2008021084,21,3535,0.0,27,25,4,0,2,92.59259259
2008021084,28,3598,0.0,32,31,5,0,1,96.875
2008021085,1,3600,0.0,25,21,3,2,4,84.0
2008021085,4,3590,0.0,34,32,9,1,2,94.11764706
2008021086,12,3697,0.0,39,37,11,0,2,94.87179487
2008021086,13,3690,0.0,31,28,2,0,3,90.32258065
2008021087,17,1538,0.0,14,11,5,0,3,78.57142857
2008021087,17,2042,0.0,12,11,1,0,1,91.66666667
2008021087,20,3576,0.0,33,30,1,2,3,90.90909091
2008021088,15,3890,0.0,29,27,10,0,2,93.10344828
2008021088,10,357,0.0,9,9,3,0,0,100.0
2008021088,10,3543,10.0,36,34,0,0,2,94.44444444
2008021089,30,3564,0.0,30,28,2,0,2,93.33333333
2008021089,3,3589,0.0,19,18,0,1,1,94.73684211
2008021090,11,3600,2.0,22,16,9,0,6,72.72727273
2008021090,8,3597,0.0,25,22,4,1,3,88.0
2008021091,29,3783,0.0,17,15,1,0,2,88.23529412
2008021091,14,3784,0.0,34,33,5,0,1,97.05882353
2008021092,24,3900,0.0,32,31,4,0,1,96.875
2008021092,18,3900,0.0,19,18,0,0,1,94.73684211
2008021093,26,3594,0.0,23,21,3,4,2,91.30434783
2008021093,19,3579,0.0,22,22,9,2,0,100.0
2008021094,23,3600,2.0,37,35,6,0,2,94.59459459
2008021094,25,3524,0.0,21,17,4,1,4,80.95238095
2008021095,17,3600,0.0,26,24,3,0,2,92.30769231
2008021095,22,3537,0.0,44,41,12,0,3,93.18181818
2008021096,13,3570,0.0,44,40,7,0,4,90.90909091
2008021096,7,3593,0.0,33,30,3,1,3,90.90909091
2008021097,30,3596,0.0,34,32,6,1,2,94.11764706
2008021097,2,3600,0.0,28,22,6,2,6,78.57142857
2008021098,9,3506,0.0,30,28,3,0,2,93.33333333
2008021098,12,3600,0.0,22,21,1,0,1,95.45454545
2008021099,20,3492,0.0,28,26,4,2,2,92.85714286
2008021099,5,3600,0.0,31,31,6,1,0,100.0
2008021100,28,3900,0.0,32,27,1,0,5,84.375
2008021100,16,3900,0.0,28,23,4,0,5,82.14285714
2008021101,24,3600,0.0,36,34,6,1,2,94.44444444
2008021101,21,1197,0.0,8,4,1,0,4,50.0
2008021101,21,2398,0.0,21,18,2,0,3,85.71428571
2008021102,13,3600,0.0,42,40,2,2,2,95.23809524
2008021102,4,3525,0.0,27,24,5,0,3,88.88888889
2008021103,3,3897,0.0,30,26,2,2,4,86.66666667
2008021103,11,2700,0.0,17,14,5,0,3,82.35294118
2008021103,11,1200,0.0,10,9,1,1,1,90.0
2008021104,20,2216,0.0,19,17,7,0,2,89.47368421
2008021104,20,1378,0.0,17,14,5,0,3,82.35294118
2008021104,29,3585,0.0,33,33,14,1,0,100.0
2008021105,14,3705,2.0,36,33,12,0,3,91.66666667
2008021105,8,3675,0.0,19,17,1,0,2,89.47368421
2008021106,28,3520,0.0,33,30,1,0,3,90.90909091
2008021106,18,3600,0.0,31,29,7,0,2,93.5483871
2008021107,23,3600,0.0,32,28,7,0,4,87.5
2008021107,19,3546,0.0,23,21,5,0,2,91.30434783
2008021108,26,3900,0.0,29,29,3,2,0,100.0
2008021108,25,3900,0.0,30,30,7,3,0,100.0
2008021109,22,3513,0.0,23,20,6,0,3,86.95652174
2008021109,27,3600,0.0,28,26,5,1,2,92.85714286
2008021110,14,3512,0.0,38,34,11,1,4,89.47368421
2008021110,15,3600,0.0,36,33,6,1,3,91.66666667
2008021111,10,1410,0.0,9,5,0,0,4,55.55555556
2008021111,10,2072,0.0,15,14,2,0,1,93.33333333
2008021111,7,3595,0.0,36,33,10,0,3,91.66666667
2008021112,2,3590,0.0,42,42,14,0,0,100.0
2008021112,17,3510,0.0,30,28,4,1,2,93.33333333
2008021113,1,3813,0.0,42,39,11,0,3,92.85714286
2008021113,16,3813,0.0,30,28,6,3,2,93.33333333
2008021114,23,3592,0.0,23,22,9,0,1,95.65217391
2008021114,21,3600,0.0,34,30,9,0,4,88.23529412
2008021115,22,3597,2.0,54,51,24,3,3,94.44444444
2008021115,24,1364,0.0,7,3,1,0,4,42.85714286
2008021115,24,2147,0.0,12,12,4,0,0,100.0
2008021116,3,3556,0.0,28,24,8,0,4,85.71428571
2008021116,5,3600,0.0,29,26,6,2,3,89.65517241
2008021117,6,3600,0.0,38,33,3,0,5,86.84210526
2008021117,10,1540,0.0,11,10,0,0,1,90.90909091
2008021117,10,1964,0.0,20,14,0,0,6,70.0
2008021118,7,3899,0.0,35,32,6,3,3,91.42857143
2008021118,8,3884,0.0,37,34,5,1,3,91.89189189
2008021119,12,3600,0.0,32,31,4,0,1,96.875
2008021119,1,3505,0.0,48,46,11,0,2,95.83333333
2008021120,4,3900,0.0,33,30,6,2,3,90.90909091
2008021120,2,3900,0.0,36,33,3,2,3,91.66666667
2008021121,9,2056,0.0,21,17,2,1,4,80.95238095
2008021121,9,1544,0.0,11,9,3,0,2,81.81818182
2008021121,11,3599,0.0,21,18,8,1,3,85.71428571
2008021122,26,3821,0.0,28,24,5,1,4,85.71428571
2008021122,18,3818,0.0,27,24,1,1,3,88.88888889
2008021123,13,3600,0.0,35,32,2,0,3,91.42857143
2008021123,25,3519,0.0,32,27,5,0,5,84.375
2008021124,29,3900,0.0,28,25,9,0,3,89.28571429
2008021124,19,3890,0.0,27,24,2,0,3,88.88888889
2008021125,30,3567,0.0,40,37,4,0,3,92.5
2008021125,20,3599,0.0,15,13,0,0,2,86.66666667
2008021126,27,3536,0.0,32,29,3,1,3,90.625
2008021126,28,3573,0.0,27,25,2,0,2,92.59259259
2008021127,18,3594,0.0,36,33,5,0,3,91.66666667
2008021127,17,3521,0.0,26,22,3,1,4,84.61538462
2008021128,19,3600,0.0,28,26,2,0,2,92.85714286
2008021128,29,3600,0.0,27,22,6,0,5,81.48148148
2008021129,9,3600,0.0,20,20,1,0,0,100.0
2008021129,14,3600,0.0,29,26,8,1,3,89.65517241
2008021130,6,3600,0.0,48,45,10,0,3,93.75
2008021130,4,3525,0.0,31,27,2,0,4,87.09677419
2008021131,23,3600,0.0,26,26,5,3,0,100.0
2008021131,16,3515,0.0,23,19,4,0,4,82.60869565
2008021132,30,3593,0.0,33,31,3,3,2,93.93939394
2008021132,22,3535,0.0,21,18,2,0,3,85.71428571
2008021133,21,3579,0.0,31,27,4,0,4,87.09677419
2008021133,24,3600,0.0,27,26,2,1,1,96.2962963
2008021134,1,3598,0.0,37,34,3,1,3,91.89189189
2008021134,3,3600,0.0,38,38,1,2,0,100.0
2008021135,28,3600,0.0,29,28,3,0,1,96.55172414
2008021135,20,3523,0.0,17,15,1,0,2,88.23529412
2008021136,25,3643,0.0,33,27,4,1,6,81.81818182
2008021136,27,3645,0.0,23,18,3,0,5,78.26086957
2008021137,14,3576,0.0,39,36,13,2,3,92.30769231
2008021137,6,3589,0.0,25,24,4,0,1,96.0
2008021138,18,3525,0.0,33,31,1,0,2,93.93939394
2008021138,29,3595,0.0,22,21,3,0,1,95.45454545
2008021139,16,3599,0.0,33,29,5,1,4,87.87878788
2008021139,8,3600,0.0,29,28,6,0,1,96.55172414
2008021140,9,2521,0.0,21,17,2,0,4,80.95238095
2008021140,9,1067,0.0,5,5,0,0,0,100.0
2008021140,13,3600,0.0,32,30,4,1,2,93.75
2008021141,23,3840,0.0,34,33,5,0,1,97.05882353
2008021141,30,3822,0.0,19,17,0,1,2,89.47368421
2008021142,24,3600,0.0,31,28,9,1,3,90.32258065
2008021142,22,3520,0.0,24,20,5,0,4,83.33333333
2008021143,25,3600,0.0,28,26,3,1,2,92.85714286
2008021143,26,3557,0.0,35,32,6,0,3,91.42857143
2008021144,2,3588,0.0,42,38,0,0,4,90.47619048
2008021144,15,3600,0.0,27,24,2,0,3,88.88888889
2008021145,7,3870,0.0,30,27,2,1,3,90.0
2008021145,11,3850,0.0,32,30,9,1,2,93.75
2008021146,4,1528,0.0,10,10,0,0,0,100.0
2008021146,4,1983,0.0,28,25,1,0,3,89.28571429
2008021146,10,3583,0.0,34,32,3,0,2,94.11764706
2008021147,1,3600,0.0,37,31,5,2,6,83.78378378
2008021147,5,3600,0.0,25,24,1,2,1,96.0
2008021148,19,3600,0.0,30,27,10,1,3,90.0
2008021148,16,3600,0.0,17,16,1,1,1,94.11764706
2008021149,27,3588,0.0,23,23,2,0,0,100.0
2008021149,21,3585,0.0,34,32,5,0,2,94.11764706
2008021150,9,3483,0.0,33,31,5,0,2,93.93939394
2008021150,6,3597,0.0,32,31,8,1,1,96.875
2008021151,8,3597,0.0,27,26,3,3,1,96.2962963
2008021151,2,3598,0.0,38,33,6,2,5,86.84210526
2008021152,3,3435,0.0,23,19,7,1,4,82.60869565
2008021152,12,3600,0.0,38,36,11,1,2,94.73684211
2008021153,19,3600,0.0,38,34,8,1,4,89.47368421
2008021153,17,3504,0.0,33,28,7,0,5,84.84848485
2008021154,20,3600,0.0,30,29,6,0,1,96.66666667
2008021154,25,3531,0.0,24,22,2,0,2,91.66666667
2008021155,28,3586,0.0,26,25,4,0,1,96.15384615
2008021155,22,3527,2.0,22,20,4,1,2,90.90909091
2008021156,24,3900,0.0,30,25,2,0,5,83.33333333
2008021156,23,3900,0.0,32,27,2,0,5,84.375
2008021157,26,3591,0.0,32,30,3,0,2,93.75
2008021157,27,3600,0.0,21,20,1,0,1,95.23809524
2008021158,14,3681,0.0,39,34,5,0,5,87.17948718
2008021158,1,1257,0.0,12,11,3,0,1,91.66666667
2008021158,1,2414,0.0,10,7,0,0,3,70.0
2008021159,10,658,0.0,5,3,0,0,2,60.0
2008021159,10,2942,0.0,30,24,1,1,6,80.0
2008021159,4,3591,0.0,32,27,0,2,5,84.375
2008021160,7,3678,0.0,37,33,8,1,4,89.18918919
2008021160,15,3707,0.0,30,25,7,0,5,83.33333333
2008021161,11,3600,0.0,36,35,9,0,1,97.22222222
2008021161,13,3549,0.0,32,29,4,1,3,90.625
2008021162,20,12,0.0,0,0,0,0,0,
2008021162,20,3585,0.0,28,24,7,2,4,85.71428571
2008021162,30,3596,0.0,27,27,7,1,0,100.0
2008021163,18,3552,0.0,31,29,2,0,2,93.5483871
2008021163,16,3600,0.0,26,25,1,1,1,96.15384615
2008021164,3,3544,0.0,24,23,1,0,1,95.83333333
2008021164,6,3600,2.0,31,31,5,1,0,100.0
2008021165,1,3600,0.0,37,35,6,0,2,94.59459459
2008021165,7,2400,0.0,22,19,2,0,3,86.36363636
2008021165,7,1131,0.0,6,6,0,0,0,100.0
2008021166,8,3600,0.0,36,34,11,0,2,94.44444444
2008021166,10,3600,0.0,29,23,5,0,6,79.31034483
2008021167,4,3900,0.0,38,35,0,0,3,92.10526316
2008021167,9,3900,0.0,34,31,4,0,3,91.17647059
2008021168,14,3513,0.0,21,18,4,1,3,85.71428571
2008021168,2,3600,0.0,30,29,5,0,1,96.66666667
2008021169,5,3671,0.0,30,27,3,0,3,90.0
2008021169,12,3671,0.0,35,33,2,1,2,94.28571429
2008021170,29,3900,0.0,33,29,7,0,4,87.87878788
2008021170,18,3900,0.0,23,19,1,1,4,82.60869565
2008021171,19,3616,0.0,24,19,3,0,5,79.16666667
2008021171,25,3616,0.0,26,22,3,0,4,84.61538462
2008021172,23,3573,0.0,24,20,4,1,4,83.33333333
2008021172,22,3598,0.0,46,43,12,2,3,93.47826087
2008021173,24,3600,0.0,30,28,5,0,2,93.33333333
2008021173,28,3584,0.0,28,23,1,0,5,82.14285714
2008021174,27,3595,0.0,32,26,2,0,6,81.25
2008021174,26,3600,0.0,30,29,3,0,1,96.66666667
2008021175,11,3539,0.0,32,27,5,1,5,84.375
2008021175,15,3600,0.0,24,20,6,4,4,83.33333333
2008021176,5,3486,0.0,26,22,3,2,4,84.61538462
2008021176,13,3582,0.0,43,41,2,0,2,95.34883721
2008021177,30,3571,0.0,44,41,6,2,3,93.18181818
2008021177,17,3562,0.0,23,21,2,0,2,91.30434783
2008021178,16,3790,0.0,20,20,3,0,0,100.0
2008021178,29,3790,0.0,25,24,1,1,1,96.0
2008021179,28,3590,2.0,21,19,0,2,2,90.47619048
2008021179,24,3508,0.0,26,23,3,0,3,88.46153846
2008021180,21,3600,0.0,21,20,4,0,1,95.23809524
2008021180,23,3600,0.0,26,22,2,0,4,84.61538462
2008021181,17,3589,0.0,33,32,5,0,1,96.96969697
2008021181,7,3525,0.0,31,28,2,1,3,90.32258065
2008021182,9,3600,0.0,22,20,3,4,2,90.90909091
2008021182,8,3499,0.0,23,20,6,2,3,86.95652174
2008021183,26,3600,0.0,38,34,6,0,4,89.47368421
2008021183,20,3599,0.0,24,23,6,1,1,95.83333333
2008021184,10,3597,0.0,48,47,20,0,1,97.91666667
2008021184,1,3600,0.0,18,14,2,1,4,77.77777778
2008021185,8,3511,0.0,44,41,5,1,3,93.18181818
2008021185,3,3583,0.0,25,24,2,0,1,96.0
2008021186,13,3526,0.0,30,28,3,3,2,93.33333333
2008021186,4,3600,0.0,30,29,6,1,1,96.66666667
2008021187,2,1200,0.0,10,7,4,0,3,70.0
2008021187,2,2400,0.0,47,41,19,0,6,87.23404255
2008021187,12,3598,0.0,12,12,0,1,0,100.0
2008021188,15,3596,0.0,31,29,6,0,2,93.5483871
2008021188,11,3510,0.0,26,22,0,1,4,84.61538462
2008021189,6,3543,0.0,32,29,8,5,3,90.625
2008021189,9,3588,0.0,33,31,7,2,2,93.93939394
2008021190,5,3594,0.0,37,33,5,1,4,89.18918919
2008021190,14,3528,0.0,30,25,8,4,5,83.33333333
2008021191,16,3600,0.0,24,22,2,0,2,91.66666667
2008021191,18,3540,0.0,27,24,0,0,3,88.88888889
2008021192,25,3586,0.0,32,29,4,1,3,90.625
2008021192,30,3592,0.0,28,27,1,3,1,96.42857143
2008021193,26,3600,0.0,39,38,3,0,1,97.43589744
2008021193,22,3553,0.0,29,27,0,0,2,93.10344828
2008021194,20,3600,0.0,25,21,3,1,4,84.0
2008021194,23,3590,0.0,47,46,10,0,1,97.87234043
2008021195,19,3600,0.0,29,28,6,1,1,96.55172414
2008021195,27,2400,0.0,21,17,2,0,4,80.95238095
2008021195,27,1185,0.0,3,2,0,0,1,66.66666667
2008021196,21,3900,0.0,30,30,10,0,0,100.0
2008021196,28,3900,2.0,20,20,2,1,0,100.0
2008021197,7,3600,0.0,33,32,13,0,1,96.96969697
2008021197,10,3474,0.0,29,26,0,0,3,89.65517241
2008021198,29,3900,0.0,27,24,3,0,3,88.88888889
2008021198,16,3900,0.0,22,19,1,0,3,86.36363636
2008021199,8,3756,0.0,33,28,7,2,5,84.84848485
2008021199,6,3762,0.0,39,35,7,1,4,89.74358974
2008021200,4,3553,0.0,31,29,1,0,2,93.5483871
2008021200,3,3600,0.0,38,37,3,1,1,97.36842105
2008021201,7,3592,0.0,27,26,2,3,1,96.2962963
2008021201,12,1787,0.0,12,11,2,1,1,91.66666667
2008021201,12,1813,0.0,13,9,0,0,4,69.23076923
2008021202,13,3587,0.0,25,23,5,1,2,92.0
2008021202,11,3507,0.0,31,28,9,0,3,90.32258065
2008021203,1,3889,0.0,30,28,3,2,2,93.33333333
2008021203,9,3868,0.0,32,30,5,1,2,93.75
2008021204,2,3600,0.0,37,31,1,0,6,83.78378378
2008021204,5,3593,0.0,29,28,7,0,1,96.55172414
2008021205,15,3590,0.0,24,22,8,0,2,91.66666667
2008021205,14,3533,0.0,32,29,4,2,3,90.625
2008021206,18,3878,0.0,26,23,1,1,3,88.46153846
2008021206,17,3900,0.0,25,22,3,3,3,88.0
2008021207,25,3900,0.0,27,25,3,0,2,92.59259259
2008021207,21,3900,0.0,39,37,4,1,2,94.87179487
2008021208,26,3524,0.0,28,27,8,1,1,96.42857143
2008021208,23,3583,0.0,20,20,2,2,0,100.0
2008021209,27,3600,0.0,41,40,13,0,1,97.56097561
2008021209,28,3600,0.0,17,13,3,0,4,76.47058824
2008021210,18,3543,0.0,35,29,6,1,6,82.85714286
2008021210,30,3586,0.0,35,31,9,1,4,88.57142857
2008021211,29,3600,0.0,25,22,8,0,3,88.0
2008021211,19,3600,0.0,17,16,0,1,1,94.11764706
2008021212,20,474,0.0,5,3,0,1,2,60.0
2008021212,20,3126,0.0,31,28,1,1,3,90.32258065
2008021212,22,3589,0.0,32,31,4,0,1,96.875
2008021213,25,3899,2.0,39,36,7,1,3,92.30769231
2008021213,24,3900,0.0,45,42,7,1,3,93.33333333
2008021214,12,3548,0.0,35,32,8,1,3,91.42857143
2008021214,1,3574,2.0,25,23,7,1,2,92.0
2008021215,4,3596,0.0,32,30,1,0,2,93.75
2008021215,2,3533,0.0,27,24,3,0,3,88.88888889
2008021216,16,3600,0.0,23,21,1,0,2,91.30434783
2008021216,17,3588,0.0,25,22,6,0,3,88.0
2008021217,23,3640,0.0,22,22,0,0,0,100.0
2008021217,21,3640,0.0,33,32,3,0,1,96.96969697
2008021218,6,3600,0.0,34,28,2,1,6,82.35294118
2008021218,7,3600,0.0,35,34,6,0,1,97.14285714
2008021219,28,3531,0.0,24,20,3,2,4,83.33333333
2008021219,26,3600,0.0,30,27,7,0,3,90.0
2008021220,9,3522,0.0,29,25,4,2,4,86.20689655
2008021220,10,3594,0.0,39,37,6,2,2,94.87179487
2008021221,5,3590,0.0,30,29,6,0,1,96.66666667
2008021221,8,3598,0.0,41,38,5,3,3,92.68292683
2008021222,14,2049,0.0,15,11,3,0,4,73.33333333
2008021222,14,1551,0.0,11,9,1,0,2,81.81818182
2008021222,11,3555,0.0,35,33,10,2,2,94.28571429
2008021223,15,3529,0.0,41,35,1,2,6,85.36585366
2008021223,13,3600,0.0,41,37,5,0,4,90.24390244
2008021224,30,3571,0.0,28,25,4,0,3,89.28571429
2008021224,29,3519,0.0,27,22,1,0,5,81.48148148
2008021225,24,1500,0.0,9,9,2,0,0,100.0
2008021225,24,2392,0.0,24,20,6,3,4,83.33333333
2008021225,27,3900,0.0,35,31,5,1,4,88.57142857
2008021226,22,3600,0.0,45,41,5,0,4,91.11111111
2008021226,20,3600,0.0,36,35,1,3,1,97.22222222
2008021227,19,3600,0.0,28,28,4,0,0,100.0
2008021227,21,3516,0.0,17,16,1,1,1,94.11764706
2008021228,6,3600,0.0,34,32,4,5,2,94.11764706
2008021228,2,1514,0.0,15,11,2,0,4,73.33333333
2008021228,2,2073,0.0,18,16,0,1,2,88.88888889
2008021229,3,3600,0.0,31,28,2,2,3,90.32258065
2008021229,4,3528,0.0,31,27,6,0,4,87.09677419
2008021230,17,3590,0.0,23,20,4,2,3,86.95652174
2008021230,16,3600,0.0,37,37,10,3,0,100.0
2009020001,15,3600,0.0,20,19,1,1,1,95.0
2009020001,6,3600,0.0,34,30,5,5,4,88.23529412
2009020002,8,3871,0.0,46,43,5,1,3,93.47826087
2009020002,10,3870,0.0,27,23,1,0,4,85.18518519
2009020003,28,3576,0.0,20,15,5,0,5,75.0
2009020003,21,3600,0.0,40,38,12,1,2,95.0
2009020004,23,3550,0.0,22,18,0,0,4,81.81818182
2009020004,20,3597,0.0,42,39,2,1,3,92.85714286
2009020005,4,3578,0.0,28,28,7,0,0,100.0
2009020005,12,3486,0.0,27,25,5,0,2,92.59259259
2009020006,3,3521,0.0,31,28,2,2,3,90.32258065
2009020006,5,3600,0.0,27,25,8,1,2,92.59259259
2009020007,13,3900,0.0,55,52,5,2,3,94.54545455
2009020007,16,3891,0.0,24,21,4,0,3,87.5
2009020008,19,3598,0.0,34,31,7,0,3,91.17647059
2009020008,17,3547,0.0,23,19,3,2,4,82.60869565
2009020009,23,3596,0.0,27,24,3,1,3,88.88888889
2009020009,21,3584,0.0,35,35,7,1,0,100.0
2009020010,12,1763,0.0,14,11,1,0,3,78.57142857
2009020010,12,1837,0.0,28,24,12,2,4,85.71428571
2009020010,6,3582,2.0,27,25,14,0,2,92.59259259
2009020011,8,3762,0.0,35,34,5,3,1,97.14285714
2009020011,7,3762,0.0,17,15,2,2,2,88.23529412
2009020012,4,3600,2.0,26,24,5,2,2,92.30769231
2009020012,1,3580,0.0,27,22,4,0,5,81.48148148
2009020013,5,3884,0.0,28,25,3,0,3,89.28571429
2009020013,2,3897,0.0,42,39,7,2,3,92.85714286
2009020014,9,3516,0.0,33,29,14,0,4,87.87878788
2009020014,3,3586,0.0,34,32,6,1,2,94.11764706
2009020015,10,2293,0.0,19,16,3,0,3,84.21052632
2009020015,10,1200,0.0,8,5,1,1,3,62.5
2009020015,15,3600,0.0,31,27,1,2,4,87.09677419
2009020016,14,3595,0.0,28,22,3,0,6,78.57142857
2009020016,11,3600,0.0,39,36,3,0,3,92.30769231
2009020017,16,3598,0.0,23,23,3,0,0,100.0
2009020017,13,3600,0.0,33,29,7,0,4,87.87878788
2009020018,30,3538,0.0,39,37,9,1,2,94.87179487
2009020018,29,3597,0.0,33,32,8,0,1,96.96969697
2009020019,18,3900,0.0,40,38,10,1,2,95.0
2009020019,25,3900,0.0,26,24,5,1,2,92.30769231
2009020020,17,3502,0.0,32,27,9,1,5,84.375
2009020020,19,3600,0.0,33,30,9,0,3,90.90909091
2009020021,20,3600,0.0,34,31,10,1,3,91.17647059
2009020021,22,3574,0.0,21,17,2,0,4,80.95238095
2009020022,28,3582,0.0,25,24,10,0,1,96.0
2009020022,24,3598,0.0,37,33,6,0,4,89.18918919
2009020023,27,3600,0.0,33,30,5,1,3,90.90909091
2009020023,26,3588,0.0,30,24,3,1,6,80.0
2009020024,3,3598,0.0,27,25,4,1,2,92.59259259
2009020024,1,3544,0.0,26,23,1,1,3,88.46153846
2009020025,29,3600,0.0,43,40,5,2,3,93.02325581
2009020025,23,1963,0.0,12,11,0,0,1,91.66666667
2009020025,23,1543,0.0,12,8,4,0,4,66.66666667
2009020026,9,3600,0.0,27,26,4,1,1,96.2962963
2009020026,10,3554,0.0,28,26,1,1,2,92.85714286
2009020027,15,2039,0.0,25,21,6,2,4,84.0
2009020027,15,1785,0.0,16,14,3,0,2,87.5
2009020027,4,3816,0.0,36,31,11,2,5,86.11111111
2009020028,14,3900,2.0,28,27,1,2,1,96.42857143
2009020028,12,3883,0.0,30,29,8,2,1,96.66666667
2009020029,24,3788,0.0,32,28,8,1,4,87.5
2009020029,30,3786,0.0,19,16,1,1,3,84.21052632
2009020030,8,3559,0.0,28,24,0,0,4,85.71428571
2009020030,20,3600,0.0,30,27,0,0,3,90.0
2009020031,25,3879,0.0,24,20,3,0,4,83.33333333
2009020031,22,3876,0.0,34,30,11,0,4,88.23529412
2009020032,28,1636,0.0,9,8,0,0,1,88.88888889
2009020032,28,1936,0.0,20,16,3,0,4,80.0
2009020032,26,3600,0.0,29,25,2,1,4,86.20689655
2009020033,27,3594,0.0,24,24,6,1,0,100.0
2009020033,5,3520,0.0,24,22,4,1,2,91.66666667
2009020034,8,480,0.0,3,3,0,0,0,100.0
2009020034,8,3118,0.0,32,25,5,0,7,78.125
2009020034,23,3585,0.0,28,27,11,2,1,96.42857143
2009020035,24,3599,0.0,34,33,4,0,1,97.05882353
2009020035,6,3592,0.0,30,24,2,3,6,80.0
2009020036,27,3524,0.0,39,37,14,0,2,94.87179487
2009020036,7,3594,0.0,24,23,3,3,1,95.83333333
2009020037,2,3619,0.0,28,25,6,0,3,89.28571429
2009020037,9,3632,0.0,25,23,8,0,2,92.0
2009020038,5,3598,0.0,34,30,10,1,4,88.23529412
2009020038,4,3508,0.0,25,20,5,3,5,80.0
2009020039,3,3600,0.0,28,25,9,0,3,89.28571429
2009020039,15,3505,0.0,29,25,2,0,4,86.20689655
2009020040,1,3821,0.0,44,41,10,0,3,93.18181818
2009020040,14,3900,0.0,34,31,1,0,3,91.17647059
2009020041,16,3497,0.0,23,20,4,0,3,86.95652174
2009020041,17,3596,0.0,34,32,7,1,2,94.11764706
2009020042,11,3600,0.0,31,29,2,0,2,93.5483871
2009020042,19,3563,0.0,21,18,2,2,3,85.71428571
2009020043,21,3518,0.0,37,34,3,0,3,91.89189189
2009020043,18,3600,0.0,24,22,6,0,2,91.66666667
2009020044,20,3848,0.0,28,25,7,1,3,89.28571429
2009020044,22,3876,0.0,28,25,7,0,3,89.28571429
2009020045,30,3592,0.0,23,17,2,0,6,73.91304348
2009020045,26,3600,0.0,29,26,4,2,3,89.65517241
2009020046,29,2494,0.0,20,15,4,0,5,75.0
2009020046,29,1099,0.0,8,7,2,0,1,87.5
2009020046,28,3600,0.0,27,24,3,1,3,88.88888889
2009020047,13,1108,0.0,7,5,0,0,2,71.42857143
2009020047,13,2492,0.0,26,21,4,2,5,80.76923077
2009020047,12,3600,0.0,27,25,6,0,2,92.59259259
2009020048,25,3600,0.0,23,21,2,0,2,91.30434783
2009020048,20,3578,0.0,29,25,8,0,4,86.20689655
2009020049,2,3900,0.0,30,27,8,2,3,90.0
2009020049,6,3900,0.0,38,35,13,3,3,92.10526316
2009020050,5,3598,0.0,20,18,1,0,2,90.0
2009020050,10,3600,0.0,33,28,6,1,5,84.84848485
2009020051,11,3560,0.0,34,30,2,1,4,88.23529412
2009020051,9,3600,0.0,28,26,4,0,2,92.85714286
2009020052,24,3848,0.0,35,33,10,0,2,94.28571429
2009020052,4,3869,0.0,33,31,6,1,2,93.93939394
2009020053,1,3600,0.0,21,19,3,2,2,90.47619048
2009020053,13,3511,0.0,41,38,7,1,3,92.68292683
2009020054,15,3533,0.0,37,34,7,1,3,91.89189189
2009020054,17,3596,0.0,24,22,6,0,2,91.66666667
2009020055,12,3580,0.0,38,34,15,2,4,89.47368421
2009020055,14,3595,0.0,26,24,6,2,2,92.30769231
2009020056,26,3596,0.0,30,29,8,2,1,96.66666667
2009020056,19,3515,0.0,26,24,6,2,2,92.30769231
2009020057,7,3599,0.0,25,25,2,4,0,100.0
2009020057,18,3540,0.0,42,41,6,0,1,97.61904762
2009020058,21,3900,0.0,26,23,2,0,3,88.46153846
2009020058,16,3883,0.0,19,16,4,1,3,84.21052632
2009020059,29,3597,0.0,36,36,10,2,0,100.0
2009020059,27,3545,0.0,18,17,4,1,1,94.44444444
2009020060,8,3542,0.0,19,16,2,0,3,84.21052632
2009020060,22,3600,0.0,35,33,1,2,2,94.28571429
2009020061,30,3498,2.0,29,25,3,2,4,86.20689655
2009020061,28,3576,0.0,40,38,8,2,2,95.0
2009020062,24,3562,0.0,37,35,3,0,2,94.59459459
2009020062,3,3594,0.0,18,18,3,0,0,100.0
2009020063,25,3898,0.0,25,22,4,1,3,88.0
2009020063,23,3896,0.0,35,32,6,0,3,91.42857143
2009020064,21,3575,2.0,32,29,6,0,3,90.625
2009020064,6,3568,0.0,22,18,3,0,4,81.81818182
2009020065,26,3600,0.0,29,28,1,2,1,96.55172414
2009020065,2,3496,0.0,22,20,2,0,2,90.90909091
2009020066,10,3600,0.0,33,26,7,2,7,78.78787879
2009020066,3,3600,0.0,29,27,1,1,2,93.10344828
2009020067,1,3900,2.0,33,31,15,1,2,93.93939394
2009020067,15,3900,0.0,29,27,6,0,2,93.10344828
2009020068,5,3600,0.0,31,30,7,0,1,96.77419355
2009020068,9,3600,0.0,28,24,3,2,4,85.71428571
2009020069,13,3557,0.0,31,28,3,2,3,90.32258065
2009020069,14,3600,0.0,33,31,10,1,2,93.93939394
2009020070,22,3600,0.0,41,40,17,0,1,97.56097561
2009020070,18,2394,0.0,11,9,0,0,2,81.81818182
2009020070,18,1200,0.0,9,5,1,0,4,55.55555556
2009020071,20,3626,0.0,39,33,6,1,6,84.61538462
2009020071,16,3194,0.0,15,13,1,4,2,86.66666667
2009020071,16,427,0.0,5,2,0,0,3,40.0
2009020072,27,3900,0.0,26,26,4,1,0,100.0
2009020072,28,3900,0.0,30,30,6,0,0,100.0
2009020073,17,1634,0.0,15,14,2,0,1,93.33333333
2009020073,17,1966,0.0,22,17,1,0,5,77.27272727
2009020073,7,3596,0.0,25,23,4,1,2,92.0
2009020074,20,3517,0.0,33,31,4,0,2,93.93939394
2009020074,29,3597,0.0,23,22,0,3,1,95.65217391
2009020075,21,3600,2.0,31,30,8,1,1,96.77419355
2009020075,10,3600,0.0,28,24,5,0,4,85.71428571
2009020076,26,3470,0.0,21,17,1,3,4,80.95238095
2009020076,3,3600,0.0,36,34,10,0,2,94.44444444
2009020077,22,3512,0.0,38,34,3,1,4,89.47368421
2009020077,16,3600,0.0,19,16,1,1,3,84.21052632
2009020078,18,391,0.0,3,0,0,0,3,0.0
2009020078,18,3200,0.0,23,20,8,0,3,86.95652174
2009020078,25,3600,0.0,29,29,6,1,0,100.0
2009020079,30,3510,0.0,35,32,12,1,3,91.42857143
2009020079,24,3600,0.0,34,32,1,2,2,94.11764706
2009020080,28,3593,2.0,36,32,7,2,4,88.88888889
2009020080,15,2400,0.0,15,15,2,0,0,100.0
2009020080,15,1199,0.0,13,12,0,1,1,92.30769231
2009020081,5,3900,0.0,29,27,3,3,2,93.10344828
2009020081,12,3893,0.0,38,36,5,0,2,94.73684211
2009020082,21,3600,0.0,31,29,9,0,2,93.5483871
2009020082,8,3560,0.0,23,20,2,1,3,86.95652174
2009020083,14,3588,0.0,35,28,4,5,7,80.0
2009020083,9,3600,0.0,17,16,5,1,1,94.11764706
2009020084,26,3550,0.0,31,27,7,1,4,87.09677419
2009020084,17,3600,0.0,26,24,3,2,2,92.30769231
2009020085,16,3600,0.0,13,12,2,0,1,92.30769231
2009020085,18,3540,0.0,30,27,0,0,3,90.0
2009020086,19,3808,0.0,34,31,3,0,3,91.17647059
2009020086,27,3817,0.0,24,22,3,3,2,91.66666667
2009020087,11,3600,0.0,30,28,5,0,2,93.33333333
2009020087,1,3521,0.0,19,15,4,2,4,78.94736842
2009020088,2,1762,0.0,12,8,1,0,4,66.66666667
2009020088,2,1828,0.0,22,20,4,1,2,90.90909091
2009020088,7,3600,0.0,39,36,3,1,3,92.30769231
2009020089,4,3534,0.0,27,24,1,1,3,88.88888889
2009020089,13,3595,0.0,27,25,3,0,2,92.59259259
2009020090,6,3600,0.0,27,27,7,0,0,100.0
2009020090,25,3566,0.0,29,26,0,3,3,89.65517241
2009020091,23,1191,0.0,5,5,1,0,0,100.0
2009020091,23,2400,0.0,19,14,4,0,5,73.68421053
2009020091,20,3594,0.0,29,26,5,1,3,89.65517241
2009020092,30,3600,2.0,19,14,3,0,5,73.68421053
2009020092,22,3600,0.0,31,29,2,0,2,93.5483871
2009020093,11,3600,0.0,42,40,7,1,2,95.23809524
2009020093,7,3561,0.0,27,23,2,0,4,85.18518519
2009020094,3,3600,0.0,35,34,6,1,1,97.14285714
2009020094,10,3600,0.0,28,24,5,0,4,85.71428571
2009020095,9,3596,0.0,28,27,6,1,1,96.42857143
2009020095,8,3567,0.0,21,18,3,0,3,85.71428571
2009020096,12,3566,0.0,28,27,8,0,1,96.42857143
2009020096,1,3600,0.0,26,26,0,2,0,100.0
2009020097,28,3594,0.0,32,31,1,0,1,96.875
2009020097,2,3600,0.0,29,25,3,2,4,86.20689655
2009020098,18,3897,0.0,35,33,4,0,2,94.28571429
2009020098,15,3894,0.0,24,22,6,2,2,91.66666667
2009020099,21,3900,0.0,31,28,4,0,3,90.32258065
2009020099,17,3894,0.0,29,26,4,1,3,89.65517241
2009020100,26,3587,0.0,23,20,5,3,3,86.95652174
2009020100,29,3588,0.0,28,27,4,2,1,96.42857143
2009020101,14,3467,0.0,33,29,14,0,4,87.87878788
2009020101,5,3595,0.0,23,22,6,0,1,95.65217391
2009020102,25,3600,0.0,32,29,3,1,3,90.625
2009020102,16,3527,0.0,25,21,7,0,4,84.0
2009020103,6,3600,0.0,36,32,0,0,4,88.88888889
2009020103,27,3600,0.0,23,22,1,0,1,95.65217391
2009020104,30,3533,0.0,39,37,10,0,2,94.87179487
2009020104,23,3600,0.0,18,17,6,0,1,94.44444444
2009020105,19,3600,0.0,26,26,5,0,0,100.0
2009020105,24,2072,0.0,20,18,2,1,2,90.0
2009020105,24,1528,0.0,12,9,1,1,3,75.0
2009020106,28,3595,2.0,29,26,8,1,3,89.65517241
2009020106,3,1200,0.0,12,10,3,0,2,83.33333333
2009020106,3,2400,0.0,18,13,3,0,5,72.22222222
2009020107,26,3600,0.0,30,29,9,0,1,96.66666667
2009020107,25,3587,0.0,31,28,8,2,3,90.32258065
2009020108,23,3511,0.0,29,27,1,0,2,93.10344828
2009020108,22,3600,2.0,40,39,2,0,1,97.5
2009020109,19,2400,0.0,35,31,7,0,4,88.57142857
2009020109,19,1200,0.0,8,7,0,0,1,87.5
2009020109,5,3600,0.0,23,22,2,0,1,95.65217391
2009020110,11,3900,0.0,35,34,15,3,1,97.14285714
2009020110,8,3900,0.0,23,22,1,0,1,95.65217391
2009020111,29,3600,0.0,22,16,4,0,6,72.72727273
2009020111,20,3584,0.0,30,27,11,0,3,90.0
2009020112,18,3537,0.0,27,24,0,0,3,88.88888889
2009020112,6,3600,0.0,30,28,5,3,2,93.33333333
2009020113,12,3900,0.0,29,26,5,1,3,89.65517241
2009020113,2,3900,0.0,38,35,5,1,3,92.10526316
2009020114,7,3600,0.0,43,41,10,2,2,95.34883721
2009020114,13,3472,0.0,33,30,4,0,3,90.90909091
2009020114,13,116,0.0,3,1,1,0,2,33.33333333
2009020115,21,3900,0.0,26,24,15,0,2,92.30769231
2009020115,30,3893,0.0,35,33,1,0,2,94.28571429
2009020116,23,3600,0.0,20,18,4,0,2,90.0
2009020116,16,3540,0.0,31,28,14,0,3,90.32258065
2009020117,25,3600,0.0,26,24,1,1,2,92.30769231
2009020117,24,3546,0.0,37,34,8,2,3,91.89189189
2009020118,2,3599,0.0,43,38,9,1,5,88.37209302
2009020118,8,3599,0.0,22,21,7,0,1,95.45454545
2009020119,1,3577,0.0,31,29,3,0,2,93.5483871
2009020119,3,3528,0.0,24,21,0,0,3,87.5
2009020120,6,3900,0.0,39,36,4,1,3,92.30769231
2009020120,4,3897,0.0,26,23,1,0,3,88.46153846
2009020121,15,3597,0.0,26,22,8,0,4,84.61538462
2009020121,11,1908,0.0,14,9,5,0,5,64.28571429
2009020121,11,1571,0.0,14,14,4,1,0,100.0
2009020122,18,3728,0.0,32,27,6,0,5,84.375
2009020122,9,3710,0.0,37,31,9,0,6,83.78378378
2009020123,28,3534,0.0,24,20,2,1,4,83.33333333
2009020123,14,3600,0.0,34,32,2,0,2,94.11764706
2009020124,29,3576,0.0,31,26,8,2,5,83.87096774
2009020124,22,3592,2.0,32,28,4,0,4,87.5
2009020125,17,3699,0.0,33,30,2,1,3,90.90909091
2009020125,27,3715,0.0,27,25,4,0,2,92.59259259
2009020126,25,3655,0.0,31,26,8,0,5,83.87096774
2009020126,26,3612,0.0,21,17,7,1,4,80.95238095
2009020127,13,3900,0.0,43,41,8,2,2,95.34883721
2009020127,5,3900,0.0,29,27,5,1,2,93.10344828
2009020128,30,3557,0.0,25,23,9,1,2,92.0
2009020128,19,3600,0.0,21,20,4,0,1,95.23809524
2009020129,12,3529,0.0,36,31,9,0,5,86.11111111
2009020129,21,3584,0.0,36,32,2,4,4,88.88888889
2009020130,3,3759,0.0,31,26,5,0,5,83.87096774
2009020130,8,3740,0.0,27,23,2,0,4,85.18518519
2009020131,6,3861,0.0,30,27,4,0,3,90.0
2009020131,9,3900,0.0,28,25,8,0,3,89.28571429
2009020132,15,3660,0.0,30,28,2,0,2,93.33333333
2009020132,2,3660,2.0,24,21,5,1,3,87.5
2009020133,13,3585,0.0,38,33,7,6,5,86.84210526
2009020133,4,3598,0.0,18,17,4,1,1,94.44444444
2009020134,28,3585,0.0,27,24,5,1,3,88.88888889
2009020134,11,1820,0.0,12,12,0,0,0,100.0
2009020134,11,1759,0.0,12,8,0,0,4,66.66666667
2009020135,10,3537,0.0,24,22,6,0,2,91.66666667
2009020135,23,3600,0.0,36,35,4,2,1,97.22222222
2009020136,1,3600,0.0,33,32,5,1,1,96.96969697
2009020136,5,3593,0.0,26,22,2,2,4,84.61538462
2009020137,7,3843,0.0,26,24,4,1,2,92.30769231
2009020137,14,3900,0.0,32,30,5,0,2,93.75
2009020138,25,3600,0.0,28,27,7,2,1,96.42857143
2009020138,19,3593,0.0,31,27,6,1,4,87.09677419
2009020139,12,3715,0.0,29,26,13,0,3,89.65517241
2009020139,30,3697,0.0,23,21,1,4,2,91.30434783
2009020140,18,3530,0.0,34,32,1,2,2,94.11764706
2009020140,16,3600,0.0,27,27,6,0,0,100.0
2009020141,17,3561,0.0,22,20,8,1,2,90.90909091
2009020141,21,3600,0.0,49,48,20,3,1,97.95918367
2009020142,26,3600,0.0,33,30,7,2,3,90.90909091
2009020142,27,3572,0.0,20,16,2,0,4,80.0
2009020143,22,3600,0.0,38,33,7,2,5,86.84210526
2009020143,20,3582,0.0,25,23,6,0,2,92.0
2009020144,29,3600,0.0,36,32,4,0,4,88.88888889
2009020144,24,3398,0.0,35,30,3,0,5,85.71428571
2009020144,24,150,0.0,1,1,0,0,0,100.0
2009020145,28,3583,0.0,38,37,3,0,1,97.36842105
2009020145,4,3600,0.0,28,24,4,0,4,85.71428571
2009020146,29,3598,0.0,25,19,6,0,6,76.0
2009020146,26,3600,0.0,27,25,3,1,2,92.59259259
2009020147,22,3543,0.0,29,27,3,0,2,93.10344828
2009020147,23,3594,0.0,27,27,11,0,0,100.0
2009020148,27,1666,0.0,11,7,2,0,4,63.63636364
2009020148,27,1929,0.0,13,12,0,2,1,92.30769231
2009020148,3,3600,0.0,32,30,6,0,2,93.75
2009020149,2,3692,0.0,31,28,2,3,3,90.32258065
2009020149,8,3692,0.0,31,29,11,2,2,93.5483871
2009020150,30,3528,2.0,35,32,6,1,3,91.42857143
2009020150,16,3594,0.0,21,20,5,0,1,95.23809524
2009020151,10,3526,0.0,28,25,4,2,3,89.28571429
2009020151,24,3597,0.0,39,33,16,1,6,84.61538462
2009020152,4,3528,0.0,35,32,8,3,3,91.42857143
2009020152,15,3597,0.0,43,41,8,2,2,95.34883721
2009020153,21,3600,0.0,25,25,4,0,0,100.0
2009020153,22,3550,0.0,33,31,3,0,2,93.93939394
2009020154,17,3170,0.0,22,20,6,0,2,90.90909091
2009020154,17,425,0.0,4,2,0,0,2,50.0
2009020154,23,3518,0.0,42,37,5,0,5,88.0952381
2009020155,7,3600,0.0,32,31,5,2,1,96.875
2009020155,1,3600,0.0,27,23,1,1,4,85.18518519
2009020156,3,3549,0.0,32,29,4,2,3,90.625
2009020156,2,3600,0.0,35,34,3,2,1,97.14285714
2009020157,19,3600,0.0,36,34,6,0,2,94.44444444
2009020157,12,3584,0.0,17,13,0,0,4,76.47058824
2009020158,27,3597,0.0,32,31,7,1,1,96.875
2009020158,29,3596,0.0,23,19,3,2,4,82.60869565
2009020159,8,2400,0.0,23,19,3,1,4,82.60869565
2009020159,8,1200,0.0,14,12,3,0,2,85.71428571
2009020159,5,3589,2.0,24,23,1,2,1,95.83333333
2009020160,9,2400,0.0,28,26,11,0,2,92.85714286
2009020160,9,1200,0.0,10,9,4,0,1,90.0
2009020160,13,3548,0.0,29,25,1,4,4,86.20689655
2009020161,18,1338,0.0,10,7,0,0,3,70.0
2009020161,18,2262,0.0,12,12,0,0,0,100.0
2009020161,30,3517,0.0,22,18,3,0,4,81.81818182
2009020162,10,3777,2.0,36,32,3,0,4,88.88888889
2009020162,25,3777,0.0,36,33,1,0,3,91.66666667
2009020163,21,3600,0.0,32,30,7,1,2,93.75
2009020163,20,3513,0.0,14,11,0,0,3,78.57142857
2009020164,26,3900,0.0,30,29,1,0,1,96.66666667
2009020164,28,3900,0.0,29,28,5,0,1,96.55172414
2009020165,1,3600,0.0,32,31,5,1,1,96.875
2009020165,6,3543,0.0,31,29,2,0,2,93.5483871
2009020166,15,3595,0.0,41,38,3,2,3,92.68292683
2009020166,11,3516,0.0,31,28,7,0,3,90.32258065
2009020167,9,3600,0.0,27,22,6,1,5,81.48148148
2009020167,14,3600,0.0,23,21,1,5,2,91.30434783
2009020168,27,3600,0.0,32,32,6,0,0,100.0
2009020168,19,3381,0.0,29,27,2,1,2,93.10344828
2009020169,16,3484,0.0,27,26,17,0,1,96.2962963
2009020169,18,3564,0.0,22,22,1,1,0,100.0
2009020170,17,3900,0.0,33,28,3,0,5,84.84848485
2009020170,22,3900,0.0,45,40,4,2,5,88.88888889
2009020171,23,3868,0.0,31,30,5,1,1,96.77419355
2009020171,26,3884,0.0,15,14,1,0,1,93.33333333
2009020172,2,3653,0.0,40,37,11,1,3,92.5
2009020172,15,3629,0.0,30,26,6,2,4,86.66666667
2009020173,5,3900,0.0,32,29,6,1,3,90.625
2009020173,29,3892,0.0,32,29,4,4,3,90.625
2009020174,10,3632,0.0,28,25,5,1,3,89.28571429
2009020174,7,3654,0.0,35,33,7,2,2,94.28571429
2009020175,3,3510,0.0,32,29,3,1,3,90.625
2009020175,30,3576,0.0,20,18,1,0,2,90.0
2009020176,8,3541,0.0,36,33,3,1,3,91.66666667
2009020176,16,3559,0.0,22,20,2,1,2,90.90909091
2009020177,13,3900,0.0,37,32,4,0,5,86.48648649
2009020177,25,3900,0.0,29,24,0,1,5,82.75862069
2009020178,23,2390,0.0,22,18,2,2,4,81.81818182
2009020178,23,1200,0.0,12,9,0,0,3,75.0
2009020178,24,3600,0.0,38,36,4,0,2,94.73684211
2009020179,21,3503,0.0,46,43,10,2,3,93.47826087
2009020179,28,3600,0.0,25,24,7,2,1,96.0
2009020180,22,3542,0.0,27,25,3,0,2,92.59259259
2009020180,6,3600,0.0,19,19,0,0,0,100.0
2009020181,12,3600,0.0,28,22,2,0,6,78.57142857
2009020181,4,3600,0.0,40,39,7,2,1,97.5
2009020182,11,3600,0.0,51,50,9,0,1,98.03921569
2009020182,9,3521,0.0,21,18,2,0,3,85.71428571
2009020183,1,3900,0.0,19,18,2,0,1,94.73684211
2009020183,14,3900,0.0,38,37,8,3,1,97.36842105
2009020184,10,3856,0.0,39,35,12,1,4,89.74358974
2009020184,8,3899,0.0,30,26,6,1,4,86.66666667
2009020185,7,1936,0.0,16,13,0,1,3,81.25
2009020185,7,1660,0.0,14,12,2,0,2,85.71428571
2009020185,2,3600,0.0,38,38,10,0,0,100.0
2009020186,30,3600,0.0,35,34,3,1,1,97.14285714
2009020186,5,3511,0.0,15,13,0,0,2,86.66666667
2009020187,13,3600,0.0,34,34,1,0,0,100.0
2009020187,19,3539,0.0,26,23,0,0,3,88.46153846
2009020188,25,3568,0.0,33,29,3,1,4,87.87878788
2009020188,18,3600,0.0,29,27,6,0,2,93.10344828
2009020189,24,3898,0.0,32,30,3,1,2,93.75
2009020189,27,3900,0.0,34,32,15,0,2,94.11764706
2009020190,17,3568,0.0,21,20,2,0,1,95.23809524
2009020190,20,3572,0.0,29,27,3,1,2,93.10344828
2009020191,6,3531,0.0,23,22,2,3,1,95.65217391
2009020191,3,3600,0.0,29,29,8,0,0,100.0
2009020192,28,3578,0.0,26,25,7,2,1,96.15384615
2009020192,12,3594,0.0,25,20,4,0,5,80.0
2009020193,29,3574,0.0,36,32,9,0,4,88.88888889
2009020193,29,91,0.0,0,0,0,0,0,
2009020193,15,3686,0.0,32,27,3,3,5,84.375
2009020194,21,3600,0.0,20,17,2,0,3,85.0
2009020194,23,3600,0.0,18,18,0,1,0,100.0
2009020195,22,3496,0.0,37,34,6,0,3,91.89189189
2009020195,2,3600,0.0,23,22,0,1,1,95.65217391
2009020196,14,1981,0.0,13,12,4,0,1,92.30769231
2009020196,14,1619,0.0,18,13,4,0,5,72.22222222
2009020196,4,3592,0.0,28,26,1,1,2,92.85714286
2009020197,26,3600,0.0,16,13,4,0,3,81.25
2009020197,27,3572,0.0,26,22,2,2,4,84.61538462
2009020198,6,3513,0.0,26,24,5,0,2,92.30769231
2009020198,17,3600,0.0,29,29,2,0,0,100.0
2009020199,14,3741,0.0,41,40,16,1,1,97.56097561
2009020199,10,3716,0.0,32,30,8,2,2,93.75
2009020200,11,3597,0.0,38,34,10,0,4,89.47368421
2009020200,8,3551,0.0,30,25,5,1,5,83.33333333
2009020201,3,3532,0.0,29,26,6,1,3,89.65517241
2009020201,23,3600,0.0,23,22,3,3,1,95.65217391
2009020202,5,3586,0.0,29,26,2,2,3,89.65517241
2009020202,24,3536,0.0,27,23,5,1,4,85.18518519
2009020203,2,3600,2.0,39,36,8,0,3,92.30769231
2009020203,7,3597,0.0,24,24,3,0,0,100.0
2009020204,15,3516,0.0,32,29,5,0,3,90.625
2009020204,1,3600,0.0,28,26,1,0,2,92.85714286
2009020205,28,3900,0.0,28,26,2,0,2,92.85714286
2009020205,29,3900,0.0,38,36,3,0,2,94.73684211
2009020206,12,3573,0.0,24,22,8,0,2,91.66666667
2009020206,13,3594,0.0,32,32,6,0,0,100.0
2009020207,20,3675,0.0,40,38,11,2,2,95.0
2009020207,25,3678,0.0,23,20,3,2,3,86.95652174
2009020208,27,3565,0.0,28,25,7,1,3,89.28571429
2009020208,21,3600,0.0,29,28,9,3,1,96.55172414
2009020209,8,3899,0.0,43,42,6,1,1,97.6744186
2009020209,6,3876,0.0,26,25,4,1,1,96.15384615
2009020210,29,3600,0.0,35,32,12,1,3,91.42857143
2009020210,11,3516,0.0,21,17,3,1,4,80.95238095
2009020211,14,3857,0.0,29,26,6,2,3,89.65517241
2009020211,9,3840,0.0,20,18,4,0,2,90.0
2009020212,28,3900,0.0,36,35,1,2,1,97.22222222
2009020212,17,3900,0.0,34,33,6,1,1,97.05882353
2009020213,20,3770,0.0,31,30,7,1,1,96.77419355
2009020213,19,3770,0.0,31,29,10,0,2,93.5483871
2009020214,23,3600,0.0,30,28,5,1,2,93.33333333
2009020214,30,1184,0.0,4,4,2,0,0,100.0
2009020214,30,2387,0.0,17,13,4,1,4,76.47058824
2009020215,16,3455,0.0,23,20,3,1,3,86.95652174
2009020215,27,3600,0.0,32,31,13,1,1,96.875
2009020216,3,3600,0.0,28,26,5,1,2,92.85714286
2009020216,22,3465,0.0,39,35,14,0,4,89.74358974
2009020217,18,3595,0.0,31,27,10,0,4,87.09677419
2009020217,24,3600,0.0,40,40,7,0,0,100.0
2009020218,5,3583,0.0,32,27,1,0,5,84.375
2009020218,26,3586,0.0,23,21,6,0,2,91.30434783
2009020219,2,3524,0.0,31,29,8,1,2,93.5483871
2009020219,1,3600,0.0,24,23,4,2,1,95.83333333
2009020220,10,3600,0.0,36,34,5,1,2,94.44444444
2009020220,12,3533,0.0,26,23,2,0,3,88.46153846
2009020221,4,3600,0.0,30,28,3,0,2,93.33333333
2009020221,7,3498,0.0,36,32,0,2,4,88.88888889
2009020222,15,3600,0.0,29,28,0,0,1,96.55172414
2009020222,13,3448,0.0,24,21,1,1,3,87.5
2009020223,23,3522,0.0,47,45,5,3,2,95.74468085
2009020223,25,3593,0.0,33,32,6,0,1,96.96969697
2009020224,16,3900,0.0,22,19,0,0,3,86.36363636
2009020224,21,3900,0.0,32,29,4,1,3,90.625
2009020225,18,3600,0.0,28,27,4,1,1,96.42857143
2009020225,26,3506,2.0,25,22,2,0,3,88.0
2009020226,7,3498,0.0,37,33,3,6,4,89.18918919
2009020226,6,3593,0.0,30,28,6,0,2,93.33333333
2009020227,17,3596,0.0,28,23,4,0,5,82.14285714
2009020227,10,3600,0.0,36,35,7,1,1,97.22222222
2009020228,14,3600,0.0,37,36,1,1,1,97.2972973
2009020228,8,3541,0.0,21,18,3,0,3,85.71428571
2009020229,1,3596,0.0,21,19,1,1,2,90.47619048
2009020229,9,3522,0.0,25,22,9,0,3,88.0
2009020230,11,2391,0.0,36,31,4,1,5,86.11111111
2009020230,11,1181,0.0,9,8,3,0,1,88.88888889
2009020230,2,3600,0.0,34,31,9,0,3,91.17647059
2009020231,19,3880,0.0,36,35,6,2,1,97.22222222
2009020231,4,3892,0.0,31,30,2,1,1,96.77419355
2009020232,13,3600,0.0,32,25,3,0,7,78.125
2009020232,15,3598,0.0,28,24,0,0,4,85.71428571
2009020233,12,3070,0.0,22,19,4,0,3,86.36363636
2009020233,12,455,0.0,4,4,0,0,0,100.0
2009020233,29,3599,0.0,26,24,4,2,2,92.30769231
2009020234,25,3533,0.0,37,34,12,1,3,91.89189189
2009020234,30,3600,0.0,21,19,3,2,2,90.47619048
2009020235,3,3442,0.0,22,19,4,0,3,86.36363636
2009020235,20,3600,0.0,33,32,7,0,1,96.96969697
2009020236,27,3545,0.0,26,22,11,0,4,84.61538462
2009020236,24,3599,0.0,30,27,7,3,3,90.0
2009020237,5,2298,0.0,21,19,5,0,2,90.47619048
2009020237,5,1301,0.0,14,11,2,0,3,78.57142857
2009020237,28,3600,0.0,27,27,7,2,0,100.0
2009020238,19,3894,0.0,40,38,7,1,2,95.0
2009020238,11,3888,0.0,32,30,7,0,2,93.75
2009020239,22,3596,0.0,37,34,12,0,3,91.89189189
2009020239,21,3524,0.0,32,27,5,0,5,84.375
2009020240,26,3600,0.0,29,25,1,0,4,86.20689655
2009020240,16,3596,0.0,18,17,0,0,1,94.44444444
2009020241,5,3542,0.0,28,26,1,0,2,92.85714286
2009020241,6,3600,0.0,27,27,0,1,0,100.0
2009020242,30,3600,0.0,39,37,10,2,2,94.87179487
2009020242,10,3486,0.0,30,26,8,1,4,86.66666667
2009020243,20,3600,0.0,25,25,5,0,0,100.0
2009020243,8,3562,0.0,31,30,12,0,1,96.77419355
2009020244,22,3895,0.0,25,22,0,0,3,88.0
2009020244,9,3900,0.0,34,31,3,0,3,91.17647059
2009020245,23,1200,0.0,13,9,0,0,4,69.23076923
2009020245,23,2400,0.0,17,15,4,0,2,88.23529412
2009020245,19,3600,0.0,23,22,4,0,1,95.65217391
2009020246,18,3572,0.0,29,25,3,0,4,86.20689655
2009020246,28,3600,0.0,26,23,3,0,3,88.46153846
2009020247,22,3532,0.0,25,23,3,0,2,92.0
2009020247,7,3580,0.0,29,28,12,1,1,96.55172414
2009020248,24,3525,0.0,25,22,6,2,3,88.0
2009020248,1,3600,0.0,32,31,8,1,1,96.875
2009020249,2,3900,0.0,41,37,2,0,4,90.24390244
2009020249,15,3476,0.0,26,25,4,0,1,96.15384615
2009020249,15,414,0.0,5,2,0,0,3,40.0
2009020250,26,3600,0.0,24,22,4,0,2,91.66666667
2009020250,12,3584,0.0,30,26,4,1,4,86.66666667
2009020251,17,3600,0.0,26,25,4,0,1,96.15384615
2009020251,29,2852,0.0,27,19,1,1,8,70.37037037
2009020251,29,748,0.0,12,11,2,0,1,91.66666667
2009020252,21,3900,0.0,39,37,1,3,2,94.87179487
2009020252,16,3900,0.0,27,25,8,0,2,92.59259259
2009020253,13,3900,0.0,40,40,9,1,0,100.0
2009020253,6,3900,0.0,23,23,5,0,0,100.0
2009020254,11,3596,0.0,36,33,7,0,3,91.66666667
2009020254,3,3546,0.0,26,22,4,0,4,84.61538462
2009020255,9,3600,0.0,27,22,6,0,5,81.48148148
2009020255,4,3597,0.0,23,22,0,0,1,95.65217391
2009020256,1,3600,0.0,26,25,4,1,1,96.15384615
2009020256,5,3535,0.0,24,21,2,2,3,87.5
2009020257,30,3887,0.0,22,19,3,0,3,86.36363636
2009020257,14,3837,0.0,34,31,8,0,3,91.17647059
2009020258,23,3576,0.0,28,26,2,1,2,92.85714286
2009020258,17,3600,0.0,32,31,6,0,1,96.875
2009020259,18,3594,0.0,22,21,0,1,1,95.45454545
2009020259,19,3564,0.0,36,34,3,1,2,94.44444444
2009020260,8,3600,0.0,20,18,1,0,2,90.0
2009020260,27,3580,0.0,19,16,1,2,3,84.21052632
2009020261,25,3894,0.0,32,30,7,1,2,93.75
2009020261,28,3900,0.0,36,34,11,0,2,94.44444444
2009020262,30,3575,0.0,40,38,6,1,2,95.0
2009020262,15,3600,0.0,30,29,3,0,1,96.66666667
2009020263,2,3826,0.0,28,25,3,0,3,89.28571429
2009020263,12,3880,0.0,25,21,1,1,4,84.0
2009020264,24,3888,0.0,29,27,4,0,2,93.10344828
2009020264,29,3900,0.0,34,32,7,2,2,94.11764706
2009020265,20,3900,0.0,33,32,2,0,1,96.96969697
2009020265,7,3894,0.0,26,25,4,3,1,96.15384615
2009020266,26,2056,0.0,14,11,0,0,3,78.57142857
2009020266,26,1543,0.0,7,3,1,0,4,42.85714286
2009020266,11,3600,0.0,38,38,5,1,0,100.0
2009020267,10,3521,0.0,34,31,8,2,3,91.17647059
2009020267,16,3600,0.0,31,29,2,0,2,93.5483871
2009020268,20,3600,0.0,40,38,10,1,2,95.0
2009020268,10,594,0.0,5,2,0,0,3,40.0
2009020268,10,3006,0.0,17,15,1,1,2,88.23529412
2009020269,3,3900,0.0,36,35,6,0,1,97.22222222
2009020269,9,3900,0.0,28,27,6,1,1,96.42857143
2009020270,15,3600,0.0,23,18,1,0,5,78.26086957
2009020270,1,3595,0.0,29,27,0,1,2,93.10344828
2009020271,7,3600,0.0,31,29,4,2,2,93.5483871
2009020271,4,3529,0.0,25,22,9,0,3,88.0
2009020272,2,3900,0.0,42,38,3,0,4,90.47619048
2009020272,13,3890,0.0,40,36,3,2,4,90.0
2009020273,24,3504,0.0,36,30,8,0,6,83.33333333
2009020273,17,3600,0.0,23,19,3,0,4,82.60869565
2009020274,6,3684,0.0,33,27,2,2,6,81.81818182
2009020274,5,3584,0.0,33,28,4,1,5,84.84848485
2009020275,26,3896,0.0,29,28,8,0,1,96.55172414
2009020275,14,3900,0.0,30,29,6,0,1,96.66666667
2009020276,28,3600,0.0,39,38,16,3,1,97.43589744
2009020276,19,3554,0.0,16,14,2,2,2,87.5
2009020277,8,3600,2.0,55,53,8,1,2,96.36363636
2009020277,18,3586,0.0,20,20,2,2,0,100.0
2009020278,25,3519,0.0,31,28,3,1,3,90.32258065
2009020278,27,3583,0.0,28,26,4,1,2,92.85714286
2009020279,23,3600,0.0,34,32,10,1,2,94.11764706
2009020279,21,2397,0.0,22,18,5,1,4,81.81818182
2009020279,21,1200,0.0,8,4,2,0,4,50.0
2009020280,30,3900,0.0,35,31,4,0,4,88.57142857
2009020280,12,3890,0.0,32,28,4,3,4,87.5
2009020281,22,3536,0.0,30,27,3,0,3,90.0
2009020281,11,3600,0.0,36,34,5,0,2,94.44444444
2009020282,28,3633,0.0,30,26,3,1,4,86.66666667
2009020282,16,3641,0.0,23,20,4,1,3,86.95652174
2009020283,2,3600,0.0,29,28,5,1,1,96.55172414
2009020283,6,3577,0.0,20,17,8,0,3,85.0
2009020284,1,3571,0.0,35,32,1,0,3,91.42857143
2009020284,4,3600,0.0,35,33,7,0,2,94.28571429
2009020285,22,3900,0.0,32,30,1,3,2,93.75
2009020285,29,3896,0.0,25,23,7,0,2,92.0
2009020286,24,3524,0.0,25,21,9,0,4,84.0
2009020286,5,3600,0.0,25,23,8,2,2,92.0
2009020287,26,3882,0.0,29,26,2,3,3,89.65517241
2009020287,13,3877,0.0,34,31,5,2,3,91.17647059
2009020288,14,3600,0.0,31,30,3,1,1,96.77419355
2009020288,27,3600,0.0,19,15,4,0,4,78.94736842
2009020289,15,3595,0.0,20,18,2,0,2,90.0
2009020289,3,3533,0.0,25,22,5,1,3,88.0
2009020290,12,1632,0.0,11,10,0,0,1,90.90909091
2009020290,12,2268,0.0,24,23,7,1,1,95.83333333
2009020290,8,3895,0.0,32,30,8,2,2,93.75
2009020291,10,3541,0.0,21,18,1,1,3,85.71428571
2009020291,9,3600,0.0,32,30,0,2,2,93.75
2009020292,28,3519,0.0,31,27,2,0,4,87.09677419
2009020292,18,3597,0.0,32,29,2,0,3,90.625
2009020293,21,3597,0.0,36,34,4,1,2,94.44444444
2009020293,20,3534,0.0,24,21,1,1,3,87.5
2009020294,13,3595,0.0,28,26,6,0,2,92.85714286
2009020294,7,3594,0.0,23,18,0,1,5,78.26086957
2009020295,25,3591,2.0,32,31,8,2,1,96.875
2009020295,17,3525,0.0,32,29,5,3,3,90.625
2009020296,27,3600,0.0,26,24,3,0,2,92.30769231
2009020296,30,3518,0.0,32,29,2,2,3,90.625
2009020297,21,3578,0.0,32,27,5,0,5,84.375
2009020297,22,3582,0.0,18,14,4,0,4,77.77777778
2009020298,4,3600,0.0,39,37,2,0,2,94.87179487
2009020298,26,3539,0.0,20,17,2,0,3,85.0
2009020299,10,3900,0.0,45,40,9,2,5,88.88888889
2009020299,12,3846,0.0,32,27,1,1,5,84.375
2009020300,6,3900,0.0,35,32,11,0,3,91.42857143
2009020300,11,3876,0.0,42,39,2,3,3,92.85714286
2009020301,5,768,0.0,7,6,0,1,1,85.71428571
2009020301,5,2832,0.0,24,19,3,1,5,79.16666667
2009020301,9,3600,0.0,27,25,8,2,2,92.59259259
2009020302,27,3617,0.0,30,27,6,0,3,90.0
2009020302,19,3617,0.0,36,34,7,0,2,94.44444444
2009020303,1,3887,0.0,28,26,1,0,2,92.85714286
2009020303,18,3900,0.0,28,26,4,0,2,92.85714286
2009020304,29,3597,2.0,26,25,4,1,1,96.15384615
2009020304,25,3593,2.0,28,24,6,1,4,85.71428571
2009020305,16,3595,0.0,28,27,6,0,1,96.42857143
2009020305,20,1200,0.0,2,1,0,0,1,50.0
2009020305,20,2400,0.0,24,18,9,0,6,75.0
2009020306,14,3652,2.0,27,23,4,0,4,85.18518519
2009020306,24,3652,0.0,24,21,5,0,3,87.5
2009020307,8,3589,0.0,34,32,5,3,2,94.11764706
2009020307,15,3514,0.0,22,19,1,2,3,86.36363636
2009020308,6,3615,0.0,26,25,1,3,1,96.15384615
2009020308,7,3647,0.0,26,24,6,0,2,92.30769231
2009020309,13,3637,0.0,40,39,7,4,1,97.5
2009020309,17,3638,0.0,20,18,0,0,2,90.0
2009020310,2,3547,0.0,29,26,6,0,3,89.65517241
2009020310,30,3579,0.0,29,27,13,0,2,93.10344828
2009020311,21,3600,0.0,27,22,1,1,5,81.48148148
2009020311,23,3588,0.0,24,22,7,0,2,91.66666667
2009020312,4,3600,0.0,29,23,6,0,6,79.31034483
2009020312,28,3596,0.0,29,26,2,0,3,89.65517241
2009020313,20,3600,0.0,25,23,3,1,2,92.0
2009020313,26,3598,0.0,32,27,8,0,5,84.375
2009020314,15,3900,0.0,39,38,2,1,1,97.43589744
2009020314,10,3897,0.0,32,31,10,2,1,96.875
2009020315,17,3897,0.0,18,16,1,2,2,88.88888889
2009020315,8,3900,0.0,34,32,7,0,2,94.11764706
2009020316,7,3498,0.0,26,21,8,0,5,80.76923077
2009020316,9,1195,0.0,16,14,6,0,2,87.5
2009020316,9,2377,0.0,25,24,8,0,1,96.0
2009020317,13,3600,0.0,34,32,0,2,2,94.11764706
2009020317,3,3522,0.0,28,25,2,0,3,89.28571429
2009020318,14,3550,0.0,27,24,9,0,3,88.88888889
2009020318,12,3600,0.0,21,20,5,0,1,95.23809524
2009020319,5,3600,0.0,33,31,1,1,2,93.93939394
2009020319,11,3452,0.0,34,31,6,1,3,91.17647059
2009020320,2,3600,0.0,26,22,2,0,4,84.61538462
2009020320,19,3599,0.0,24,23,1,1,1,95.83333333
2009020321,29,3899,0.0,48,45,16,0,3,93.75
2009020321,18,3892,0.0,29,26,7,1,3,89.65517241
2009020322,1,2279,0.0,17,15,2,0,2,88.23529412
2009020322,1,1200,0.0,9,6,1,1,3,66.66666667
2009020322,25,3576,0.0,34,31,8,3,3,91.17647059
2009020323,4,3543,0.0,20,18,4,0,2,90.0
2009020323,27,3600,0.0,24,23,5,0,1,95.83333333
2009020324,16,3600,0.0,27,25,3,0,2,92.59259259
2009020324,22,3600,0.0,30,25,2,1,5,83.33333333
2009020325,28,3600,0.0,30,28,2,1,2,93.33333333
2009020325,24,3590,0.0,36,33,3,3,3,91.66666667
2009020326,14,3776,0.0,31,28,3,2,3,90.32258065
2009020326,11,3759,0.0,40,36,9,3,4,90.0
2009020327,16,3600,0.0,30,30,3,1,0,100.0
2009020327,23,3532,0.0,17,16,2,0,1,94.11764706
2009020328,17,3519,0.0,25,22,3,0,3,88.0
2009020328,18,3600,0.0,31,30,5,0,1,96.77419355
2009020329,2,3857,0.0,61,58,12,2,3,95.08196721
2009020329,10,1646,0.0,6,5,0,0,1,83.33333333
2009020329,10,2144,0.0,15,12,2,1,3,80.0
2009020330,29,1572,0.0,18,14,6,0,4,77.77777778
2009020330,29,2028,0.0,15,12,4,1,3,80.0
2009020330,3,3600,0.0,30,26,1,0,4,86.66666667
2009020331,15,3664,0.0,37,33,8,0,4,89.18918919
2009020331,9,3669,0.0,28,25,7,0,3,89.28571429
2009020332,5,3787,0.0,21,19,2,0,2,90.47619048
2009020332,13,3787,0.0,45,42,7,0,3,93.33333333
2009020333,6,3557,0.0,31,29,6,0,2,93.5483871
2009020333,19,3521,0.0,23,19,3,0,4,82.60869565
2009020334,12,3590,0.0,29,27,13,0,2,93.10344828
2009020334,25,3599,0.0,22,22,9,3,0,100.0
2009020335,4,1796,0.0,14,13,3,0,1,92.85714286
2009020335,4,1746,0.0,17,13,1,0,4,76.47058824
2009020335,21,3600,0.0,34,30,4,3,4,88.23529412
2009020336,27,3600,0.0,25,21,6,1,4,84.0
2009020336,22,3598,0.0,36,36,1,1,0,100.0
2009020337,20,3875,0.0,31,29,8,1,2,93.5483871
2009020337,24,3900,0.0,43,41,5,0,2,95.34883721
2009020338,29,3600,0.0,29,24,5,0,5,82.75862069
2009020338,8,3600,0.0,36,33,8,0,3,91.66666667
2009020339,9,3592,0.0,20,18,3,0,2,90.0
2009020339,1,3600,0.0,25,24,0,0,1,96.0
2009020340,4,3600,0.0,29,28,5,0,1,96.55172414
2009020340,2,3525,0.0,28,26,1,1,2,92.85714286
2009020341,7,3524,0.0,24,22,0,3,2,91.66666667
2009020341,15,3600,0.0,25,25,2,0,0,100.0
2009020342,10,3600,0.0,31,28,2,1,3,90.32258065
2009020342,14,3535,0.0,35,31,5,0,4,88.57142857
2009020343,8,3600,0.0,30,27,6,1,3,90.0
2009020343,5,3587,0.0,19,18,1,1,1,94.73684211
2009020344,3,3900,0.0,26,25,2,2,1,96.15384615
2009020344,13,3900,0.0,28,27,5,2,1,96.42857143
2009020345,11,3600,0.0,40,40,10,2,0,100.0
2009020345,17,3506,0.0,25,23,5,1,2,92.0
2009020346,6,3900,2.0,29,28,11,0,1,96.55172414
2009020346,30,3896,0.0,16,15,5,0,1,93.75
2009020347,19,3900,0.0,37,34,6,0,3,91.89189189
2009020347,25,3863,0.0,38,35,1,1,3,92.10526316
2009020348,18,3781,0.0,22,19,6,0,3,86.36363636
2009020348,21,3787,0.0,27,23,2,2,4,85.18518519
2009020349,27,3526,0.0,26,24,0,1,2,92.30769231
2009020349,20,3600,0.0,28,27,1,0,1,96.42857143
2009020350,26,3594,0.0,23,22,3,0,1,95.65217391
2009020350,22,3563,0.0,34,32,4,0,2,94.11764706
2009020351,12,3547,0.0,33,30,0,1,3,90.90909091
2009020351,24,3600,0.0,30,28,5,1,2,93.33333333
2009020352,16,3600,0.0,24,22,9,0,2,91.66666667
2009020352,28,1200,0.0,12,9,0,2,3,75.0
2009020352,28,2374,0.0,29,25,3,1,4,86.20689655
2009020353,29,3586,0.0,36,34,5,3,2,94.44444444
2009020353,9,3592,0.0,33,32,9,3,1,96.96969697
2009020354,26,3537,0.0,33,30,7,2,3,90.90909091
2009020354,23,3598,0.0,32,31,4,2,1,96.875
2009020355,1,3900,0.0,33,32,0,0,1,96.96969697
2009020355,6,3900,0.0,37,36,6,2,1,97.2972973
2009020356,7,3592,0.0,33,31,6,0,2,93.93939394
2009020356,4,3395,0.0,25,21,2,0,4,84.0
2009020357,5,3527,0.0,37,34,5,2,3,91.89189189
2009020357,2,3600,0.0,21,19,4,0,2,90.47619048
2009020358,21,3525,0.0,31,27,5,1,4,87.09677419
2009020358,30,3598,0.0,34,31,6,0,3,91.17647059
2009020359,16,3600,0.0,34,31,5,1,3,91.17647059
2009020359,24,3600,0.0,28,28,2,1,0,100.0
2009020360,11,3600,0.0,36,32,12,0,4,88.88888889
2009020360,12,3588,0.0,33,28,4,3,5,84.84848485
2009020361,3,1945,0.0,22,18,3,1,4,81.81818182
2009020361,3,1653,0.0,9,8,0,1,1,88.88888889
2009020361,14,3600,0.0,27,26,1,0,1,96.2962963
2009020362,10,3600,0.0,30,26,8,1,4,86.66666667
2009020362,13,3519,0.0,32,27,3,0,5,84.375
2009020363,20,3600,0.0,40,40,11,0,0,100.0
2009020363,17,3600,0.0,17,14,0,1,3,82.35294118
2009020364,19,3600,0.0,38,37,7,1,1,97.36842105
2009020364,18,3496,0.0,38,35,7,3,3,92.10526316
2009020365,28,3884,0.0,33,29,3,0,4,87.87878788
2009020365,22,3900,0.0,31,27,5,2,4,87.09677419
2009020366,25,2171,0.0,19,15,0,2,4,78.94736842
2009020366,25,1413,0.0,10,9,0,0,1,90.0
2009020366,27,3600,0.0,32,30,6,0,2,93.75
2009020367,2,3600,0.0,42,36,3,3,6,85.71428571
2009020367,1,3600,0.0,23,22,2,0,1,95.65217391
2009020368,9,3859,0.0,33,30,4,1,3,90.90909091
2009020368,6,3898,0.0,22,19,4,0,3,86.36363636
2009020369,12,3598,0.0,24,19,7,1,5,79.16666667
2009020369,7,3599,0.0,31,30,9,3,1,96.77419355
2009020370,15,3827,0.0,24,21,2,0,3,87.5
2009020370,8,3900,0.0,23,20,1,0,3,86.95652174
2009020371,4,3491,0.0,18,17,2,0,1,94.44444444
2009020371,11,3597,2.0,34,34,9,1,0,100.0
2009020372,20,3899,0.0,32,29,4,0,3,90.625
2009020372,29,3900,0.0,32,29,8,0,3,90.625
2009020373,3,3600,0.0,33,25,7,0,8,75.75757576
2009020373,5,3600,0.0,25,22,3,1,3,88.0
2009020374,17,3875,0.0,35,32,6,0,3,91.42857143
2009020374,19,3884,0.0,36,33,0,0,3,91.66666667
2009020375,13,3537,0.0,28,25,4,0,3,89.28571429
2009020375,18,3595,0.0,24,23,5,0,1,95.83333333
2009020376,14,3732,2.0,38,34,6,0,4,89.47368421
2009020376,25,3732,0.0,28,25,3,1,3,89.28571429
2009020377,30,3900,0.0,22,20,0,1,2,90.90909091
2009020377,21,3900,0.0,36,34,5,0,2,94.44444444
2009020378,22,3095,0.0,24,21,5,1,3,87.5
2009020378,22,505,2.0,11,7,4,0,4,63.63636364
2009020378,23,3558,0.0,34,31,1,0,3,91.17647059
2009020379,16,3885,0.0,22,21,3,0,1,95.45454545
2009020379,26,3895,0.0,33,32,3,1,1,96.96969697
2009020380,27,3678,0.0,28,26,4,0,2,92.85714286
2009020380,24,3678,0.0,26,23,2,0,3,88.46153846
2009020381,28,3582,2.0,27,25,1,0,2,92.59259259
2009020381,23,3600,0.0,30,26,5,1,4,86.66666667
2009020382,7,3600,0.0,38,38,7,0,0,100.0
2009020382,10,3536,0.0,31,28,4,1,3,90.32258065
2009020383,5,3600,0.0,31,29,2,3,2,93.5483871
2009020383,3,3543,0.0,32,28,8,1,4,87.5
2009020384,15,3599,0.0,40,38,11,1,2,95.0
2009020384,12,3461,0.0,33,30,4,1,3,90.90909091
2009020385,13,534,0.0,5,3,0,0,2,60.0
2009020385,13,3060,0.0,30,28,4,1,2,93.33333333
2009020385,11,3590,0.0,28,25,4,0,3,89.28571429
2009020386,19,3527,0.0,25,22,7,1,3,88.0
2009020386,29,3573,0.0,29,27,5,0,2,93.10344828
2009020387,21,3600,0.0,33,33,9,2,0,100.0
2009020387,14,3484,0.0,28,26,7,3,2,92.85714286
2009020388,25,3597,0.0,32,28,11,1,4,87.5
2009020388,17,3600,0.0,30,29,5,1,1,96.66666667
2009020389,20,3600,0.0,22,22,4,0,0,100.0
2009020389,18,3567,0.0,29,25,2,0,4,86.20689655
2009020390,10,1200,0.0,8,8,3,0,0,100.0
2009020390,10,2400,0.0,18,18,1,0,0,100.0
2009020390,8,3600,0.0,31,28,1,0,3,90.32258065
2009020391,29,3844,0.0,26,23,2,1,3,88.46153846
2009020391,16,3859,0.0,23,20,2,0,3,86.95652174
2009020392,26,3592,0.0,30,27,4,1,3,90.0
2009020392,24,3505,0.0,42,38,13,0,4,90.47619048
2009020393,9,3536,0.0,32,28,7,2,4,87.5
2009020393,28,3600,0.0,27,25,4,1,2,92.59259259
2009020394,14,3600,0.0,39,35,4,2,4,89.74358974
2009020394,6,3600,0.0,40,39,8,1,1,97.5
2009020395,23,3600,0.0,29,27,5,1,2,93.10344828
2009020395,1,3551,0.0,26,21,2,0,5,80.76923077
2009020396,21,3774,0.0,44,39,8,0,5,88.63636364
2009020396,21,42,0.0,0,0,0,0,0,
2009020396,13,3891,0.0,34,29,7,0,5,85.29411765
2009020397,18,3686,0.0,27,22,0,0,5,81.48148148
2009020397,30,3686,0.0,35,31,1,0,4,88.57142857
2009020398,8,3600,0.0,37,31,1,0,6,83.78378378
2009020398,7,3600,0.0,23,21,1,1,2,91.30434783
2009020399,23,3600,0.0,38,38,11,2,0,100.0
2009020399,4,3600,0.0,29,26,4,3,3,89.65517241
2009020400,13,2887,0.0,33,29,10,4,4,87.87878788
2009020400,13,710,0.0,11,9,0,0,2,81.81818182
2009020400,15,3584,0.0,28,26,8,2,2,92.85714286
2009020401,2,3589,0.0,27,26,7,1,1,96.2962963
2009020401,11,3442,0.0,26,23,3,1,3,88.46153846
2009020402,10,3600,0.0,36,33,5,6,3,91.66666667
2009020402,29,1855,0.0,14,10,0,0,4,71.42857143
2009020402,29,1743,0.0,11,9,1,1,2,81.81818182
2009020403,21,3548,0.0,31,29,5,0,2,93.5483871
2009020403,5,3572,0.0,16,15,2,0,1,93.75
2009020404,22,3600,0.0,28,27,2,0,1,96.42857143
2009020404,17,3600,0.0,36,32,1,2,4,88.88888889
2009020405,24,3558,0.0,36,34,9,2,2,94.44444444
2009020405,25,3600,0.0,27,26,3,0,1,96.2962963
2009020406,20,3539,0.0,31,29,11,0,2,93.5483871
2009020406,27,3600,0.0,29,28,3,1,1,96.55172414
2009020407,9,3600,0.0,24,18,5,0,6,75.0
2009020407,26,3600,0.0,30,27,3,0,3,90.0
2009020408,19,3868,0.0,34,32,15,1,2,94.11764706
2009020408,28,3899,0.0,30,28,0,2,2,93.33333333
2009020409,14,3579,0.0,19,16,0,0,3,84.21052632
2009020409,1,3595,0.0,24,22,6,2,2,91.66666667
2009020410,6,1144,0.0,6,6,0,3,0,100.0
2009020410,6,2400,0.0,23,18,3,2,5,78.26086957
2009020410,8,3600,0.0,38,37,8,1,1,97.36842105
2009020411,24,3889,0.0,29,25,1,0,4,86.20689655
2009020411,30,3900,0.0,22,18,5,0,4,81.81818182
2009020412,18,3600,0.0,35,34,3,1,1,97.14285714
2009020412,16,3600,0.0,23,19,3,1,4,82.60869565
2009020413,23,3553,0.0,27,23,1,0,4,85.18518519
2009020413,12,3599,0.0,36,33,8,0,3,91.66666667
2009020414,22,3900,0.0,35,33,2,0,2,94.28571429
2009020414,25,3858,0.0,36,34,5,0,2,94.44444444
2009020415,19,3898,0.0,40,36,6,0,4,90.0
2009020415,26,3878,0.0,31,27,5,0,4,87.09677419
2009020416,10,1200,0.0,10,7,1,0,3,70.0
2009020416,10,2392,0.0,23,19,1,1,4,82.60869565
2009020416,6,3600,0.0,33,31,5,5,2,93.93939394
2009020417,3,3600,0.0,37,36,5,0,1,97.2972973
2009020417,7,3502,0.0,32,30,2,0,2,93.75
2009020418,17,3900,0.0,26,23,3,1,3,88.46153846
2009020418,1,3875,0.0,31,28,0,0,3,90.32258065
2009020419,15,3600,0.0,36,34,2,3,2,94.44444444
2009020419,4,1726,0.0,13,10,0,0,3,76.92307692
2009020419,4,1874,0.0,17,12,2,0,5,70.58823529
2009020420,11,3900,0.0,31,30,12,1,1,96.77419355
2009020420,13,3900,0.0,37,36,5,2,1,97.2972973
2009020421,21,3600,0.0,31,29,6,0,2,93.5483871
2009020421,29,3524,0.0,19,16,2,0,3,84.21052632
2009020422,16,3758,0.0,33,32,0,1,1,96.96969697
2009020422,5,3751,0.0,31,29,4,0,2,93.5483871
2009020423,2,3600,0.0,25,21,4,0,4,84.0
2009020423,14,3600,0.0,30,30,7,1,0,100.0
2009020424,30,3600,0.0,29,26,6,1,3,89.65517241
2009020424,18,2400,0.0,28,24,1,0,4,85.71428571
2009020424,18,1200,0.0,11,10,5,0,1,90.90909091
2009020425,9,3456,0.0,25,22,2,1,3,88.0
2009020425,27,3600,0.0,28,26,3,0,2,92.85714286
2009020426,20,3600,0.0,36,35,9,0,1,97.22222222
2009020426,28,3542,0.0,36,34,7,1,2,94.44444444
2009020427,17,3600,0.0,29,28,7,0,1,96.55172414
2009020427,3,3543,0.0,30,28,3,0,2,93.33333333
2009020428,9,3900,0.0,36,33,2,2,3,91.66666667
2009020428,24,3900,0.0,29,26,10,0,3,89.65517241
2009020429,1,3600,0.0,22,22,2,0,0,100.0
2009020429,7,3580,0.0,37,34,4,1,3,91.89189189
2009020430,11,2400,0.0,22,17,6,0,5,77.27272727
2009020430,11,1199,0.0,6,6,0,0,0,100.0
2009020430,10,3600,0.0,24,22,1,1,2,91.66666667
2009020431,4,3487,0.0,13,10,0,0,3,76.92307692
2009020431,8,3600,2.0,15,14,3,0,1,93.33333333
2009020432,12,3600,0.0,32,30,3,2,2,93.75
2009020432,5,3505,0.0,21,18,3,0,3,85.71428571
2009020433,15,3576,0.0,26,26,3,2,0,100.0
2009020433,14,3600,0.0,34,31,6,2,3,91.17647059
2009020434,22,3897,0.0,35,33,11,1,2,94.28571429
2009020434,13,3900,0.0,28,26,5,1,2,92.85714286
2009020435,21,3600,0.0,35,35,0,0,0,100.0
2009020435,19,3600,0.0,22,18,2,0,4,81.81818182
2009020436,30,3551,0.0,31,29,2,0,2,93.5483871
2009020436,27,3600,0.0,28,28,5,0,0,100.0
2009020437,20,3540,0.0,16,14,3,0,2,87.5
2009020437,26,3600,0.0,27,26,8,0,1,96.2962963
2009020438,2,3598,0.0,37,31,7,1,6,83.78378378
2009020438,4,3567,0.0,24,22,6,0,2,91.66666667
2009020439,8,3600,0.0,46,45,13,2,1,97.82608696
2009020439,9,3572,0.0,26,23,6,2,3,88.46153846
2009020440,23,3591,0.0,25,22,5,1,3,88.0
2009020440,18,3584,0.0,36,34,7,4,2,94.44444444
2009020441,25,3851,0.0,42,38,1,3,4,90.47619048
2009020441,24,3853,0.0,22,19,4,0,3,86.36363636
2009020442,15,3600,0.0,28,25,4,0,3,89.28571429
2009020442,7,3600,0.0,35,35,2,1,0,100.0
2009020443,2,3547,2.0,35,32,4,1,3,91.42857143
2009020443,10,3583,0.0,32,30,5,2,2,93.75
2009020444,12,3549,0.0,30,27,10,0,3,90.0
2009020444,1,3600,0.0,23,21,2,1,2,91.30434783
2009020445,13,3533,0.0,31,29,0,0,2,93.5483871
2009020445,29,3596,0.0,32,32,5,0,0,100.0
2009020446,22,3595,0.0,34,32,2,0,2,94.11764706
2009020446,14,3529,0.0,32,29,6,0,3,90.625
2009020447,19,3591,2.0,42,42,13,3,0,100.0
2009020447,17,3569,0.0,26,25,7,0,1,96.15384615
2009020448,3,3823,0.0,41,39,7,0,2,95.12195122
2009020448,16,3760,0.0,18,17,2,0,1,94.44444444
2009020449,30,3600,0.0,22,22,4,0,0,100.0
2009020449,21,3557,0.0,22,21,2,1,1,95.45454545
2009020450,11,3545,0.0,31,29,4,3,2,93.5483871
2009020450,20,3600,0.0,25,24,3,1,1,96.0
2009020451,26,3671,0.0,34,30,13,0,4,88.23529412
2009020451,28,3672,0.0,28,23,2,0,5,82.14285714
2009020452,10,3489,0.0,33,29,6,0,4,87.87878788
2009020452,6,3600,0.0,34,32,3,2,2,94.11764706
2009020453,9,3600,0.0,23,23,8,3,0,100.0
2009020453,4,3503,0.0,24,23,2,1,1,95.83333333
2009020454,5,3589,0.0,21,19,0,1,2,90.47619048
2009020454,8,3535,0.0,41,38,8,1,3,92.68292683
2009020455,29,3900,0.0,39,36,8,0,3,92.30769231
2009020455,18,3893,0.0,31,28,5,1,3,90.32258065
2009020456,11,3553,0.0,38,34,5,1,4,89.47368421
2009020456,23,3518,0.0,24,22,2,1,2,91.66666667
2009020457,27,3892,0.0,28,26,2,1,2,92.85714286
2009020457,26,3900,0.0,31,29,4,2,2,93.5483871
2009020458,13,3600,0.0,28,26,4,0,2,92.85714286
2009020458,1,3574,0.0,22,18,3,0,4,81.81818182
2009020459,12,3676,0.0,40,36,3,1,4,90.0
2009020459,15,3663,0.0,19,16,4,0,3,84.21052632
2009020460,16,3532,0.0,33,31,5,2,2,93.93939394
2009020460,7,3600,0.0,40,39,10,4,1,97.5
2009020461,24,3667,2.0,31,28,14,0,3,90.32258065
2009020461,17,3644,0.0,27,25,3,1,2,92.59259259
2009020462,22,3600,0.0,30,27,3,3,3,90.0
2009020462,19,3492,0.0,38,33,5,1,5,86.84210526
2009020463,14,3900,0.0,34,33,8,0,1,97.05882353
2009020463,21,3897,0.0,22,21,1,0,1,95.45454545
2009020464,30,3783,0.0,23,22,2,0,1,95.65217391
2009020464,20,3795,0.0,46,44,9,2,2,95.65217391
2009020465,25,3894,0.0,35,33,7,0,2,94.28571429
2009020465,28,3897,0.0,44,42,13,1,2,95.45454545
2009020466,15,3589,0.0,36,30,4,0,6,83.33333333
2009020466,10,3581,2.0,37,34,1,1,3,91.89189189
2009020467,12,3587,0.0,38,35,7,1,3,92.10526316
2009020467,9,3597,0.0,25,23,3,0,2,92.0
2009020468,4,3578,0.0,28,24,6,0,4,85.71428571
2009020468,1,3600,0.0,23,22,2,4,1,95.65217391
2009020469,6,3619,0.0,19,16,2,0,3,84.21052632
2009020469,2,3624,0.0,32,30,4,0,2,93.75
2009020470,7,3600,0.0,38,36,6,1,2,94.73684211
2009020470,3,3539,0.0,32,29,3,1,3,90.625
2009020471,8,3678,0.0,34,30,4,1,4,88.23529412
2009020471,11,3645,0.0,19,16,6,3,3,84.21052632
2009020472,24,3584,0.0,36,35,8,0,1,97.22222222
2009020472,29,3506,0.0,25,22,2,1,3,88.0
2009020473,13,3637,0.0,40,37,9,1,3,92.5
2009020473,5,3635,0.0,31,29,5,2,2,93.5483871
2009020474,17,3615,0.0,35,33,2,2,2,94.28571429
2009020474,18,3600,0.0,29,26,8,0,3,89.65517241
2009020475,28,3531,2.0,35,33,9,2,2,94.28571429
2009020475,27,3600,0.0,38,37,11,5,1,97.36842105
2009020476,30,3516,0.0,29,25,4,1,4,86.20689655
2009020476,23,3595,0.0,41,38,5,1,3,92.68292683
2009020477,25,3900,0.0,27,25,3,1,2,92.59259259
2009020477,26,3900,0.0,27,25,3,0,2,92.59259259
2009020478,14,3600,0.0,29,25,9,1,4,86.20689655
2009020478,16,3589,0.0,18,18,8,0,0,100.0
2009020479,20,3536,0.0,35,32,16,1,3,91.42857143
2009020479,21,3597,0.0,21,19,2,2,2,90.47619048
2009020480,4,3600,2.0,27,26,2,0,1,96.2962963
2009020480,6,3513,0.0,37,35,7,1,2,94.59459459
2009020481,9,3489,0.0,24,21,0,0,3,87.5
2009020481,10,3600,0.0,24,22,0,0,2,91.66666667
2009020482,13,3594,0.0,31,30,3,0,1,96.77419355
2009020482,2,2455,0.0,23,18,0,0,5,78.26086957
2009020482,2,1140,0.0,3,1,0,0,2,33.33333333
2009020483,11,3895,0.0,48,46,11,0,2,95.83333333
2009020483,3,3895,0.0,27,25,3,0,2,92.59259259
2009020484,18,3593,0.0,31,28,7,1,3,90.32258065
2009020484,29,3529,0.0,32,27,4,0,5,84.375
2009020485,7,3592,0.0,24,21,2,0,3,87.5
2009020485,8,3540,0.0,27,23,4,1,4,85.18518519
2009020486,27,3538,0.0,32,29,7,1,3,90.625
2009020486,17,3595,0.0,32,30,3,0,2,93.75
2009020487,26,3600,0.0,28,25,3,1,3,89.28571429
2009020487,23,3590,0.0,25,24,7,0,1,96.0
2009020488,4,3600,0.0,35,29,6,0,6,82.85714286
2009020488,5,3600,0.0,27,26,12,2,1,96.2962963
2009020489,20,3530,0.0,34,30,8,2,4,88.23529412
2009020489,19,3568,0.0,23,20,5,0,3,86.95652174
2009020490,14,1942,0.0,14,10,0,0,4,71.42857143
2009020490,14,1658,0.0,13,10,3,0,3,76.92307692
2009020490,18,3600,0.0,34,30,2,0,4,88.23529412
2009020491,29,3569,0.0,23,21,0,0,2,91.30434783
2009020491,30,3580,0.0,22,21,0,0,1,95.45454545
2009020492,15,3600,0.0,28,27,3,1,1,96.42857143
2009020492,21,2400,0.0,21,16,2,1,5,76.19047619
2009020492,21,1200,0.0,4,3,1,0,1,75.0
2009020493,26,3600,0.0,29,27,0,0,2,93.10344828
2009020493,22,3551,0.0,26,23,0,0,3,88.46153846
2009020494,8,3538,2.0,27,25,3,1,2,92.59259259
2009020494,1,3587,0.0,18,17,1,1,1,94.44444444
2009020495,2,3600,4.0,26,25,3,0,1,96.15384615
2009020495,3,3530,0.0,28,26,2,2,2,92.85714286
2009020496,25,3507,0.0,28,24,6,0,4,85.71428571
2009020496,12,3598,0.0,27,24,3,1,3,88.88888889
2009020497,27,3599,0.0,30,27,5,1,3,90.0
2009020497,10,3518,0.0,28,23,3,1,5,82.14285714
2009020498,7,3505,0.0,28,26,5,2,2,92.85714286
2009020498,9,3600,0.0,22,22,9,2,0,100.0
2009020499,11,3503,0.0,29,25,3,0,4,86.20689655
2009020499,13,3600,0.0,23,20,3,1,3,86.95652174
2009020500,19,3600,0.0,35,32,6,0,3,91.42857143
2009020500,16,3600,0.0,27,27,2,1,0,100.0
2009020501,24,3576,0.0,30,28,3,1,2,93.33333333
2009020501,23,3527,0.0,34,31,5,3,3,91.17647059
2009020502,30,3600,0.0,31,30,2,0,1,96.77419355
2009020502,8,3442,0.0,21,18,3,0,3,85.71428571
2009020503,3,3600,0.0,37,35,14,0,2,94.59459459
2009020503,2,3595,0.0,22,17,4,2,5,77.27272727
2009020504,5,3900,0.0,33,31,3,1,2,93.93939394
2009020504,4,3898,0.0,30,28,5,3,2,93.33333333
2009020505,25,1711,0.0,10,7,3,1,3,70.0
2009020505,25,1955,0.0,15,12,0,0,3,80.0
2009020505,11,3676,0.0,47,42,4,1,5,89.36170213
2009020506,27,3900,0.0,39,38,8,1,1,97.43589744
2009020506,29,3892,0.0,27,26,0,0,1,96.2962963
2009020507,14,3600,0.0,22,19,3,0,3,86.36363636
2009020507,17,3600,0.0,30,30,3,0,0,100.0
2009020508,26,3538,0.0,24,22,4,1,2,91.66666667
2009020508,20,3600,0.0,35,34,8,2,1,97.14285714
2009020509,18,3292,0.0,22,21,6,0,1,95.45454545
2009020509,18,301,0.0,4,2,0,0,2,50.0
2009020509,22,3572,0.0,27,21,1,0,6,77.77777778
2009020510,24,3595,0.0,37,33,12,1,4,89.18918919
2009020510,28,3600,0.0,21,20,1,0,1,95.23809524
2009020511,9,3596,0.0,22,18,0,3,4,81.81818182
2009020511,1,3600,0.0,29,27,9,0,2,93.10344828
2009020512,10,1632,0.0,17,16,0,0,1,94.11764706
2009020512,10,1964,0.0,10,6,2,0,4,60.0
2009020512,7,3600,0.0,42,40,1,0,2,95.23809524
2009020513,12,2687,0.0,26,21,2,0,5,80.76923077
2009020513,12,913,0.0,2,1,0,0,1,50.0
2009020513,13,3600,0.0,35,32,1,2,3,91.42857143
2009020514,14,3600,0.0,26,23,6,1,3,88.46153846
2009020514,19,3548,0.0,23,18,4,1,5,78.26086957
2009020515,6,3900,0.0,44,40,4,0,4,90.90909091
2009020515,16,3900,0.0,29,25,2,0,4,86.20689655
2009020516,15,3519,0.0,20,17,4,1,3,85.0
2009020516,23,3589,0.0,27,25,1,3,2,92.59259259
2009020517,3,3600,0.0,37,36,1,1,1,97.2972973
2009020517,4,3512,0.0,24,22,2,1,2,91.66666667
2009020518,17,3573,0.0,21,17,3,0,4,80.95238095
2009020518,25,3600,0.0,33,30,1,1,3,90.90909091
2009020519,27,3564,0.0,34,30,13,1,4,88.23529412
2009020519,24,3600,0.0,41,39,11,3,2,95.12195122
2009020520,5,3889,0.0,32,31,10,1,1,96.875
2009020520,7,3891,0.0,24,23,7,1,1,95.83333333
2009020521,6,3562,0.0,31,29,5,1,2,93.5483871
2009020521,10,3600,0.0,25,25,2,0,0,100.0
2009020522,30,3589,0.0,24,20,4,0,4,83.33333333
2009020522,9,3600,0.0,23,22,6,0,1,95.65217391
2009020523,8,3600,0.0,40,40,10,2,0,100.0
2009020523,2,3597,0.0,28,25,5,2,3,89.28571429
2009020524,13,3542,0.0,24,21,2,0,3,87.5
2009020524,12,3600,0.0,30,28,7,0,2,93.33333333
2009020525,1,1200,0.0,6,3,0,0,3,50.0
2009020525,1,2400,0.0,20,19,1,0,1,95.0
2009020525,11,3522,0.0,42,37,2,0,5,88.0952381
2009020526,18,3600,0.0,32,29,2,1,3,90.625
2009020526,20,3521,0.0,19,15,4,0,4,78.94736842
2009020527,29,255,0.0,7,4,1,0,3,57.14285714
2009020527,29,3345,0.0,24,22,8,0,2,91.66666667
2009020527,21,3600,0.0,30,28,4,0,2,93.33333333
2009020528,15,3600,0.0,28,26,4,1,2,92.85714286
2009020528,22,3511,0.0,42,38,3,1,4,90.47619048
2009020529,17,3600,0.0,35,32,5,0,3,91.42857143
2009020529,16,3594,0.0,20,20,1,0,0,100.0
2009020530,19,3582,0.0,30,29,4,1,1,96.66666667
2009020530,23,3473,0.0,26,23,2,0,3,88.46153846
2009020531,7,3792,0.0,36,34,0,1,2,94.44444444
2009020531,10,3815,0.0,30,27,1,0,3,90.0
2009020532,14,3600,0.0,38,36,4,0,2,94.73684211
2009020532,2,3600,0.0,28,24,3,1,4,85.71428571
2009020533,13,3600,0.0,31,30,11,0,1,96.77419355
2009020533,4,2279,0.0,17,15,8,0,2,88.23529412
2009020533,4,1321,0.0,13,11,1,0,2,84.61538462
2009020534,3,3600,0.0,33,32,5,0,1,96.96969697
2009020534,12,3569,0.0,30,28,5,1,2,93.33333333
2009020535,8,3742,0.0,50,47,8,0,3,94.0
2009020535,11,3728,0.0,23,19,1,3,4,82.60869565
2009020536,6,3600,0.0,29,29,0,1,0,100.0
2009020536,9,3498,0.0,29,27,5,0,2,93.10344828
2009020537,1,3600,0.0,35,35,8,0,0,100.0
2009020537,5,1737,0.0,14,14,3,1,0,100.0
2009020537,5,1830,0.0,16,12,1,0,4,75.0
2009020538,21,3600,0.0,31,28,5,1,3,90.32258065
2009020538,30,3491,0.0,21,17,5,0,4,80.95238095
2009020539,28,3600,0.0,38,36,8,0,2,94.73684211
2009020539,25,3557,0.0,31,28,0,0,3,90.32258065
2009020540,19,3600,0.0,25,23,2,1,2,92.0
2009020540,22,3600,0.0,26,19,4,0,7,73.07692308
2009020541,29,3600,0.0,23,18,7,1,5,78.26086957
2009020541,27,3585,0.0,27,25,4,3,2,92.59259259
2009020542,28,3584,0.0,47,45,7,1,2,95.74468085
2009020542,16,3466,0.0,14,11,5,0,3,78.57142857
2009020543,24,3597,0.0,17,15,2,0,2,88.23529412
2009020543,21,3594,0.0,42,39,6,3,3,92.85714286
2009020544,18,3600,0.0,36,32,11,1,4,88.88888889
2009020544,23,3600,0.0,21,20,2,0,1,95.23809524
2009020545,11,652,0.0,8,5,1,0,3,62.5
2009020545,11,2890,0.0,22,20,4,1,2,90.90909091
2009020545,6,3600,0.0,29,25,6,1,4,86.20689655
2009020546,10,3550,0.0,22,20,5,0,2,90.90909091
2009020546,2,3600,0.0,27,26,3,1,1,96.2962963
2009020547,13,3577,0.0,32,28,5,2,4,87.5
2009020547,3,3595,0.0,34,33,5,1,1,97.05882353
2009020548,9,1200,0.0,12,10,4,1,2,83.33333333
2009020548,9,2379,0.0,24,18,8,0,6,75.0
2009020548,5,3588,0.0,47,45,11,0,2,95.74468085
2009020549,7,3600,0.0,38,33,0,2,5,86.84210526
2009020549,15,3600,0.0,34,32,3,0,2,94.11764706
2009020550,8,3592,0.0,47,46,18,1,1,97.87234043
2009020550,12,572,0.0,7,4,0,0,3,57.14285714
2009020550,12,3028,0.0,18,16,2,0,2,88.88888889
2009020551,22,3547,0.0,26,24,3,1,2,92.30769231
2009020551,30,3586,0.0,31,30,2,1,1,96.77419355
2009020552,4,3600,0.0,33,31,7,2,2,93.93939394
2009020552,14,3565,0.0,35,31,2,0,4,88.57142857
2009020553,16,3600,0.0,33,33,7,0,0,100.0
2009020553,17,3598,0.0,31,28,3,0,3,90.32258065
2009020554,29,3511,0.0,28,25,0,1,3,89.28571429
2009020554,25,3589,0.0,34,33,8,6,1,97.05882353
2009020555,24,482,0.0,4,3,2,0,1,75.0
2009020555,24,3118,0.0,28,25,0,2,3,89.28571429
2009020555,27,3600,0.0,21,21,3,0,0,100.0
2009020556,19,3891,0.0,24,23,1,1,1,95.83333333
2009020556,20,3900,0.0,27,26,0,1,1,96.2962963
2009020557,9,3900,0.0,22,20,1,0,2,90.90909091
2009020557,7,3900,0.0,40,38,9,1,2,95.0
2009020558,8,3634,0.0,49,47,7,0,2,95.91836735
2009020558,10,3621,0.0,23,20,4,0,3,86.95652174
2009020559,2,3853,0.0,38,36,2,0,2,94.73684211
2009020559,3,3812,0.0,22,19,0,0,3,86.36363636
2009020560,1,3600,0.0,40,36,4,5,4,90.0
2009020560,15,3577,0.0,30,29,5,0,1,96.66666667
2009020561,4,3900,0.0,40,37,8,2,3,92.5
2009020561,12,3900,0.0,36,33,1,0,3,91.66666667
2009020562,29,3530,0.0,27,25,4,2,2,92.59259259
2009020562,17,3594,0.0,29,28,4,3,1,96.55172414
2009020563,11,3510,0.0,34,30,4,0,4,88.23529412
2009020563,14,3600,0.0,27,24,2,0,3,88.88888889
2009020564,16,3593,0.0,26,25,5,2,1,96.15384615
2009020564,18,3600,0.0,40,36,3,1,4,90.0
2009020565,19,3521,0.0,20,16,5,0,4,80.0
2009020565,30,3600,0.0,18,15,3,1,3,83.33333333
2009020566,26,3516,0.0,35,32,5,2,3,91.42857143
2009020566,27,3594,0.0,25,23,6,1,2,92.0
2009020567,25,3535,0.0,32,29,3,0,3,90.625
2009020567,21,3600,0.0,40,39,0,0,1,97.5
2009020568,22,3551,0.0,27,24,8,0,3,88.88888889
2009020568,23,3587,0.0,25,24,3,0,1,96.0
2009020569,24,3600,0.0,25,20,2,0,5,80.0
2009020569,28,3600,0.0,32,30,7,0,2,93.75
2009020570,4,3599,0.0,29,28,2,0,1,96.55172414
2009020570,2,3587,0.0,30,28,1,1,2,93.33333333
2009020571,6,3600,0.0,26,25,4,3,1,96.15384615
2009020571,13,3535,0.0,28,26,0,0,2,92.85714286
2009020572,7,3600,0.0,35,32,6,1,3,91.42857143
2009020572,19,3493,0.0,24,19,4,2,5,79.16666667
2009020573,10,3600,0.0,24,21,1,0,3,87.5
2009020573,5,3542,0.0,27,23,3,0,4,85.18518519
2009020574,18,3538,0.0,29,24,4,0,5,82.75862069
2009020574,16,3575,0.0,20,16,1,2,4,80.0
2009020575,23,3600,0.0,30,29,5,2,1,96.66666667
2009020575,20,2400,0.0,16,15,11,0,1,93.75
2009020575,20,1200,0.0,13,9,1,0,4,69.23076923
2009020576,11,3524,0.0,26,23,2,0,3,88.46153846
2009020576,1,3600,0.0,26,24,0,1,2,92.30769231
2009020577,12,3600,0.0,31,28,9,1,3,90.32258065
2009020577,15,3554,0.0,25,20,4,1,5,80.0
2009020578,17,3792,0.0,40,39,6,1,1,97.5
2009020578,29,3787,0.0,34,34,8,0,0,100.0
2009020579,8,3579,0.0,27,24,3,0,3,88.88888889
2009020579,9,3593,0.0,31,29,0,1,2,93.5483871
2009020580,6,3532,0.0,39,37,4,0,2,94.87179487
2009020580,14,3600,0.0,32,31,4,2,1,96.875
2009020581,20,3600,0.0,35,34,8,3,1,97.14285714
2009020581,22,3600,0.0,23,19,5,3,4,82.60869565
2009020582,30,3600,0.0,32,29,1,1,3,90.625
2009020582,26,3536,0.0,23,19,2,0,4,82.60869565
2009020583,27,3900,0.0,38,36,9,0,2,94.73684211
2009020583,28,3898,0.0,33,31,4,1,2,93.93939394
2009020584,5,3512,0.0,24,20,2,0,4,83.33333333
2009020584,7,1288,0.0,11,8,0,0,3,72.72727273
2009020584,7,2312,0.0,27,27,8,2,0,100.0
2009020585,29,3900,0.0,25,24,3,0,1,96.0
2009020585,2,3900,0.0,42,41,4,1,1,97.61904762
2009020586,18,3595,0.0,27,24,8,0,3,88.88888889
2009020586,19,3536,0.0,30,26,8,0,4,86.66666667
2009020587,16,2257,0.0,14,13,1,0,1,92.85714286
2009020587,16,1292,0.0,10,6,2,0,4,60.0
2009020587,25,3600,2.0,37,33,13,4,4,89.18918919
2009020588,23,3899,0.0,25,23,3,0,2,92.0
2009020588,27,3891,0.0,30,28,4,0,2,93.33333333
2009020589,30,3517,0.0,31,28,2,1,3,90.32258065
2009020589,24,3600,0.0,31,29,3,0,2,93.5483871
2009020590,11,1010,0.0,10,7,0,0,3,70.0
2009020590,11,2577,0.0,20,19,7,4,1,95.0
2009020590,6,3587,0.0,18,18,1,1,0,100.0
2009020591,5,3526,0.0,32,31,3,0,1,96.875
2009020591,1,3600,0.0,32,32,1,3,0,100.0
2009020592,4,3600,0.0,22,22,5,0,0,100.0
2009020592,3,1200,0.0,11,8,0,0,3,72.72727273
2009020592,3,2400,0.0,20,17,3,0,3,85.0
2009020593,8,3793,0.0,35,34,2,1,1,97.14285714
2009020593,14,3810,2.0,35,33,1,0,2,94.28571429
2009020594,21,3598,0.0,30,27,2,0,3,90.0
2009020594,9,3513,0.0,20,16,0,0,4,80.0
2009020595,26,3581,0.0,21,19,7,0,2,90.47619048
2009020595,20,3600,0.0,24,23,4,1,1,95.83333333
2009020596,10,3503,0.0,23,20,2,0,3,86.95652174
2009020596,22,3600,0.0,28,27,3,0,1,96.42857143
2009020597,15,3600,0.0,33,28,4,1,5,84.84848485
2009020597,28,3600,0.0,26,24,4,0,2,92.30769231
2009020598,8,3600,0.0,36,32,6,0,4,88.88888889
2009020598,13,3523,0.0,42,37,3,0,5,88.0952381
2009020599,2,3897,0.0,36,34,5,1,2,94.44444444
2009020599,9,3900,0.0,27,25,4,0,2,92.59259259
2009020600,21,3533,0.0,34,31,2,1,3,91.17647059
2009020600,17,3600,0.0,22,20,6,0,2,90.90909091
2009020601,18,3611,0.0,32,31,2,0,1,96.875
2009020601,29,3628,0.0,29,27,3,0,2,93.10344828
2009020602,28,3900,0.0,36,34,8,0,2,94.44444444
2009020602,27,3899,0.0,33,31,0,4,2,93.93939394
2009020603,3,3600,0.0,18,17,1,0,1,94.44444444
2009020603,12,3530,0.0,35,33,10,0,2,94.28571429
2009020604,23,3735,0.0,25,22,7,0,3,88.0
2009020604,19,3735,0.0,30,26,10,0,4,86.66666667
2009020605,26,3577,0.0,29,27,4,0,2,93.10344828
2009020605,30,3522,0.0,28,24,1,0,4,85.71428571
2009020606,24,3525,0.0,42,37,5,1,5,88.0952381
2009020606,25,3600,0.0,34,31,0,2,3,91.17647059
2009020607,1,3600,0.0,36,31,6,1,5,86.11111111
2009020607,16,3591,0.0,27,26,3,0,1,96.2962963
2009020608,22,3548,0.0,39,37,2,0,2,94.87179487
2009020608,20,3600,0.0,22,21,3,0,1,95.45454545
2009020609,4,3717,0.0,26,24,4,1,2,92.30769231
2009020609,6,3710,0.0,25,24,5,0,1,96.0
2009020610,11,3842,0.0,23,19,4,1,4,82.60869565
2009020610,7,3842,0.0,35,32,6,3,3,91.42857143
2009020611,12,3825,0.0,28,27,3,5,1,96.42857143
2009020611,3,3825,0.0,19,17,4,1,2,89.47368421
2009020612,23,3600,0.0,32,31,1,0,1,96.875
2009020612,25,3546,0.0,26,24,3,1,2,92.30769231
2009020613,5,3596,0.0,37,34,4,0,3,91.89189189
2009020613,14,3589,0.0,26,25,4,1,1,96.15384615
2009020614,15,3552,0.0,19,17,7,1,2,89.47368421
2009020614,26,3597,0.0,27,26,5,1,1,96.2962963
2009020615,11,3893,0.0,36,31,3,1,5,86.11111111
2009020615,2,3879,0.0,27,22,6,1,5,81.48148148
2009020616,21,3600,0.0,28,26,3,1,2,92.85714286
2009020616,29,3544,0.0,37,34,3,2,3,91.89189189
2009020617,10,3538,0.0,34,32,7,0,2,94.11764706
2009020617,20,3598,0.0,25,24,4,0,1,96.0
2009020618,16,3600,0.0,22,19,7,0,3,86.36363636
2009020618,19,3593,0.0,33,27,4,0,6,81.81818182
2009020619,24,3513,0.0,35,33,3,0,2,94.28571429
2009020619,18,3600,0.0,26,25,4,1,1,96.15384615
2009020620,1,3591,0.0,32,29,1,1,3,90.625
2009020620,30,3559,0.0,25,21,2,0,4,84.0
2009020621,17,3576,0.0,36,35,2,1,1,97.22222222
2009020621,27,3575,0.0,35,32,8,1,3,91.42857143
2009020622,22,3598,0.0,27,23,4,0,4,85.18518519
2009020622,28,3600,0.0,23,22,2,0,1,95.65217391
2009020623,7,3600,0.0,30,30,5,0,0,100.0
2009020623,8,3525,0.0,30,29,1,1,1,96.66666667
2009020624,4,547,0.0,7,5,1,0,2,71.42857143
2009020624,4,3053,0.0,26,21,3,0,5,80.76923077
2009020624,9,2046,0.0,11,10,0,0,1,90.90909091
2009020624,9,1553,0.0,10,7,0,1,3,70.0
2009020625,5,3494,0.0,34,29,0,0,5,85.29411765
2009020625,13,3600,0.0,48,46,12,0,2,95.83333333
2009020626,24,3600,0.0,28,23,2,1,5,82.14285714
2009020626,16,3589,0.0,24,22,4,0,2,91.66666667
2009020627,6,3548,0.0,35,32,4,2,3,91.42857143
2009020627,3,3599,0.0,28,26,4,0,2,92.85714286
2009020628,26,3600,0.0,47,45,11,0,2,95.74468085
2009020628,28,1197,0.0,4,3,2,0,1,75.0
2009020628,28,2392,0.0,16,11,1,1,5,68.75
2009020629,13,3535,0.0,31,28,2,0,3,90.32258065
2009020629,10,3600,0.0,31,29,0,0,2,93.5483871
2009020630,25,3594,0.0,27,23,7,0,4,85.18518519
2009020630,1,3600,0.0,28,28,6,3,0,100.0
2009020631,8,3505,0.0,43,39,4,2,4,90.69767442
2009020631,15,3600,0.0,26,24,3,3,2,92.30769231
2009020632,6,3597,0.0,28,27,6,1,1,96.42857143
2009020632,9,825,0.0,16,12,8,0,4,75.0
2009020632,9,2771,0.0,19,19,8,0,0,100.0
2009020633,11,3600,0.0,37,32,6,1,5,86.48648649
2009020633,5,3588,0.0,33,31,2,0,2,93.93939394
2009020634,20,3600,0.0,28,27,5,1,1,96.42857143
2009020634,18,3554,0.0,33,31,2,0,2,93.93939394
2009020635,30,3600,0.0,33,29,1,1,4,87.87878788
2009020635,16,3600,0.0,20,19,4,0,1,95.0
2009020636,27,3697,2.0,42,38,6,0,4,90.47619048
2009020636,22,3697,0.0,30,25,3,0,5,83.33333333
2009020637,29,2093,0.0,17,11,0,0,6,64.70588235
2009020637,29,1478,0.0,7,6,1,1,1,85.71428571
2009020637,23,3599,0.0,32,29,11,0,3,90.625
2009020638,17,3531,0.0,34,31,8,4,3,91.17647059
2009020638,24,3600,0.0,39,38,8,4,1,97.43589744
2009020639,14,3478,0.0,35,30,3,3,5,85.71428571
2009020639,7,3600,0.0,39,36,7,0,3,92.30769231
2009020640,25,3553,0.0,24,20,8,0,4,83.33333333
2009020640,3,3594,0.0,27,25,4,1,2,92.59259259
2009020641,10,3600,0.0,32,26,3,2,6,81.25
2009020641,4,3600,0.0,32,30,4,0,2,93.75
2009020642,20,3600,0.0,35,31,10,1,4,88.57142857
2009020642,30,3600,0.0,26,25,0,2,1,96.15384615
2009020643,2,3600,0.0,32,30,5,0,2,93.75
2009020643,21,3523,0.0,35,32,3,1,3,91.42857143
2009020644,19,3846,0.0,44,42,14,2,2,95.45454545
2009020644,28,3846,0.0,29,28,8,2,1,96.55172414
2009020645,16,3600,0.0,21,19,5,0,2,90.47619048
2009020645,6,1787,0.0,12,11,0,0,1,91.66666667
2009020645,6,1813,0.0,24,20,3,1,4,83.33333333
2009020646,9,3600,0.0,38,33,6,1,5,86.84210526
2009020646,15,3600,0.0,28,26,2,0,2,92.85714286
2009020647,3,3900,0.0,32,31,2,3,1,96.875
2009020647,11,3900,0.0,30,29,3,0,1,96.66666667
2009020648,13,3507,0.0,38,37,4,0,1,97.36842105
2009020648,8,3600,0.0,38,38,5,1,0,100.0
2009020649,4,3586,0.0,39,35,4,0,4,89.74358974
2009020649,5,2237,0.0,15,13,0,2,2,86.66666667
2009020649,5,1302,0.0,15,11,1,0,4,73.33333333
2009020650,12,3526,0.0,34,30,8,0,4,88.23529412
2009020650,18,3579,0.0,27,25,4,1,2,92.59259259
2009020651,29,3600,0.0,26,24,2,0,2,92.30769231
2009020651,22,3534,0.0,29,25,3,0,4,86.20689655
2009020652,27,3600,0.0,24,20,0,1,4,83.33333333
2009020652,23,3600,0.0,31,31,7,0,0,100.0
2009020653,19,3525,0.0,28,25,6,1,3,89.28571429
2009020653,24,3600,0.0,22,20,5,1,2,90.90909091
2009020654,17,3597,0.0,52,51,13,1,1,98.07692308
2009020654,26,3581,0.0,24,22,4,1,2,91.66666667
2009020655,14,3600,0.0,35,33,7,1,2,94.28571429
2009020655,1,1841,0.0,7,4,1,0,3,57.14285714
2009020655,1,1740,0.0,7,6,1,0,1,85.71428571
2009020656,21,3505,0.0,20,18,3,1,2,90.0
2009020656,12,3600,0.0,30,29,10,1,1,96.66666667
2009020657,10,3497,0.0,31,28,0,1,3,90.32258065
2009020657,7,3597,2.0,50,48,7,0,2,96.0
2009020658,2,3532,0.0,28,24,1,1,4,85.71428571
2009020658,25,3600,0.0,22,19,2,0,3,86.36363636
2009020659,29,3600,2.0,22,20,2,2,2,90.90909091
2009020659,20,3542,0.0,22,19,3,1,3,86.36363636
2009020660,3,3600,0.0,30,29,5,1,1,96.66666667
2009020660,6,3502,0.0,34,31,9,0,3,91.17647059
2009020661,21,3900,2.0,35,32,5,0,3,91.42857143
2009020661,7,3887,0.0,30,27,9,0,3,90.0
2009020662,5,3585,0.0,43,42,7,1,1,97.6744186
2009020662,10,3600,0.0,39,35,9,0,4,89.74358974
2009020663,1,3757,0.0,30,29,7,1,1,96.66666667
2009020663,8,3756,0.0,28,26,4,0,2,92.85714286
2009020664,13,3600,0.0,24,24,5,1,0,100.0
2009020664,9,3596,0.0,19,16,5,2,3,84.21052632
2009020665,14,3551,0.0,30,27,7,1,3,90.0
2009020665,4,3600,0.0,18,17,3,2,1,94.44444444
2009020666,15,3575,0.0,39,38,3,0,1,97.43589744
2009020666,11,2117,0.0,28,24,1,0,4,85.71428571
2009020666,11,1475,0.0,9,5,0,1,4,55.55555556
2009020667,24,3600,0.0,27,25,0,0,2,92.59259259
2009020667,18,3519,0.0,21,18,1,0,3,85.71428571
2009020668,16,3900,0.0,21,16,1,0,5,76.19047619
2009020668,30,1500,0.0,13,13,0,0,0,100.0
2009020668,30,2400,0.0,12,7,1,0,5,58.33333333
2009020669,2,3900,0.0,29,25,3,1,4,86.20689655
2009020669,27,1781,0.0,15,11,7,0,4,73.33333333
2009020669,27,2119,0.0,15,15,2,0,0,100.0
2009020670,20,3900,0.0,21,19,4,0,2,90.47619048
2009020670,23,3897,0.0,40,38,2,0,2,95.0
2009020671,19,3598,0.0,24,21,3,0,3,87.5
2009020671,26,2721,0.0,23,19,2,1,4,82.60869565
2009020671,26,811,0.0,9,9,3,0,0,100.0
2009020672,17,3600,0.0,32,31,4,1,1,96.875
2009020672,28,3600,0.0,22,18,1,0,4,81.81818182
2009020673,9,3600,0.0,33,29,5,1,4,87.87878788
2009020673,12,3600,0.0,32,31,2,0,1,96.875
2009020674,25,3564,0.0,40,39,4,0,1,97.5
2009020674,29,3600,0.0,26,26,2,0,0,100.0
2009020675,24,3600,0.0,43,42,4,1,1,97.6744186
2009020675,16,3546,0.0,11,9,2,0,2,81.81818182
2009020676,5,3544,0.0,24,20,7,1,4,83.33333333
2009020676,30,3581,0.0,38,35,6,2,3,92.10526316
2009020677,21,3876,0.0,46,44,12,0,2,95.65217391
2009020677,20,3885,0.0,21,19,1,1,2,90.47619048
2009020678,18,3600,2.0,32,30,1,1,2,93.75
2009020678,23,3523,0.0,25,22,3,1,3,88.0
2009020679,28,3578,0.0,34,33,16,0,1,97.05882353
2009020679,26,3493,0.0,36,34,9,3,2,94.44444444
2009020680,12,3600,0.0,40,38,2,0,2,95.0
2009020680,10,3563,0.0,17,14,0,0,3,82.35294118
2009020681,17,1758,0.0,20,17,0,0,3,85.0
2009020681,17,1842,0.0,11,8,5,0,3,72.72727273
2009020681,2,3600,0.0,16,16,3,0,0,100.0
2009020682,1,3900,0.0,51,51,4,0,0,100.0
2009020682,3,3897,0.0,45,45,3,1,0,100.0
2009020683,25,1980,0.0,19,14,8,0,5,73.68421053
2009020683,25,1620,0.0,9,8,0,1,1,88.88888889
2009020683,4,3600,0.0,30,27,6,0,3,90.0
2009020684,9,2400,0.0,14,11,1,0,3,78.57142857
2009020684,9,1200,0.0,14,11,1,0,3,78.57142857
2009020684,11,3593,0.0,31,30,3,1,1,96.77419355
2009020685,15,1200,0.0,15,11,5,0,4,73.33333333
2009020685,15,2397,0.0,21,18,11,0,3,85.71428571
2009020685,14,1986,0.0,24,22,7,2,2,91.66666667
2009020685,14,1596,0.0,12,10,3,0,2,83.33333333
2009020686,29,2334,0.0,13,13,0,0,0,100.0
2009020686,29,1189,0.0,9,6,1,0,3,66.66666667
2009020686,19,3587,0.0,27,26,7,0,1,96.2962963
2009020687,18,3600,0.0,41,38,2,0,3,92.68292683
2009020687,22,2000,0.0,14,13,1,0,1,92.85714286
2009020687,22,1600,0.0,14,10,0,0,4,71.42857143
2009020688,28,3600,0.0,33,32,11,2,1,96.96969697
2009020688,27,3512,0.0,32,29,1,0,3,90.625
2009020689,23,628,0.0,3,3,1,0,0,100.0
2009020689,23,2971,0.0,19,14,4,0,5,73.68421053
2009020689,30,3600,0.0,31,29,3,1,2,93.5483871
2009020690,15,1789,0.0,15,11,1,0,4,73.33333333
2009020690,15,2110,0.0,15,15,3,0,0,100.0
2009020690,13,3900,0.0,37,33,0,0,4,89.18918919
2009020691,5,3600,0.0,38,37,9,1,1,97.36842105
2009020691,20,3596,0.0,27,24,8,1,3,88.88888889
2009020692,6,3545,0.0,32,28,2,0,4,87.5
2009020692,24,3600,0.0,30,27,6,2,3,90.0
2009020693,4,3600,0.0,35,31,7,0,4,88.57142857
2009020693,10,3591,0.0,38,38,10,1,0,100.0
2009020694,9,3600,0.0,32,32,2,0,0,100.0
2009020694,3,3534,0.0,33,32,2,0,1,96.96969697
2009020695,7,3681,0.0,33,32,5,1,1,96.96969697
2009020695,11,3747,0.0,32,30,10,2,2,93.75
2009020696,25,3483,0.0,28,23,1,2,5,82.14285714
2009020696,8,3572,0.0,36,33,2,2,3,91.66666667
2009020697,13,3600,0.0,30,28,1,2,2,93.33333333
2009020697,14,3512,0.0,29,26,3,0,3,89.65517241
2009020698,12,3600,0.0,35,32,5,0,3,91.42857143
2009020698,17,3600,0.0,38,37,3,1,1,97.36842105
2009020699,30,3526,0.0,37,36,0,3,1,97.2972973
2009020699,19,3572,0.0,19,19,3,1,0,100.0
2009020700,29,3600,0.0,36,33,2,0,3,91.66666667
2009020700,16,3600,0.0,24,24,3,0,0,100.0
2009020701,1,3510,0.0,19,15,1,0,4,78.94736842
2009020701,27,3600,0.0,34,31,4,1,3,91.17647059
2009020702,5,3596,2.0,35,33,9,1,2,94.28571429
2009020702,22,3549,0.0,31,28,6,0,3,90.32258065
2009020703,24,1636,0.0,14,13,3,1,1,92.85714286
2009020703,24,1963,0.0,13,10,2,0,3,76.92307692
2009020703,26,3600,0.0,22,22,3,1,0,100.0
2009020704,6,3900,0.0,42,41,2,0,1,97.61904762
2009020704,28,3900,0.0,31,30,0,2,1,96.77419355
2009020705,10,3584,2.0,24,18,2,0,6,75.0
2009020705,15,3579,0.0,29,28,10,1,1,96.55172414
2009020706,18,3588,2.0,22,22,1,0,0,100.0
2009020706,20,3523,0.0,21,20,2,0,1,95.23809524
2009020707,16,3591,0.0,26,21,3,0,5,80.76923077
2009020707,29,3524,0.0,31,25,2,0,6,80.64516129
2009020708,17,3897,0.0,30,28,5,0,2,93.33333333
2009020708,25,3897,0.0,28,26,0,0,2,92.85714286
2009020709,1,3541,0.0,27,25,4,1,2,92.59259259
2009020709,21,3597,0.0,38,37,11,1,1,97.36842105
2009020710,6,3900,0.0,34,31,11,0,3,91.17647059
2009020710,26,3898,0.0,24,21,0,2,3,87.5
2009020711,22,3563,0.0,36,32,5,1,4,88.88888889
2009020711,28,3600,0.0,29,27,1,1,2,93.10344828
2009020712,9,3593,0.0,32,30,12,0,2,93.75
2009020712,8,3562,0.0,27,24,4,0,3,88.88888889
2009020713,7,3896,0.0,38,36,11,0,2,94.73684211
2009020713,2,3895,0.0,33,31,2,1,2,93.93939394
2009020714,14,2358,0.0,18,13,3,0,5,72.22222222
2009020714,14,1200,0.0,5,5,0,0,0,100.0
2009020714,13,3600,0.0,49,47,8,1,2,95.91836735
2009020715,11,3600,0.0,32,29,5,0,3,90.625
2009020715,12,3578,0.0,36,32,2,0,4,88.88888889
2009020716,3,3451,0.0,24,21,2,3,3,87.5
2009020716,19,3571,0.0,22,21,0,0,1,95.45454545
2009020717,30,3549,0.0,33,27,5,0,6,81.81818182
2009020717,27,3600,0.0,22,18,0,0,4,81.81818182
2009020718,5,2131,0.0,13,12,2,0,1,92.30769231
2009020718,5,1469,0.0,14,9,0,0,5,64.28571429
2009020718,23,3587,0.0,24,22,1,0,2,91.66666667
2009020719,4,3510,0.0,22,17,1,0,5,77.27272727
2009020719,15,3600,0.0,33,30,9,0,3,90.90909091
2009020720,16,3900,0.0,38,35,4,0,3,92.10526316
2009020720,17,3859,0.0,29,26,7,1,3,89.65517241
2009020721,8,3596,0.0,34,28,6,2,6,82.35294118
2009020721,3,3600,0.0,20,18,8,0,2,90.0
2009020722,20,3525,0.0,26,21,1,0,5,80.76923077
2009020722,24,3598,0.0,37,33,11,0,4,89.18918919
2009020723,9,3581,0.0,23,22,4,3,1,95.65217391
2009020723,6,1796,0.0,17,15,4,0,2,88.23529412
2009020723,6,1804,0.0,9,6,1,0,3,66.66666667
2009020724,1,2400,0.0,32,28,10,0,4,87.5
2009020724,1,1198,0.0,14,14,0,0,0,100.0
2009020724,2,3600,0.0,20,20,0,0,0,100.0
2009020725,14,3600,0.0,22,20,3,0,2,90.90909091
2009020725,12,3553,0.0,32,29,1,0,3,90.625
2009020726,19,3483,0.0,30,26,4,1,4,86.66666667
2009020726,29,3580,0.0,32,30,5,0,2,93.75
2009020727,7,3599,0.0,26,24,2,1,2,92.30769231
2009020727,27,1441,0.0,13,10,1,0,3,76.92307692
2009020727,27,2136,0.0,18,14,4,0,4,77.77777778
2009020728,11,3502,0.0,24,23,7,1,1,95.83333333
2009020728,13,3599,0.0,27,27,3,0,0,100.0
2009020729,10,3600,0.0,30,27,2,1,3,90.0
2009020729,18,3050,0.0,14,13,2,0,1,92.85714286
2009020729,18,540,0.0,8,5,0,0,3,62.5
2009020730,30,1530,2.0,14,14,4,0,0,100.0
2009020730,30,2017,0.0,15,11,0,0,4,73.33333333
2009020730,25,3600,0.0,25,22,1,2,3,88.0
2009020731,22,3600,0.0,34,28,3,3,6,82.35294118
2009020731,21,3600,0.0,24,24,3,0,0,100.0
2009020732,20,1200,0.0,12,9,1,0,3,75.0
2009020732,20,2400,0.0,34,28,6,0,6,82.35294118
2009020732,28,3592,0.0,22,21,4,1,1,95.45454545
2009020733,14,2139,0.0,20,15,2,4,5,75.0
2009020733,14,1461,0.0,11,8,0,0,3,72.72727273
2009020733,3,3600,0.0,23,21,3,0,2,91.30434783
2009020734,29,596,0.0,7,7,3,0,0,100.0
2009020734,29,2952,0.0,30,25,3,1,5,83.33333333
2009020734,4,3595,0.0,28,25,5,0,3,89.28571429
2009020735,17,3555,0.0,23,20,0,0,3,86.95652174
2009020735,15,3583,0.0,46,44,10,0,2,95.65217391
2009020736,10,3528,0.0,32,28,11,0,4,87.5
2009020736,11,3600,0.0,40,37,9,0,3,92.5
2009020737,16,3600,0.0,18,14,5,0,4,77.77777778
2009020737,9,3600,0.0,30,29,3,3,1,96.66666667
2009020738,2,3580,2.0,28,23,6,2,5,82.14285714
2009020738,5,3600,0.0,35,31,4,4,4,88.57142857
2009020739,7,2907,0.0,19,18,4,3,1,94.73684211
2009020739,7,626,2.0,11,7,2,0,4,63.63636364
2009020739,24,3600,0.0,45,41,3,0,4,91.11111111
2009020740,28,3600,0.0,37,36,10,2,1,97.2972973
2009020740,26,3600,0.0,24,19,3,0,5,79.16666667
2009020741,13,3480,0.0,31,30,1,1,1,96.77419355
2009020741,1,3586,0.0,22,22,4,0,0,100.0
2009020742,19,3799,2.0,38,35,8,1,3,92.10526316
2009020742,8,3782,0.0,28,24,5,2,4,85.71428571
2009020743,23,3694,0.0,33,31,5,0,2,93.93939394
2009020743,22,3699,0.0,29,26,5,1,3,89.65517241
2009020744,29,3600,0.0,34,32,1,1,2,94.11764706
2009020744,6,3560,0.0,25,22,2,3,3,88.0
2009020745,19,3574,0.0,30,27,3,0,3,90.0
2009020745,9,3598,0.0,29,27,7,0,2,93.10344828
2009020746,13,3894,0.0,36,35,1,0,1,97.22222222
2009020746,2,3900,0.0,34,33,6,0,1,97.05882353
2009020747,3,3473,0.0,27,25,1,2,2,92.59259259
2009020747,4,3600,0.0,24,24,0,1,0,100.0
2009020748,12,3600,0.0,34,32,6,3,2,94.11764706
2009020748,11,3549,0.0,21,17,7,1,4,80.95238095
2009020749,10,3861,0.0,32,29,11,0,3,90.625
2009020749,14,3890,0.0,22,20,7,0,2,90.90909091
2009020750,15,3600,0.0,38,35,6,0,3,92.10526316
2009020750,5,3534,0.0,33,28,0,0,5,84.84848485
2009020751,17,3900,0.0,30,27,1,0,3,90.0
2009020751,30,1200,0.0,11,10,2,3,1,90.90909091
2009020751,30,2700,0.0,18,16,2,0,2,88.88888889
2009020752,18,3452,0.0,23,19,0,0,4,82.60869565
2009020752,27,3600,0.0,43,41,3,0,2,95.34883721
2009020753,16,3593,0.0,20,19,4,0,1,95.0
2009020753,20,3578,0.0,27,25,1,0,2,92.59259259
2009020754,25,3600,0.0,23,19,3,0,4,82.60869565
2009020754,23,3600,0.0,23,20,2,0,3,86.95652174
2009020755,7,3870,0.0,29,26,7,2,3,89.65517241
2009020755,26,3897,0.0,29,26,2,0,3,89.65517241
2009020756,24,3497,0.0,24,22,8,0,2,91.66666667
2009020756,28,3584,0.0,27,26,10,2,1,96.2962963
2009020757,8,3593,0.0,32,31,2,1,1,96.875
2009020757,1,3513,0.0,24,21,1,0,3,87.5
2009020758,18,3527,0.0,23,21,5,1,2,91.30434783
2009020758,21,3594,0.0,30,29,8,2,1,96.66666667
2009020759,25,3596,0.0,38,35,5,0,3,92.10526316
2009020759,22,3574,0.0,32,28,7,1,4,87.5
2009020760,9,3600,0.0,33,32,1,0,1,96.96969697
2009020760,6,3549,0.0,23,21,6,0,2,91.30434783
2009020761,12,3122,0.0,22,20,6,1,2,90.90909091
2009020761,12,396,0.0,7,6,0,0,1,85.71428571
2009020761,4,3579,0.0,35,33,7,0,2,94.28571429
2009020762,3,1577,0.0,15,11,0,0,4,73.33333333
2009020762,3,2023,0.0,16,14,4,1,2,87.5
2009020762,8,3600,0.0,32,32,3,0,0,100.0
2009020763,1,3600,0.0,22,20,6,0,2,90.90909091
2009020763,2,3582,0.0,27,24,0,0,3,88.88888889
2009020764,27,3503,0.0,33,30,9,0,3,90.90909091
2009020764,15,3600,0.0,30,28,3,6,2,93.33333333
2009020765,10,3483,0.0,22,20,3,0,2,90.90909091
2009020765,13,3599,0.0,39,39,8,0,0,100.0
2009020766,26,3600,0.0,33,31,6,2,2,93.93939394
2009020766,17,3533,0.0,33,30,4,0,3,90.90909091
2009020767,11,3894,0.0,26,25,2,3,1,96.15384615
2009020767,14,3892,0.0,38,37,8,1,1,97.36842105
2009020768,24,3890,0.0,21,18,3,0,3,85.71428571
2009020768,19,3900,0.0,37,34,8,0,3,91.89189189
2009020769,29,3600,0.0,28,24,6,0,4,85.71428571
2009020769,30,3593,0.0,24,22,1,0,2,91.66666667
2009020770,16,1200,0.0,12,9,0,0,3,75.0
2009020770,16,2397,0.0,16,14,1,0,2,87.5
2009020770,23,3600,0.0,44,43,9,2,1,97.72727273
2009020771,7,3586,0.0,23,19,4,0,4,82.60869565
2009020771,28,3582,0.0,40,38,9,1,2,95.0
2009020772,5,3600,0.0,28,27,13,2,1,96.42857143
2009020772,4,3514,0.0,22,20,4,0,2,90.90909091
2009020773,6,1723,0.0,5,4,0,1,1,80.0
2009020773,6,1862,0.0,15,11,2,0,4,73.33333333
2009020773,12,3600,0.0,28,27,3,1,1,96.42857143
2009020774,25,3600,0.0,36,32,8,3,4,88.88888889
2009020774,21,3600,0.0,27,27,5,1,0,100.0
2009020775,5,3600,0.0,30,28,9,0,2,93.33333333
2009020775,3,3546,0.0,27,24,1,2,3,88.88888889
2009020776,19,3600,0.0,34,34,4,0,0,100.0
2009020776,20,3457,0.0,29,27,4,1,2,93.10344828
2009020777,7,3537,0.0,25,22,5,0,3,88.0
2009020777,23,3600,0.0,32,30,0,0,2,93.75
2009020778,26,3600,0.0,28,25,2,0,3,89.28571429
2009020778,10,3516,0.0,32,28,4,0,4,87.5
2009020779,15,1200,0.0,11,11,0,0,0,100.0
2009020779,15,2400,0.0,20,18,9,0,2,90.0
2009020779,2,2390,0.0,21,18,2,1,3,85.71428571
2009020779,2,1196,0.0,12,8,2,0,4,66.66666667
2009020780,24,3540,0.0,34,32,4,3,2,94.11764706
2009020780,11,3600,2.0,35,34,9,1,1,97.14285714
2009020781,18,3557,0.0,17,14,1,0,3,82.35294118
2009020781,29,3598,0.0,31,29,11,2,2,93.5483871
2009020782,1,2400,0.0,12,9,1,0,3,75.0
2009020782,1,1192,0.0,6,6,0,0,0,100.0
2009020782,9,3600,0.0,24,24,4,2,0,100.0
2009020783,8,3541,0.0,29,27,1,0,2,93.10344828
2009020783,13,3593,0.0,17,16,1,0,1,94.11764706
2009020784,27,3751,0.0,36,32,3,0,4,88.88888889
2009020784,17,3830,0.0,37,32,7,2,5,86.48648649
2009020785,16,3600,0.0,24,22,0,0,2,91.66666667
2009020785,22,3547,0.0,37,33,2,0,4,89.18918919
2009020786,1,3900,0.0,31,30,0,1,1,96.77419355
2009020786,7,3900,0.0,40,39,0,1,1,97.5
2009020787,12,3596,0.0,38,37,9,0,1,97.36842105
2009020787,3,3591,0.0,24,19,2,2,5,79.16666667
2009020788,24,3600,0.0,49,44,12,1,5,89.79591837
2009020788,15,3600,0.0,31,30,4,0,1,96.77419355
2009020789,8,3600,0.0,30,27,2,0,3,90.0
2009020789,14,3600,0.0,33,33,3,1,0,100.0
2009020790,17,3600,0.0,25,20,6,0,5,80.0
2009020790,30,3593,0.0,28,26,2,2,2,92.85714286
2009020791,20,3900,4.0,36,33,3,2,3,91.66666667
2009020791,25,3895,0.0,26,23,1,0,3,88.46153846
2009020792,19,3540,0.0,34,31,8,0,3,91.17647059
2009020792,23,3600,0.0,27,25,1,0,2,92.59259259
2009020793,11,3600,0.0,37,34,7,3,3,91.89189189
2009020793,4,3526,0.0,28,24,2,2,4,85.71428571
2009020794,9,3593,0.0,31,30,7,1,1,96.77419355
2009020794,5,3572,0.0,27,24,4,1,3,88.88888889
2009020795,2,3575,0.0,22,19,6,0,3,86.36363636
2009020795,12,3597,0.0,27,26,1,0,1,96.2962963
2009020796,26,3600,0.0,30,29,3,0,1,96.66666667
2009020796,29,3595,0.0,18,14,2,1,4,77.77777778
2009020797,30,3577,0.0,29,29,2,2,0,100.0
2009020797,21,3444,0.0,26,25,5,1,1,96.15384615
2009020798,20,3900,0.0,31,29,9,2,2,93.5483871
2009020798,27,3900,0.0,26,24,7,1,2,92.30769231
2009020799,19,3600,0.0,25,24,0,0,1,96.0
2009020799,22,3534,0.0,20,18,1,1,2,90.0
2009020800,16,3696,0.0,37,34,2,0,3,91.89189189
2009020800,28,3687,0.0,39,35,6,0,4,89.74358974
2009020801,10,1907,0.0,19,16,3,1,3,84.21052632
2009020801,10,1947,0.0,12,10,0,0,2,83.33333333
2009020801,1,3854,0.0,29,25,4,0,4,86.20689655
2009020802,13,3600,0.0,40,36,7,5,4,90.0
2009020802,15,3600,0.0,36,35,5,1,1,97.22222222
2009020803,6,3526,0.0,23,21,2,0,2,91.30434783
2009020803,7,3599,0.0,31,30,3,3,1,96.77419355
2009020804,24,3898,0.0,31,30,4,0,1,96.77419355
2009020804,14,3900,0.0,32,31,2,0,1,96.875
2009020805,18,3505,0.0,29,25,7,0,4,86.20689655
2009020805,17,3595,0.0,48,46,12,2,2,95.83333333
2009020806,21,3524,0.0,31,28,4,0,3,90.32258065
2009020806,25,3600,0.0,26,24,1,1,2,92.30769231
2009020807,8,3813,0.0,37,34,5,0,3,91.89189189
2009020807,9,3813,0.0,29,27,0,0,2,93.10344828
2009020808,26,3899,0.0,33,31,4,1,2,93.93939394
2009020808,6,3900,2.0,29,27,4,1,2,93.10344828
2009020809,23,2398,0.0,13,13,3,1,0,100.0
2009020809,23,1198,0.0,8,5,1,0,3,62.5
2009020809,10,3562,0.0,35,31,11,0,4,88.57142857
2009020810,2,3540,0.0,32,30,8,1,2,93.75
2009020810,4,3598,0.0,32,31,5,1,1,96.875
2009020811,16,3441,0.0,24,20,0,0,4,83.33333333
2009020811,12,3600,0.0,41,39,3,1,2,95.12195122
2009020812,29,3692,0.0,27,25,2,2,2,92.59259259
2009020812,19,3668,0.0,19,16,6,0,3,84.21052632
2009020813,11,3494,0.0,31,27,4,0,4,87.09677419
2009020813,18,3591,0.0,26,23,0,1,3,88.46153846
2009020814,3,3507,0.0,24,21,6,0,3,87.5
2009020814,27,3587,0.0,26,24,2,3,2,92.30769231
2009020815,22,3600,0.0,30,24,3,1,6,80.0
2009020815,20,3588,0.0,28,27,6,0,1,96.42857143
2009020816,30,3590,0.0,36,31,8,2,5,86.11111111
2009020816,28,3580,0.0,38,36,3,3,2,94.73684211
2009020817,17,3885,0.0,47,46,2,2,1,97.87234043
2009020817,5,3895,0.0,24,23,8,0,1,95.83333333
2009020818,14,3556,0.0,31,28,4,0,3,90.32258065
2009020818,15,3598,0.0,27,25,1,0,2,92.59259259
2009020819,26,3600,0.0,28,26,7,3,2,92.85714286
2009020819,1,3589,0.0,22,19,1,0,3,86.36363636
2009020820,2,3544,2.0,25,23,2,0,2,92.0
2009020820,13,3600,0.0,33,33,11,0,0,100.0
2009020821,27,3600,0.0,40,38,4,0,2,95.0
2009020821,25,3481,0.0,31,27,0,0,4,87.09677419
2009020822,3,3585,0.0,35,34,5,0,1,97.14285714
2009020822,21,3531,2.0,34,31,7,5,3,91.17647059
2009020823,7,3519,0.0,31,26,3,1,5,83.87096774
2009020823,5,3600,0.0,34,30,9,0,4,88.23529412
2009020824,24,3592,0.0,33,33,5,0,0,100.0
2009020824,13,3594,0.0,25,22,4,0,3,88.0
2009020825,4,3595,0.0,18,18,2,0,0,100.0
2009020825,20,3598,0.0,27,24,4,0,3,88.88888889
2009020826,12,3478,0.0,27,23,5,2,4,85.18518519
2009020826,22,3600,0.0,35,33,1,0,2,94.28571429
2009020827,15,3595,0.0,42,41,10,4,1,97.61904762
2009020827,6,3527,0.0,25,22,4,2,3,88.0
2009020828,1,3600,0.0,26,23,3,0,3,88.46153846
2009020828,10,3600,0.0,30,30,1,0,0,100.0
2009020829,14,3599,0.0,27,26,4,0,1,96.2962963
2009020829,11,3516,0.0,24,22,5,1,2,91.66666667
2009020830,23,3543,0.0,28,25,3,3,3,89.28571429
2009020830,8,3600,0.0,47,45,9,0,2,95.74468085
2009020831,27,3900,0.0,25,25,1,0,0,100.0
2009020831,18,3900,2.0,26,26,2,0,0,100.0
2009020832,30,3484,0.0,18,14,5,1,4,77.77777778
2009020832,25,3588,0.0,42,40,8,0,2,95.23809524
2009020833,29,3578,0.0,26,21,1,0,5,80.76923077
2009020833,21,3600,0.0,21,20,9,0,1,95.23809524
2009020834,3,3557,0.0,21,19,5,0,2,90.47619048
2009020834,26,3600,0.0,21,20,2,0,1,95.23809524
2009020835,17,3599,0.0,34,32,4,1,2,94.11764706
2009020835,28,3473,0.0,37,33,8,0,4,89.18918919
2009020836,9,3596,0.0,36,34,5,0,2,94.44444444
2009020836,7,3574,0.0,37,34,2,3,3,91.89189189
2009020837,19,3600,0.0,34,32,4,1,2,94.11764706
2009020837,16,3559,2.0,19,16,2,0,3,84.21052632
2009020838,12,3585,0.0,38,35,2,7,3,92.10526316
2009020838,20,3597,0.0,28,27,5,0,1,96.42857143
2009020839,4,3583,0.0,27,26,2,0,1,96.2962963
2009020839,22,3600,0.0,33,33,11,0,0,100.0
2009020840,17,3519,0.0,30,27,6,0,3,90.0
2009020840,24,3578,0.0,47,46,5,2,1,97.87234043
2009020841,8,3900,0.0,47,45,5,3,2,95.74468085
2009020841,6,3900,0.0,25,23,2,2,2,92.0
2009020842,15,3573,0.0,38,33,6,2,5,86.84210526
2009020842,3,3541,0.0,32,26,11,1,6,81.25
2009020843,25,3548,0.0,25,24,0,1,1,96.0
2009020843,29,3600,0.0,23,22,3,0,1,95.65217391
2009020844,23,3540,0.0,20,18,1,0,2,90.0
2009020844,9,3600,0.0,30,29,6,1,1,96.66666667
2009020845,2,3565,0.0,30,26,6,1,4,86.66666667
2009020845,14,3588,0.0,36,34,6,3,2,94.44444444
2009020846,28,3600,0.0,37,35,3,0,2,94.59459459
2009020846,19,3480,0.0,31,27,7,0,4,87.09677419
2009020847,21,3577,2.0,36,31,3,0,5,86.11111111
2009020847,18,3600,0.0,26,23,1,2,3,88.46153846
2009020848,22,3552,0.0,36,32,8,0,4,88.88888889
2009020848,30,573,0.0,9,9,3,0,0,100.0
2009020848,30,3022,0.0,23,21,2,0,2,91.30434783
2009020849,24,3600,0.0,31,25,1,0,6,80.64516129
2009020849,26,3595,0.0,22,18,1,0,4,81.81818182
2009020850,10,3577,0.0,28,24,2,1,4,85.71428571
2009020850,1,3595,0.0,20,17,2,0,3,85.0
2009020851,11,3579,0.0,31,27,4,0,4,87.09677419
2009020851,15,3597,0.0,45,43,12,0,2,95.55555556
2009020852,12,3600,0.0,31,28,8,3,3,90.32258065
2009020852,7,3524,0.0,27,23,3,1,4,85.18518519
2009020853,20,3600,0.0,13,12,1,0,1,92.30769231
2009020853,13,3557,0.0,40,38,9,2,2,95.0
2009020854,27,3900,0.0,29,28,3,2,1,96.55172414
2009020854,16,3900,0.0,22,21,2,2,1,95.45454545
2009020855,23,3900,0.0,43,41,8,4,2,95.34883721
2009020855,6,3900,0.0,31,29,4,1,2,93.5483871
2009020856,5,765,0.0,4,3,1,0,1,75.0
2009020856,5,2835,0.0,28,24,1,3,4,85.71428571
2009020856,8,3594,0.0,21,18,1,0,3,85.71428571
2009020857,17,3536,0.0,27,23,3,2,4,85.18518519
2009020857,26,3600,0.0,23,20,5,0,3,86.95652174
2009020858,27,3600,0.0,35,31,4,0,4,88.57142857
2009020858,25,3600,2.0,34,34,6,0,0,100.0
2009020859,9,2399,0.0,30,26,8,2,4,86.66666667
2009020859,9,1198,0.0,7,6,1,1,1,85.71428571
2009020859,10,3600,0.0,30,30,3,3,0,100.0
2009020860,12,3594,0.0,35,34,7,1,1,97.14285714
2009020860,2,3594,0.0,25,22,3,0,3,88.0
2009020861,1,3480,0.0,25,22,2,0,3,88.0
2009020861,3,3600,0.0,42,41,5,5,1,97.61904762
2009020862,13,3587,0.0,34,31,6,3,3,91.17647059
2009020862,11,3589,0.0,28,26,6,1,2,92.85714286
2009020863,20,3718,0.0,23,21,3,0,2,91.30434783
2009020863,14,3718,0.0,26,25,6,3,1,96.15384615
2009020864,7,3600,0.0,25,21,4,0,4,84.0
2009020864,29,3600,0.0,28,28,7,0,0,100.0
2009020865,16,3600,0.0,35,34,13,2,1,97.14285714
2009020865,19,3524,0.0,30,28,10,2,2,93.33333333
2009020866,28,3600,0.0,38,35,7,0,3,92.10526316
2009020866,18,3554,0.0,29,25,5,0,4,86.20689655
2009020867,4,3492,0.0,30,28,8,0,2,93.33333333
2009020867,30,3594,0.0,39,38,9,2,1,97.43589744
2009020868,22,3559,0.0,41,39,7,2,2,95.12195122
2009020868,21,3591,0.0,20,20,6,0,0,100.0
2009020869,6,3600,0.0,36,36,3,0,0,100.0
2009020869,8,3600,0.0,27,24,0,0,3,88.88888889
2009020870,5,3769,0.0,34,29,6,0,5,85.29411765
2009020870,15,3763,0.0,35,31,9,0,4,88.57142857
2009020871,28,3600,0.0,34,32,6,1,2,94.11764706
2009020871,10,3514,0.0,26,23,5,0,3,88.46153846
2009020872,1,3539,0.0,37,34,11,0,3,91.89189189
2009020872,4,3579,0.0,30,28,7,0,2,93.33333333
2009020873,19,1596,0.0,15,10,3,0,5,66.66666667
2009020873,19,2004,0.0,18,18,5,0,0,100.0
2009020873,21,3600,0.0,34,32,4,5,2,94.11764706
2009020874,22,3600,0.0,33,27,3,1,6,81.81818182
2009020874,27,3596,0.0,34,33,8,0,1,97.05882353
2009020875,26,3500,0.0,33,29,7,1,4,87.87878788
2009020875,24,3591,0.0,37,35,6,0,2,94.59459459
2009020876,6,3900,0.0,45,43,9,1,2,95.55555556
2009020876,7,3900,0.0,34,32,7,0,2,94.11764706
2009020877,18,3892,0.0,32,29,8,2,3,90.625
2009020877,2,3839,0.0,27,24,2,1,3,88.88888889
2009020878,13,3578,0.0,29,26,3,0,3,89.65517241
2009020878,12,3600,0.0,20,19,2,2,1,95.0
2009020879,20,3541,0.0,31,28,1,0,3,90.32258065
2009020879,9,3600,0.0,29,27,1,2,2,93.10344828
2009020880,23,3448,0.0,19,16,3,2,3,84.21052632
2009020880,14,3600,0.0,40,39,8,4,1,97.5
2009020881,17,3900,0.0,45,42,12,0,3,93.33333333
2009020881,19,3897,0.0,42,39,6,2,3,92.85714286
2009020882,25,3896,0.0,40,37,4,0,3,92.5
2009020882,16,3890,0.0,27,24,7,0,3,88.88888889
2009020883,4,3807,0.0,23,21,1,0,2,91.30434783
2009020883,1,3807,2.0,15,12,3,0,3,80.0
2009020884,18,3600,0.0,38,37,8,2,1,97.36842105
2009020884,3,3486,0.0,36,34,7,1,2,94.44444444
2009020885,28,3489,0.0,20,18,4,0,2,90.0
2009020885,29,3596,0.0,40,40,5,1,0,100.0
2009020886,15,1540,0.0,14,12,0,1,2,85.71428571
2009020886,15,2237,0.0,25,21,4,0,4,84.0
2009020886,8,3887,0.0,38,33,12,3,5,86.84210526
2009020887,2,3600,2.0,28,25,2,0,3,89.28571429
2009020887,5,3600,0.0,38,37,3,0,1,97.36842105
2009020888,27,3600,0.0,31,29,1,0,2,93.5483871
2009020888,30,3510,0.0,31,28,3,1,3,90.32258065
2009020889,11,3609,0.0,35,31,6,1,4,88.57142857
2009020889,21,3609,2.0,36,33,10,1,3,91.66666667
2009020890,22,3537,0.0,30,27,10,1,3,90.0
2009020890,24,3591,0.0,39,37,2,3,2,94.87179487
2009020891,15,3541,0.0,28,22,1,0,6,78.57142857
2009020891,9,3585,0.0,24,19,2,0,5,79.16666667
2009020892,7,3707,0.0,35,31,3,0,4,88.57142857
2009020892,12,3692,0.0,32,29,1,2,3,90.625
2009020893,6,3598,0.0,35,31,5,0,4,88.57142857
2009020893,14,1200,0.0,21,17,0,0,4,80.95238095
2009020893,14,2344,0.0,15,14,1,2,1,93.33333333
2009020894,23,3600,0.0,31,31,7,6,0,100.0
2009020894,13,3600,0.0,35,32,7,2,3,91.42857143
2009020895,28,3900,0.0,52,50,8,1,2,96.15384615
2009020895,17,3900,0.0,26,24,3,1,2,92.30769231
2009020896,25,3600,0.0,34,33,7,2,1,97.05882353
2009020896,20,3540,0.0,22,20,7,0,2,90.90909091
2009020897,22,3900,2.0,43,41,8,1,2,95.34883721
2009020897,26,3875,0.0,23,21,1,0,2,91.30434783
2009020898,18,3558,0.0,27,23,5,0,4,85.18518519
2009020898,1,3598,0.0,21,19,2,1,2,90.47619048
2009020899,8,3541,0.0,33,30,9,1,3,90.90909091
2009020899,4,3600,0.0,25,23,1,0,2,92.0
2009020900,23,3597,0.0,35,32,7,1,3,91.42857143
2009020900,29,3514,0.0,35,31,5,1,4,88.57142857
2009020901,3,3662,0.0,27,25,1,1,2,92.59259259
2009020901,5,2165,0.0,22,20,1,0,2,90.90909091
2009020901,5,1497,0.0,17,16,5,0,1,94.11764706
2009020902,10,3586,0.0,33,29,2,2,4,87.87878788
2009020902,19,3600,0.0,30,30,9,0,0,100.0
2009020903,11,3580,0.0,38,36,1,3,2,94.73684211
2009020903,30,3522,0.0,24,21,4,0,3,87.5
2009020904,27,3554,0.0,25,23,6,2,2,92.0
2009020904,21,3600,0.0,34,33,1,4,1,97.05882353
2009020905,14,3513,0.0,33,28,8,1,5,84.84848485
2009020905,2,3600,0.0,42,38,10,1,4,90.47619048
2009020906,28,3488,0.0,28,25,3,0,3,89.28571429
2009020906,7,3600,0.0,28,27,4,1,1,96.42857143
2009020907,4,3600,0.0,28,26,6,0,2,92.85714286
2009020907,8,2367,0.0,17,12,3,0,5,70.58823529
2009020907,8,1190,0.0,9,8,0,0,1,88.88888889
2009020908,1,2624,0.0,22,18,5,0,4,81.81818182
2009020908,1,911,0.0,8,8,0,0,0,100.0
2009020908,12,3520,0.0,25,23,4,0,2,92.0
2009020909,6,3898,0.0,28,26,2,0,2,92.85714286
2009020909,13,3897,0.0,39,37,4,3,2,94.87179487
2009020910,9,3569,0.0,39,36,4,1,3,92.30769231
2009020910,17,3600,0.0,30,29,4,0,1,96.66666667
2009020911,15,3900,0.0,36,33,8,0,3,91.66666667
2009020911,19,3900,0.0,34,31,6,0,3,91.17647059
2009020912,25,3600,2.0,40,40,4,1,0,100.0
2009020912,27,3600,0.0,22,19,0,0,3,86.36363636
2009020913,11,3873,0.0,40,36,4,1,4,90.0
2009020913,16,3873,0.0,27,23,7,1,4,85.18518519
2009020914,24,3489,0.0,38,35,4,1,3,92.10526316
2009020914,20,3600,0.0,27,26,2,0,1,96.2962963
2009020915,21,3600,0.0,23,20,3,1,3,86.95652174
2009020915,26,3600,0.0,22,22,5,0,0,100.0
2009020916,14,3538,0.0,22,18,4,0,4,81.81818182
2009020916,3,3600,0.0,29,27,1,1,2,93.10344828
2009020917,18,3884,0.0,33,30,4,0,3,90.90909091
2009020917,5,3834,0.0,26,23,8,0,3,88.46153846
2009020918,23,716,0.0,9,8,2,0,1,88.88888889
2009020918,23,2866,0.0,32,27,11,0,5,84.375
2009020918,30,3582,0.0,29,27,1,0,2,93.10344828
2009020919,9,3600,0.0,37,34,8,2,3,91.89189189
2009020919,2,3489,0.0,35,31,5,1,4,88.57142857
2009020920,16,3862,0.0,28,24,6,0,4,85.71428571
2009020920,29,3900,0.0,37,33,6,0,4,89.18918919
2009020921,24,3600,0.0,29,26,7,4,3,89.65517241
2009020921,22,3593,0.0,46,39,17,0,7,84.7826087
2009020922,17,3597,0.0,24,22,2,2,2,91.66666667
2009020922,21,3498,2.0,30,27,3,0,3,90.0
2009020923,8,3600,0.0,24,23,4,1,1,95.83333333
2009020923,6,3600,0.0,32,28,3,0,4,87.5
2009020924,12,3600,0.0,33,32,4,1,1,96.96969697
2009020924,10,3600,0.0,30,25,1,0,5,83.33333333
2009020925,16,1372,0.0,12,9,0,0,3,75.0
2009020925,16,2101,0.0,11,9,0,0,2,81.81818182
2009020925,2,3600,0.0,44,41,0,0,3,93.18181818
2009020926,13,3509,0.0,39,35,10,2,4,89.74358974
2009020926,11,3595,0.0,36,34,10,0,2,94.44444444
2009020927,23,3693,0.0,30,27,3,1,3,90.0
2009020927,29,3693,0.0,31,27,1,2,4,87.09677419
2009020928,3,3600,0.0,25,24,3,0,1,96.0
2009020928,9,2266,0.0,16,12,2,0,4,75.0
2009020928,9,1334,0.0,9,9,0,1,0,100.0
2009020929,7,3530,0.0,28,25,2,3,3,89.28571429
2009020929,5,3600,0.0,28,26,5,0,2,92.85714286
2009020930,4,3598,0.0,38,36,10,4,2,94.73684211
2009020930,14,3091,0.0,31,25,8,1,6,80.64516129
2009020930,14,509,0.0,3,2,0,0,1,66.66666667
2009020931,22,3565,0.0,28,24,1,1,4,85.71428571
2009020931,18,3595,0.0,25,22,0,2,3,88.0
2009020932,26,3598,0.0,32,31,8,0,1,96.875
2009020932,25,3600,0.0,22,17,1,0,5,77.27272727
2009020933,19,3598,0.0,39,37,6,1,2,94.87179487
2009020933,27,2400,0.0,22,17,2,2,5,77.27272727
2009020933,27,1200,0.0,13,13,5,0,0,100.0
2009020934,1,3599,0.0,20,17,0,0,3,85.0
2009020934,28,3557,0.0,25,21,4,0,4,84.0
2009020935,15,3594,0.0,24,23,3,0,1,95.83333333
2009020935,7,3520,0.0,39,37,1,1,2,94.87179487
2009020936,4,1960,0.0,26,22,4,0,4,84.61538462
2009020936,4,1590,0.0,16,14,1,0,2,87.5
2009020936,13,3598,0.0,42,38,7,0,4,90.47619048
2009020937,23,3600,0.0,31,28,1,0,3,90.32258065
2009020937,17,1893,0.0,21,17,1,0,4,80.95238095
2009020937,17,1707,0.0,12,10,0,0,2,83.33333333
2009020938,22,3600,0.0,47,42,4,0,5,89.36170213
2009020938,16,3600,0.0,14,12,3,0,2,85.71428571
2009020939,30,3600,0.0,29,29,2,0,0,100.0
2009020939,20,3600,0.0,21,17,0,0,4,80.95238095
2009020940,21,3600,0.0,34,31,13,0,3,91.17647059
2009020940,24,3543,0.0,25,21,2,0,4,84.0
2009020941,10,3900,0.0,31,29,4,0,2,93.5483871
2009020941,6,3900,0.0,26,24,4,1,2,92.30769231
2009020942,5,1853,0.0,4,4,0,0,0,100.0
2009020942,5,1969,0.0,12,8,3,0,4,66.66666667
2009020942,3,3822,0.0,55,50,9,4,5,90.90909091
2009020943,14,3573,0.0,34,29,4,0,5,85.29411765
2009020943,15,3600,0.0,29,25,6,0,4,86.20689655
2009020944,9,3208,0.0,15,14,3,1,1,93.33333333
2009020944,9,383,0.0,5,3,0,0,2,60.0
2009020944,12,3600,0.0,26,25,2,2,1,96.15384615
2009020945,2,556,0.0,7,4,0,0,3,57.14285714
2009020945,2,3044,0.0,15,12,2,0,3,80.0
2009020945,11,3600,0.0,37,34,11,0,3,91.89189189
2009020946,26,3565,0.0,31,28,3,0,3,90.32258065
2009020946,18,3589,0.0,22,20,2,0,2,90.90909091
2009020947,19,3600,0.0,30,29,7,0,1,96.66666667
2009020947,25,2290,0.0,16,14,4,2,2,87.5
2009020947,25,1310,0.0,11,7,2,0,4,63.63636364
2009020948,21,3582,0.0,29,27,0,0,2,93.10344828
2009020948,27,3595,0.0,24,23,3,0,1,95.83333333
2009020949,8,3486,0.0,40,37,8,0,3,92.5
2009020949,28,3600,0.0,30,28,7,1,2,93.33333333
2009020950,4,3751,0.0,35,32,3,0,3,91.42857143
2009020950,7,3748,0.0,29,27,1,1,2,93.10344828
2009020951,18,3544,0.0,31,27,5,1,4,87.09677419
2009020951,17,3574,0.0,22,20,2,1,2,90.90909091
2009020952,23,2400,0.0,10,9,2,1,1,90.0
2009020952,23,1200,0.0,14,9,7,0,5,64.28571429
2009020952,16,3600,0.0,23,20,7,1,3,86.95652174
2009020953,1,3537,0.0,25,20,1,0,5,80.0
2009020953,20,3600,0.0,25,22,4,0,3,88.0
2009020954,30,3900,0.0,23,22,1,1,1,95.65217391
2009020954,22,3900,0.0,29,28,5,0,1,96.55172414
2009020955,25,3587,0.0,34,28,4,0,6,82.35294118
2009020955,5,3590,0.0,30,27,8,2,3,90.0
2009020956,6,3598,0.0,39,37,8,0,2,94.87179487
2009020956,2,3522,0.0,34,31,2,0,3,91.17647059
2009020957,10,3900,0.0,23,22,6,1,1,95.65217391
2009020957,9,3897,2.0,31,30,6,1,1,96.77419355
2009020958,3,3547,0.0,28,26,6,2,2,92.85714286
2009020958,15,3600,0.0,30,30,3,1,0,100.0
2009020959,12,3558,0.0,29,26,3,3,3,89.65517241
2009020959,13,3578,0.0,32,31,8,2,1,96.875
2009020960,11,3567,0.0,30,24,4,2,6,80.0
2009020960,14,3600,0.0,31,29,5,0,2,93.5483871
2009020961,24,3594,0.0,30,26,4,1,4,86.66666667
2009020961,27,3598,0.0,32,32,8,0,0,100.0
2009020962,19,1278,0.0,15,11,1,0,4,73.33333333
2009020962,19,2271,0.0,17,15,5,0,2,88.23529412
2009020962,21,3596,0.0,42,39,6,1,3,92.85714286
2009020963,8,3600,0.0,25,23,4,0,2,92.0
2009020963,26,3581,0.0,24,21,1,3,3,87.5
2009020964,29,3574,0.0,44,42,10,2,2,95.45454545
2009020964,28,3599,0.0,22,21,0,2,1,95.45454545
2009020965,6,3497,0.0,33,31,1,0,2,93.93939394
2009020965,5,3600,0.0,22,21,3,0,1,95.45454545
2009020966,23,3600,0.0,35,33,2,1,2,94.28571429
2009020966,18,3524,0.0,27,24,2,1,3,88.88888889
2009020967,20,3594,0.0,29,27,8,0,2,93.10344828
2009020967,30,3533,0.0,23,19,2,1,4,82.60869565
2009020968,12,3600,0.0,27,27,2,3,0,100.0
2009020968,11,3585,0.0,33,29,10,1,4,87.87878788
2009020969,7,3742,0.0,36,35,5,0,1,97.22222222
2009020969,3,3736,0.0,32,30,1,0,2,93.75
2009020970,10,3521,0.0,25,22,5,0,3,88.0
2009020970,4,3599,0.0,28,27,7,1,1,96.42857143
2009020971,17,3600,0.0,32,28,3,0,4,87.5
2009020971,16,1711,0.0,8,7,0,0,1,87.5
2009020971,16,1827,0.0,17,13,1,0,4,76.47058824
2009020972,1,3600,0.0,35,33,5,0,2,94.28571429
2009020972,22,3600,0.0,22,22,0,3,0,100.0
2009020973,8,2628,0.0,21,21,0,0,0,100.0
2009020973,8,1200,0.0,11,8,1,0,3,72.72727273
2009020973,24,3900,0.0,43,40,14,0,3,93.02325581
2009020974,25,3900,0.0,52,49,8,0,3,94.23076923
2009020974,15,3900,0.0,26,23,1,1,3,88.46153846
2009020975,29,919,0.0,13,9,3,0,4,69.23076923
2009020975,29,2681,0.0,22,20,5,3,2,90.90909091
2009020975,26,3575,0.0,11,11,5,0,0,100.0
2009020976,6,3849,0.0,30,26,4,0,4,86.66666667
2009020976,10,3846,0.0,29,26,2,2,3,89.65517241
2009020977,2,3537,0.0,35,32,5,0,3,91.42857143
2009020977,4,3597,0.0,25,23,1,0,2,92.0
2009020978,18,3600,0.0,31,30,4,0,1,96.77419355
2009020978,11,3501,0.0,32,30,0,1,2,93.75
2009020979,14,1653,0.0,13,9,0,0,4,69.23076923
2009020979,14,1899,0.0,15,14,2,1,1,93.33333333
2009020979,8,3600,0.0,31,28,7,0,3,90.32258065
2009020980,20,3600,0.0,30,28,5,0,2,93.33333333
2009020980,17,3537,0.0,31,28,3,1,3,90.32258065
2009020981,13,3882,0.0,11,9,0,0,2,81.81818182
2009020981,30,3900,0.0,31,29,7,0,2,93.5483871
2009020982,23,3600,0.0,27,23,0,0,4,85.18518519
2009020982,21,3525,0.0,31,26,0,0,5,83.87096774
2009020983,9,3600,0.0,19,18,6,2,1,94.73684211
2009020983,22,3600,0.0,39,35,13,0,4,89.74358974
2009020984,29,3592,0.0,38,36,9,0,2,94.73684211
2009020984,24,1987,0.0,20,17,1,1,3,85.0
2009020984,24,1547,0.0,9,7,4,0,2,77.77777778
2009020985,25,3545,0.0,42,38,5,1,4,90.47619048
2009020985,7,3600,0.0,20,17,3,0,3,85.0
2009020986,3,2119,0.0,17,12,0,2,5,70.58823529
2009020986,3,1481,0.0,10,9,2,0,1,90.0
2009020986,1,3596,0.0,19,16,3,0,3,84.21052632
2009020987,12,3800,0.0,39,35,5,0,4,89.74358974
2009020987,15,3787,0.0,31,28,2,4,3,90.32258065
2009020988,26,3728,0.0,43,40,7,0,3,93.02325581
2009020988,16,3728,0.0,30,28,5,1,2,93.33333333
2009020989,23,3898,2.0,34,31,4,1,3,91.17647059
2009020989,27,3900,0.0,39,36,7,0,3,92.30769231
2009020990,14,3808,0.0,38,34,4,1,4,89.47368421
2009020990,10,3813,0.0,33,30,3,1,3,90.90909091
2009020991,19,3899,0.0,30,29,7,1,1,96.66666667
2009020991,2,3876,0.0,36,35,11,2,1,97.22222222
2009020992,6,3592,0.0,32,31,0,0,1,96.875
2009020992,4,1876,0.0,25,21,0,0,4,84.0
2009020992,4,1724,0.0,12,11,2,0,1,91.66666667
2009020993,5,3623,0.0,21,17,1,0,4,80.95238095
2009020993,12,3611,0.0,40,37,5,0,3,92.5
2009020994,11,3512,0.0,21,19,7,0,2,90.47619048
2009020994,29,3600,0.0,29,28,4,2,1,96.55172414
2009020995,22,3900,0.0,26,22,8,0,4,84.61538462
2009020995,8,3899,0.0,25,21,0,2,4,84.0
2009020996,30,3600,0.0,30,25,8,2,5,83.33333333
2009020996,17,3593,0.0,22,21,2,2,1,95.45454545
2009020997,13,3598,0.0,31,28,3,0,3,90.32258065
2009020997,21,3600,0.0,27,27,1,0,0,100.0
2009020998,9,3508,0.0,25,23,2,1,2,92.0
2009020998,20,3600,0.0,33,33,4,0,0,100.0
2009020999,18,3254,0.0,23,17,3,1,6,73.91304348
2009020999,18,275,0.0,2,1,0,0,1,50.0
2009020999,28,3600,0.0,45,40,10,1,5,88.88888889
2009021000,5,3511,0.0,32,29,8,0,3,90.625
2009021000,1,3578,0.0,35,34,5,1,1,97.14285714
2009021001,14,3599,0.0,30,28,7,1,2,93.33333333
2009021001,15,3540,0.0,27,24,0,0,3,88.88888889
2009021002,30,3596,0.0,45,43,9,0,2,95.55555556
2009021002,7,3519,0.0,33,30,3,4,3,90.90909091
2009021003,3,3600,0.0,31,29,5,0,2,93.5483871
2009021003,11,3554,2.0,34,30,9,1,4,88.23529412
2009021004,26,3900,0.0,30,29,9,1,1,96.66666667
2009021004,25,3900,2.0,28,27,7,0,1,96.42857143
2009021005,18,3600,0.0,31,31,0,1,0,100.0
2009021005,24,3554,0.0,28,27,1,0,1,96.42857143
2009021006,16,3588,2.0,34,31,5,1,3,91.17647059
2009021006,4,3600,0.0,41,39,10,2,2,95.12195122
2009021007,22,1163,0.0,19,18,6,0,1,94.73684211
2009021007,22,2400,2.0,28,23,3,1,5,82.14285714
2009021007,10,3600,0.0,29,25,5,1,4,86.20689655
2009021008,6,3541,0.0,27,24,6,1,3,88.88888889
2009021008,8,3600,0.0,23,21,2,0,2,91.30434783
2009021009,1,3503,0.0,29,25,0,3,4,86.20689655
2009021009,2,3600,2.0,40,38,5,0,2,95.0
2009021010,27,3600,0.0,29,29,6,0,0,100.0
2009021010,12,3585,0.0,20,16,2,0,4,80.0
2009021011,7,3631,0.0,37,34,7,0,3,91.89189189
2009021011,17,3631,0.0,26,24,6,0,2,92.30769231
2009021012,19,3600,0.0,25,24,12,0,1,96.0
2009021012,29,3526,0.0,35,31,3,2,4,88.57142857
2009021013,9,3600,0.0,35,30,13,0,5,85.71428571
2009021013,23,3600,0.0,14,13,2,1,1,92.85714286
2009021014,13,3738,0.0,39,37,6,1,2,94.87179487
2009021014,28,3761,0.0,28,25,6,0,3,89.28571429
2009021015,4,3496,0.0,21,18,4,1,3,85.71428571
2009021015,3,3587,0.0,18,17,3,0,1,94.44444444
2009021016,21,3600,0.0,51,48,14,0,3,94.11764706
2009021016,25,1469,0.0,4,3,0,0,1,75.0
2009021016,25,2026,0.0,18,14,5,0,4,77.77777778
2009021017,18,3600,0.0,20,18,1,0,2,90.0
2009021017,26,3539,0.0,31,28,1,0,3,90.32258065
2009021018,10,3592,0.0,32,28,9,3,4,87.5
2009021018,2,3600,0.0,27,26,11,0,1,96.2962963
2009021019,27,3890,0.0,41,39,16,0,2,95.12195122
2009021019,11,3900,0.0,34,32,12,2,2,94.11764706
2009021020,5,3600,0.0,22,21,10,0,1,95.45454545
2009021020,14,3554,0.0,39,37,8,0,2,94.87179487
2009021021,19,1196,0.0,7,4,0,0,3,57.14285714
2009021021,19,2273,0.0,13,12,0,0,1,92.30769231
2009021021,30,3600,0.0,38,36,7,0,2,94.73684211
2009021022,15,3790,0.0,23,20,4,0,3,86.95652174
2009021022,16,3790,0.0,30,26,5,3,4,86.66666667
2009021023,28,3534,0.0,32,29,9,0,3,90.625
2009021023,24,3600,0.0,33,31,5,1,2,93.93939394
2009021024,20,2314,0.0,8,8,2,0,0,100.0
2009021024,20,1200,0.0,20,17,9,1,3,85.0
2009021024,23,3580,0.0,33,32,10,2,1,96.96969697
2009021025,6,2316,0.0,16,16,0,0,0,100.0
2009021025,6,1192,0.0,12,9,2,0,3,75.0
2009021025,1,3600,0.0,36,34,4,0,2,94.44444444
2009021026,22,3562,0.0,28,24,1,1,4,85.71428571
2009021026,29,3599,0.0,32,29,4,0,3,90.625
2009021027,17,3600,0.0,23,22,2,1,1,95.65217391
2009021027,20,3528,0.0,28,26,0,1,2,92.85714286
2009021028,8,3600,0.0,20,19,3,0,1,95.0
2009021028,3,3547,0.0,34,32,4,1,2,94.11764706
2009021029,6,3600,0.0,32,30,8,0,2,93.75
2009021029,12,3600,0.0,37,32,5,2,5,86.48648649
2009021030,7,340,0.0,5,2,0,0,3,40.0
2009021030,7,3206,0.0,21,20,2,1,1,95.23809524
2009021030,11,3600,0.0,32,29,2,2,3,90.625
2009021031,10,3600,0.0,31,30,4,3,1,96.77419355
2009021031,9,3550,0.0,29,26,3,0,3,89.65517241
2009021032,27,3600,0.0,28,27,14,0,1,96.42857143
2009021032,14,3550,0.0,28,26,5,0,2,92.85714286
2009021033,15,3577,0.0,37,34,4,0,3,91.89189189
2009021033,13,2046,0.0,21,16,5,0,5,76.19047619
2009021033,13,1554,0.0,18,16,0,0,2,88.88888889
2009021034,21,3600,0.0,39,36,5,1,3,92.30769231
2009021034,19,3554,0.0,26,21,2,0,5,80.76923077
2009021035,4,585,0.0,5,3,0,0,2,60.0
2009021035,4,3315,0.0,25,24,0,0,1,96.0
2009021035,18,3900,0.0,45,42,2,0,3,93.33333333
2009021036,22,3457,0.0,28,24,3,0,4,85.71428571
2009021036,30,3600,0.0,36,34,8,0,2,94.44444444
2009021037,28,1928,0.0,14,10,3,0,4,71.42857143
2009021037,28,1666,0.0,17,13,2,0,4,76.47058824
2009021037,25,3593,0.0,47,45,11,1,2,95.74468085
2009021038,2,3600,0.0,37,35,3,1,2,94.59459459
2009021038,23,1136,0.0,7,7,0,1,0,100.0
2009021038,23,2393,0.0,12,8,2,1,4,66.66666667
2009021039,5,1759,0.0,5,5,0,0,0,100.0
2009021039,5,1817,0.0,13,9,0,1,4,69.23076923
2009021039,1,3600,0.0,26,24,3,0,2,92.30769231
2009021040,20,3600,0.0,34,32,2,2,2,94.11764706
2009021040,21,3507,0.0,34,31,6,2,3,91.17647059
2009021041,16,3553,0.0,35,32,5,0,3,91.42857143
2009021041,24,3600,0.0,41,39,4,0,2,95.12195122
2009021042,5,3600,0.0,17,17,4,0,0,100.0
2009021042,6,3600,0.0,31,28,9,2,3,90.32258065
2009021043,19,3600,0.0,29,26,5,0,3,89.65517241
2009021043,3,3523,0.0,16,12,1,1,4,75.0
2009021044,15,3750,0.0,29,25,4,0,4,86.20689655
2009021044,12,3842,0.0,28,25,2,1,3,89.28571429
2009021045,9,3563,0.0,27,21,3,1,6,77.77777778
2009021045,11,3582,0.0,39,36,7,4,3,92.30769231
2009021046,1,3895,0.0,26,25,7,0,1,96.15384615
2009021046,10,3896,0.0,25,24,6,0,1,96.0
2009021047,7,3597,0.0,25,23,3,3,2,92.0
2009021047,14,3516,0.0,27,22,6,0,5,81.48148148
2009021048,27,3883,0.0,24,21,5,1,3,87.5
2009021048,13,3893,0.0,46,43,4,0,3,93.47826087
2009021049,30,1200,0.0,11,10,0,1,1,90.90909091
2009021049,30,2400,0.0,26,22,2,1,4,84.61538462
2009021049,18,3600,0.0,17,17,0,0,0,100.0
2009021050,4,3600,0.0,29,27,7,0,2,93.10344828
2009021050,25,3522,0.0,31,28,2,0,3,90.32258065
2009021051,28,3534,0.0,26,23,4,1,3,88.46153846
2009021051,23,3600,0.0,34,32,5,0,2,94.11764706
2009021052,16,3584,0.0,17,17,0,1,0,100.0
2009021052,26,3600,0.0,37,34,10,0,3,91.89189189
2009021053,30,3593,0.0,32,28,4,0,4,87.5
2009021053,29,3579,0.0,20,18,4,0,2,90.0
2009021054,28,3496,0.0,24,20,1,0,4,83.33333333
2009021054,20,3596,0.0,28,25,3,1,3,89.28571429
2009021055,17,3819,0.0,24,22,0,0,2,91.66666667
2009021055,22,3900,0.0,33,31,1,0,2,93.93939394
2009021056,2,3614,0.0,39,34,2,0,5,87.17948718
2009021056,24,1362,0.0,17,14,0,0,3,82.35294118
2009021056,24,2226,0.0,14,13,1,0,1,92.85714286
2009021057,12,1652,0.0,8,8,0,0,0,100.0
2009021057,12,2247,0.0,17,15,1,1,2,88.23529412
2009021057,5,3895,0.0,29,26,8,0,3,89.65517241
2009021058,9,843,0.0,6,6,4,0,0,100.0
2009021058,9,2673,0.0,19,14,3,0,5,73.68421053
2009021058,25,3600,0.0,29,25,3,1,4,86.20689655
2009021059,8,3900,0.0,33,31,1,2,2,93.93939394
2009021059,10,3900,0.0,27,25,8,0,2,92.59259259
2009021060,19,3594,0.0,29,29,8,1,0,100.0
2009021060,1,3534,2.0,20,19,1,0,1,95.0
2009021061,4,3600,0.0,28,23,2,0,5,82.14285714
2009021061,11,3591,0.0,27,25,4,0,2,92.59259259
2009021062,7,3600,0.0,32,31,9,1,1,96.875
2009021062,13,1374,0.0,19,17,9,0,2,89.47368421
2009021062,13,2143,0.0,17,16,1,3,1,94.11764706
2009021063,15,3568,0.0,34,33,12,2,1,97.05882353
2009021063,14,3589,0.0,28,25,5,0,3,89.28571429
2009021064,29,3714,0.0,31,30,4,0,1,96.77419355
2009021064,18,3714,0.0,33,33,3,0,0,100.0
2009021065,16,3900,0.0,35,31,8,0,4,88.57142857
2009021065,27,3900,0.0,38,34,4,1,4,89.47368421
2009021066,17,3899,0.0,32,29,3,1,3,90.625
2009021066,23,3899,0.0,54,50,6,0,4,92.59259259
2009021067,2,3532,0.0,26,25,5,3,1,96.15384615
2009021067,26,3596,0.0,26,26,5,0,0,100.0
2009021068,3,3533,0.0,31,29,2,0,2,93.5483871
2009021068,6,3600,0.0,24,23,4,0,1,95.83333333
2009021069,20,1385,0.0,12,9,0,0,3,75.0
2009021069,20,2142,0.0,9,8,0,0,1,88.88888889
2009021069,30,3600,0.0,32,29,0,0,3,90.625
2009021070,7,3600,0.0,30,27,9,1,3,90.0
2009021070,12,1676,0.0,6,5,0,1,1,83.33333333
2009021070,12,1723,0.0,14,10,1,0,4,71.42857143
2009021071,14,3600,0.0,40,35,13,0,5,87.5
2009021071,13,3583,0.0,31,29,4,1,2,93.5483871
2009021072,18,3591,0.0,25,23,6,0,2,92.0
2009021072,19,3524,0.0,39,36,6,1,3,92.30769231
2009021073,11,3585,0.0,45,44,11,1,1,97.77777778
2009021073,4,3484,0.0,31,28,7,0,3,90.32258065
2009021074,27,3900,0.0,32,30,2,1,2,93.75
2009021074,25,3900,0.0,35,33,3,0,2,94.28571429
2009021075,28,3599,0.0,25,20,1,0,5,80.0
2009021075,22,3600,0.0,28,27,4,0,1,96.42857143
2009021076,21,1965,0.0,19,15,6,0,4,78.94736842
2009021076,21,1635,0.0,14,13,2,0,1,92.85714286
2009021076,24,3588,0.0,28,26,6,1,2,92.85714286
2009021077,5,3565,0.0,33,30,8,1,3,90.90909091
2009021077,17,3600,2.0,27,26,2,0,1,96.2962963
2009021078,9,3600,0.0,29,29,8,0,0,100.0
2009021078,8,3554,0.0,27,25,1,2,2,92.59259259
2009021079,21,3772,2.0,23,19,0,1,4,82.60869565
2009021079,26,3820,0.0,21,18,5,0,3,85.71428571
2009021080,13,3576,0.0,43,42,12,0,1,97.6744186
2009021080,10,3536,0.0,28,25,4,0,3,89.28571429
2009021081,29,3600,0.0,30,24,5,0,6,80.0
2009021081,1,3600,0.0,22,19,2,1,3,86.36363636
2009021082,6,3600,0.0,27,27,2,0,0,100.0
2009021082,11,3586,0.0,33,29,4,0,4,87.87878788
2009021083,4,3475,0.0,26,24,8,0,2,92.30769231
2009021083,9,3600,0.0,26,26,8,2,0,100.0
2009021084,12,3629,0.0,27,24,4,0,3,88.88888889
2009021084,14,3629,0.0,29,27,0,1,2,93.10344828
2009021085,25,3600,0.0,35,34,4,1,1,97.14285714
2009021085,18,3513,0.0,14,11,1,1,3,78.57142857
2009021086,28,3600,0.0,19,18,3,1,1,94.73684211
2009021086,30,3580,0.0,16,13,5,1,3,81.25
2009021087,27,3495,0.0,32,30,5,0,2,93.75
2009021087,16,3595,0.0,28,28,8,0,0,100.0
2009021088,24,3497,0.0,28,25,1,0,3,89.28571429
2009021088,20,3590,0.0,23,22,0,0,1,95.65217391
2009021089,23,3541,0.0,22,19,3,2,3,86.36363636
2009021089,22,3597,0.0,33,31,3,0,2,93.93939394
2009021090,2,3578,0.0,44,39,10,0,5,88.63636364
2009021090,3,3600,0.0,27,27,4,1,0,100.0
2009021091,5,3897,0.0,32,29,1,1,3,90.625
2009021091,15,3900,0.0,42,39,9,1,3,92.85714286
2009021092,8,3884,2.0,42,40,13,0,2,95.23809524
2009021092,7,3743,0.0,28,26,6,2,2,92.85714286
2009021093,19,3558,0.0,23,20,2,1,3,86.95652174
2009021093,17,3600,0.0,32,30,4,0,2,93.75
2009021094,26,1088,0.0,16,13,8,0,3,81.25
2009021094,26,2804,0.0,14,14,3,0,0,100.0
2009021094,21,3880,0.0,30,27,4,0,3,90.0
2009021095,24,3546,0.0,29,26,3,1,3,89.65517241
2009021095,23,3600,0.0,31,30,6,0,1,96.77419355
2009021096,14,3600,0.0,50,47,7,1,3,94.0
2009021096,6,3473,0.0,18,13,2,1,5,72.22222222
2009021097,3,3815,0.0,38,35,6,2,3,92.10526316
2009021097,1,3900,0.0,31,28,2,0,3,90.32258065
2009021098,20,3485,0.0,22,19,1,2,3,86.36363636
2009021098,2,3599,0.0,23,21,6,0,2,91.30434783
2009021099,30,3753,0.0,35,32,5,0,3,91.42857143
2009021099,4,3753,0.0,21,17,2,0,4,80.95238095
2009021100,15,3900,0.0,31,29,5,0,2,93.5483871
2009021100,12,3896,0.0,43,41,3,0,2,95.34883721
2009021101,10,3639,0.0,20,19,0,0,1,95.0
2009021101,11,3639,0.0,30,28,3,0,2,93.33333333
2009021102,16,343,0.0,5,4,1,0,1,80.0
2009021102,16,3253,0.0,27,20,1,1,7,74.07407407
2009021102,29,3600,0.0,41,38,6,0,3,92.68292683
2009021103,13,3479,0.0,29,27,4,1,2,93.10344828
2009021103,8,3590,0.0,24,23,5,1,1,95.83333333
2009021104,26,3526,0.0,25,22,5,1,3,88.0
2009021104,19,3598,0.0,31,30,4,0,1,96.77419355
2009021105,27,3900,0.0,31,28,0,0,3,90.32258065
2009021105,18,3900,0.0,35,32,4,0,3,91.42857143
2009021106,25,3591,0.0,41,38,13,1,3,92.68292683
2009021106,28,3600,0.0,27,27,4,0,0,100.0
2009021107,9,3594,0.0,43,41,8,1,2,95.34883721
2009021107,7,3485,0.0,30,27,3,3,3,90.0
2009021108,30,2400,0.0,32,28,7,3,4,87.5
2009021108,30,1200,0.0,10,8,1,0,2,80.0
2009021108,17,3581,0.0,27,25,5,3,2,92.59259259
2009021109,24,3596,0.0,36,34,12,0,2,94.44444444
2009021109,22,3488,2.0,40,37,5,3,3,92.5
2009021110,20,849,0.0,6,6,0,0,0,100.0
2009021110,20,2751,0.0,29,24,5,0,5,82.75862069
2009021110,6,3600,0.0,31,31,4,1,0,100.0
2009021111,4,1200,0.0,7,5,1,1,2,71.42857143
2009021111,4,2400,0.0,24,22,3,1,2,91.66666667
2009021111,5,3560,0.0,27,26,4,0,1,96.2962963
2009021112,14,532,0.0,6,3,0,0,3,50.0
2009021112,14,3060,0.0,20,16,0,0,4,80.0
2009021112,7,3592,0.0,23,22,1,1,1,95.65217391
2009021113,3,3639,0.0,32,29,2,0,3,90.625
2009021113,10,3639,0.0,38,36,2,1,2,94.73684211
2009021114,1,3600,0.0,27,25,5,0,2,92.59259259
2009021114,8,3560,0.0,25,22,2,2,3,88.0
2009021115,13,3524,0.0,25,22,1,0,3,88.0
2009021115,9,3600,0.0,22,20,2,0,2,90.90909091
2009021116,11,3600,0.0,34,34,1,0,0,100.0
2009021116,12,3542,0.0,43,39,9,1,4,90.69767442
2009021117,2,3778,0.0,37,34,8,0,3,91.89189189
2009021117,29,3771,0.0,28,24,0,0,4,85.71428571
2009021118,17,3900,0.0,33,33,4,0,0,100.0
2009021118,18,3900,0.0,38,38,3,2,0,100.0
2009021119,21,3502,0.0,31,26,1,2,5,83.87096774
2009021119,27,3600,0.0,29,27,3,1,2,93.10344828
2009021120,23,3542,0.0,29,26,1,0,3,89.65517241
2009021120,28,3600,0.0,37,35,3,1,2,94.59459459
2009021121,25,3600,0.0,30,29,7,1,1,96.66666667
2009021121,26,3600,0.0,26,22,7,0,4,84.61538462
2009021122,20,3600,0.0,34,31,4,0,3,91.17647059
2009021122,15,2852,0.0,12,10,0,0,2,83.33333333
2009021122,15,634,0.0,10,7,2,0,3,70.0
2009021123,10,3896,0.0,45,41,8,0,4,91.11111111
2009021123,5,3889,2.0,29,25,9,0,4,86.20689655
2009021124,22,3507,0.0,31,29,9,0,2,93.5483871
2009021124,19,3600,0.0,24,23,1,4,1,95.83333333
2009021125,1,2400,0.0,19,15,0,0,4,78.94736842
2009021125,1,1200,0.0,6,5,1,0,1,83.33333333
2009021125,4,3586,0.0,33,32,9,1,1,96.96969697
2009021126,29,3570,0.0,35,33,9,0,2,94.28571429
2009021126,16,3536,0.0,19,16,3,1,3,84.21052632
2009021127,21,3488,0.0,32,28,1,0,4,87.5
2009021127,28,3600,0.0,45,42,7,0,3,93.33333333
2009021128,7,3600,0.0,42,40,3,1,2,95.23809524
2009021128,6,1966,0.0,19,19,2,1,0,100.0
2009021128,6,1568,0.0,14,11,0,0,3,78.57142857
2009021129,12,3600,0.0,27,26,2,2,1,96.2962963
2009021129,11,3554,0.0,21,18,4,0,3,85.71428571
2009021130,18,3660,0.0,29,27,7,1,2,93.10344828
2009021130,13,3646,0.0,25,22,0,0,3,88.0
2009021131,26,3517,0.0,20,17,2,1,3,85.0
2009021131,30,3584,0.0,31,29,6,0,2,93.5483871
2009021132,25,3502,0.0,46,43,8,0,3,93.47826087
2009021132,24,3600,0.0,31,30,4,0,1,96.77419355
2009021133,11,3599,0.0,29,27,0,1,2,93.10344828
2009021133,10,3528,0.0,25,22,3,0,3,88.0
2009021134,6,3881,0.0,21,21,2,0,0,100.0
2009021134,1,3881,0.0,34,33,1,0,1,97.05882353
2009021135,3,3600,0.0,28,25,3,0,3,89.28571429
2009021135,2,3544,0.0,27,23,1,0,4,85.18518519
2009021136,9,3881,0.0,21,17,4,0,4,80.95238095
2009021136,15,3873,0.0,31,26,2,1,5,83.87096774
2009021137,14,3493,0.0,25,22,10,0,3,88.0
2009021137,29,3590,0.0,18,16,6,0,2,88.88888889
2009021138,22,3544,0.0,44,39,6,1,5,88.63636364
2009021138,17,3598,0.0,26,22,4,1,4,84.61538462
2009021139,16,3498,0.0,30,26,1,0,4,86.66666667
2009021139,19,3600,0.0,34,32,5,1,2,94.11764706
2009021140,26,3600,0.0,34,34,3,1,0,100.0
2009021140,18,3489,0.0,31,29,3,0,2,93.5483871
2009021141,27,3600,0.0,29,25,9,2,4,86.20689655
2009021141,23,3600,0.0,33,32,8,1,1,96.96969697
2009021142,13,3598,0.0,41,35,1,0,6,85.36585366
2009021142,7,3600,0.0,15,13,3,0,2,86.66666667
2009021143,12,3594,0.0,35,34,6,0,1,97.14285714
2009021143,8,3545,0.0,27,25,5,2,2,92.59259259
2009021144,14,3600,2.0,27,27,6,2,0,100.0
2009021144,5,3507,0.0,17,15,2,1,2,88.23529412
2009021145,16,3600,0.0,21,21,4,0,0,100.0
2009021145,30,3600,0.0,35,31,3,0,4,88.57142857
2009021146,28,1200,0.0,8,8,3,0,0,100.0
2009021146,28,2400,0.0,21,16,3,1,5,76.19047619
2009021146,25,3577,0.0,30,29,12,1,1,96.66666667
2009021147,24,3600,0.0,29,27,2,0,2,93.10344828
2009021147,21,3600,0.0,27,22,2,0,5,81.48148148
2009021148,27,3516,0.0,31,29,10,1,2,93.5483871
2009021148,20,3600,0.0,30,29,3,0,1,96.66666667
2009021149,13,3594,0.0,36,36,7,1,0,100.0
2009021149,6,3537,0.0,20,19,1,0,1,95.0
2009021150,7,3522,0.0,33,30,8,0,3,90.90909091
2009021150,10,3600,0.0,24,22,2,0,2,91.66666667
2009021151,4,2550,0.0,24,19,5,0,5,79.16666667
2009021151,4,1004,0.0,4,3,1,0,1,75.0
2009021151,2,3600,0.0,35,31,2,1,4,88.57142857
2009021152,11,3542,0.0,24,22,0,1,2,91.66666667
2009021152,15,3600,0.0,20,19,2,0,1,95.0
2009021153,12,3900,0.0,35,32,2,0,3,91.42857143
2009021153,9,3833,0.0,31,28,1,1,3,90.32258065
2009021154,29,3505,0.0,32,29,7,0,3,90.625
2009021154,17,3600,0.0,22,20,2,1,2,90.90909091
2009021155,19,3528,0.0,32,29,12,0,3,90.625
2009021155,18,3600,0.0,33,31,6,0,2,93.93939394
2009021156,23,3599,0.0,29,21,4,0,8,72.4137931
2009021156,26,3600,0.0,30,27,2,1,3,90.0
2009021157,16,3857,0.0,33,32,0,0,1,96.96969697
2009021157,1,3900,0.0,26,25,0,0,1,96.15384615
2009021158,8,3600,0.0,35,35,3,0,0,100.0
2009021158,4,3509,0.0,23,22,1,1,1,95.65217391
2009021159,3,3600,0.0,30,30,6,1,0,100.0
2009021159,14,2400,0.0,15,14,3,1,1,93.33333333
2009021159,14,1200,0.0,7,3,1,0,4,42.85714286
2009021160,28,3600,0.0,29,27,7,4,2,93.10344828
2009021160,30,3520,0.0,28,25,2,1,3,89.28571429
2009021161,22,3580,0.0,35,29,5,0,6,82.85714286
2009021161,25,3600,0.0,28,25,10,1,3,89.28571429
2009021162,20,3600,0.0,36,35,2,0,1,97.22222222
2009021162,21,3562,0.0,27,25,3,2,2,92.59259259
2009021163,23,3894,2.0,34,30,13,0,4,88.23529412
2009021163,24,3873,0.0,40,36,8,0,4,90.0
2009021164,11,3760,0.0,35,31,2,1,4,88.57142857
2009021164,5,3749,2.0,24,21,9,0,3,87.5
2009021165,9,3600,0.0,33,29,3,2,4,87.87878788
2009021165,2,3600,0.0,29,28,8,3,1,96.55172414
2009021166,18,3616,0.0,31,28,4,0,3,90.32258065
2009021166,17,3571,0.0,24,20,2,1,4,83.33333333
2009021167,6,3805,0.0,28,27,3,0,1,96.42857143
2009021167,10,3801,0.0,30,28,4,1,2,93.33333333
2009021168,7,3600,0.0,38,35,13,2,3,92.10526316
2009021168,8,3600,0.0,29,29,6,2,0,100.0
2009021169,1,3600,0.0,26,26,2,0,0,100.0
2009021169,12,3536,0.0,28,25,2,0,3,89.28571429
2009021170,3,3600,0.0,20,19,6,0,1,95.0
2009021170,13,3549,0.0,26,23,0,0,3,88.46153846
2009021171,15,3595,0.0,36,34,3,2,2,94.44444444
2009021171,29,2900,0.0,23,22,8,1,1,95.65217391
2009021171,29,649,0.0,4,2,0,0,2,50.0
2009021172,25,3515,0.0,23,21,3,0,2,91.30434783
2009021172,19,3597,0.0,25,24,7,0,1,96.0
2009021173,22,3900,0.0,44,42,19,0,2,95.45454545
2009021173,27,3831,0.0,27,25,4,2,2,92.59259259
2009021174,24,3859,0.0,29,28,5,0,1,96.55172414
2009021174,26,3899,0.0,33,32,4,0,1,96.96969697
2009021175,17,3559,0.0,25,21,4,1,4,84.0
2009021175,4,3600,0.0,34,31,3,0,3,91.17647059
2009021176,20,3513,0.0,31,27,6,0,4,87.09677419
2009021176,16,3600,0.0,26,25,2,0,1,96.15384615
2009021177,28,3766,0.0,40,35,10,1,5,87.5
2009021177,21,3713,0.0,22,18,3,0,4,81.81818182
2009021178,30,3697,0.0,39,36,7,5,3,92.30769231
2009021178,23,3735,0.0,27,24,12,2,3,88.88888889
2009021179,6,3644,0.0,30,27,1,0,3,90.0
2009021179,15,3644,0.0,30,28,3,0,2,93.33333333
2009021180,29,3831,0.0,34,32,10,0,2,94.11764706
2009021180,19,3817,0.0,28,27,10,2,1,96.42857143
2009021181,30,3574,0.0,31,27,5,2,4,87.09677419
2009021181,22,3600,0.0,26,25,3,1,1,96.15384615
2009021182,3,1517,0.0,16,13,2,2,3,81.25
2009021182,3,2083,0.0,14,12,1,0,2,85.71428571
2009021182,7,3596,2.0,32,30,3,2,2,93.75
2009021183,4,3591,0.0,23,23,5,1,0,100.0
2009021183,10,3539,0.0,22,21,7,0,1,95.45454545
2009021184,8,3900,0.0,42,39,7,0,3,92.85714286
2009021184,2,3897,0.0,31,28,3,0,3,90.32258065
2009021185,1,3600,0.0,19,19,0,1,0,100.0
2009021185,11,3497,0.0,27,24,4,0,3,88.88888889
2009021186,15,3600,0.0,29,26,2,0,3,89.65517241
2009021186,5,1907,0.0,15,13,0,0,2,86.66666667
2009021186,5,1571,0.0,12,9,0,0,3,75.0
2009021187,12,2090,0.0,26,23,2,0,3,88.46153846
2009021187,12,1509,0.0,11,9,2,0,2,81.81818182
2009021187,14,1200,0.0,23,18,2,1,5,78.26086957
2009021187,14,2310,0.0,17,15,6,0,2,88.23529412
2009021188,9,3592,0.0,34,32,3,0,2,94.11764706
2009021188,13,3600,0.0,28,23,3,2,5,82.14285714
2009021189,16,3600,0.0,28,26,7,1,2,92.85714286
2009021189,25,3600,0.0,38,33,2,1,5,86.84210526
2009021190,28,3600,0.0,39,38,3,1,1,97.43589744
2009021190,20,3531,0.0,26,24,6,0,2,92.30769231
2009021191,21,3887,0.0,32,29,0,0,3,90.625
2009021191,23,3900,0.0,31,28,0,0,3,90.32258065
2009021192,26,1369,0.0,8,5,0,0,3,62.5
2009021192,26,2530,0.0,13,12,0,1,1,92.30769231
2009021192,24,3900,0.0,40,36,4,3,4,90.0
2009021193,10,3600,0.0,32,27,6,2,5,84.375
2009021193,3,3600,0.0,27,26,6,1,1,96.2962963
2009021194,29,3543,0.0,35,31,9,0,4,88.57142857
2009021194,17,3581,0.0,24,21,3,0,3,87.5
2009021195,19,463,0.0,4,1,0,0,3,25.0
2009021195,19,3065,0.0,22,19,4,2,3,86.36363636
2009021195,16,3593,0.0,31,26,7,1,5,83.87096774
2009021196,21,3830,0.0,45,40,0,1,5,88.88888889
2009021196,22,3830,0.0,35,31,3,0,4,88.57142857
2009021197,18,3517,0.0,29,25,7,0,4,86.20689655
2009021197,27,3593,0.0,25,23,4,1,2,92.0
2009021198,7,3545,0.0,34,31,6,1,3,91.17647059
2009021198,6,3600,0.0,32,31,5,1,1,96.875
2009021199,8,3561,0.0,32,28,1,2,4,87.5
2009021199,12,3600,0.0,32,30,5,0,2,93.75
2009021200,2,2399,0.0,25,22,4,1,3,88.0
2009021200,2,1200,0.0,10,6,2,0,4,60.0
2009021200,5,3600,2.0,35,32,9,3,3,91.42857143
2009021201,9,3878,0.0,29,26,8,0,3,89.65517241
2009021201,14,3899,4.0,38,35,15,1,3,92.10526316
2009021202,1,3540,0.0,18,15,3,1,3,83.33333333
2009021202,13,3600,0.0,44,42,3,0,2,95.45454545
2009021203,24,3900,0.0,51,49,11,1,2,96.07843137
2009021203,25,3900,0.0,19,17,2,0,2,89.47368421
2009021204,30,1347,0.0,5,5,2,0,0,100.0
2009021204,30,2523,0.0,28,27,8,1,1,96.42857143
2009021204,20,3894,0.0,24,23,3,1,1,95.83333333
2009021205,27,3900,0.0,24,22,0,1,2,91.66666667
2009021205,26,3900,0.0,27,25,3,0,2,92.59259259
2009021206,23,3560,0.0,31,27,10,1,4,87.09677419
2009021206,28,3584,0.0,32,30,6,1,2,93.75
2009021207,4,3514,0.0,25,21,1,0,4,84.0
2009021207,3,3600,0.0,27,24,2,1,3,88.88888889
2009021208,11,3596,0.0,47,42,11,0,5,89.36170213
2009021208,15,3600,0.0,31,29,5,0,2,93.5483871
2009021209,17,3900,0.0,22,22,4,0,0,100.0
2009021209,29,3871,0.0,45,45,7,0,0,100.0
2009021210,24,3576,0.0,48,42,8,1,6,87.5
2009021210,19,3600,0.0,26,23,2,2,3,88.46153846
2009021211,16,3600,0.0,32,30,5,0,2,93.75
2009021211,21,3562,0.0,36,32,4,1,4,88.88888889
2009021212,12,3580,0.0,41,38,7,2,3,92.68292683
2009021212,6,3592,0.0,35,33,2,2,2,94.28571429
2009021213,22,3900,0.0,55,52,14,1,3,94.54545455
2009021213,26,3875,0.0,16,13,1,2,3,81.25
2009021214,10,3726,0.0,37,34,8,0,3,91.89189189
2009021214,8,3726,0.0,28,24,1,1,4,85.71428571
2009021215,7,3600,0.0,30,28,7,3,2,93.33333333
2009021215,9,3588,0.0,28,23,6,1,5,82.14285714
2009021216,2,3600,0.0,37,30,13,0,7,81.08108108
2009021216,1,3598,0.0,19,18,2,0,1,94.73684211
2009021217,5,3559,0.0,22,21,5,1,1,95.45454545
2009021217,11,3600,0.0,33,33,6,3,0,100.0
2009021218,13,3887,0.0,37,34,9,0,3,91.89189189
2009021218,14,3885,0.0,32,29,6,0,3,90.625
2009021219,19,3900,0.0,36,35,7,0,1,97.22222222
2009021219,18,3900,0.0,34,33,0,2,1,97.05882353
2009021220,25,3900,0.0,27,24,1,0,3,88.88888889
2009021220,30,3900,0.0,26,23,4,0,3,88.46153846
2009021221,20,973,0.0,8,7,2,0,1,87.5
2009021221,20,2627,0.0,21,15,3,0,6,71.42857143
2009021221,23,3600,0.0,41,38,2,3,3,92.68292683
2009021222,27,3900,2.0,30,28,3,0,2,93.33333333
2009021222,28,3900,0.0,29,27,0,0,2,93.10344828
2009021223,3,3900,0.0,47,46,9,0,1,97.87234043
2009021223,4,3899,0.0,25,24,2,1,1,96.0
2009021224,6,3900,4.0,37,34,6,0,3,91.89189189
2009021224,15,3900,0.0,38,35,3,1,3,92.10526316
2009021225,17,3791,0.0,29,27,5,0,2,93.10344828
2009021225,16,3757,0.0,21,18,3,0,3,85.71428571
2009021226,26,3683,0.0,32,31,3,0,1,96.875
2009021226,21,3691,0.0,33,31,2,0,2,93.93939394
2009021227,7,3600,0.0,34,32,4,1,2,94.11764706
2009021227,1,3600,0.0,23,22,1,1,1,95.65217391
2009021228,5,3862,0.0,38,33,12,0,5,86.84210526
2009021228,2,3854,0.0,37,31,6,1,6,83.78378378
2009021229,14,3596,0.0,31,30,6,1,1,96.77419355
2009021229,13,3557,0.0,30,28,7,0,2,93.33333333
2009021230,22,3600,0.0,45,38,5,0,7,84.44444444
2009021230,24,2089,0.0,19,18,1,0,1,94.73684211
2009021230,24,1506,0.0,12,11,2,1,1,91.66666667
2010020001,8,3539,0.0,24,21,2,0,3,87.5
2010020001,10,3529,0.0,28,26,3,2,2,92.85714286
2010020002,4,3600,0.0,31,29,3,1,2,93.5483871
2010020002,5,3527,0.0,27,24,3,1,3,88.88888889
2010020003,12,3600,0.0,29,26,7,0,3,89.65517241
2010020003,30,3525,0.0,31,27,1,1,4,87.09677419
2010020004,16,3809,0.0,41,37,5,1,4,90.24390244
2010020004,21,3810,0.0,38,35,8,1,3,92.10526316
2010020005,20,3587,0.0,33,29,10,0,4,87.87878788
2010020005,22,3600,0.0,37,37,8,2,0,100.0
2010020006,28,3600,0.0,32,30,15,1,2,93.75
2010020006,29,3478,0.0,28,25,15,2,3,89.28571429
2010020007,25,3693,0.0,30,27,0,1,3,90.0
2010020007,1,3696,0.0,28,24,1,0,4,85.71428571
2010020008,30,3882,0.0,37,36,7,0,1,97.2972973
2010020008,12,3900,0.0,42,41,8,0,1,97.61904762
2010020009,24,3600,0.0,43,39,16,0,4,90.69767442
2010020009,17,3573,0.0,21,21,1,1,0,100.0
2010020010,7,3590,0.0,26,25,8,0,1,96.15384615
2010020010,9,3522,0.0,36,34,11,0,2,94.44444444
2010020011,15,3550,0.0,31,27,3,1,4,87.09677419
2010020011,11,145,0.0,0,0,0,0,0,
2010020011,11,3455,0.0,31,29,5,1,2,93.5483871
2010020012,27,3600,0.0,42,40,6,0,2,95.23809524
2010020012,6,3587,0.0,36,32,4,4,4,88.88888889
2010020013,3,3600,0.0,36,33,2,2,3,91.66666667
2010020013,7,3493,0.0,27,22,0,4,5,81.48148148
2010020014,9,3595,0.0,38,33,12,1,5,86.84210526
2010020014,10,3600,0.0,18,17,1,0,1,94.44444444
2010020015,25,3894,0.0,47,43,13,2,4,91.4893617
2010020015,2,3900,0.0,22,18,9,0,4,81.81818182
2010020016,8,3600,0.0,38,36,6,0,2,94.73684211
2010020016,5,3519,0.0,27,24,7,0,3,88.88888889
2010020017,1,2400,0.0,20,15,1,0,5,75.0
2010020017,1,1200,0.0,9,7,3,0,2,77.77777778
2010020017,15,3598,0.0,33,31,5,3,2,93.93939394
2010020018,11,3511,0.0,36,31,3,2,5,86.11111111
2010020018,14,3600,0.0,30,27,5,1,3,90.0
2010020019,4,3707,0.0,25,23,4,1,2,92.0
2010020019,19,3666,0.0,30,29,1,3,1,96.66666667
2010020020,24,3600,0.0,49,45,15,0,4,91.83673469
2010020020,18,2556,0.0,30,29,11,0,1,96.66666667
2010020020,18,1042,0.0,7,7,0,0,0,100.0
2010020021,17,3579,0.0,28,26,4,1,2,92.85714286
2010020021,16,3550,0.0,26,23,3,2,3,88.46153846
2010020022,29,3716,0.0,35,33,15,1,2,94.28571429
2010020022,28,3683,0.0,25,22,3,0,3,88.0
2010020023,26,3900,0.0,24,23,5,2,1,95.83333333
2010020023,23,3900,0.0,32,31,14,1,1,96.875
2010020024,6,3596,0.0,29,29,2,2,0,100.0
2010020024,27,3600,0.0,37,34,12,0,3,91.89189189
2010020025,26,3573,0.0,31,29,5,0,2,93.5483871
2010020025,20,3594,0.0,22,21,1,2,1,95.45454545
2010020026,13,3544,0.0,13,10,0,1,3,76.92307692
2010020026,22,3600,0.0,28,26,3,0,2,92.85714286
2010020027,5,3597,0.0,31,30,6,2,1,96.77419355
2010020027,1,3530,0.0,30,28,5,1,2,93.33333333
2010020028,3,3545,0.0,31,26,4,0,5,83.87096774
2010020028,2,3600,0.0,33,29,4,1,4,87.87878788
2010020029,24,2151,0.0,34,30,10,0,4,88.23529412
2010020029,24,1449,0.0,19,18,10,1,1,94.73684211
2010020029,19,3600,0.0,14,13,5,0,1,92.85714286
2010020030,16,3594,0.0,35,32,7,0,3,91.42857143
2010020030,7,3513,0.0,30,26,5,2,4,86.66666667
2010020031,21,3503,2.0,37,34,6,1,3,91.89189189
2010020031,4,3600,0.0,27,25,1,1,2,92.59259259
2010020032,9,3868,0.0,26,23,9,3,3,88.46153846
2010020032,15,3848,0.0,31,29,6,1,2,93.5483871
2010020033,13,3528,0.0,35,33,0,0,2,94.28571429
2010020033,23,3600,0.0,42,41,5,0,1,97.61904762
2010020034,21,3899,0.0,28,24,0,0,4,85.71428571
2010020034,17,3879,0.0,38,34,7,0,4,89.47368421
2010020035,11,3560,0.0,34,32,1,0,2,94.11764706
2010020035,26,3585,0.0,32,31,4,0,1,96.875
2010020036,1,3620,0.0,24,24,2,0,0,100.0
2010020036,7,3653,0.0,35,34,6,0,1,97.14285714
2010020037,2,3531,0.0,26,24,6,0,2,92.30769231
2010020037,15,3600,0.0,24,23,1,0,1,95.83333333
2010020038,14,3838,0.0,27,24,1,0,3,88.88888889
2010020038,8,3849,0.0,48,44,6,3,4,91.66666667
2010020039,10,3600,0.0,25,22,1,0,3,88.0
2010020039,5,3519,0.0,14,10,1,0,4,71.42857143
2010020040,18,3600,0.0,25,23,1,0,2,92.0
2010020040,16,3540,0.0,27,24,2,0,3,88.88888889
2010020041,23,3537,0.0,32,28,4,0,4,87.5
2010020041,24,3600,0.0,39,36,0,4,3,92.30769231
2010020042,14,3595,0.0,26,24,3,2,2,92.30769231
2010020042,4,3508,0.0,24,21,7,0,3,87.5
2010020043,12,3524,0.0,39,36,4,0,3,92.30769231
2010020043,9,3474,0.0,21,19,2,2,2,90.47619048
2010020043,9,126,0.0,3,3,0,0,0,100.0
2010020044,19,3535,0.0,22,18,1,0,4,81.81818182
2010020044,18,3600,0.0,35,32,2,0,3,91.42857143
2010020045,22,3486,0.0,24,20,6,0,4,83.33333333
2010020045,30,3600,0.0,26,24,9,0,2,92.30769231
2010020046,17,3590,0.0,15,11,2,1,4,73.33333333
2010020046,25,3600,0.0,26,25,6,0,1,96.15384615
2010020047,13,3597,0.0,27,27,4,1,0,100.0
2010020047,20,3594,0.0,18,15,5,0,3,83.33333333
2010020048,21,3600,0.0,43,41,10,2,2,95.34883721
2010020048,1,3549,0.0,22,19,3,0,3,86.36363636
2010020049,10,3788,0.0,24,21,7,0,3,87.5
2010020049,3,3787,0.0,38,34,5,1,4,89.47368421
2010020050,2,3711,0.0,29,26,11,0,3,89.65517241
2010020050,5,3703,0.0,24,22,3,1,2,91.66666667
2010020051,16,3600,0.0,32,30,6,1,2,93.75
2010020051,29,3547,0.0,40,35,5,1,5,87.5
2010020052,8,3600,0.0,23,22,0,1,1,95.65217391
2010020052,7,3584,0.0,28,26,9,0,2,92.85714286
2010020053,11,3887,0.0,41,37,11,1,4,90.24390244
2010020053,24,3900,0.0,33,29,3,1,4,87.87878788
2010020054,23,3600,0.0,19,15,1,1,4,78.94736842
2010020054,26,3598,0.0,26,25,2,2,1,96.15384615
2010020055,9,3260,0.0,37,33,13,1,4,89.18918919
2010020055,9,282,0.0,3,3,0,0,0,100.0
2010020055,8,3600,0.0,19,16,4,0,3,84.21052632
2010020056,6,3579,0.0,32,31,7,0,1,96.875
2010020056,1,3600,0.0,35,31,4,1,4,88.57142857
2010020057,21,3550,0.0,24,20,5,4,4,83.33333333
2010020057,2,3600,0.0,30,28,3,2,2,93.33333333
2010020058,5,3592,0.0,30,29,8,4,1,96.66666667
2010020058,4,3578,0.0,31,27,10,3,4,87.09677419
2010020059,14,2687,0.0,23,20,5,0,3,86.95652174
2010020059,14,913,0.0,15,12,0,0,3,80.0
2010020059,13,3592,0.0,29,29,4,0,0,100.0
2010020060,15,3704,0.0,39,37,12,2,2,94.87179487
2010020060,18,3684,0.0,34,31,5,1,3,91.17647059
2010020061,29,3600,0.0,23,21,3,1,2,91.30434783
2010020061,30,3518,0.0,25,22,2,0,3,88.0
2010020062,19,3898,0.0,25,23,5,1,2,92.0
2010020062,25,3877,0.0,43,41,9,0,2,95.34883721
2010020063,7,3520,0.0,21,17,2,0,4,80.95238095
2010020063,16,3593,0.0,41,38,15,1,3,92.68292683
2010020064,17,3869,0.0,26,25,4,1,1,96.15384615
2010020064,27,3868,0.0,33,31,11,1,2,93.93939394
2010020065,22,3550,0.0,45,41,9,1,4,91.11111111
2010020065,20,3600,0.0,30,27,2,1,3,90.0
2010020066,11,3600,0.0,39,37,6,3,2,94.87179487
2010020066,28,3482,0.0,28,24,0,1,4,85.71428571
2010020067,27,3532,0.0,35,32,2,0,3,91.42857143
2010020067,24,3600,0.0,38,36,1,2,2,94.73684211
2010020068,12,3600,0.0,28,23,3,1,5,82.14285714
2010020068,23,3597,0.0,33,32,6,3,1,96.96969697
2010020069,2,3806,0.0,30,29,4,0,1,96.66666667
2010020069,10,3802,0.0,20,18,1,1,2,90.0
2010020070,21,3600,0.0,32,31,9,0,1,96.875
2010020070,3,3487,0.0,34,31,3,1,3,91.17647059
2010020071,9,1832,0.0,22,17,8,0,5,77.27272727
2010020071,9,1768,0.0,7,7,0,1,0,100.0
2010020071,5,3600,0.0,34,32,3,0,2,94.11764706
2010020072,25,3500,0.0,44,39,6,0,5,88.63636364
2010020072,14,3598,0.0,19,15,4,1,4,78.94736842
2010020073,19,3830,2.0,33,30,5,0,3,90.90909091
2010020073,16,3827,0.0,34,32,2,0,2,94.11764706
2010020074,6,3598,0.0,36,35,4,2,1,97.22222222
2010020074,15,762,0.0,7,5,0,0,2,71.42857143
2010020074,15,2740,0.0,14,13,2,0,1,92.85714286
2010020075,20,3730,0.0,34,34,10,3,0,100.0
2010020075,18,3707,0.0,35,34,2,0,1,97.14285714
2010020076,23,2397,0.0,18,12,2,0,6,66.66666667
2010020076,23,1200,0.0,6,6,0,1,0,100.0
2010020076,30,3600,0.0,27,25,5,0,2,92.59259259
2010020077,12,3600,0.0,43,41,5,5,2,95.34883721
2010020077,28,3600,0.0,31,26,4,0,5,83.87096774
2010020078,7,3597,0.0,18,17,3,2,1,94.44444444
2010020078,11,3600,2.0,42,38,7,0,4,90.47619048
2010020079,24,3519,0.0,21,19,1,0,2,90.47619048
2010020079,29,3598,0.0,32,31,6,0,1,96.875
2010020080,23,3900,0.0,32,31,0,1,1,96.875
2010020080,16,3900,2.0,37,36,4,1,1,97.2972973
2010020081,12,3548,0.0,27,23,5,1,4,85.18518519
2010020081,26,3600,0.0,30,27,6,0,3,90.0
2010020082,15,47,0.0,0,0,0,0,0,
2010020082,15,3466,0.0,34,30,4,1,4,88.23529412
2010020082,6,3600,0.0,39,38,7,1,1,97.43589744
2010020083,3,3600,0.0,25,24,7,0,1,96.0
2010020083,10,3555,0.0,32,30,3,3,2,93.75
2010020084,24,3600,0.0,42,40,6,2,2,95.23809524
2010020084,4,3466,0.0,22,19,4,2,3,86.36363636
2010020085,20,3593,0.0,30,26,6,1,4,86.66666667
2010020085,17,3600,0.0,36,34,11,1,2,94.44444444
2010020086,1,3600,0.0,29,29,8,0,0,100.0
2010020086,8,3600,0.0,20,17,1,0,3,85.0
2010020087,2,3716,0.0,30,28,5,2,2,93.33333333
2010020087,14,3716,0.0,25,22,3,0,3,88.0
2010020088,25,3600,0.0,28,27,5,1,1,96.42857143
2010020088,13,2400,0.0,23,19,4,0,4,82.60869565
2010020088,13,1177,0.0,6,6,0,0,0,100.0
2010020089,5,3829,0.0,24,21,2,0,3,87.5
2010020089,18,3825,2.0,38,34,12,0,4,89.47368421
2010020090,28,3590,0.0,31,29,3,1,2,93.5483871
2010020090,21,3524,0.0,33,30,5,0,3,90.90909091
2010020091,30,3600,0.0,36,34,5,1,2,94.44444444
2010020091,22,3488,0.0,24,21,0,1,3,87.5
2010020092,26,3551,0.0,26,23,3,0,3,88.46153846
2010020092,27,3584,0.0,30,28,4,2,2,93.33333333
2010020093,20,3600,0.0,22,20,5,0,2,90.90909091
2010020093,29,3596,0.0,23,17,9,0,6,73.91304348
2010020094,9,3600,0.0,36,34,2,2,2,94.44444444
2010020094,7,3554,0.0,31,28,6,0,3,90.32258065
2010020095,14,3600,2.0,30,28,9,1,2,93.33333333
2010020095,11,1194,0.0,16,13,8,0,3,81.25
2010020095,11,2306,0.0,16,15,0,1,1,93.75
2010020096,16,3599,0.0,28,24,2,0,4,85.71428571
2010020096,19,3600,0.0,25,23,2,0,2,92.0
2010020097,30,3600,0.0,35,30,8,0,5,85.71428571
2010020097,23,3598,0.0,24,23,5,0,1,95.83333333
2010020098,3,3600,0.0,37,35,6,5,2,94.59459459
2010020098,6,3534,0.0,30,27,9,2,3,90.0
2010020099,8,3600,0.0,19,19,2,0,0,100.0
2010020099,9,3600,0.0,34,31,7,1,3,91.17647059
2010020100,7,3574,0.0,27,26,1,0,1,96.2962963
2010020100,1,1903,0.0,14,12,4,0,2,85.71428571
2010020100,1,1697,0.0,15,11,0,1,4,73.33333333
2010020101,10,3588,2.0,40,35,14,0,5,87.5
2010020101,4,3591,0.0,14,12,3,0,2,85.71428571
2010020102,11,3659,0.0,44,40,8,2,4,90.90909091
2010020102,15,3697,0.0,32,29,8,0,3,90.625
2010020103,2,3528,0.0,30,26,4,1,4,86.66666667
2010020103,13,3585,0.0,33,30,7,2,3,90.90909091
2010020104,24,3591,0.0,41,36,3,0,5,87.80487805
2010020104,17,3593,0.0,25,21,1,0,4,84.0
2010020105,5,3650,0.0,24,23,7,0,1,95.83333333
2010020105,19,3650,0.0,31,31,10,1,0,100.0
2010020106,18,3600,0.0,30,30,5,3,0,100.0
2010020106,25,3532,0.0,24,23,1,1,1,95.83333333
2010020107,29,3600,0.0,32,30,3,0,2,93.75
2010020107,16,3566,0.0,40,37,14,2,3,92.5
2010020108,26,3598,0.0,32,28,8,2,4,87.5
2010020108,21,3551,0.0,30,24,4,1,6,80.0
2010020109,12,3772,0.0,39,36,1,0,3,92.30769231
2010020109,27,3772,0.0,41,37,4,2,4,90.24390244
2010020110,28,3600,0.0,22,21,4,0,1,95.45454545
2010020110,22,3591,0.0,34,28,5,0,6,82.35294118
2010020111,18,3600,0.0,45,42,5,0,3,93.33333333
2010020111,14,3534,0.0,26,22,1,2,4,84.61538462
2010020112,1,3537,0.0,33,31,11,1,2,93.93939394
2010020112,3,3597,0.0,28,27,7,1,1,96.42857143
2010020113,28,3083,2.0,25,24,5,0,1,96.0
2010020113,28,516,0.0,5,2,0,0,3,40.0
2010020113,20,3570,0.0,27,27,7,2,0,100.0
2010020114,4,3509,0.0,25,23,4,0,2,92.0
2010020114,29,3600,0.0,29,28,6,1,1,96.55172414
2010020115,27,3682,0.0,29,26,5,1,3,89.65517241
2010020115,8,3685,0.0,29,27,3,0,2,93.10344828
2010020116,26,3895,0.0,22,20,7,0,2,90.90909091
2010020116,30,3900,0.0,34,32,10,2,2,94.11764706
2010020117,13,3513,0.0,27,24,1,0,3,88.88888889
2010020117,10,3590,0.0,22,21,3,0,1,95.45454545
2010020118,7,3540,0.0,33,28,8,1,5,84.84848485
2010020118,4,3598,0.0,35,32,1,0,3,91.42857143
2010020119,27,2400,0.0,16,14,2,1,2,87.5
2010020119,27,1200,0.0,20,17,4,1,3,85.0
2010020119,9,3600,0.0,30,28,10,0,2,93.33333333
2010020120,22,3898,0.0,39,35,5,2,4,89.74358974
2010020120,20,3856,0.0,32,28,2,1,4,87.5
2010020121,24,3600,0.0,37,35,11,0,2,94.59459459
2010020121,25,3584,0.0,26,21,4,2,5,80.76923077
2010020122,21,3610,0.0,31,27,7,0,4,87.09677419
2010020122,23,3601,0.0,39,36,4,1,3,92.30769231
2010020123,11,3600,0.0,28,24,1,0,4,85.71428571
2010020123,3,3543,0.0,25,20,4,0,5,80.0
2010020124,15,3600,0.0,29,29,5,1,0,100.0
2010020124,12,3543,0.0,32,30,3,6,2,93.75
2010020125,2,3578,0.0,34,30,4,1,4,88.23529412
2010020125,8,3582,0.0,21,18,1,1,3,85.71428571
2010020126,5,3537,0.0,30,26,9,3,4,86.66666667
2010020126,14,735,0.0,7,4,0,1,3,57.14285714
2010020126,14,2863,0.0,24,24,7,1,0,100.0
2010020127,26,3573,0.0,28,25,4,0,3,89.28571429
2010020127,16,3600,0.0,34,33,2,0,1,97.05882353
2010020128,1,3599,0.0,39,34,8,1,5,87.17948718
2010020128,28,3600,0.0,29,27,4,0,2,93.10344828
2010020129,10,3534,0.0,32,30,4,3,2,93.75
2010020129,6,3598,0.0,20,20,6,0,0,100.0
2010020130,27,3594,2.0,45,43,13,2,2,95.55555556
2010020130,17,3582,0.0,35,32,3,3,3,91.42857143
2010020131,22,3887,0.0,41,39,11,1,2,95.12195122
2010020131,29,3895,0.0,27,25,2,1,2,92.59259259
2010020132,13,3532,0.0,28,23,2,1,5,82.14285714
2010020132,9,3590,0.0,31,28,2,0,3,90.32258065
2010020133,19,3595,0.0,24,24,3,0,0,100.0
2010020133,18,3600,0.0,34,31,6,0,3,91.17647059
2010020134,15,3516,0.0,17,15,4,0,2,88.23529412
2010020134,30,3600,0.0,22,21,4,1,1,95.45454545
2010020135,26,3598,0.0,32,30,12,0,2,93.75
2010020135,25,914,0.0,8,8,0,1,0,100.0
2010020135,25,2629,0.0,15,11,3,0,4,73.33333333
2010020136,21,3600,0.0,19,14,4,1,5,73.68421053
2010020136,20,3525,0.0,36,30,9,0,6,83.33333333
2010020137,8,3600,0.0,31,30,6,2,1,96.77419355
2010020137,2,3495,0.0,26,23,1,2,3,88.46153846
2010020138,12,3600,0.0,43,40,9,1,3,93.02325581
2010020138,3,3513,0.0,38,34,6,0,4,89.47368421
2010020139,4,3600,0.0,28,26,3,0,2,92.85714286
2010020139,5,3543,0.0,24,21,2,2,3,87.5
2010020140,7,3795,0.0,22,18,4,0,4,81.81818182
2010020140,11,3865,0.0,28,25,6,0,3,89.28571429
2010020141,22,3600,0.0,41,37,3,0,4,90.24390244
2010020141,16,2374,0.0,9,7,0,1,2,77.77777778
2010020141,16,1200,0.0,12,8,0,0,4,66.66666667
2010020142,1,3594,0.0,28,27,3,0,1,96.42857143
2010020142,24,3528,0.0,27,25,6,0,2,92.59259259
2010020143,3,3600,0.0,36,36,5,0,0,100.0
2010020143,10,3487,0.0,24,22,2,0,2,91.66666667
2010020144,13,3600,0.0,41,40,9,4,1,97.56097561
2010020144,8,3600,0.0,31,28,4,1,3,90.32258065
2010020145,6,3600,0.0,29,29,8,0,0,100.0
2010020145,9,3600,0.0,25,21,4,0,4,84.0
2010020146,2,3600,4.0,29,23,8,3,6,79.31034483
2010020146,4,3600,0.0,31,30,8,5,1,96.77419355
2010020147,5,3600,0.0,33,33,11,0,0,100.0
2010020147,12,3600,0.0,31,28,4,0,3,90.32258065
2010020148,18,3600,0.0,28,23,5,0,5,82.14285714
2010020148,17,3583,0.0,25,23,5,0,2,92.0
2010020149,11,3887,0.0,35,32,5,1,3,91.42857143
2010020149,19,3900,0.0,28,25,8,0,3,89.28571429
2010020150,16,3600,0.0,26,25,7,0,1,96.15384615
2010020150,30,3596,0.0,31,29,2,0,2,93.5483871
2010020151,7,3600,0.0,41,37,5,1,4,90.24390244
2010020151,25,3594,0.0,34,34,3,0,0,100.0
2010020152,29,1844,0.0,19,15,3,0,4,78.94736842
2010020152,29,1756,0.0,12,11,2,0,1,91.66666667
2010020152,21,3593,0.0,34,33,3,0,1,97.05882353
2010020153,14,3600,0.0,23,23,1,0,0,100.0
2010020153,27,3600,0.0,23,20,1,0,3,86.95652174
2010020154,15,3592,0.0,29,27,8,2,2,93.10344828
2010020154,20,365,0.0,1,0,0,0,1,0.0
2010020154,20,3235,0.0,27,21,4,0,6,77.77777778
2010020155,1,3585,0.0,23,20,4,0,3,86.95652174
2010020155,26,3600,0.0,40,39,1,1,1,97.5
2010020156,24,3461,0.0,41,36,17,0,5,87.80487805
2010020156,28,3583,0.0,24,22,0,0,2,91.66666667
2010020157,16,3509,0.0,23,20,4,0,3,86.95652174
2010020157,3,3600,0.0,35,33,5,1,2,94.28571429
2010020158,12,3526,0.0,37,34,8,1,3,91.89189189
2010020158,4,3598,0.0,28,26,4,0,2,92.85714286
2010020159,1,3600,0.0,23,20,3,0,3,86.95652174
2010020159,23,3578,0.0,30,30,3,0,0,100.0
2010020160,9,3600,0.0,35,33,8,2,2,94.28571429
2010020160,10,3443,0.0,24,21,2,1,3,87.5
2010020161,8,3599,0.0,24,21,4,0,3,87.5
2010020161,29,3600,0.0,29,29,4,0,0,100.0
2010020162,28,3528,0.0,16,15,7,1,1,93.75
2010020162,30,3566,0.0,36,36,8,3,0,100.0
2010020163,23,3596,0.0,26,23,6,0,3,88.46153846
2010020163,22,3564,0.0,30,26,2,0,4,86.66666667
2010020164,6,3598,0.0,35,33,12,1,2,94.28571429
2010020164,7,1200,0.0,12,9,2,0,3,75.0
2010020164,7,2383,0.0,13,12,4,0,1,92.30769231
2010020165,10,3900,0.0,30,26,4,1,4,86.66666667
2010020165,15,3899,0.0,28,24,3,1,4,85.71428571
2010020166,2,3600,0.0,32,25,2,1,7,78.125
2010020166,12,3600,0.0,33,31,10,3,2,93.93939394
2010020167,11,3600,0.0,55,52,3,1,3,94.54545455
2010020167,13,3523,0.0,23,19,0,0,4,82.60869565
2010020168,1,1548,0.0,8,8,0,0,0,100.0
2010020168,1,2052,0.0,24,21,6,0,3,87.5
2010020168,16,3542,2.0,22,19,5,1,3,86.36363636
2010020169,5,3600,0.0,29,24,5,0,5,82.75862069
2010020169,25,3600,0.0,23,21,5,0,2,91.30434783
2010020170,17,3600,0.0,17,16,7,0,1,94.11764706
2010020170,20,3554,0.0,33,31,5,3,2,93.93939394
2010020171,18,3545,0.0,28,24,3,1,4,85.71428571
2010020171,27,3598,0.0,31,28,7,0,3,90.32258065
2010020172,14,3770,0.0,30,27,7,0,3,90.0
2010020172,24,3773,0.0,34,32,3,0,2,94.11764706
2010020173,3,3600,0.0,21,17,5,0,4,80.95238095
2010020173,4,3552,0.0,21,20,4,0,1,95.23809524
2010020174,29,3600,0.0,25,25,3,0,0,100.0
2010020174,11,3568,0.0,41,39,6,0,2,95.12195122
2010020175,2,3548,0.0,26,23,3,1,3,88.46153846
2010020175,9,3600,0.0,29,28,3,2,1,96.55172414
2010020176,28,3534,0.0,29,27,8,0,2,93.10344828
2010020176,19,3600,0.0,25,25,4,3,0,100.0
2010020177,23,3592,0.0,34,33,4,1,1,97.05882353
2010020177,21,3508,0.0,36,33,2,1,3,91.66666667
2010020178,14,3549,0.0,26,25,5,2,1,96.15384615
2010020178,26,3600,0.0,24,24,1,1,0,100.0
2010020179,3,3600,0.0,33,33,3,3,0,100.0
2010020179,1,3600,0.0,20,17,4,1,3,85.0
2010020180,6,1174,0.0,13,12,0,0,1,92.30769231
2010020180,6,2400,0.0,25,22,3,1,3,88.0
2010020180,15,2989,0.0,14,11,1,1,3,78.57142857
2010020180,15,609,0.0,4,4,0,0,0,100.0
2010020181,8,3600,0.0,31,29,3,0,2,93.5483871
2010020181,7,3543,0.0,32,29,6,0,3,90.625
2010020182,12,3553,0.0,49,43,3,1,6,87.75510204
2010020182,13,649,0.0,7,5,2,0,2,71.42857143
2010020182,13,2951,0.0,24,22,5,0,2,91.66666667
2010020183,20,3537,0.0,23,21,2,1,2,91.30434783
2010020183,30,3600,0.0,34,33,9,3,1,97.05882353
2010020184,27,1521,0.0,18,15,7,0,3,83.33333333
2010020184,27,2079,0.0,13,10,1,0,3,76.92307692
2010020184,25,3556,2.0,28,25,10,0,3,89.28571429
2010020185,17,3600,0.0,30,29,5,1,1,96.66666667
2010020185,22,3547,0.0,29,27,6,2,2,93.10344828
2010020186,5,3512,0.0,19,16,2,0,3,84.21052632
2010020186,24,3600,0.0,32,30,2,2,2,93.75
2010020187,18,1847,0.0,22,18,1,0,4,81.81818182
2010020187,18,1753,0.0,9,9,2,0,0,100.0
2010020187,26,3600,0.0,26,25,7,0,1,96.15384615
2010020188,19,3900,0.0,34,33,7,3,1,97.05882353
2010020188,6,3900,0.0,35,34,4,2,1,97.14285714
2010020189,7,3866,0.0,25,23,3,2,2,92.0
2010020189,10,3900,0.0,31,29,3,0,2,93.5483871
2010020190,9,3600,0.0,23,21,1,1,2,91.30434783
2010020190,8,3531,0.0,31,28,3,1,3,90.32258065
2010020191,4,3600,2.0,32,31,12,2,1,96.875
2010020191,2,3508,0.0,26,24,3,1,2,92.30769231
2010020192,13,3458,0.0,29,26,7,1,3,89.65517241
2010020192,12,3600,0.0,20,18,2,0,2,90.0
2010020193,16,3900,0.0,37,33,6,0,4,89.18918919
2010020193,11,3894,0.0,40,36,4,0,4,90.0
2010020194,30,3600,0.0,37,35,11,1,2,94.59459459
2010020194,29,3506,0.0,24,21,3,0,3,87.5
2010020195,25,3600,0.0,45,40,3,1,5,88.88888889
2010020195,21,3600,0.0,31,31,2,0,0,100.0
2010020196,5,3484,0.0,23,22,2,1,1,95.65217391
2010020196,5,416,0.0,5,3,0,0,2,60.0
2010020196,27,3900,0.0,36,33,6,0,3,91.66666667
2010020197,17,3585,0.0,34,28,8,1,6,82.35294118
2010020197,23,3593,0.0,28,24,5,3,4,85.71428571
2010020198,14,3600,0.0,39,34,14,0,5,87.17948718
2010020198,28,3599,0.0,35,33,6,2,2,94.28571429
2010020199,4,3629,0.0,39,36,8,1,3,92.30769231
2010020199,15,3629,0.0,25,23,0,1,2,92.0
2010020200,19,3600,0.0,27,27,7,0,0,100.0
2010020200,3,3508,0.0,21,20,5,1,1,95.23809524
2010020201,22,3592,0.0,27,26,4,0,1,96.2962963
2010020201,16,3521,0.0,26,24,5,0,2,92.30769231
2010020202,18,3600,0.0,37,32,3,1,5,86.48648649
2010020202,24,3600,0.0,24,20,5,0,4,83.33333333
2010020203,27,3683,0.0,40,37,3,0,3,92.5
2010020203,17,3678,0.0,31,29,2,0,2,93.5483871
2010020204,15,3600,0.0,28,25,8,0,3,89.28571429
2010020204,3,3522,0.0,23,19,4,1,4,82.60869565
2010020205,22,439,0.0,8,4,2,0,4,50.0
2010020205,22,3158,0.0,34,31,10,2,3,91.17647059
2010020205,12,3600,0.0,22,21,3,2,1,95.45454545
2010020206,23,3455,0.0,29,27,3,1,2,93.10344828
2010020206,8,3579,0.0,34,34,4,2,0,100.0
2010020207,11,1847,0.0,11,10,1,0,1,90.90909091
2010020207,11,1752,0.0,18,14,1,0,4,77.77777778
2010020207,9,3600,0.0,37,35,5,0,2,94.59459459
2010020208,10,3583,0.0,25,21,1,0,4,84.0
2010020208,14,3596,0.0,28,28,5,0,0,100.0
2010020209,20,3591,0.0,31,29,10,0,2,93.5483871
2010020209,21,3501,0.0,24,21,2,0,3,87.5
2010020210,24,3867,0.0,41,39,11,0,2,95.12195122
2010020210,28,3851,0.0,20,17,3,0,3,85.0
2010020211,7,3871,0.0,32,28,2,0,4,87.5
2010020211,1,3900,0.0,42,38,7,0,4,90.47619048
2010020212,6,3600,0.0,46,42,1,1,4,91.30434783
2010020212,5,3546,0.0,32,26,6,2,6,81.25
2010020213,19,1426,0.0,15,11,0,1,4,73.33333333
2010020213,19,2174,0.0,20,16,0,0,4,80.0
2010020213,29,3600,0.0,30,29,4,0,1,96.66666667
2010020214,10,3599,0.0,28,24,4,1,4,85.71428571
2010020214,13,3600,0.0,33,32,10,3,1,96.96969697
2010020215,27,3600,0.0,36,35,2,0,1,97.22222222
2010020215,16,3523,0.0,22,20,0,1,2,90.90909091
2010020216,2,3545,0.0,14,13,0,1,1,92.85714286
2010020216,24,3600,0.0,27,27,6,0,0,100.0
2010020217,8,3592,0.0,35,34,7,2,1,97.14285714
2010020217,6,3515,0.0,41,38,1,2,3,92.68292683
2010020218,7,3692,0.0,28,25,6,1,3,89.28571429
2010020218,3,3692,0.0,31,29,2,0,2,93.5483871
2010020219,14,3508,0.0,25,20,0,3,5,80.0
2010020219,15,3600,0.0,41,38,8,0,3,92.68292683
2010020220,4,3600,0.0,36,35,3,0,1,97.22222222
2010020220,12,1558,0.0,13,9,0,0,4,69.23076923
2010020220,12,2040,0.0,13,9,0,1,4,69.23076923
2010020221,30,3600,0.0,34,29,5,0,5,85.29411765
2010020221,11,3600,0.0,33,32,1,1,1,96.96969697
2010020222,22,3600,0.0,34,28,3,3,6,82.35294118
2010020222,17,3600,0.0,25,23,6,0,2,92.0
2010020223,23,3600,0.0,35,33,3,1,2,94.28571429
2010020223,9,3599,0.0,33,27,2,0,6,81.81818182
2010020224,18,3900,0.0,23,21,5,0,2,91.30434783
2010020224,19,3900,0.0,26,24,3,0,2,92.30769231
2010020225,25,3518,0.0,29,26,12,0,3,89.65517241
2010020225,26,3599,0.0,28,27,9,1,1,96.42857143
2010020226,2,3899,0.0,38,37,9,0,1,97.36842105
2010020226,28,3900,0.0,25,24,0,1,1,96.0
2010020227,22,3807,0.0,39,35,4,0,4,89.74358974
2010020227,1,3805,0.0,24,21,3,0,3,87.5
2010020228,14,3600,0.0,20,15,2,0,5,75.0
2010020228,5,3598,0.0,16,15,4,0,1,93.75
2010020229,21,3600,0.0,29,28,2,1,1,96.55172414
2010020229,29,3600,0.0,29,24,1,0,5,82.75862069
2010020230,30,3528,0.0,27,25,1,2,2,92.59259259
2010020230,13,3596,0.0,23,22,3,3,1,95.65217391
2010020231,20,3553,0.0,25,21,0,0,4,84.0
2010020231,27,3600,0.0,35,31,2,0,4,88.57142857
2010020232,25,3542,0.0,36,33,7,0,3,91.66666667
2010020232,24,3545,0.0,29,27,3,0,2,93.10344828
2010020233,9,3597,0.0,31,31,4,3,0,100.0
2010020233,6,3555,0.0,33,31,2,2,2,93.93939394
2010020234,15,3840,0.0,27,24,9,1,3,88.88888889
2010020234,7,3840,0.0,25,23,1,0,2,92.0
2010020235,23,3600,0.0,32,29,2,1,3,90.625
2010020235,10,3544,0.0,31,27,4,4,4,87.09677419
2010020236,12,2131,0.0,22,18,3,1,4,81.81818182
2010020236,12,1466,0.0,11,8,4,0,3,72.72727273
2010020236,8,3600,0.0,30,28,13,1,2,93.33333333
2010020237,13,3600,0.0,42,37,5,1,5,88.0952381
2010020237,4,3600,0.0,36,34,3,1,2,94.44444444
2010020238,5,3600,0.0,33,31,7,1,2,93.93939394
2010020238,11,3569,0.0,27,24,6,5,3,88.88888889
2010020239,21,3464,0.0,25,22,1,1,3,88.0
2010020239,17,3600,0.0,22,21,5,0,1,95.45454545
2010020240,16,3890,2.0,33,30,6,1,3,90.90909091
2010020240,18,3900,0.0,32,29,5,0,3,90.625
2010020241,19,3513,2.0,26,22,8,0,4,84.61538462
2010020241,27,3593,0.0,38,35,5,1,3,92.10526316
2010020242,20,3551,0.0,35,31,11,1,4,88.57142857
2010020242,28,3600,0.0,31,28,7,2,3,90.32258065
2010020243,2,3600,0.0,34,29,8,0,5,85.29411765
2010020243,26,3600,0.0,19,18,4,1,1,94.73684211
2010020244,22,3600,0.0,31,23,2,0,8,74.19354839
2010020244,3,3600,0.0,21,19,2,3,2,90.47619048
2010020245,11,2209,0.0,16,15,1,0,1,93.75
2010020245,11,1343,0.0,16,12,2,0,4,75.0
2010020245,15,3559,0.0,27,23,3,2,4,85.18518519
2010020246,30,3588,0.0,38,37,3,3,1,97.36842105
2010020246,14,3589,0.0,17,14,1,1,3,82.35294118
2010020247,24,3872,0.0,43,40,8,1,3,93.02325581
2010020247,16,3872,0.0,26,24,6,0,2,92.30769231
2010020248,1,3599,0.0,24,21,6,0,3,87.5
2010020248,6,3600,0.0,28,28,3,2,0,100.0
2010020249,23,3877,0.0,39,35,12,0,4,89.74358974
2010020249,7,3874,0.0,39,36,3,1,3,92.30769231
2010020250,9,3600,0.0,46,41,9,0,5,89.13043478
2010020250,4,3600,0.0,29,28,0,0,1,96.55172414
2010020251,3,3815,2.0,39,37,6,0,2,94.87179487
2010020251,5,3810,0.0,25,22,0,1,3,88.0
2010020252,19,3600,0.0,23,17,2,0,6,73.91304348
2010020252,21,3600,0.0,30,27,4,0,3,90.0
2010020253,26,3593,0.0,34,28,0,0,6,82.35294118
2010020253,28,3600,0.0,35,32,3,2,3,91.42857143
2010020254,18,3539,0.0,33,28,11,0,5,84.84848485
2010020254,10,2810,0.0,28,24,3,1,4,85.71428571
2010020254,10,789,0.0,6,6,1,0,0,100.0
2010020255,4,3570,0.0,28,25,5,1,3,89.28571429
2010020255,8,3600,0.0,41,41,8,5,0,100.0
2010020256,24,3547,0.0,26,24,4,1,2,92.30769231
2010020256,25,3599,0.0,27,26,5,3,1,96.2962963
2010020257,14,3600,0.0,36,34,13,3,2,94.44444444
2010020257,2,3543,0.0,39,36,7,2,3,92.30769231
2010020258,6,3594,0.0,36,34,8,0,2,94.44444444
2010020258,3,3543,0.0,20,17,0,1,3,85.0
2010020259,23,3478,0.0,29,26,3,2,3,89.65517241
2010020259,5,3600,0.0,30,29,8,1,1,96.66666667
2010020260,7,3527,0.0,28,25,2,2,3,89.28571429
2010020260,15,3598,0.0,33,31,10,0,2,93.93939394
2010020261,9,999,0.0,16,12,3,3,4,75.0
2010020261,9,2589,0.0,12,9,1,1,3,75.0
2010020261,12,3600,0.0,24,23,1,3,1,95.83333333
2010020262,13,3600,0.0,39,38,3,1,1,97.43589744
2010020262,11,3522,0.0,34,32,7,0,2,94.11764706
2010020263,19,3600,0.0,31,24,6,0,7,77.41935484
2010020263,17,3600,2.0,36,33,6,4,3,91.66666667
2010020264,24,3816,0.0,27,25,0,0,2,92.59259259
2010020264,30,3816,0.0,28,27,0,0,1,96.42857143
2010020265,28,3727,0.0,22,18,1,1,4,81.81818182
2010020265,21,3727,0.0,43,40,7,1,3,93.02325581
2010020266,27,3598,0.0,40,39,2,2,1,97.5
2010020266,20,3526,0.0,30,28,6,0,2,93.33333333
2010020267,16,3600,0.0,18,18,2,1,0,100.0
2010020267,22,2400,0.0,31,27,2,0,4,87.09677419
2010020267,22,1200,0.0,16,15,2,0,1,93.75
2010020268,29,3600,0.0,36,33,6,1,3,91.66666667
2010020268,26,3578,0.0,25,21,2,0,4,84.0
2010020269,13,3600,0.0,40,36,2,1,4,90.0
2010020269,6,3600,0.0,41,41,11,2,0,100.0
2010020270,1,2400,0.0,20,18,2,0,2,90.0
2010020270,1,1058,0.0,7,6,1,0,1,85.71428571
2010020270,10,3600,0.0,30,29,3,0,1,96.66666667
2010020271,14,2666,0.0,22,19,4,2,3,86.36363636
2010020271,14,934,0.0,10,6,0,1,4,60.0
2010020271,4,2294,0.0,22,18,10,0,4,81.81818182
2010020271,4,1200,0.0,11,7,4,0,4,63.63636364
2010020272,18,3600,0.0,30,30,3,0,0,100.0
2010020272,8,3598,0.0,30,27,2,2,3,90.0
2010020273,28,3772,0.0,41,36,4,2,5,87.80487805
2010020273,25,3772,0.0,39,35,10,3,4,89.74358974
2010020274,12,3870,0.0,36,32,4,0,4,88.88888889
2010020274,5,3900,0.0,34,30,2,0,4,88.23529412
2010020275,30,3824,0.0,44,41,10,1,3,93.18181818
2010020275,17,3847,0.0,27,23,3,0,4,85.18518519
2010020276,26,3585,0.0,26,22,5,0,4,84.61538462
2010020276,7,3600,0.0,36,34,8,0,2,94.44444444
2010020277,15,3045,0.0,31,29,7,1,2,93.5483871
2010020277,15,547,0.0,5,2,0,0,3,40.0
2010020277,11,3600,0.0,29,29,2,0,0,100.0
2010020278,9,3600,0.0,33,28,8,0,5,84.84848485
2010020278,19,3600,0.0,20,18,5,0,2,90.0
2010020279,3,1947,0.0,16,13,1,2,3,81.25
2010020279,3,1652,0.0,10,8,0,1,2,80.0
2010020279,21,3600,0.0,26,25,7,0,1,96.15384615
2010020280,16,3587,0.0,36,29,6,1,7,80.55555556
2010020280,20,3595,0.0,33,31,2,2,2,93.93939394
2010020281,27,3875,0.0,30,27,8,1,3,90.0
2010020281,22,3900,0.0,42,39,4,0,3,92.85714286
2010020282,29,3600,0.0,50,47,8,1,3,94.0
2010020282,24,3537,0.0,29,25,1,0,4,86.20689655
2010020283,26,3885,0.0,41,38,6,2,3,92.68292683
2010020283,6,3879,0.0,26,23,5,2,3,88.46153846
2010020284,14,3600,0.0,30,29,3,2,1,96.66666667
2010020284,7,3562,0.0,22,20,3,0,2,90.90909091
2010020285,10,3524,0.0,39,37,3,1,2,94.87179487
2010020285,8,3564,0.0,30,30,5,0,0,100.0
2010020286,13,3595,0.0,40,39,6,1,1,97.5
2010020286,2,3600,0.0,31,27,10,0,4,87.09677419
2010020287,4,3883,0.0,37,33,12,0,4,89.18918919
2010020287,15,3893,0.0,35,31,13,0,4,88.57142857
2010020288,18,3894,0.0,22,21,1,0,1,95.45454545
2010020288,12,3890,0.0,27,26,1,2,1,96.2962963
2010020289,1,3570,0.0,27,24,3,1,3,88.88888889
2010020289,19,3600,0.0,37,35,1,1,2,94.59459459
2010020290,3,3598,0.0,28,26,5,0,2,92.85714286
2010020290,30,3505,0.0,30,25,5,1,5,83.33333333
2010020291,21,3900,0.0,29,26,4,1,3,89.65517241
2010020291,25,3900,0.0,26,23,3,1,3,88.46153846
2010020292,16,3598,0.0,28,27,3,5,1,96.42857143
2010020292,23,2131,0.0,20,16,7,1,4,80.0
2010020292,23,1459,0.0,21,18,13,0,3,85.71428571
2010020293,29,3597,0.0,35,35,9,1,0,100.0
2010020293,28,3541,0.0,26,24,2,1,2,92.30769231
2010020294,2,3690,0.0,35,33,1,2,2,94.28571429
2010020294,11,3690,0.0,29,28,3,0,1,96.55172414
2010020295,20,3698,0.0,38,33,2,0,5,86.84210526
2010020295,17,3587,0.0,27,23,2,1,4,85.18518519
2010020296,22,3600,0.0,40,38,13,0,2,95.0
2010020296,24,3562,0.0,25,22,2,0,3,88.0
2010020297,27,3598,0.0,27,25,0,0,2,92.59259259
2010020297,23,3525,0.0,28,25,6,0,3,89.28571429
2010020298,25,3477,0.0,25,22,0,1,3,88.0
2010020298,10,3594,0.0,22,21,3,0,1,95.45454545
2010020299,15,3560,0.0,23,18,1,0,5,78.26086957
2010020299,1,3600,0.0,30,30,4,0,0,100.0
2010020300,20,3540,0.0,24,22,2,0,2,91.66666667
2010020300,3,3599,0.0,32,31,2,0,1,96.875
2010020301,8,3544,0.0,45,42,10,0,3,93.33333333
2010020301,4,3598,0.0,31,29,5,0,2,93.5483871
2010020302,18,3581,0.0,30,28,4,0,2,93.33333333
2010020302,29,3591,0.0,27,27,6,3,0,100.0
2010020303,26,3515,0.0,19,16,2,0,3,84.21052632
2010020303,9,3600,0.0,30,28,6,1,2,93.33333333
2010020304,6,3558,0.0,36,33,6,0,3,91.66666667
2010020304,14,3586,0.0,27,26,4,1,1,96.2962963
2010020305,5,3596,0.0,29,27,5,0,2,93.10344828
2010020305,13,3510,0.0,26,23,4,0,3,88.46153846
2010020306,22,3600,0.0,34,29,3,1,5,85.29411765
2010020306,27,3600,0.0,23,23,3,0,0,100.0
2010020307,5,3598,0.0,30,30,7,1,0,100.0
2010020307,7,3539,0.0,29,28,6,0,1,96.55172414
2010020308,29,3743,0.0,24,21,2,0,3,87.5
2010020308,2,3751,0.0,38,34,9,1,4,89.47368421
2010020309,15,3599,2.0,32,30,2,0,2,93.75
2010020309,12,3515,0.0,38,35,9,1,3,92.10526316
2010020310,17,2400,0.0,30,26,0,0,4,86.66666667
2010020310,17,1200,0.0,8,7,0,2,1,87.5
2010020310,11,3600,0.0,33,32,6,0,1,96.96969697
2010020311,26,3600,0.0,33,29,4,2,4,87.87878788
2010020311,8,3566,0.0,25,24,4,2,1,96.0
2010020312,25,3600,0.0,19,18,1,1,1,94.73684211
2010020312,9,3519,0.0,26,24,9,0,2,92.30769231
2010020313,20,3900,0.0,21,20,5,0,1,95.23809524
2010020313,1,3900,0.0,26,25,5,1,1,96.15384615
2010020314,3,3541,2.0,34,29,14,1,5,85.29411765
2010020314,14,3599,0.0,20,17,3,1,3,85.0
2010020315,6,3585,0.0,32,31,6,0,1,96.875
2010020315,13,3600,0.0,37,34,3,0,3,91.89189189
2010020316,19,3844,0.0,30,29,5,1,1,96.66666667
2010020316,18,3900,0.0,15,14,5,0,1,93.33333333
2010020317,4,3587,0.0,16,15,2,0,1,93.75
2010020317,30,3600,0.0,28,22,1,0,6,78.57142857
2010020318,21,1200,0.0,7,6,0,0,1,85.71428571
2010020318,21,2207,0.0,12,9,1,0,3,75.0
2010020318,23,3592,0.0,23,21,7,2,2,91.30434783
2010020319,16,3517,0.0,28,24,4,0,4,85.71428571
2010020319,28,3600,0.0,32,30,7,2,2,93.75
2010020320,21,3580,0.0,24,21,4,0,3,87.5
2010020320,22,3600,0.0,37,35,5,2,2,94.59459459
2010020321,12,3600,0.0,37,37,6,0,0,100.0
2010020321,6,3588,0.0,21,18,1,0,3,85.71428571
2010020322,1,3497,0.0,20,18,6,0,2,90.0
2010020322,2,3600,0.0,29,29,5,1,0,100.0
2010020323,20,3897,0.0,36,34,8,2,2,94.44444444
2010020323,4,3877,0.0,30,28,1,0,2,93.33333333
2010020324,9,3524,0.0,40,38,9,1,2,95.0
2010020324,5,3586,2.0,44,43,7,0,1,97.72727273
2010020325,18,1200,0.0,9,6,0,0,3,66.66666667
2010020325,18,2400,0.0,14,12,1,0,2,85.71428571
2010020325,30,3600,0.0,34,32,6,4,2,94.11764706
2010020326,16,3600,0.0,27,26,6,0,1,96.2962963
2010020326,24,2966,0.0,28,24,5,2,4,85.71428571
2010020326,24,620,0.0,6,6,4,0,0,100.0
2010020327,14,1736,0.0,18,14,2,3,4,77.77777778
2010020327,14,1864,0.0,11,9,4,1,2,81.81818182
2010020327,15,3590,0.0,17,17,7,0,0,100.0
2010020328,17,3600,0.0,35,34,7,0,1,97.14285714
2010020328,29,3552,0.0,32,30,6,1,2,93.75
2010020329,10,3492,0.0,28,25,3,3,3,89.28571429
2010020329,7,3600,0.0,36,35,6,2,1,97.22222222
2010020330,8,3582,0.0,47,44,12,0,3,93.61702128
2010020330,11,3595,0.0,25,25,8,2,0,100.0
2010020331,3,3600,0.0,40,40,9,1,0,100.0
2010020331,13,3370,0.0,19,16,2,1,3,84.21052632
2010020332,19,3546,0.0,22,19,3,0,3,86.36363636
2010020332,25,3600,0.0,27,25,0,2,2,92.59259259
2010020333,28,3600,0.0,32,26,3,0,6,81.25
2010020333,23,3600,0.0,33,32,4,0,1,96.96969697
2010020334,4,3900,0.0,25,24,3,0,1,96.0
2010020334,1,3888,0.0,41,40,2,0,1,97.56097561
2010020335,20,3519,0.0,42,39,10,0,3,92.85714286
2010020335,5,3600,0.0,31,30,9,0,1,96.77419355
2010020336,7,3577,0.0,33,30,11,1,3,90.90909091
2010020336,8,3600,0.0,36,35,13,0,1,97.22222222
2010020337,10,3592,0.0,28,25,2,0,3,89.28571429
2010020337,9,3600,0.0,29,29,1,1,0,100.0
2010020338,13,3900,0.0,37,34,10,0,3,91.89189189
2010020338,14,3896,0.0,27,24,10,0,3,88.88888889
2010020339,25,3596,0.0,36,35,4,0,1,97.22222222
2010020339,19,3525,0.0,23,21,5,0,2,91.30434783
2010020340,3,3900,0.0,30,29,6,1,1,96.66666667
2010020340,18,3900,4.0,24,23,5,0,1,95.83333333
2010020341,24,3600,0.0,34,30,12,0,4,88.23529412
2010020341,27,3575,0.0,25,19,4,2,6,76.0
2010020342,30,2809,0.0,38,31,7,0,7,81.57894737
2010020342,30,791,0.0,2,2,1,0,0,100.0
2010020342,21,3600,0.0,32,28,2,0,4,87.5
2010020343,28,3594,0.0,25,22,1,1,3,88.0
2010020343,22,3540,0.0,25,21,3,0,4,84.0
2010020344,16,3600,0.0,22,21,3,0,1,95.45454545
2010020344,26,3534,0.0,23,21,1,1,2,91.30434783
2010020345,12,3845,0.0,40,38,4,2,2,95.0
2010020345,15,3900,0.0,28,26,2,0,2,92.85714286
2010020346,6,3589,0.0,26,22,5,0,4,84.61538462
2010020346,11,3600,0.0,41,40,3,0,1,97.56097561
2010020347,29,3576,0.0,41,38,5,1,3,92.68292683
2010020347,17,3588,0.0,29,27,2,1,2,93.10344828
2010020348,5,3590,0.0,26,25,4,0,1,96.15384615
2010020348,3,3501,0.0,27,24,1,1,3,88.88888889
2010020349,25,3600,0.0,28,27,3,0,1,96.42857143
2010020349,12,3600,0.0,33,29,4,0,4,87.87878788
2010020350,22,3600,0.0,23,22,4,4,1,95.65217391
2010020350,9,3596,0.0,24,21,5,2,3,87.5
2010020351,30,3600,0.0,31,28,7,3,3,90.32258065
2010020351,20,3600,0.0,32,32,9,1,0,100.0
2010020352,26,3521,0.0,19,17,2,0,2,89.47368421
2010020352,24,3600,0.0,27,27,4,0,0,100.0
2010020353,14,3611,0.0,25,22,4,2,3,88.0
2010020353,10,3632,0.0,39,35,7,1,4,89.74358974
2010020354,27,3550,0.0,22,20,6,1,2,90.90909091
2010020354,18,3600,0.0,33,33,5,2,0,100.0
2010020355,19,3464,0.0,24,17,6,0,7,70.83333333
2010020355,16,3600,0.0,26,21,1,2,5,80.76923077
2010020356,11,3703,0.0,31,29,6,4,2,93.5483871
2010020356,21,3704,0.0,31,28,6,1,3,90.32258065
2010020357,17,3600,0.0,28,25,3,0,3,89.28571429
2010020357,28,3477,0.0,29,24,2,0,5,82.75862069
2010020358,22,3748,0.0,39,36,4,5,3,92.30769231
2010020358,8,3747,0.0,32,28,6,3,4,87.5
2010020359,6,3600,2.0,41,41,7,0,0,100.0
2010020359,4,3514,0.0,31,29,6,1,2,93.5483871
2010020360,18,3893,0.0,31,28,5,1,3,90.32258065
2010020360,29,3900,0.0,29,26,2,0,3,89.65517241
2010020361,15,3600,0.0,38,37,3,2,1,97.36842105
2010020361,19,3537,0.0,25,22,3,0,3,88.0
2010020362,27,3600,0.0,35,33,6,0,2,94.28571429
2010020362,30,3548,0.0,35,32,4,2,3,91.42857143
2010020363,23,3590,0.0,20,18,3,0,2,90.0
2010020363,20,3587,0.0,36,29,13,2,7,80.55555556
2010020364,13,3513,0.0,28,24,2,0,4,85.71428571
2010020364,24,3585,0.0,32,29,2,0,3,90.625
2010020365,14,2434,0.0,22,17,3,0,5,77.27272727
2010020365,14,1166,0.0,10,7,2,0,3,70.0
2010020365,6,3589,0.0,38,37,2,0,1,97.36842105
2010020366,22,3600,0.0,33,33,7,2,0,100.0
2010020366,10,2010,0.0,13,10,1,1,3,76.92307692
2010020366,10,1565,0.0,6,4,0,0,2,66.66666667
2010020367,8,3600,0.0,28,27,4,1,1,96.42857143
2010020367,1,3502,0.0,29,26,3,0,3,89.65517241
2010020367,1,98,0.0,3,1,0,0,2,33.33333333
2010020368,3,1650,0.0,11,9,2,0,2,81.81818182
2010020368,3,1950,0.0,21,18,0,0,3,85.71428571
2010020368,2,3530,0.0,26,20,1,0,6,76.92307692
2010020369,11,3532,0.0,28,25,0,0,3,89.28571429
2010020369,5,3594,0.0,22,20,2,0,2,90.90909091
2010020370,28,3598,0.0,28,28,4,1,0,100.0
2010020370,9,3600,0.0,33,29,2,1,4,87.87878788
2010020371,15,3511,0.0,21,19,3,2,2,90.47619048
2010020371,25,3600,0.0,38,37,5,1,1,97.36842105
2010020372,13,3531,0.0,24,21,2,1,3,87.5
2010020372,26,3600,0.0,26,24,1,2,2,92.30769231
2010020373,2,3546,2.0,20,19,3,0,1,95.0
2010020373,3,3600,0.0,17,17,2,3,0,100.0
2010020374,21,3666,0.0,30,28,2,0,2,93.33333333
2010020374,12,3676,0.0,35,34,6,1,1,97.14285714
2010020375,29,3600,0.0,37,32,10,1,5,86.48648649
2010020375,7,3600,0.0,19,19,4,0,0,100.0
2010020376,20,3896,0.0,22,20,3,1,2,90.90909091
2010020376,30,3900,0.0,32,30,4,0,2,93.75
2010020377,23,3600,0.0,32,32,7,0,0,100.0
2010020377,16,3600,0.0,18,15,3,1,3,83.33333333
2010020378,17,3553,0.0,41,41,4,0,0,100.0
2010020378,24,3595,0.0,29,25,1,0,4,86.20689655
2010020379,1,3528,0.0,33,29,4,0,4,87.87878788
2010020379,4,3600,0.0,26,23,3,0,3,88.46153846
2010020380,28,3502,0.0,19,16,0,0,3,84.21052632
2010020380,8,3600,0.0,27,26,3,0,1,96.2962963
2010020381,6,3900,0.0,40,38,9,1,2,95.0
2010020381,10,3861,0.0,27,25,1,1,2,92.59259259
2010020382,7,3897,0.0,32,32,3,0,0,100.0
2010020382,9,3900,0.0,31,31,1,0,0,100.0
2010020383,11,3600,0.0,46,45,15,0,1,97.82608696
2010020383,15,3497,0.0,33,30,1,1,3,90.90909091
2010020384,5,3600,0.0,23,21,2,0,2,91.30434783
2010020384,29,949,0.0,13,9,1,1,4,69.23076923
2010020384,29,2651,0.0,22,19,0,1,3,86.36363636
2010020385,21,3508,0.0,39,33,11,0,6,84.61538462
2010020385,14,3599,0.0,24,19,2,4,5,79.16666667
2010020386,12,3593,0.0,38,34,4,1,4,89.47368421
2010020386,18,3578,0.0,30,28,4,0,2,93.33333333
2010020387,30,3817,0.0,33,29,10,0,4,87.87878788
2010020387,25,3810,0.0,31,28,5,2,3,90.32258065
2010020388,13,3895,0.0,41,40,2,6,1,97.56097561
2010020388,27,3886,0.0,37,36,7,0,1,97.2972973
2010020389,19,3610,0.0,26,24,2,0,2,92.30769231
2010020389,22,3623,0.0,32,31,4,0,1,96.875
2010020390,17,3844,2.0,25,22,3,0,3,88.0
2010020390,26,3844,0.0,29,27,6,0,2,93.10344828
2010020391,4,3600,0.0,30,28,11,1,2,93.33333333
2010020391,2,3539,0.0,27,24,7,1,3,88.88888889
2010020392,9,3600,0.0,26,25,3,0,1,96.15384615
2010020392,3,3519,0.0,24,22,0,2,2,91.66666667
2010020393,20,3588,0.0,31,28,9,1,3,90.32258065
2010020393,16,3573,0.0,26,24,6,1,2,92.30769231
2010020394,27,3598,0.0,26,26,5,3,0,100.0
2010020394,24,3597,0.0,38,36,8,0,2,94.73684211
2010020395,19,3591,0.0,23,21,5,1,2,91.30434783
2010020395,23,3539,0.0,28,25,6,2,3,89.28571429
2010020396,1,3529,2.0,34,32,10,0,2,94.11764706
2010020396,5,3600,0.0,28,27,4,0,1,96.42857143
2010020397,10,3885,0.0,36,32,1,0,4,88.88888889
2010020397,15,3898,0.0,28,24,4,1,4,85.71428571
2010020398,18,3686,0.0,37,34,6,0,3,91.89189189
2010020398,11,3728,0.0,29,27,3,1,2,93.10344828
2010020399,28,3573,0.0,27,25,9,2,2,92.59259259
2010020399,17,3579,0.0,35,30,10,2,5,85.71428571
2010020400,25,3895,0.0,29,27,4,0,2,93.10344828
2010020400,29,3870,0.0,18,16,5,0,2,88.88888889
2010020401,7,3731,0.0,36,33,7,0,3,91.66666667
2010020401,6,3721,0.0,30,28,1,1,2,93.33333333
2010020402,9,148,0.0,2,1,0,0,1,50.0
2010020402,9,3452,0.0,33,30,5,0,3,90.90909091
2010020402,8,3600,0.0,28,27,0,2,1,96.42857143
2010020403,21,3640,0.0,25,21,2,0,4,84.0
2010020403,13,3643,0.0,25,22,1,1,3,88.0
2010020404,14,3497,0.0,19,15,0,0,4,78.94736842
2010020404,20,3600,0.0,24,22,2,2,2,91.66666667
2010020405,24,3900,0.0,36,34,8,1,2,94.44444444
2010020405,22,3889,0.0,32,30,6,0,2,93.75
2010020406,28,3900,0.0,35,31,0,0,4,88.57142857
2010020406,4,3885,0.0,33,29,7,1,4,87.87878788
2010020407,10,3572,0.0,26,21,1,1,5,80.76923077
2010020407,5,3594,2.0,25,23,7,0,2,92.0
2010020408,18,3600,0.0,37,35,7,2,2,94.59459459
2010020408,17,3474,0.0,24,21,3,1,3,87.5
2010020409,25,3552,0.0,24,20,3,0,4,83.33333333
2010020409,16,3600,0.0,31,28,5,4,3,90.32258065
2010020410,24,738,0.0,13,12,1,0,1,92.30769231
2010020410,24,3162,0.0,27,24,6,0,3,88.88888889
2010020410,23,3847,0.0,20,16,1,0,4,80.0
2010020411,2,3536,2.0,35,32,8,2,3,91.42857143
2010020411,6,3600,0.0,35,33,3,2,2,94.28571429
2010020412,28,3551,0.0,36,31,5,0,5,86.11111111
2010020412,7,3600,0.0,29,26,3,0,3,89.65517241
2010020413,4,3598,0.0,32,31,2,2,1,96.875
2010020413,10,3568,0.0,28,24,4,0,4,85.71428571
2010020414,13,3595,0.0,36,36,17,2,0,100.0
2010020414,15,3593,0.0,32,29,8,2,3,90.625
2010020415,3,3600,0.0,27,24,8,0,3,88.88888889
2010020415,9,3566,0.0,27,23,7,0,4,85.18518519
2010020416,29,3553,0.0,23,20,3,2,3,86.95652174
2010020416,19,3600,0.0,28,27,7,0,1,96.42857143
2010020417,30,3592,0.0,35,33,3,0,2,94.28571429
2010020417,27,3492,0.0,33,30,4,0,3,90.90909091
2010020418,20,3569,0.0,32,30,3,1,2,93.75
2010020418,26,3595,0.0,27,26,2,1,1,96.2962963
2010020419,8,3578,0.0,31,28,11,0,3,90.32258065
2010020419,17,3598,0.0,38,36,2,1,2,94.73684211
2010020420,1,3548,0.0,29,26,7,1,3,89.65517241
2010020420,9,3600,0.0,31,29,6,1,2,93.5483871
2010020421,21,3590,0.0,26,24,2,0,2,92.30769231
2010020421,11,3525,0.0,28,25,2,0,3,89.28571429
2010020422,12,3884,0.0,29,28,5,2,1,96.55172414
2010020422,25,3900,0.0,23,22,1,0,1,95.65217391
2010020423,14,3900,0.0,23,20,5,0,3,86.95652174
2010020423,22,3900,0.0,41,38,4,0,3,92.68292683
2010020424,20,3900,0.0,25,23,8,1,2,92.0
2010020424,24,3900,0.0,39,37,7,0,2,94.87179487
2010020425,4,3897,0.0,36,35,5,2,1,97.22222222
2010020425,6,3897,0.0,33,31,4,1,2,93.93939394
2010020426,5,3600,2.0,36,34,3,1,2,94.44444444
2010020426,7,3542,0.0,23,19,3,0,4,82.60869565
2010020427,8,3584,0.0,23,21,7,0,2,91.30434783
2010020427,10,3597,0.0,23,22,1,0,1,95.65217391
2010020428,17,3600,0.0,34,33,10,2,1,97.05882353
2010020428,1,3600,0.0,23,19,1,0,4,82.60869565
2010020429,11,3600,0.0,29,25,6,4,4,86.20689655
2010020429,2,3464,0.0,35,30,6,3,5,85.71428571
2010020430,21,3600,0.0,42,40,2,2,2,95.23809524
2010020430,15,3521,0.0,26,23,5,0,3,88.46153846
2010020431,3,3522,0.0,23,20,0,0,3,86.95652174
2010020431,29,3600,0.0,33,32,7,1,1,96.96969697
2010020432,12,3900,0.0,39,38,5,0,1,97.43589744
2010020432,19,3885,0.0,29,28,2,2,1,96.55172414
2010020433,13,3567,2.0,26,24,2,0,2,92.30769231
2010020433,18,3589,0.0,22,22,2,0,0,100.0
2010020434,25,3023,0.0,30,25,7,2,5,83.33333333
2010020434,25,575,0.0,4,4,3,0,0,100.0
2010020434,27,3584,0.0,35,33,12,0,2,94.28571429
2010020435,14,3630,0.0,27,23,3,1,4,85.18518519
2010020435,23,3634,0.0,23,18,3,0,5,78.26086957
2010020436,30,3770,0.0,26,24,7,0,2,92.30769231
2010020436,26,3770,0.0,21,18,3,1,3,85.71428571
2010020437,16,3832,0.0,30,28,5,0,2,93.33333333
2010020437,28,3832,0.0,29,28,0,2,1,96.55172414
2010020438,15,3600,0.0,20,13,2,1,7,65.0
2010020438,3,3600,0.0,31,31,6,1,0,100.0
2010020439,23,3544,0.0,12,11,2,0,1,91.66666667
2010020439,22,3509,0.0,32,30,7,1,2,93.75
2010020440,30,3600,0.0,36,30,11,2,6,83.33333333
2010020440,24,3599,0.0,22,20,6,0,2,90.90909091
2010020441,26,3600,0.0,51,51,11,0,0,100.0
2010020441,17,3600,0.0,26,21,1,0,5,80.76923077
2010020442,11,3669,0.0,30,27,4,0,3,90.0
2010020442,9,3669,0.0,24,20,0,0,4,83.33333333
2010020443,2,3600,0.0,26,21,4,0,5,80.76923077
2010020443,18,3600,0.0,28,28,2,1,0,100.0
2010020444,16,2313,0.0,19,17,1,2,2,89.47368421
2010020444,16,1240,0.0,10,6,0,0,4,60.0
2010020444,21,3600,0.0,34,29,5,0,5,85.29411765
2010020445,29,265,0.0,4,2,0,0,2,50.0
2010020445,29,3564,0.0,21,20,2,0,1,95.23809524
2010020445,20,3821,0.0,24,22,0,0,2,91.66666667
2010020446,25,3879,0.0,33,31,2,0,2,93.93939394
2010020446,28,3900,0.0,31,29,6,0,2,93.5483871
2010020447,5,3529,0.0,37,34,6,0,3,91.89189189
2010020447,4,3596,0.0,23,21,5,2,2,91.30434783
2010020448,10,3598,0.0,24,23,1,0,1,95.83333333
2010020448,22,3581,0.0,34,30,9,3,4,88.23529412
2010020449,6,3523,0.0,35,32,4,1,3,91.42857143
2010020449,7,3588,0.0,34,32,6,2,2,94.11764706
2010020450,27,3596,0.0,29,26,6,1,3,89.65517241
2010020450,1,3600,0.0,29,29,3,1,0,100.0
2010020451,3,3600,0.0,28,27,4,0,1,96.42857143
2010020451,5,3600,0.0,22,18,1,0,4,81.81818182
2010020452,24,3841,0.0,32,31,6,0,1,96.875
2010020452,15,3843,0.0,24,22,2,0,2,91.66666667
2010020453,19,3532,0.0,36,32,10,0,4,88.88888889
2010020453,17,3584,0.0,21,19,2,1,2,90.47619048
2010020454,4,3600,0.0,41,38,2,1,3,92.68292683
2010020454,8,3542,0.0,30,25,4,0,5,83.33333333
2010020455,11,3900,0.0,31,30,5,4,1,96.77419355
2010020455,14,3900,0.0,28,27,4,1,1,96.42857143
2010020456,12,102,0.0,5,3,0,0,2,60.0
2010020456,12,3498,0.0,22,21,2,0,1,95.45454545
2010020456,13,3532,0.0,34,30,8,0,4,88.23529412
2010020457,28,3499,0.0,35,32,3,0,3,91.42857143
2010020457,18,3600,0.0,27,25,6,1,2,92.59259259
2010020458,21,3600,0.0,38,35,3,1,3,92.10526316
2010020458,16,3505,0.0,23,19,3,2,4,82.60869565
2010020459,29,3810,0.0,30,27,8,0,3,90.0
2010020459,23,3810,0.0,30,28,0,2,2,93.33333333
2010020460,24,2536,0.0,17,17,1,2,0,100.0
2010020460,24,1005,0.0,12,9,0,1,3,75.0
2010020460,2,3600,0.0,32,30,8,1,2,93.75
2010020461,27,3898,0.0,36,33,5,0,3,91.66666667
2010020461,3,3884,0.0,33,30,2,0,3,90.90909091
2010020462,12,3900,0.0,47,45,5,1,2,95.74468085
2010020462,11,3900,0.0,29,27,0,1,2,93.10344828
2010020463,6,3521,0.0,41,37,4,3,4,90.24390244
2010020463,8,3600,0.0,37,34,3,0,3,91.89189189
2010020464,26,3583,0.0,30,25,7,0,5,83.33333333
2010020464,19,3587,0.0,29,25,2,2,4,86.20689655
2010020465,9,3589,0.0,24,23,4,0,1,95.83333333
2010020465,30,3572,0.0,24,22,1,0,2,91.66666667
2010020466,28,3677,0.0,18,15,0,2,3,83.33333333
2010020466,25,3680,0.0,43,39,16,0,4,90.69767442
2010020467,10,2400,0.0,24,20,1,0,4,83.33333333
2010020467,10,1200,0.0,9,8,0,0,1,88.88888889
2010020467,20,3597,0.0,19,17,0,2,2,89.47368421
2010020468,29,2400,0.0,27,21,2,1,6,77.77777778
2010020468,29,1200,0.0,9,9,3,0,0,100.0
2010020468,22,3598,0.0,40,37,7,0,3,92.5
2010020469,18,3600,0.0,16,15,0,0,1,93.75
2010020469,1,3470,0.0,20,17,3,0,3,85.0
2010020470,7,1192,0.0,10,6,1,0,4,60.0
2010020470,7,2400,0.0,16,14,2,0,2,87.5
2010020470,13,3600,0.0,43,41,10,4,2,95.34883721
2010020471,17,3518,0.0,30,27,1,0,3,90.0
2010020471,16,3586,0.0,30,29,0,0,1,96.66666667
2010020472,9,3756,0.0,25,19,2,1,6,76.0
2010020472,21,3756,0.0,29,24,6,0,5,82.75862069
2010020473,3,3600,0.0,39,35,6,1,4,89.74358974
2010020473,4,3600,0.0,25,24,2,0,1,96.0
2010020474,15,3559,0.0,21,18,0,1,3,85.71428571
2010020474,6,3600,0.0,41,39,1,0,2,95.12195122
2010020475,27,3893,0.0,44,41,12,1,3,93.18181818
2010020475,2,3896,0.0,35,32,6,3,3,91.42857143
2010020476,24,3429,0.0,31,28,2,0,3,90.32258065
2010020476,12,3600,0.0,45,43,18,0,2,95.55555556
2010020477,1,1655,0.0,15,11,1,0,4,73.33333333
2010020477,1,1943,0.0,7,4,0,0,3,57.14285714
2010020477,11,3600,0.0,27,26,3,0,1,96.2962963
2010020478,25,3598,0.0,36,35,8,1,1,97.22222222
2010020478,29,3562,2.0,23,21,7,1,2,91.30434783
2010020479,7,3537,0.0,36,34,10,2,2,94.44444444
2010020479,14,3600,0.0,23,22,7,2,1,95.65217391
2010020480,28,3594,0.0,22,21,1,0,1,95.45454545
2010020480,19,3600,0.0,34,30,6,0,4,88.23529412
2010020481,26,3600,0.0,30,29,4,0,1,96.66666667
2010020481,18,2999,0.0,25,22,4,0,3,88.0
2010020481,18,599,0.0,9,6,0,0,3,66.66666667
2010020482,30,3600,0.0,29,28,2,1,1,96.55172414
2010020482,20,3507,0.0,16,13,1,0,3,81.25
2010020483,10,3534,0.0,28,25,11,0,3,89.28571429
2010020483,23,3578,0.0,28,27,6,1,1,96.42857143
2010020484,15,3597,0.0,26,24,9,0,2,92.30769231
2010020484,9,3534,0.0,34,31,12,1,3,91.17647059
2010020485,25,3848,0.0,31,28,4,3,3,90.32258065
2010020485,17,3858,0.0,32,28,7,1,4,87.5
2010020486,26,3560,0.0,24,21,3,0,3,87.5
2010020486,16,3600,0.0,28,26,1,1,2,92.85714286
2010020487,8,3516,0.0,28,25,3,1,3,89.28571429
2010020487,21,3600,2.0,29,27,6,0,2,93.10344828
2010020488,24,3600,0.0,45,45,3,0,0,100.0
2010020488,6,3600,0.0,25,22,2,3,3,88.0
2010020489,11,3600,0.0,40,37,4,0,3,92.5
2010020489,10,849,0.0,4,4,0,0,0,100.0
2010020489,10,2659,0.0,18,13,0,2,5,72.22222222
2010020490,13,3600,0.0,26,26,0,1,0,100.0
2010020490,4,1608,0.0,12,11,3,0,1,91.66666667
2010020490,4,1992,0.0,22,18,2,0,4,81.81818182
2010020491,27,1641,0.0,22,17,4,2,5,77.27272727
2010020491,27,1944,0.0,16,15,1,3,1,93.75
2010020491,5,3600,2.0,27,26,6,0,1,96.2962963
2010020492,12,3593,0.0,34,29,5,0,5,85.29411765
2010020492,14,3600,0.0,22,21,4,0,1,95.45454545
2010020493,23,3600,0.0,16,15,2,2,1,93.75
2010020493,19,3526,0.0,29,26,6,0,3,89.65517241
2010020494,20,3521,0.0,22,19,1,2,3,86.36363636
2010020494,30,3594,2.0,35,34,4,1,1,97.14285714
2010020495,24,3587,0.0,42,37,11,1,5,88.0952381
2010020495,7,3600,0.0,23,21,3,2,2,91.30434783
2010020496,1,3600,2.0,28,23,5,1,5,82.14285714
2010020496,15,3572,0.0,36,35,5,3,1,97.22222222
2010020497,19,3590,2.0,39,37,7,1,2,94.87179487
2010020497,11,3533,0.0,26,23,4,1,3,88.46153846
2010020498,20,3573,0.0,36,34,4,1,2,94.44444444
2010020498,29,3600,0.0,30,29,3,2,1,96.66666667
2010020499,8,3600,0.0,17,12,2,1,5,70.58823529
2010020499,25,3600,0.0,29,27,2,0,2,93.10344828
2010020500,26,3593,0.0,23,23,2,0,0,100.0
2010020500,21,3600,0.0,32,27,0,0,5,84.375
2010020501,22,3510,0.0,30,28,9,0,2,93.33333333
2010020501,28,3600,0.0,27,26,0,0,1,96.2962963
2010020502,14,3802,0.0,28,26,2,1,2,92.85714286
2010020502,2,3803,0.0,35,34,8,0,1,97.14285714
2010020503,13,657,0.0,14,11,5,0,3,78.57142857
2010020503,13,2855,0.0,19,18,4,0,1,94.73684211
2010020503,5,2400,0.0,21,20,4,0,1,95.23809524
2010020503,5,1200,0.0,16,15,4,0,1,93.75
2010020504,23,3779,0.0,45,40,5,0,5,88.88888889
2010020504,17,3775,0.0,39,35,2,0,4,89.74358974
2010020505,18,3594,0.0,35,31,4,0,4,88.57142857
2010020505,16,3600,0.0,25,24,3,0,1,96.0
2010020506,11,3585,0.0,36,32,5,0,4,88.88888889
2010020506,6,3600,0.0,27,26,1,0,1,96.2962963
2010020507,13,3600,0.0,48,45,10,1,3,93.75
2010020507,7,3524,2.0,29,25,4,1,4,86.20689655
2010020508,2,3600,0.0,35,34,7,0,1,97.14285714
2010020508,1,3600,0.0,14,9,0,0,5,64.28571429
2010020509,14,3900,0.0,37,34,2,1,3,91.89189189
2010020509,3,3900,0.0,24,21,0,0,3,87.5
2010020510,5,3856,0.0,34,32,11,0,2,94.11764706
2010020510,15,3900,0.0,27,25,3,0,2,92.59259259
2010020511,8,3600,0.0,24,22,2,0,2,91.66666667
2010020511,12,3539,0.0,29,26,6,0,3,89.65517241
2010020512,23,3600,0.0,27,24,0,2,3,88.88888889
2010020512,29,1634,0.0,8,7,1,0,1,87.5
2010020512,29,1964,0.0,22,16,1,0,6,72.72727273
2010020513,17,3534,0.0,25,21,3,2,4,84.0
2010020513,19,3594,0.0,38,35,6,1,3,92.10526316
2010020514,9,3572,0.0,26,25,5,3,1,96.15384615
2010020514,18,3539,0.0,30,28,5,1,2,93.33333333
2010020515,20,3862,0.0,16,14,0,1,2,87.5
2010020515,25,3900,0.0,33,31,1,0,2,93.93939394
2010020516,30,3600,0.0,37,36,2,0,1,97.2972973
2010020516,21,1353,0.0,14,11,0,2,3,78.57142857
2010020516,21,2158,0.0,18,18,2,0,0,100.0
2010020517,22,3900,0.0,29,27,6,0,2,93.10344828
2010020517,26,3900,0.0,29,27,2,0,2,93.10344828
2010020518,27,3600,0.0,39,35,15,0,4,89.74358974
2010020518,28,3599,0.0,25,24,2,0,1,96.0
2010020519,5,3472,0.0,24,21,2,1,3,87.5
2010020519,9,3574,0.0,45,44,3,0,1,97.77777778
2010020520,10,3600,0.0,30,29,9,0,1,96.66666667
2010020520,1,2395,0.0,14,11,0,0,3,78.57142857
2010020520,1,1200,0.0,8,7,3,0,1,87.5
2010020521,8,3600,0.0,25,21,9,1,4,84.0
2010020521,2,3584,0.0,39,38,3,2,1,97.43589744
2010020522,15,3598,0.0,35,33,2,0,2,94.28571429
2010020522,12,3519,0.0,30,27,9,0,3,90.0
2010020523,14,3668,0.0,28,26,1,1,2,92.85714286
2010020523,11,3670,0.0,34,31,5,1,3,91.17647059
2010020524,29,3597,0.0,25,21,3,0,4,84.0
2010020524,16,3600,0.0,27,26,7,1,1,96.2962963
2010020525,18,3556,0.0,25,24,0,0,1,96.0
2010020525,19,3600,0.0,32,32,0,1,0,100.0
2010020526,17,3597,0.0,17,16,4,0,1,94.11764706
2010020526,30,3596,0.0,27,23,5,1,4,85.18518519
2010020527,27,3600,0.0,30,30,3,2,0,100.0
2010020527,25,3517,0.0,25,24,2,1,1,96.0
2010020528,22,3579,0.0,33,30,3,3,3,90.90909091
2010020528,23,3600,0.0,21,19,1,0,2,90.47619048
2010020529,24,2277,0.0,23,19,2,0,4,82.60869565
2010020529,24,1323,0.0,7,7,2,0,0,100.0
2010020529,26,3599,0.0,19,18,2,0,1,94.73684211
2010020530,2,3600,0.0,52,45,8,0,7,86.53846154
2010020530,3,3600,0.0,20,18,2,1,2,90.0
2010020531,30,3896,0.0,22,19,0,0,3,86.36363636
2010020531,29,3900,0.0,40,37,9,0,3,92.5
2010020532,6,3900,2.0,34,32,1,0,2,94.11764706
2010020532,13,3900,0.0,42,40,2,0,2,95.23809524
2010020533,17,3816,0.0,49,46,15,1,3,93.87755102
2010020533,21,3819,2.0,30,26,7,0,4,86.66666667
2010020534,7,3521,0.0,33,28,3,0,5,84.84848485
2010020534,20,3600,0.0,27,25,2,1,2,92.59259259
2010020535,26,3600,0.0,24,24,4,1,0,100.0
2010020535,28,3598,0.0,37,33,2,0,4,89.18918919
2010020536,12,3600,0.0,37,34,6,1,3,91.89189189
2010020536,10,3501,0.0,27,23,4,1,4,85.18518519
2010020537,11,3600,0.0,36,30,3,2,6,83.33333333
2010020537,5,3586,0.0,34,31,13,3,3,91.17647059
2010020538,8,3548,0.0,29,27,15,0,2,93.10344828
2010020538,15,3585,0.0,25,25,9,2,0,100.0
2010020539,6,3600,0.0,34,31,3,1,3,91.17647059
2010020539,14,3566,0.0,29,25,2,1,4,86.20689655
2010020540,16,3462,0.0,43,40,8,3,3,93.02325581
2010020540,19,3600,0.0,26,25,1,2,1,96.15384615
2010020541,25,3600,0.0,46,44,13,0,2,95.65217391
2010020541,18,3532,0.0,25,21,2,0,4,84.0
2010020542,7,3600,0.0,31,29,8,0,2,93.5483871
2010020542,22,3543,0.0,20,17,0,1,3,85.0
2010020543,24,3600,0.0,32,31,7,0,1,96.875
2010020543,27,3537,0.0,24,21,5,0,3,87.5
2010020544,4,1521,0.0,28,24,8,0,4,85.71428571
2010020544,4,2079,0.0,21,19,4,0,2,90.47619048
2010020544,23,3600,0.0,37,35,3,1,2,94.59459459
2010020545,3,3600,0.0,44,43,6,1,1,97.72727273
2010020545,1,3545,0.0,25,23,6,0,2,92.0
2010020546,5,3899,0.0,26,25,3,0,1,96.15384615
2010020546,2,3900,0.0,38,37,2,2,1,97.36842105
2010020547,12,3600,0.0,37,37,6,2,0,100.0
2010020547,9,3600,0.0,31,27,6,0,4,87.09677419
2010020548,28,3476,0.0,24,19,6,0,5,79.16666667
2010020548,30,3576,0.0,32,29,5,3,3,90.625
2010020549,17,3584,0.0,31,28,5,0,3,90.32258065
2010020549,25,3517,0.0,25,19,0,0,6,76.0
2010020550,26,1802,0.0,18,12,2,0,6,66.66666667
2010020550,26,1797,0.0,13,13,3,0,0,100.0
2010020550,27,3573,0.0,26,23,3,1,3,88.46153846
2010020551,29,3600,0.0,22,20,0,1,2,90.90909091
2010020551,10,3509,0.0,32,29,0,0,3,90.625
2010020552,6,3900,0.0,32,30,4,2,2,93.75
2010020552,11,3882,0.0,44,42,8,1,2,95.45454545
2010020553,8,3130,0.0,20,16,5,1,4,80.0
2010020553,8,470,0.0,3,3,2,0,0,100.0
2010020553,14,3600,0.0,28,27,6,4,1,96.42857143
2010020554,28,3600,0.0,29,26,4,0,3,89.65517241
2010020554,16,3533,0.0,24,20,9,0,4,83.33333333
2010020555,21,3882,0.0,35,32,7,0,3,91.42857143
2010020555,22,3885,0.0,27,24,1,1,3,88.88888889
2010020556,4,3587,0.0,36,32,6,0,4,88.88888889
2010020556,26,1543,0.0,6,5,0,0,1,83.33333333
2010020556,26,1992,0.0,22,16,6,2,6,72.72727273
2010020557,11,3491,0.0,28,25,0,0,3,89.28571429
2010020557,1,3600,0.0,29,28,4,0,1,96.55172414
2010020558,8,3821,2.0,22,20,6,0,2,90.90909091
2010020558,13,3799,0.0,48,45,9,1,3,93.75
2010020559,18,3588,0.0,23,22,7,1,1,95.65217391
2010020559,30,3528,0.0,30,28,1,1,2,93.33333333
2010020560,2,3835,0.0,41,38,7,0,3,92.68292683
2010020560,17,3837,0.0,23,19,0,0,4,82.60869565
2010020561,9,3701,0.0,23,19,5,1,4,82.60869565
2010020561,29,3726,0.0,38,35,4,1,3,92.10526316
2010020562,27,3519,0.0,22,18,1,2,4,81.81818182
2010020562,19,3600,0.0,33,30,2,0,3,90.90909091
2010020563,4,3591,0.0,27,22,3,0,5,81.48148148
2010020563,24,3600,0.0,37,35,3,0,2,94.59459459
2010020564,23,3567,0.0,45,44,13,1,1,97.77777778
2010020564,25,1390,0.0,8,8,3,1,0,100.0
2010020564,25,2210,0.0,14,10,2,1,4,71.42857143
2010020565,21,3510,0.0,23,20,3,0,3,86.95652174
2010020565,20,3599,0.0,21,19,3,3,2,90.47619048
2010020566,15,3600,0.0,33,32,9,1,1,96.96969697
2010020566,5,3528,0.0,32,29,3,1,3,90.625
2010020567,6,1200,0.0,16,13,2,0,3,81.25
2010020567,6,2700,0.0,19,16,3,1,3,84.21052632
2010020567,7,3841,0.0,40,34,3,0,6,85.0
2010020568,10,3596,0.0,33,32,6,0,1,96.96969697
2010020568,9,2630,0.0,14,12,4,1,2,85.71428571
2010020568,9,970,0.0,7,4,1,0,3,57.14285714
2010020569,1,480,0.0,7,4,2,0,3,57.14285714
2010020569,1,3120,0.0,18,15,5,0,3,83.33333333
2010020569,12,3600,0.0,28,25,1,3,3,89.28571429
2010020570,3,3604,0.0,33,31,6,1,2,93.93939394
2010020570,14,3619,0.0,35,34,4,3,1,97.14285714
2010020571,28,3600,0.0,29,29,6,0,0,100.0
2010020571,26,3540,0.0,19,18,2,1,1,94.73684211
2010020572,20,3600,0.0,17,16,0,0,1,94.11764706
2010020572,22,3530,2.0,30,28,3,0,2,93.33333333
2010020573,11,3823,0.0,50,47,3,1,3,94.0
2010020573,8,3823,0.0,28,24,3,4,4,85.71428571
2010020574,3,3526,0.0,35,33,7,1,2,94.28571429
2010020574,13,3600,0.0,32,32,2,1,0,100.0
2010020575,4,3600,0.0,27,25,1,0,2,92.59259259
2010020575,17,2400,0.0,27,24,2,0,3,88.88888889
2010020575,17,1134,2.0,5,5,1,0,0,100.0
2010020576,25,3600,0.0,30,28,2,0,2,93.33333333
2010020576,19,3531,0.0,27,23,1,0,4,85.18518519
2010020577,29,3600,0.0,26,22,4,0,4,84.61538462
2010020577,18,3596,0.0,20,19,2,0,1,95.0
2010020578,27,3646,0.0,29,23,1,0,6,79.31034483
2010020578,30,3599,0.0,44,39,1,0,5,88.63636364
2010020579,23,3597,0.0,32,31,5,0,1,96.875
2010020579,21,3521,0.0,29,27,5,1,2,93.10344828
2010020580,16,3529,0.0,18,16,4,0,2,88.88888889
2010020580,24,3595,0.0,40,39,2,1,1,97.5
2010020581,6,3600,0.0,37,36,0,3,1,97.2972973
2010020581,10,3536,0.0,33,31,1,0,2,93.93939394
2010020582,13,3676,0.0,37,34,6,1,3,91.89189189
2010020582,12,3651,0.0,28,24,3,1,4,85.71428571
2010020583,2,2060,0.0,29,28,7,0,1,96.55172414
2010020583,2,1533,0.0,14,13,4,0,1,92.85714286
2010020583,20,3544,0.0,25,21,1,0,4,84.0
2010020584,16,3600,0.0,29,26,7,0,3,89.65517241
2010020584,26,3566,0.0,28,24,4,0,4,85.71428571
2010020585,23,3567,0.0,35,32,5,0,3,91.42857143
2010020585,28,3495,0.0,47,43,6,0,4,91.4893617
2010020586,30,3600,0.0,22,21,3,0,1,95.45454545
2010020586,1,3547,0.0,18,16,0,0,2,88.88888889
2010020587,14,3774,0.0,34,34,6,0,0,100.0
2010020587,15,3754,0.0,38,37,5,1,1,97.36842105
2010020588,7,3855,0.0,34,30,7,1,4,88.23529412
2010020588,21,3857,0.0,40,37,16,0,3,92.5
2010020589,17,3600,0.0,25,22,5,1,3,88.0
2010020589,22,3493,0.0,37,32,5,2,5,86.48648649
2010020590,29,3510,0.0,33,29,6,1,4,87.87878788
2010020590,27,3598,0.0,28,26,2,1,2,92.85714286
2010020591,12,3789,0.0,35,33,9,0,2,94.28571429
2010020591,3,3782,0.0,32,31,7,0,1,96.875
2010020592,14,1963,0.0,18,15,1,0,3,83.33333333
2010020592,14,1637,0.0,23,18,4,0,5,78.26086957
2010020592,5,3600,0.0,32,31,2,1,1,96.875
2010020593,11,3600,0.0,35,33,0,2,2,94.28571429
2010020593,13,1587,0.0,15,12,3,0,3,80.0
2010020593,13,1919,0.0,16,16,10,1,0,100.0
2010020594,25,3593,0.0,37,35,6,0,2,94.59459459
2010020594,16,3481,0.0,21,18,2,0,3,85.71428571
2010020595,20,3475,0.0,21,18,3,0,3,85.71428571
2010020595,23,3600,0.0,44,43,5,1,1,97.72727273
2010020596,18,3600,2.0,41,40,5,1,1,97.56097561
2010020596,24,3526,0.0,22,20,4,0,2,90.90909091
2010020597,30,3600,0.0,36,35,4,0,1,97.22222222
2010020597,6,3564,0.0,33,31,1,2,2,93.93939394
2010020598,19,1929,0.0,19,15,0,0,4,78.94736842
2010020598,19,1965,0.0,12,11,3,0,1,91.66666667
2010020598,10,3900,0.0,44,39,5,1,5,88.63636364
2010020599,4,3600,0.0,20,18,0,2,2,90.0
2010020599,1,3526,0.0,20,16,2,0,4,80.0
2010020600,5,3900,2.0,23,22,2,2,1,95.65217391
2010020600,8,3900,0.0,32,31,3,3,1,96.875
2010020601,27,3600,0.0,34,34,1,2,0,100.0
2010020601,21,3548,0.0,32,31,2,0,1,96.875
2010020602,2,317,0.0,3,1,0,0,2,33.33333333
2010020602,2,3223,0.0,19,19,1,0,0,100.0
2010020602,22,3574,2.0,31,30,15,0,1,96.77419355
2010020603,18,3600,0.0,26,24,2,0,2,92.30769231
2010020603,26,3583,0.0,28,23,1,0,5,82.14285714
2010020604,7,3600,0.0,36,36,9,1,0,100.0
2010020604,28,3594,0.0,22,19,4,0,3,86.36363636
2010020605,10,3572,0.0,44,41,13,0,3,93.18181818
2010020605,11,2045,0.0,24,19,3,1,5,79.16666667
2010020605,11,1549,0.0,10,6,3,0,4,60.0
2010020606,12,3600,0.0,35,32,5,2,3,91.42857143
2010020606,13,3542,0.0,34,30,6,0,4,88.23529412
2010020607,9,3893,0.0,26,24,0,0,2,92.30769231
2010020607,16,3900,0.0,26,24,0,0,2,92.30769231
2010020608,3,3900,0.0,30,28,3,1,2,93.33333333
2010020608,25,3900,0.0,31,29,5,1,2,93.5483871
2010020609,17,3895,0.0,39,35,6,2,4,89.74358974
2010020609,20,3863,0.0,27,23,7,1,4,85.18518519
2010020610,22,3600,0.0,34,28,2,1,6,82.35294118
2010020610,23,3587,0.0,24,23,6,0,1,95.83333333
2010020611,29,2820,0.0,24,20,3,0,4,83.33333333
2010020611,29,780,0.0,5,3,1,0,2,60.0
2010020611,24,3585,0.0,27,27,2,0,0,100.0
2010020612,1,2640,0.0,19,19,5,0,0,100.0
2010020612,1,881,0.0,10,8,2,0,2,80.0
2010020612,4,3585,0.0,35,34,4,0,1,97.14285714
2010020613,2,3832,0.0,37,34,3,0,3,91.89189189
2010020613,21,3726,0.0,27,23,3,0,4,85.18518519
2010020614,6,3818,0.0,42,39,8,1,3,92.85714286
2010020614,8,3786,0.0,29,27,2,1,2,93.10344828
2010020615,14,3586,0.0,32,31,2,0,1,96.875
2010020615,9,3562,0.0,27,25,9,1,2,92.59259259
2010020616,30,3600,0.0,26,26,2,3,0,100.0
2010020616,5,3579,0.0,36,33,12,2,3,91.66666667
2010020617,13,3510,0.0,27,24,1,2,3,88.88888889
2010020617,15,3600,0.0,27,25,7,1,2,92.59259259
2010020618,3,3600,0.0,25,24,10,1,1,96.0
2010020618,19,3584,0.0,24,22,5,1,2,91.66666667
2010020619,7,3792,0.0,34,33,3,0,1,97.05882353
2010020619,27,3780,0.0,32,30,4,0,2,93.75
2010020620,18,3600,0.0,43,42,4,0,1,97.6744186
2010020620,28,3504,0.0,26,24,0,0,2,92.30769231
2010020621,17,3900,0.0,35,34,6,2,1,97.14285714
2010020621,23,3900,0.0,33,32,5,1,1,96.96969697
2010020622,29,3565,0.0,35,30,7,1,5,85.71428571
2010020622,26,3600,0.0,34,30,4,4,4,88.23529412
2010020623,11,3720,0.0,34,30,1,2,4,88.23529412
2010020623,12,3729,0.0,28,25,6,0,3,89.28571429
2010020624,14,3518,0.0,24,20,5,0,4,83.33333333
2010020624,1,3590,0.0,36,33,3,1,3,91.66666667
2010020625,25,3579,0.0,26,26,0,2,0,100.0
2010020625,30,3595,0.0,28,24,4,0,4,85.71428571
2010020626,2,3600,0.0,45,40,7,0,5,88.88888889
2010020626,16,3600,0.0,29,29,3,0,0,100.0
2010020627,28,3566,0.0,28,27,7,0,1,96.42857143
2010020627,24,3600,0.0,37,37,6,0,0,100.0
2010020628,6,3600,0.0,25,23,5,1,2,92.0
2010020628,5,3584,0.0,31,28,4,3,3,90.32258065
2010020629,27,3600,0.0,36,33,6,1,3,91.66666667
2010020629,19,3549,0.0,33,29,6,0,4,87.87878788
2010020630,17,855,0.0,10,6,2,0,4,60.0
2010020630,17,2671,0.0,16,15,3,1,1,93.75
2010020630,21,3600,0.0,30,26,3,0,4,86.66666667
2010020631,10,3600,0.0,32,30,5,0,2,93.75
2010020631,26,3493,0.0,28,25,3,0,3,89.28571429
2010020632,9,1200,0.0,12,11,4,0,1,91.66666667
2010020632,9,2400,0.0,27,22,0,2,5,81.48148148
2010020632,6,3600,0.0,31,31,3,0,0,100.0
2010020633,4,3600,0.0,40,38,1,0,2,95.0
2010020633,7,3589,0.0,32,28,3,0,4,87.5
2010020634,23,3900,0.0,41,38,1,1,3,92.68292683
2010020634,2,3900,0.0,51,48,4,1,3,94.11764706
2010020635,8,3600,0.0,26,25,0,0,1,96.15384615
2010020635,3,3532,0.0,38,36,3,1,2,94.73684211
2010020636,20,2363,0.0,22,21,2,0,1,95.45454545
2010020636,20,1537,0.0,8,4,1,0,4,50.0
2010020636,12,3900,0.0,32,27,1,1,5,84.375
2010020637,27,3591,0.0,40,37,8,1,3,92.5
2010020637,29,3501,0.0,28,24,6,1,4,85.71428571
2010020638,15,3771,0.0,41,37,7,0,4,90.24390244
2010020638,13,3759,0.0,33,30,9,0,3,90.90909091
2010020639,30,561,0.0,5,4,0,0,1,80.0
2010020639,30,3039,0.0,25,21,3,0,4,84.0
2010020639,18,3600,0.0,26,25,7,0,1,96.15384615
2010020640,22,3503,0.0,20,17,2,0,3,85.0
2010020640,25,3600,0.0,41,39,5,3,2,95.12195122
2010020641,10,3600,0.0,42,40,8,0,2,95.23809524
2010020641,28,3552,0.0,25,22,4,1,3,88.0
2010020642,5,3600,0.0,22,20,1,1,2,90.90909091
2010020642,8,3600,0.0,36,31,9,1,5,86.11111111
2010020643,15,3600,0.0,38,35,8,0,3,92.10526316
2010020643,14,3600,0.0,23,23,4,0,0,100.0
2010020644,21,3600,0.0,31,27,2,0,4,87.09677419
2010020644,16,3598,0.0,24,24,5,1,0,100.0
2010020645,19,3600,0.0,24,17,4,0,7,70.83333333
2010020645,24,3600,0.0,34,30,5,1,4,88.23529412
2010020646,4,3550,0.0,36,30,10,0,6,83.33333333
2010020646,6,3600,0.0,35,30,3,2,5,85.71428571
2010020647,12,3486,0.0,35,32,2,0,3,91.42857143
2010020647,7,3600,0.0,29,27,4,0,2,93.10344828
2010020648,9,3600,0.0,24,20,1,1,4,83.33333333
2010020648,2,1810,0.0,19,15,0,2,4,78.94736842
2010020648,2,1763,0.0,19,17,3,0,2,89.47368421
2010020649,23,3531,0.0,35,34,9,1,1,97.14285714
2010020649,3,3600,0.0,31,31,5,0,0,100.0
2010020650,18,3501,0.0,34,31,2,2,3,91.17647059
2010020650,13,3600,0.0,29,27,2,0,2,93.10344828
2010020651,10,3490,0.0,20,16,4,0,4,80.0
2010020651,27,3583,0.0,29,28,7,3,1,96.55172414
2010020652,19,3600,0.0,25,24,3,0,1,96.0
2010020652,26,3553,0.0,21,18,1,0,3,85.71428571
2010020653,22,3600,0.0,43,41,12,1,2,95.34883721
2010020653,28,3519,0.0,28,24,7,1,4,85.71428571
2010020654,23,3600,0.0,27,25,3,0,2,92.59259259
2010020654,15,3549,0.0,34,31,1,0,3,91.17647059
2010020655,17,763,0.0,11,9,2,0,2,81.81818182
2010020655,17,3137,0.0,21,21,6,0,0,100.0
2010020655,29,3900,0.0,28,26,6,1,2,92.85714286
2010020656,20,3600,0.0,35,33,6,0,2,94.28571429
2010020656,9,3490,0.0,26,23,2,1,3,88.46153846
2010020657,4,3600,0.0,29,27,5,1,2,93.10344828
2010020657,11,3581,0.0,35,31,4,0,4,88.57142857
2010020658,1,3600,0.0,32,30,1,1,2,93.75
2010020658,14,2646,0.0,16,15,2,1,1,93.75
2010020658,14,954,0.0,9,5,0,0,4,55.55555556
2010020659,21,3600,0.0,33,32,4,0,1,96.96969697
2010020659,30,3563,0.0,17,14,3,2,3,82.35294118
2010020660,5,3600,0.0,46,44,6,0,2,95.65217391
2010020660,6,3523,0.0,36,33,0,2,3,91.66666667
2010020661,20,3900,0.0,33,32,7,0,1,96.96969697
2010020661,10,3825,2.0,33,32,4,0,1,96.96969697
2010020662,3,3513,2.0,41,38,10,1,3,92.68292683
2010020662,8,3600,0.0,33,31,5,0,2,93.93939394
2010020663,7,3492,0.0,37,32,5,0,5,86.48648649
2010020663,2,3600,0.0,43,40,3,0,3,93.02325581
2010020664,14,3514,0.0,30,25,7,2,5,83.33333333
2010020664,12,3595,0.0,34,30,4,0,4,88.23529412
2010020665,1,3816,0.0,22,19,2,0,3,86.36363636
2010020665,13,3812,0.0,35,33,7,0,2,94.28571429
2010020666,29,3632,0.0,34,28,1,0,6,82.35294118
2010020666,17,3645,0.0,30,25,3,0,5,83.33333333
2010020667,16,3900,0.0,26,24,1,0,2,92.30769231
2010020667,18,3892,0.0,33,31,1,2,2,93.93939394
2010020668,11,3132,0.0,24,18,6,0,6,75.0
2010020668,11,468,0.0,3,3,0,0,0,100.0
2010020668,25,3600,0.0,30,29,4,1,1,96.66666667
2010020669,24,2299,0.0,26,22,7,0,4,84.61538462
2010020669,24,1301,0.0,8,6,1,1,2,75.0
2010020669,27,3600,0.0,28,26,3,2,2,92.85714286
2010020670,22,3583,0.0,22,18,3,2,4,81.81818182
2010020670,26,3579,0.0,26,24,5,0,2,92.30769231
2010020671,19,3505,0.0,29,25,7,0,4,86.20689655
2010020671,28,3585,0.0,30,28,2,0,2,93.33333333
2010020672,9,3476,0.0,26,23,2,0,3,88.46153846
2010020672,15,3600,0.0,23,22,0,0,1,95.65217391
2010020673,23,3584,0.0,25,21,8,0,4,84.0
2010020673,30,3600,0.0,32,32,4,1,0,100.0
2010020674,4,3600,0.0,36,34,1,4,2,94.44444444
2010020674,3,3499,0.0,27,24,1,0,3,88.88888889
2010020675,18,3592,0.0,34,28,6,2,6,82.35294118
2010020675,16,3575,0.0,23,20,5,0,3,86.95652174
2010020676,22,3491,0.0,28,25,6,1,3,89.28571429
2010020676,24,173,0.0,3,3,0,0,0,100.0
2010020676,24,3427,0.0,25,23,7,0,2,92.0
2010020677,12,688,0.0,5,3,0,0,2,60.0
2010020677,12,2912,4.0,33,28,3,3,5,84.84848485
2010020677,6,3589,0.0,31,31,6,2,0,100.0
2010020678,1,3585,0.0,29,27,4,1,2,93.10344828
2010020678,2,3600,0.0,27,22,0,0,5,81.48148148
2010020679,28,3598,0.0,36,34,12,0,2,94.44444444
2010020679,27,3524,0.0,35,32,3,2,3,91.42857143
2010020680,20,2072,0.0,12,11,0,0,1,91.66666667
2010020680,20,1594,0.0,17,13,3,1,4,76.47058824
2010020680,8,1090,0.0,4,4,0,0,0,100.0
2010020680,8,2576,0.0,24,20,4,1,4,83.33333333
2010020681,11,3864,0.0,40,38,7,1,2,95.0
2010020681,13,3900,0.0,30,28,2,0,2,93.33333333
2010020682,26,3518,0.0,27,25,6,0,2,92.59259259
2010020682,25,3574,0.0,24,23,2,1,1,95.83333333
2010020683,8,3669,0.0,39,37,9,0,2,94.87179487
2010020683,7,3669,0.0,30,29,0,0,1,96.66666667
2010020684,15,1200,0.0,8,7,0,0,1,87.5
2010020684,15,2467,0.0,22,20,0,0,2,90.90909091
2010020684,4,3667,0.0,25,23,0,0,2,92.0
2010020685,17,3570,0.0,28,25,0,0,3,89.28571429
2010020685,5,3600,0.0,37,36,4,0,1,97.2972973
2010020686,6,3600,2.0,45,43,13,0,2,95.55555556
2010020686,12,3544,0.0,28,25,6,0,3,89.28571429
2010020687,24,3900,0.0,40,39,5,0,1,97.5
2010020687,9,3900,0.0,27,26,0,0,1,96.2962963
2010020688,29,3899,0.0,22,20,2,0,2,90.90909091
2010020688,14,3900,0.0,30,28,4,0,2,93.33333333
2010020689,26,3542,0.0,26,24,6,1,2,92.30769231
2010020689,19,3589,0.0,27,26,5,0,1,96.2962963
2010020690,23,3772,0.0,30,26,6,0,4,86.66666667
2010020690,21,3772,0.0,43,40,6,3,3,93.02325581
2010020691,30,3600,0.0,32,31,8,1,1,96.875
2010020691,22,3600,0.0,26,22,2,1,4,84.61538462
2010020692,18,3600,0.0,34,32,3,2,2,94.11764706
2010020692,27,3600,0.0,21,16,0,0,5,76.19047619
2010020693,10,399,0.0,3,2,0,0,1,66.66666667
2010020693,10,3191,0.0,25,19,0,1,6,76.0
2010020693,3,3600,0.0,22,22,1,0,0,100.0
2010020694,29,3787,0.0,31,29,2,0,2,93.5483871
2010020694,13,3846,0.0,38,35,4,2,3,92.10526316
2010020695,30,3600,0.0,37,37,6,2,0,100.0
2010020695,20,3586,0.0,24,18,4,0,6,75.0
2010020696,7,3600,0.0,40,38,5,3,2,95.0
2010020696,6,3484,0.0,33,29,5,1,4,87.87878788
2010020697,24,3600,0.0,37,32,3,3,5,86.48648649
2010020697,10,3600,0.0,28,26,1,0,2,92.85714286
2010020698,5,3557,0.0,20,18,4,0,2,90.0
2010020698,1,3600,0.0,23,23,2,2,0,100.0
2010020699,15,3592,0.0,25,24,8,0,1,96.0
2010020699,2,3508,0.0,24,22,4,0,2,91.66666667
2010020700,9,446,0.0,1,1,1,0,0,100.0
2010020700,9,3154,0.0,22,16,0,1,6,72.72727273
2010020700,4,3600,0.0,27,25,2,0,2,92.59259259
2010020701,3,3588,0.0,39,35,3,1,4,89.74358974
2010020701,12,3600,0.0,40,39,2,0,1,97.5
2010020702,14,3898,0.0,29,27,2,1,2,93.10344828
2010020702,11,3900,0.0,31,29,1,0,2,93.5483871
2010020703,17,3711,0.0,29,26,2,1,3,89.65517241
2010020703,19,3700,0.0,29,25,0,0,4,86.20689655
2010020704,18,3599,0.0,33,32,1,0,1,96.96969697
2010020704,21,3600,0.0,28,23,3,0,5,82.14285714
2010020705,25,3575,0.0,32,30,8,4,2,93.75
2010020705,22,3544,0.0,23,20,4,0,3,86.95652174
2010020706,28,3900,0.0,37,36,9,0,1,97.2972973
2010020706,23,3895,0.0,46,45,9,2,1,97.82608696
2010020707,27,3600,0.0,36,36,10,0,0,100.0
2010020707,26,3500,0.0,15,13,3,0,2,86.66666667
2010020708,2,1200,0.0,10,10,5,0,0,100.0
2010020708,2,2400,0.0,28,26,0,1,2,92.85714286
2010020708,7,630,0.0,10,8,2,0,2,80.0
2010020708,7,2917,0.0,18,16,2,0,2,88.88888889
2010020709,8,3590,0.0,34,33,5,0,1,97.05882353
2010020709,9,1533,0.0,15,11,0,0,4,73.33333333
2010020709,9,2067,0.0,20,17,4,1,3,85.0
2010020710,14,3899,0.0,30,29,14,0,1,96.66666667
2010020710,13,3900,0.0,21,20,1,1,1,95.23809524
2010020711,25,3600,0.0,19,12,2,1,7,63.15789474
2010020711,20,3600,0.0,21,17,4,0,4,80.95238095
2010020712,1,3600,0.0,27,26,1,2,1,96.2962963
2010020712,4,3528,0.0,21,19,0,0,2,90.47619048
2010020713,16,3600,0.0,37,36,5,0,1,97.2972973
2010020713,17,3600,0.0,33,29,2,1,4,87.87878788
2010020714,6,3600,0.0,34,32,8,1,2,94.11764706
2010020714,21,2400,0.0,28,24,4,0,4,85.71428571
2010020714,21,1115,0.0,11,10,0,0,1,90.90909091
2010020715,15,3600,0.0,36,35,4,2,1,97.22222222
2010020715,10,3455,0.0,30,27,3,1,3,90.0
2010020716,24,3891,0.0,40,37,14,2,3,92.5
2010020716,8,3838,0.0,26,23,9,0,3,88.46153846
2010020717,12,3543,0.0,31,28,4,1,3,90.32258065
2010020717,5,3600,0.0,26,24,4,2,2,92.30769231
2010020718,3,3900,0.0,22,20,3,0,2,90.90909091
2010020718,11,3854,0.0,31,29,4,0,2,93.5483871
2010020719,29,3600,0.0,21,19,1,0,2,90.47619048
2010020719,19,3542,0.0,29,25,4,0,4,86.20689655
2010020720,26,3598,0.0,26,23,0,0,3,88.46153846
2010020720,27,3504,0.0,33,29,6,0,4,87.87878788
2010020721,20,3900,0.0,44,41,10,1,3,93.18181818
2010020721,23,3900,0.0,33,30,7,1,3,90.90909091
2010020722,30,3529,0.0,42,38,5,1,4,90.47619048
2010020722,28,3594,0.0,26,23,6,1,3,88.46153846
2010020723,13,2389,0.0,14,12,5,0,2,85.71428571
2010020723,13,1200,0.0,8,6,0,0,2,75.0
2010020723,1,3580,0.0,26,24,0,0,2,92.30769231
2010020724,7,3600,0.0,34,31,5,0,3,91.17647059
2010020724,2,3570,0.0,22,18,2,1,4,81.81818182
2010020725,4,3598,0.0,31,30,1,1,1,96.77419355
2010020725,16,3554,0.0,33,30,4,1,3,90.90909091
2010020726,11,1539,0.0,19,16,0,1,3,84.21052632
2010020726,11,2061,0.0,20,16,3,0,4,80.0
2010020726,14,3600,0.0,22,21,1,1,1,95.45454545
2010020727,18,3868,0.0,24,22,5,0,2,91.66666667
2010020727,22,3900,0.0,28,26,5,1,2,92.85714286
2010020728,3,3900,0.0,23,22,1,0,1,95.65217391
2010020728,15,3900,0.0,29,28,4,0,1,96.55172414
2010020729,10,3552,0.0,27,22,5,2,5,81.48148148
2010020729,12,3596,0.0,30,26,7,1,4,86.66666667
2010020730,18,3518,0.0,27,24,8,0,3,88.88888889
2010020730,20,3600,0.0,24,23,2,1,1,95.83333333
2010020731,19,3486,0.0,32,28,6,0,4,87.5
2010020731,21,3600,0.0,24,21,1,0,3,87.5
2010020732,25,408,0.0,3,3,1,0,0,100.0
2010020732,25,3192,0.0,33,26,9,1,7,78.78787879
2010020732,23,3600,0.0,26,25,2,0,1,96.15384615
2010020733,6,3503,0.0,34,32,4,0,2,94.11764706
2010020733,26,3600,0.0,34,34,6,0,0,100.0
2010020734,13,3600,0.0,35,32,7,1,3,91.42857143
2010020734,3,3502,0.0,17,13,1,1,4,76.47058824
2010020735,8,3526,0.0,34,30,3,1,4,88.23529412
2010020735,4,3566,0.0,31,29,4,0,2,93.5483871
2010020736,2,3544,0.0,31,30,2,0,1,96.77419355
2010020736,5,3600,0.0,29,29,3,0,0,100.0
2010020737,24,3600,0.0,37,35,8,3,2,94.59459459
2010020737,29,3494,0.0,22,19,2,0,3,86.36363636
2010020738,7,3719,2.0,29,27,7,0,2,93.10344828
2010020738,9,3719,0.0,26,23,3,1,3,88.46153846
2010020739,10,3503,0.0,31,29,6,0,2,93.5483871
2010020739,14,3600,0.0,26,26,0,1,0,100.0
2010020740,30,3600,0.0,33,31,0,0,2,93.93939394
2010020740,16,3492,0.0,22,18,2,0,4,81.81818182
2010020741,22,3600,0.0,27,24,0,0,3,88.88888889
2010020741,27,3586,0.0,35,31,2,1,4,88.57142857
2010020742,13,3529,0.0,35,33,2,2,2,94.28571429
2010020742,6,3600,0.0,35,34,1,0,1,97.14285714
2010020743,12,3600,0.0,25,23,2,2,2,92.0
2010020743,2,3563,0.0,31,27,8,0,4,87.09677419
2010020744,15,3538,0.0,24,23,4,0,1,95.83333333
2010020744,11,3600,0.0,36,36,7,0,0,100.0
2010020745,1,3572,0.0,29,26,4,1,3,89.65517241
2010020745,17,3600,0.0,24,23,2,0,1,95.83333333
2010020746,22,3521,4.0,21,18,3,0,3,85.71428571
2010020746,25,3587,0.0,35,34,6,2,1,97.14285714
2010020747,27,3600,0.0,31,29,7,2,2,93.5483871
2010020747,21,2709,0.0,27,25,11,0,2,92.59259259
2010020747,21,839,0.0,9,7,0,1,2,77.77777778
2010020748,19,3510,0.0,19,16,0,0,3,84.21052632
2010020748,20,3588,0.0,29,28,2,1,1,96.55172414
2010020749,18,3540,2.0,35,33,5,0,2,94.28571429
2010020749,23,3598,0.0,27,26,5,1,1,96.2962963
2010020750,28,3873,0.0,20,18,2,0,2,90.0
2010020750,26,3900,0.0,24,22,4,0,2,91.66666667
2010020751,13,3900,0.0,25,22,2,0,3,88.0
2010020751,10,3900,0.0,33,30,3,2,3,90.90909091
2010020752,9,3533,0.0,33,31,3,2,2,93.93939394
2010020752,1,3600,0.0,16,15,1,0,1,93.75
2010020753,5,3900,0.0,29,26,5,0,3,89.65517241
2010020753,3,3893,0.0,26,23,0,1,3,88.46153846
2010020754,8,3888,0.0,29,27,3,3,2,93.10344828
2010020754,15,3900,0.0,38,36,11,0,2,94.73684211
2010020755,6,3600,0.0,26,24,7,0,2,92.30769231
2010020755,12,3524,0.0,33,30,0,2,3,90.90909091
2010020756,2,3600,0.0,26,25,1,0,1,96.15384615
2010020756,11,3568,0.0,33,29,1,0,4,87.87878788
2010020757,16,3600,0.0,33,29,4,0,4,87.87878788
2010020757,29,2400,0.0,22,17,3,2,5,77.27272727
2010020757,29,1138,0.0,4,3,0,0,1,75.0
2010020758,4,2397,0.0,16,15,1,0,1,93.75
2010020758,4,1192,0.0,6,3,0,1,3,50.0
2010020758,14,3600,0.0,38,38,4,1,0,100.0
2010020759,21,3600,0.0,45,42,0,1,3,93.33333333
2010020759,19,3515,0.0,27,23,4,0,4,85.18518519
2010020760,20,3900,2.0,27,25,8,0,2,92.59259259
2010020760,18,3886,0.0,28,26,6,0,2,92.85714286
2010020761,26,3900,0.0,25,25,2,0,0,100.0
2010020761,30,3888,0.0,27,27,3,1,0,100.0
2010020762,23,3595,0.0,26,25,7,0,1,96.15384615
2010020762,25,3600,0.0,26,22,3,0,4,84.61538462
2010020763,27,3558,0.0,37,33,7,0,4,89.18918919
2010020763,28,1787,0.0,9,9,5,0,0,100.0
2010020763,28,1813,0.0,27,24,3,0,3,88.88888889
2010020764,17,3598,0.0,34,29,1,0,5,85.29411765
2010020764,9,1730,0.0,18,16,5,0,2,88.88888889
2010020764,9,1849,0.0,19,15,0,0,4,78.94736842
2010020765,2,3459,19.0,21,19,4,2,2,90.47619048
2010020765,2,17,0.0,1,1,1,0,0,100.0
2010020765,5,3559,17.0,20,20,3,1,0,100.0
2010020765,5,17,0.0,0,0,0,0,0,
2010020766,13,3468,0.0,40,37,9,2,3,92.5
2010020766,8,3597,0.0,35,33,3,1,2,94.28571429
2010020767,23,3600,0.0,23,23,2,0,0,100.0
2010020767,27,3097,0.0,31,26,4,0,5,83.87096774
2010020767,27,503,0.0,2,1,0,0,1,50.0
2010020768,26,3600,0.0,33,32,5,0,1,96.96969697
2010020768,22,3524,0.0,26,23,5,0,3,88.46153846
2010020769,28,3600,0.0,30,27,10,0,3,90.0
2010020769,24,675,0.0,10,7,0,0,3,70.0
2010020769,24,2911,0.0,18,17,1,0,1,94.44444444
2010020770,25,80,0.0,2,0,0,0,2,0.0
2010020770,25,3496,0.0,32,29,8,2,3,90.625
2010020770,6,3596,0.0,33,30,14,1,3,90.90909091
2010020771,12,3600,0.0,41,38,8,0,3,92.68292683
2010020771,10,3600,2.0,27,27,3,0,0,100.0
2010020772,1,3600,0.0,27,25,8,1,2,92.59259259
2010020772,3,2104,0.0,12,9,3,1,3,75.0
2010020772,3,1421,0.0,6,6,1,0,0,100.0
2010020773,18,3542,0.0,29,26,2,1,3,89.65517241
2010020773,4,3580,0.0,28,26,2,0,2,92.85714286
2010020774,20,3600,0.0,24,22,5,1,2,91.66666667
2010020774,11,3504,0.0,23,20,6,0,3,86.95652174
2010020775,30,3600,0.0,41,38,7,0,3,92.68292683
2010020775,21,3491,0.0,25,21,9,0,4,84.0
2010020776,13,3720,0.0,31,28,4,2,3,90.32258065
2010020776,1,3712,2.0,29,25,1,0,4,86.20689655
2010020777,7,3548,0.0,39,36,6,0,3,92.30769231
2010020777,5,3579,0.0,29,27,0,1,2,93.10344828
2010020778,29,3599,0.0,34,34,9,1,0,100.0
2010020778,17,3535,0.0,23,21,8,1,2,91.30434783
2010020779,15,3589,0.0,25,23,6,0,2,92.0
2010020779,14,3515,2.0,35,31,7,1,4,88.57142857
2010020780,22,3480,0.0,26,21,2,0,5,80.76923077
2010020780,19,3600,0.0,32,29,2,0,3,90.625
2010020781,16,3500,0.0,32,28,4,2,4,87.5
2010020781,23,3600,0.0,45,42,10,0,3,93.33333333
2010020782,28,3600,0.0,26,26,1,1,0,100.0
2010020782,6,3566,0.0,17,16,0,1,1,94.11764706
2010020783,3,3553,0.0,28,27,1,3,1,96.42857143
2010020783,8,3600,0.0,35,35,1,1,0,100.0
2010020784,24,3596,0.0,25,25,4,0,0,100.0
2010020784,21,3491,0.0,28,26,4,1,2,92.85714286
2010020785,10,1200,0.0,13,12,0,0,1,92.30769231
2010020785,10,2400,0.0,30,25,6,1,5,83.33333333
2010020785,7,3600,0.0,25,23,3,1,2,92.0
2010020786,9,1200,0.0,13,10,1,0,3,76.92307692
2010020786,9,2304,2.0,24,23,7,0,1,95.83333333
2010020786,2,3600,0.0,23,20,1,1,3,86.95652174
2010020787,25,3507,2.0,32,29,3,1,3,90.625
2010020787,4,3568,0.0,31,30,7,0,1,96.77419355
2010020788,11,3748,2.0,37,33,5,1,4,89.18918919
2010020788,12,3768,0.0,37,34,8,1,3,91.89189189
2010020789,22,3513,0.0,34,30,4,0,4,88.23529412
2010020789,29,3600,0.0,26,23,6,1,3,88.46153846
2010020790,17,3597,0.0,29,26,2,3,3,89.65517241
2010020790,18,3600,0.0,35,35,7,0,0,100.0
2010020791,30,3507,0.0,41,40,5,0,1,97.56097561
2010020791,27,3600,0.0,25,25,6,0,0,100.0
2010020792,26,3894,0.0,35,32,9,0,3,91.42857143
2010020792,20,3899,0.0,33,30,9,0,3,90.90909091
2010020793,5,3574,0.0,23,21,5,1,2,91.30434783
2010020793,15,3600,0.0,22,22,3,1,0,100.0
2010020794,1,1200,0.0,11,11,4,0,0,100.0
2010020794,1,2400,0.0,15,14,0,0,1,93.33333333
2010020794,8,3593,0.0,29,26,6,0,3,89.65517241
2010020795,19,3893,0.0,40,36,8,1,4,90.0
2010020795,14,3879,0.0,32,29,8,1,3,90.625
2010020796,11,3529,0.0,32,27,3,3,5,84.375
2010020796,10,3600,0.0,34,30,9,0,4,88.23529412
2010020797,3,3525,0.0,35,32,3,0,3,91.42857143
2010020797,17,3600,0.0,47,45,4,1,2,95.74468085
2010020798,22,3600,0.0,37,37,6,0,0,100.0
2010020798,18,2815,2.0,20,16,3,1,4,80.0
2010020798,18,777,0.0,2,2,0,0,0,100.0
2010020799,16,3582,0.0,27,25,5,2,2,92.59259259
2010020799,20,3596,0.0,23,22,5,3,1,95.65217391
2010020800,21,3599,0.0,26,23,4,0,3,88.46153846
2010020800,27,3578,0.0,26,26,5,0,0,100.0
2010020801,9,3554,0.0,29,26,5,1,3,89.65517241
2010020801,23,3598,0.0,33,31,6,0,2,93.93939394
2010020802,12,3762,0.0,34,31,0,0,3,91.17647059
2010020802,1,3762,0.0,22,20,0,0,2,90.90909091
2010020803,10,3600,0.0,34,31,2,4,3,91.17647059
2010020803,2,3516,0.0,26,21,2,1,5,80.76923077
2010020804,29,3592,0.0,33,32,3,0,1,96.96969697
2010020804,5,3600,0.0,25,21,0,0,4,84.0
2010020805,28,3591,0.0,25,25,5,0,0,100.0
2010020805,15,3493,0.0,36,34,1,0,2,94.44444444
2010020806,7,3600,0.0,34,30,3,1,4,88.23529412
2010020806,14,3600,0.0,28,21,5,0,7,75.0
2010020807,19,3580,0.0,31,30,10,0,1,96.77419355
2010020807,13,3512,0.0,28,26,2,0,2,92.85714286
2010020808,8,3600,9.0,34,26,3,0,8,76.47058824
2010020808,6,3600,7.0,33,27,3,1,6,81.81818182
2010020809,18,3600,0.0,35,34,5,0,1,97.14285714
2010020809,17,1826,0.0,16,12,1,0,4,75.0
2010020809,17,1757,0.0,14,14,2,0,0,100.0
2010020810,28,3592,0.0,44,42,10,2,2,95.45454545
2010020810,29,3504,0.0,32,29,6,0,3,90.625
2010020811,21,1842,0.0,17,14,1,2,3,82.35294118
2010020811,21,1702,0.0,7,7,3,0,0,100.0
2010020811,30,3600,0.0,25,23,3,0,2,92.0
2010020812,27,3660,0.0,18,16,1,0,2,88.88888889
2010020812,25,3673,0.0,35,32,8,0,3,91.42857143
2010020813,9,3587,0.0,35,30,15,0,5,85.71428571
2010020813,20,3594,0.0,26,24,5,0,2,92.30769231
2010020814,16,3593,0.0,24,23,2,1,1,95.83333333
2010020814,22,3487,0.0,25,22,4,0,3,88.0
2010020815,24,3598,0.0,38,35,1,1,3,92.10526316
2010020815,23,3464,0.0,24,20,2,0,4,83.33333333
2010020816,1,3876,0.0,32,31,5,2,1,96.875
2010020816,10,3876,0.0,39,37,5,0,2,94.87179487
2010020817,12,3567,0.0,25,23,4,1,2,92.0
2010020817,4,3598,0.0,32,31,6,0,1,96.875
2010020818,26,3856,0.0,26,24,2,0,2,92.30769231
2010020818,5,3881,0.0,33,32,4,1,1,96.96969697
2010020819,2,3884,0.0,40,37,1,1,3,92.5
2010020819,8,3900,0.0,33,30,5,1,3,90.90909091
2010020820,7,3895,0.0,26,24,2,0,2,92.30769231
2010020820,13,3895,0.0,27,24,2,1,3,88.88888889
2010020821,17,3600,0.0,26,25,1,2,1,96.15384615
2010020821,6,2400,0.0,19,14,1,2,5,73.68421053
2010020821,6,1200,0.0,15,14,3,1,1,93.33333333
2010020822,28,3520,0.0,23,21,2,0,2,91.30434783
2010020822,1,3600,0.0,32,31,0,1,1,96.875
2010020823,5,2626,5.0,27,20,6,3,7,74.07407407
2010020823,5,974,0.0,9,7,3,1,2,77.77777778
2010020823,2,3600,0.0,38,35,19,0,3,92.10526316
2010020824,21,3513,0.0,31,29,6,0,2,93.5483871
2010020824,29,3600,0.0,32,31,2,1,1,96.875
2010020825,3,3514,0.0,35,32,9,2,3,91.42857143
2010020825,11,3600,0.0,29,27,6,1,2,93.10344828
2010020826,30,3864,0.0,35,31,4,0,4,88.57142857
2010020826,19,3900,0.0,27,23,1,0,4,85.18518519
2010020827,16,3900,0.0,35,32,7,2,3,91.42857143
2010020827,25,3900,0.0,26,23,5,0,3,88.46153846
2010020828,24,3870,0.0,25,21,7,0,4,84.0
2010020828,20,3881,0.0,30,25,0,0,5,83.33333333
2010020829,26,3600,0.0,23,22,7,0,1,95.65217391
2010020829,15,3600,0.0,28,24,2,0,4,85.71428571
2010020830,9,3595,0.0,18,15,3,0,3,83.33333333
2010020830,22,3476,4.0,24,20,8,1,4,83.33333333
2010020831,10,3530,0.0,39,36,7,4,3,92.30769231
2010020831,8,3576,0.0,27,27,8,0,0,100.0
2010020832,12,3634,0.0,41,37,10,0,4,90.24390244
2010020832,14,3692,0.0,34,31,8,2,3,91.17647059
2010020833,21,3558,0.0,38,34,2,2,4,89.47368421
2010020833,18,3564,0.0,18,15,1,1,3,83.33333333
2010020834,16,3900,0.0,25,23,4,1,2,92.0
2010020834,27,3892,0.0,33,31,2,0,2,93.93939394
2010020835,19,1702,2.0,20,17,4,0,3,85.0
2010020835,19,1772,0.0,11,11,3,0,0,100.0
2010020835,30,3600,0.0,25,24,6,1,1,96.0
2010020836,20,3591,0.0,32,29,4,1,3,90.625
2010020836,23,3600,0.0,26,24,4,0,2,92.30769231
2010020837,2,2286,0.0,14,12,2,0,2,85.71428571
2010020837,2,1471,0.0,14,10,1,0,4,71.42857143
2010020837,7,3775,0.0,26,19,6,0,7,73.07692308
2010020838,5,3517,0.0,31,26,8,0,5,83.87096774
2010020838,3,3600,0.0,29,26,7,1,3,89.65517241
2010020839,29,3600,0.0,30,29,6,1,1,96.66666667
2010020839,25,3541,0.0,39,37,7,2,2,94.87179487
2010020840,12,3600,0.0,43,41,1,0,2,95.34883721
2010020840,11,3563,0.0,17,14,3,0,3,82.35294118
2010020841,28,3530,0.0,22,19,1,0,3,86.36363636
2010020841,13,3600,0.0,30,28,1,1,2,93.33333333
2010020842,6,3524,0.0,36,32,3,0,4,88.88888889
2010020842,17,3600,0.0,25,23,4,0,2,92.0
2010020843,26,3600,0.0,40,40,2,3,0,100.0
2010020843,4,3540,0.0,25,24,1,3,1,96.0
2010020844,24,3587,0.0,12,12,1,1,0,100.0
2010020844,22,1109,0.0,7,7,5,0,0,100.0
2010020844,22,2491,0.0,15,11,0,0,4,73.33333333
2010020845,23,3514,0.0,34,31,1,0,3,91.17647059
2010020845,19,3600,0.0,25,23,4,1,2,92.0
2010020846,20,396,0.0,5,5,1,0,0,100.0
2010020846,20,3189,0.0,18,17,2,1,1,94.44444444
2010020846,21,1475,0.0,15,11,1,0,4,73.33333333
2010020846,21,2125,0.0,18,13,6,0,5,72.22222222
2010020847,15,3545,0.0,18,15,1,0,3,83.33333333
2010020847,27,3600,0.0,31,29,14,1,2,93.5483871
2010020848,10,3593,0.0,35,32,5,0,3,91.42857143
2010020848,6,3552,0.0,28,24,4,1,4,85.71428571
2010020849,7,3869,0.0,34,32,7,0,2,94.11764706
2010020849,8,3900,0.0,32,30,3,0,2,93.75
2010020850,2,3896,0.0,31,28,7,2,3,90.32258065
2010020850,9,3900,0.0,28,25,7,1,3,89.28571429
2010020851,4,3900,0.0,27,24,0,0,3,88.88888889
2010020851,14,3900,0.0,29,26,0,3,3,89.65517241
2010020852,28,3831,0.0,31,30,2,0,1,96.77419355
2010020852,18,3833,0.0,50,48,10,0,2,96.0
2010020853,23,3596,0.0,29,28,6,0,1,96.55172414
2010020853,30,3538,0.0,13,10,1,1,3,76.92307692
2010020854,25,3584,0.0,30,26,5,0,4,86.66666667
2010020854,22,3595,0.0,25,24,4,1,1,96.0
2010020855,10,1200,0.0,9,9,3,0,0,100.0
2010020855,10,2400,0.0,15,14,0,0,1,93.33333333
2010020855,7,3508,0.0,30,28,7,1,2,93.33333333
2010020856,12,3448,0.0,22,19,0,0,3,86.36363636
2010020856,1,3600,0.0,27,25,4,1,2,92.59259259
2010020857,26,3900,0.0,24,21,0,0,3,87.5
2010020857,29,3891,0.0,29,26,2,0,3,89.65517241
2010020858,4,3592,0.0,35,33,4,3,2,94.28571429
2010020858,13,3541,0.0,34,31,6,1,3,91.17647059
2010020859,30,3544,0.0,36,34,8,0,2,94.44444444
2010020859,16,3594,0.0,34,33,2,1,1,97.05882353
2010020860,5,3847,0.0,31,29,2,2,2,93.5483871
2010020860,21,3850,0.0,36,33,4,1,3,91.66666667
2010020861,25,13,0.0,0,0,0,0,0,
2010020861,25,3522,0.0,31,27,4,0,4,87.09677419
2010020861,20,3600,0.0,24,22,1,0,2,91.66666667
2010020862,15,2400,0.0,12,9,0,0,3,75.0
2010020862,15,1200,0.0,9,6,1,0,3,66.66666667
2010020862,24,3541,0.0,31,24,1,1,7,77.41935484
2010020863,6,3600,0.0,37,34,4,0,3,91.89189189
2010020863,2,2232,0.0,16,15,1,0,1,93.75
2010020863,2,1368,0.0,18,13,0,0,5,72.22222222
2010020864,26,3896,0.0,37,34,5,0,3,91.89189189
2010020864,3,3900,0.0,28,25,3,2,3,89.28571429
2010020865,17,3600,0.0,40,38,11,0,2,95.0
2010020865,14,3600,2.0,31,25,1,1,6,80.64516129
2010020866,23,3556,0.0,26,23,0,0,3,88.46153846
2010020866,18,3595,0.0,36,35,4,0,1,97.22222222
2010020867,8,3564,0.0,27,24,4,0,3,88.88888889
2010020867,22,3600,0.0,37,36,1,0,1,97.2972973
2010020868,11,3510,0.0,32,28,3,0,4,87.5
2010020868,27,3600,0.0,36,33,6,0,3,91.66666667
2010020869,15,3589,0.0,28,25,0,0,3,89.28571429
2010020869,28,3591,0.0,25,23,0,0,2,92.0
2010020870,3,3518,0.0,28,27,4,1,1,96.42857143
2010020870,1,3600,0.0,16,16,0,0,0,100.0
2010020871,4,3522,0.0,29,26,5,1,3,89.65517241
2010020871,12,3541,0.0,23,21,4,2,2,91.30434783
2010020872,19,3600,0.0,25,25,2,1,0,100.0
2010020872,7,3575,0.0,23,21,2,0,2,91.30434783
2010020873,6,3591,0.0,34,32,1,1,2,94.11764706
2010020873,9,3529,0.0,33,29,7,0,4,87.87878788
2010020874,17,3600,0.0,32,29,5,2,3,90.625
2010020874,13,3533,0.0,30,26,3,1,4,86.66666667
2010020875,24,3585,0.0,26,21,1,1,5,80.76923077
2010020875,30,3600,0.0,30,29,1,0,1,96.66666667
2010020876,29,3573,0.0,40,37,3,0,3,92.5
2010020876,16,3515,0.0,36,32,8,1,4,88.88888889
2010020877,11,3524,0.0,25,21,4,3,4,84.0
2010020877,22,3598,0.0,31,28,5,1,3,90.32258065
2010020878,9,3900,0.0,47,47,10,1,0,100.0
2010020878,10,3900,0.0,22,22,2,3,0,100.0
2010020879,26,3598,0.0,23,20,3,3,3,86.95652174
2010020879,2,3566,0.0,35,35,5,1,0,100.0
2010020880,1,3596,0.0,25,24,5,0,1,96.0
2010020880,12,3600,0.0,25,21,4,0,4,84.0
2010020881,13,3900,0.0,36,34,6,0,2,94.44444444
2010020881,14,3900,0.0,26,24,4,1,2,92.30769231
2010020882,24,1182,0.0,11,7,0,0,4,63.63636364
2010020882,24,2400,0.0,12,7,0,0,5,58.33333333
2010020882,19,2598,0.0,20,20,4,1,0,100.0
2010020882,19,1002,0.0,5,2,0,0,3,40.0
2010020883,27,3600,0.0,32,30,4,2,2,93.75
2010020883,18,3535,0.0,26,23,5,2,3,88.46153846
2010020884,25,3600,0.0,38,33,3,0,5,86.84210526
2010020884,23,3598,0.0,24,22,4,0,2,91.66666667
2010020885,21,3595,2.0,33,29,9,0,4,87.87878788
2010020885,28,3600,0.0,25,25,6,1,0,100.0
2010020886,15,3596,0.0,29,28,0,1,1,96.55172414
2010020886,7,3501,0.0,39,37,11,0,2,94.87179487
2010020887,4,3600,0.0,39,37,0,1,2,94.87179487
2010020887,3,3531,0.0,23,20,4,0,3,86.95652174
2010020888,5,3900,0.0,31,29,2,1,2,93.5483871
2010020888,16,3900,0.0,26,24,4,1,2,92.30769231
2010020889,17,3900,0.0,26,25,6,1,1,96.15384615
2010020889,30,3890,0.0,39,38,2,1,1,97.43589744
2010020890,8,3600,0.0,37,33,5,2,4,89.18918919
2010020890,20,3600,0.0,39,39,0,4,0,100.0
2010020891,13,3561,0.0,36,32,14,2,4,88.88888889
2010020891,2,3597,0.0,21,20,2,0,1,95.23809524
2010020892,16,3600,0.0,34,31,2,0,3,91.17647059
2010020892,19,1957,0.0,18,14,1,0,4,77.77777778
2010020892,19,1543,0.0,7,7,0,1,0,100.0
2010020893,15,3600,0.0,39,39,5,4,0,100.0
2010020893,5,3536,0.0,24,23,4,0,1,95.83333333
2010020894,2,3523,0.0,25,23,2,2,2,92.0
2010020894,10,3600,0.0,29,28,5,0,1,96.55172414
2010020895,27,3761,0.0,39,37,10,1,2,94.87179487
2010020895,4,3732,0.0,29,26,3,1,3,89.65517241
2010020896,3,3900,0.0,33,30,4,1,3,90.90909091
2010020896,12,3900,0.0,46,43,9,0,3,93.47826087
2010020897,28,3597,0.0,38,35,1,0,3,92.10526316
2010020897,17,3540,0.0,43,39,12,0,4,90.69767442
2010020898,18,3581,0.0,30,26,4,0,4,86.66666667
2010020898,29,3600,0.0,20,20,6,0,0,100.0
2010020899,22,3598,0.0,23,19,3,3,4,82.60869565
2010020899,30,3598,0.0,21,20,5,2,1,95.23809524
2010020900,1,3600,0.0,19,19,1,2,0,100.0
2010020900,25,3530,0.0,23,22,6,1,1,95.65217391
2010020901,8,3600,2.0,39,37,12,0,2,94.87179487
2010020901,23,3554,0.0,25,22,6,2,3,88.0
2010020902,11,3600,0.0,39,35,6,0,4,89.74358974
2010020902,7,3600,0.0,41,40,3,5,1,97.56097561
2010020903,13,3600,2.0,34,29,11,4,5,85.29411765
2010020903,9,3600,0.0,24,23,11,1,1,95.83333333
2010020904,28,3884,0.0,26,24,3,0,2,92.30769231
2010020904,5,3871,0.0,38,35,8,1,3,92.10526316
2010020905,27,3600,0.0,39,31,7,0,8,79.48717949
2010020905,14,3600,0.0,28,25,1,0,3,89.28571429
2010020906,6,3600,0.0,29,28,2,0,1,96.55172414
2010020906,20,3543,0.0,28,26,6,0,2,92.85714286
2010020907,22,3600,0.0,39,38,4,0,1,97.43589744
2010020907,21,3600,0.0,31,26,1,3,5,83.87096774
2010020908,26,3600,0.0,27,25,3,0,2,92.59259259
2010020908,24,3550,0.0,18,15,0,0,3,83.33333333
2010020909,2,3841,0.0,43,39,3,1,4,90.69767442
2010020909,4,3882,0.0,35,32,1,1,3,91.42857143
2010020910,25,3600,0.0,39,38,10,0,1,97.43589744
2010020910,17,3558,2.0,24,21,4,2,3,87.5
2010020911,10,3597,0.0,35,31,1,2,4,88.57142857
2010020911,8,2811,0.0,19,17,5,2,2,89.47368421
2010020911,8,782,0.0,9,6,1,0,3,66.66666667
2010020912,16,3595,0.0,31,31,0,0,0,100.0
2010020912,18,3494,0.0,24,22,0,0,2,91.66666667
2010020913,19,3495,0.0,27,24,2,0,3,88.88888889
2010020913,23,3600,0.0,30,28,3,0,2,93.33333333
2010020914,30,3530,0.0,29,26,9,1,3,89.65517241
2010020914,26,3588,0.0,27,25,8,0,2,92.59259259
2010020915,3,3600,0.0,35,35,8,0,0,100.0
2010020915,15,3600,0.0,28,22,5,0,6,78.57142857
2010020916,5,1740,0.0,10,9,1,0,1,90.0
2010020916,5,1859,0.0,11,8,5,0,3,72.72727273
2010020916,12,3600,0.0,34,33,7,1,1,97.05882353
2010020917,27,3538,0.0,34,29,11,1,5,85.29411765
2010020917,29,3600,0.0,28,25,3,0,3,89.28571429
2010020918,9,3555,0.0,38,35,2,2,3,92.10526316
2010020918,7,3558,0.0,31,29,3,0,2,93.5483871
2010020919,13,3897,0.0,46,45,6,3,1,97.82608696
2010020919,11,1200,0.0,7,6,2,0,1,85.71428571
2010020919,11,2688,0.0,25,25,4,1,0,100.0
2010020920,1,3544,0.0,30,28,1,0,2,93.33333333
2010020920,14,3600,0.0,20,19,1,0,1,95.0
2010020921,28,3900,0.0,24,21,1,2,3,87.5
2010020921,20,3900,0.0,33,30,2,2,3,90.90909091
2010020922,19,3594,0.0,39,39,5,2,0,100.0
2010020922,22,3600,0.0,22,17,3,0,5,77.27272727
2010020923,30,3891,0.0,48,46,9,2,2,95.83333333
2010020923,24,3884,0.0,31,28,2,2,3,90.32258065
2010020924,18,3535,0.0,25,22,5,0,3,88.0
2010020924,25,3600,0.0,27,25,1,2,2,92.59259259
2010020925,21,3546,0.0,42,38,12,1,4,90.47619048
2010020925,26,3572,0.0,17,14,2,0,3,82.35294118
2010020926,17,3894,0.0,32,30,2,0,2,93.75
2010020926,7,3900,0.0,37,35,3,0,2,94.59459459
2010020927,5,3900,0.0,31,26,3,0,5,83.87096774
2010020927,10,3900,0.0,40,35,0,1,5,87.5
2010020928,12,3529,0.0,27,23,2,2,4,85.18518519
2010020928,8,3538,0.0,31,28,5,0,3,90.32258065
2010020929,4,3600,0.0,29,25,1,2,4,86.20689655
2010020929,9,3600,0.0,31,30,5,0,1,96.77419355
2010020930,15,3600,0.0,31,29,7,1,2,93.5483871
2010020930,2,3518,2.0,22,19,0,1,3,86.36363636
2010020931,6,3594,0.0,28,27,3,1,1,96.42857143
2010020931,23,3582,0.0,24,22,6,0,2,91.66666667
2010020932,14,3594,0.0,23,22,4,2,1,95.65217391
2010020932,3,3510,0.0,19,17,2,1,2,89.47368421
2010020933,29,3533,0.0,28,25,5,1,3,89.28571429
2010020933,18,3600,0.0,27,25,8,0,2,92.59259259
2010020934,10,1587,0.0,25,22,3,1,3,88.0
2010020934,10,2164,0.0,18,18,5,1,0,100.0
2010020934,11,3727,2.0,24,22,6,0,2,91.66666667
2010020935,1,3595,0.0,26,25,1,0,1,96.15384615
2010020935,13,3494,0.0,26,24,7,0,2,92.30769231
2010020936,27,3900,0.0,41,38,4,1,3,92.68292683
2010020936,16,3900,0.0,29,26,4,0,3,89.65517241
2010020937,19,3495,0.0,20,19,3,0,1,95.0
2010020937,20,3598,0.0,27,27,3,1,0,100.0
2010020938,6,3600,0.0,17,15,0,0,2,88.23529412
2010020938,22,3510,0.0,40,37,6,0,3,92.5
2010020939,21,3516,0.0,32,29,11,1,3,90.625
2010020939,24,3582,0.0,24,22,0,1,2,91.66666667
2010020940,16,3600,0.0,26,24,4,1,2,92.30769231
2010020940,30,3512,0.0,34,30,2,2,4,88.23529412
2010020941,17,3600,0.0,39,35,8,1,4,89.74358974
2010020941,26,2722,0.0,24,18,2,1,6,75.0
2010020941,26,847,0.0,3,2,1,0,1,66.66666667
2010020942,7,3596,0.0,31,29,8,1,2,93.5483871
2010020942,3,3513,0.0,26,23,4,1,3,88.46153846
2010020943,2,3712,0.0,42,40,3,1,2,95.23809524
2010020943,15,3700,0.0,29,28,7,0,1,96.55172414
2010020944,13,3557,0.0,22,20,0,0,2,90.90909091
2010020944,12,3587,0.0,42,41,2,0,1,97.61904762
2010020945,8,3600,2.0,41,40,7,0,1,97.56097561
2010020945,11,3542,0.0,22,20,3,0,2,90.90909091
2010020946,6,3600,0.0,33,33,0,1,0,100.0
2010020946,9,3546,0.0,21,20,3,0,1,95.23809524
2010020947,20,3596,0.0,25,25,2,0,0,100.0
2010020947,19,3596,0.0,29,23,4,0,6,79.31034483
2010020948,18,3881,0.0,26,25,5,1,1,96.15384615
2010020948,22,3900,0.0,35,34,1,2,1,97.14285714
2010020949,25,3549,0.0,27,25,4,0,2,92.59259259
2010020949,27,3565,0.0,30,27,9,1,3,90.0
2010020950,29,3900,0.0,26,25,4,0,1,96.15384615
2010020950,23,3900,0.0,31,30,4,1,1,96.77419355
2010020951,21,3900,0.0,35,34,5,0,1,97.14285714
2010020951,28,3895,0.0,19,18,3,1,1,94.73684211
2010020952,5,3642,0.0,20,17,6,0,3,85.0
2010020952,10,3642,0.0,29,27,1,3,2,93.10344828
2010020953,14,3571,0.0,27,25,3,1,2,92.59259259
2010020953,1,3600,0.0,16,15,1,1,1,93.75
2010020954,30,1241,0.0,19,16,2,0,3,84.21052632
2010020954,30,2359,0.0,22,21,0,0,1,95.45454545
2010020954,2,3590,0.0,34,33,6,0,1,97.05882353
2010020955,20,1165,0.0,10,9,1,0,1,90.0
2010020955,20,2400,0.0,19,15,1,0,4,78.94736842
2010020955,16,3598,0.0,25,21,2,1,4,84.0
2010020956,17,3766,0.0,28,26,5,2,2,92.85714286
2010020956,24,3770,0.0,29,28,4,0,1,96.55172414
2010020957,14,3537,0.0,28,26,6,1,2,92.85714286
2010020957,6,3600,0.0,28,27,7,0,1,96.42857143
2010020958,30,3600,2.0,41,40,8,0,1,97.56097561
2010020958,3,3481,0.0,19,16,2,0,3,84.21052632
2010020959,10,3600,0.0,30,28,1,5,2,93.33333333
2010020959,4,3543,0.0,33,30,10,0,3,90.90909091
2010020960,19,3512,0.0,30,27,2,1,3,90.0
2010020960,15,3600,0.0,27,25,4,0,2,92.59259259
2010020961,7,3625,0.0,24,21,2,2,3,87.5
2010020961,12,3626,0.0,29,27,7,1,2,93.10344828
2010020962,9,3600,0.0,43,42,2,2,1,97.6744186
2010020962,11,3482,0.0,27,24,2,0,3,88.88888889
2010020963,8,3600,0.0,30,30,6,0,0,100.0
2010020963,13,534,0.0,3,1,0,0,2,33.33333333
2010020963,13,3066,0.0,28,26,4,1,2,92.85714286
2010020964,29,1214,0.0,14,11,6,0,3,78.57142857
2010020964,29,2337,0.0,23,23,1,1,0,100.0
2010020964,22,3559,0.0,28,26,8,0,2,92.85714286
2010020965,18,3600,0.0,29,29,1,0,0,100.0
2010020965,23,3516,0.0,28,26,4,0,2,92.85714286
2010020966,27,3553,0.0,18,17,0,0,1,94.44444444
2010020966,26,3575,0.0,25,25,2,0,0,100.0
2010020967,17,3488,0.0,28,25,2,0,3,89.28571429
2010020967,28,3600,0.0,27,26,7,1,1,96.2962963
2010020968,5,3875,0.0,30,28,1,0,2,93.33333333
2010020968,1,3875,0.0,26,25,3,0,1,96.15384615
2010020969,3,3600,0.0,29,28,5,1,1,96.55172414
2010020969,9,3595,0.0,27,23,2,0,4,85.18518519
2010020970,12,3600,0.0,29,24,0,2,5,82.75862069
2010020970,16,3600,0.0,20,18,1,3,2,90.0
2010020971,29,3535,0.0,28,24,5,0,4,85.71428571
2010020971,20,3600,0.0,40,37,5,3,3,92.5
2010020972,25,3896,0.0,29,25,1,0,4,86.20689655
2010020972,24,3877,0.0,26,23,5,0,3,88.46153846
2010020973,19,3599,0.0,22,17,2,0,5,77.27272727
2010020973,2,3600,0.0,23,21,3,0,2,91.30434783
2010020974,7,3600,2.0,36,33,5,3,3,91.66666667
2010020974,4,3546,0.0,34,30,6,1,4,88.23529412
2010020975,23,3589,0.0,22,21,6,0,1,95.45454545
2010020975,26,3564,0.0,35,33,10,1,2,94.28571429
2010020976,5,3712,0.0,31,29,0,2,2,93.5483871
2010020976,6,3669,0.0,39,36,2,2,3,92.30769231
2010020977,16,3600,0.0,33,30,7,3,3,90.90909091
2010020977,10,1166,0.0,6,6,0,0,0,100.0
2010020977,10,2400,0.0,19,14,3,1,5,73.68421053
2010020978,13,3625,0.0,36,32,6,2,4,88.88888889
2010020978,11,3625,0.0,34,31,3,1,3,91.17647059
2010020979,8,3600,0.0,45,43,5,0,2,95.55555556
2010020979,14,3495,0.0,23,19,3,1,4,82.60869565
2010020980,17,3891,0.0,36,32,5,1,4,88.88888889
2010020980,27,3889,0.0,26,22,4,1,4,84.61538462
2010020981,22,3600,0.0,34,33,10,0,1,97.05882353
2010020981,21,1716,0.0,19,15,1,0,4,78.94736842
2010020981,21,1883,0.0,12,11,0,1,1,91.66666667
2010020982,25,3600,0.0,31,29,4,1,2,93.5483871
2010020982,28,3526,2.0,28,25,6,1,3,89.28571429
2010020983,1,3900,0.0,22,20,0,0,2,90.90909091
2010020983,2,3895,0.0,29,27,0,0,2,93.10344828
2010020984,4,1588,0.0,18,14,3,0,4,77.77777778
2010020984,4,2011,0.0,18,15,5,1,3,83.33333333
2010020984,3,3595,0.0,24,24,3,0,0,100.0
2010020985,15,3637,0.0,34,32,11,0,2,94.11764706
2010020985,13,3648,0.0,25,22,0,3,3,88.0
2010020986,7,3628,0.0,26,24,0,1,2,92.30769231
2010020986,30,3623,0.0,33,30,3,0,3,90.90909091
2010020987,18,3501,0.0,36,33,3,0,3,91.66666667
2010020987,20,3600,0.0,23,21,1,1,2,91.30434783
2010020988,23,3586,0.0,26,26,7,0,0,100.0
2010020988,24,3600,0.0,16,13,0,0,3,81.25
2010020989,15,2700,0.0,21,21,6,0,0,100.0
2010020989,15,1200,0.0,7,6,2,0,1,85.71428571
2010020989,14,3894,0.0,30,29,6,0,1,96.66666667
2010020990,29,3900,0.0,36,32,2,1,4,88.88888889
2010020990,19,3290,0.0,20,19,3,0,1,95.0
2010020990,19,610,0.0,8,5,0,0,3,62.5
2010020991,25,3638,0.0,23,20,7,0,3,86.95652174
2010020991,26,3638,0.0,22,18,3,2,4,81.81818182
2010020992,9,3599,0.0,32,31,7,0,1,96.875
2010020992,1,3556,0.0,21,19,0,1,2,90.47619048
2010020993,10,3842,0.0,40,36,0,1,4,90.0
2010020993,2,3842,0.0,27,24,2,0,3,88.88888889
2010020994,22,3562,0.0,26,23,5,1,3,88.46153846
2010020994,4,3600,0.0,25,24,3,0,1,96.0
2010020995,7,3513,0.0,31,28,12,0,3,90.32258065
2010020995,5,3592,0.0,30,29,5,1,1,96.66666667
2010020996,6,3587,0.0,26,22,2,1,4,84.61538462
2010020996,8,3587,0.0,31,30,5,4,1,96.77419355
2010020997,16,1200,0.0,8,5,0,1,3,62.5
2010020997,16,2322,0.0,7,7,0,0,0,100.0
2010020997,13,3600,0.0,39,37,7,0,2,94.87179487
2010020998,21,3493,2.0,24,20,0,1,4,83.33333333
2010020998,30,3595,0.0,30,28,5,1,2,93.33333333
2010020999,23,3733,0.0,34,31,4,0,3,91.17647059
2010020999,27,3715,0.0,39,35,3,1,4,89.74358974
2010021000,18,3804,0.0,33,30,4,0,3,90.90909091
2010021000,28,3804,0.0,25,23,7,0,2,92.0
2010021001,22,3600,2.0,36,31,7,1,5,86.11111111
2010021001,15,3574,0.0,22,22,1,3,0,100.0
2010021002,11,3693,0.0,37,35,6,1,2,94.59459459
2010021002,12,3698,0.0,29,26,3,0,3,89.65517241
2010021003,26,3600,0.0,29,28,1,0,1,96.55172414
2010021003,17,3530,0.0,26,24,4,0,2,92.30769231
2010021004,19,3651,0.0,22,19,2,0,3,86.36363636
2010021004,29,3609,0.0,26,22,4,1,4,84.61538462
2010021005,16,3900,0.0,30,27,4,0,3,90.0
2010021005,14,3887,0.0,31,28,0,0,3,90.32258065
2010021006,20,3900,0.0,34,31,3,1,3,91.17647059
2010021006,25,3900,0.0,34,31,1,1,3,91.17647059
2010021007,3,3596,0.0,33,28,6,2,5,84.84848485
2010021007,24,3600,0.0,32,30,1,1,2,93.75
2010021008,7,3824,0.0,29,26,3,0,3,89.65517241
2010021008,6,3824,0.0,45,41,8,1,4,91.11111111
2010021009,4,3583,0.0,29,27,0,0,2,93.10344828
2010021009,10,3528,0.0,33,30,9,0,3,90.90909091
2010021010,9,3600,0.0,34,33,8,0,1,97.05882353
2010021010,13,3517,0.0,39,37,6,4,2,94.87179487
2010021011,8,3592,0.0,26,23,5,0,3,88.46153846
2010021011,19,3595,0.0,28,27,3,1,1,96.42857143
2010021012,30,3600,0.0,31,27,5,0,4,87.09677419
2010021012,18,3600,0.0,19,19,1,1,0,100.0
2010021013,20,3591,0.0,31,29,0,1,2,93.5483871
2010021013,27,3600,0.0,39,39,5,0,0,100.0
2010021014,23,3888,0.0,48,44,15,3,4,91.66666667
2010021014,28,3841,0.0,28,24,7,1,4,85.71428571
2010021015,6,3544,0.0,41,38,3,1,3,92.68292683
2010021015,2,3600,0.0,28,26,5,0,2,92.85714286
2010021016,12,3497,0.0,26,24,1,2,2,92.30769231
2010021016,15,3600,0.0,41,40,3,1,1,97.56097561
2010021017,22,3858,0.0,44,42,12,1,2,95.45454545
2010021017,17,3811,0.0,27,26,4,0,1,96.2962963
2010021018,26,3595,0.0,34,32,4,1,2,94.11764706
2010021018,29,3526,0.0,22,18,4,0,4,81.81818182
2010021019,1,3858,0.0,26,24,3,1,2,92.30769231
2010021019,11,3852,0.0,30,27,10,0,3,90.0
2010021020,9,3575,0.0,35,34,11,0,1,97.14285714
2010021020,14,3529,0.0,22,20,6,0,2,90.90909091
2010021021,30,3600,0.0,31,27,5,2,4,87.09677419
2010021021,25,3600,0.0,14,14,1,0,0,100.0
2010021022,24,3581,0.0,26,24,4,1,2,92.30769231
2010021022,21,3600,0.0,33,27,6,1,6,81.81818182
2010021023,8,3600,0.0,26,26,5,0,0,100.0
2010021023,5,1895,0.0,8,8,4,1,0,100.0
2010021023,5,1599,0.0,12,9,0,0,3,75.0
2010021024,7,3533,0.0,29,25,4,0,4,86.20689655
2010021024,10,3600,0.0,42,39,0,0,3,92.85714286
2010021025,2,3789,0.0,35,32,10,1,3,91.42857143
2010021025,1,3789,0.0,15,13,0,1,2,86.66666667
2010021026,11,2400,0.0,12,9,1,1,3,75.0
2010021026,11,1254,0.0,12,11,0,0,1,91.66666667
2010021026,4,3677,0.0,41,36,5,0,5,87.80487805
2010021027,29,3600,2.0,31,29,11,2,2,93.5483871
2010021027,12,3480,0.0,27,25,9,1,2,92.59259259
2010021028,14,3884,0.0,27,23,1,0,4,85.18518519
2010021028,13,3884,0.0,38,35,11,2,3,92.10526316
2010021029,17,3593,0.0,29,26,4,0,3,89.65517241
2010021029,19,3494,0.0,27,22,2,2,5,81.48148148
2010021030,21,3497,0.0,28,25,5,0,3,89.28571429
2010021030,18,3599,0.0,38,36,4,1,2,94.73684211
2010021031,23,3600,0.0,23,20,0,0,3,86.95652174
2010021031,20,3524,0.0,32,28,2,2,4,87.5
2010021032,3,3900,0.0,33,31,2,1,2,93.93939394
2010021032,28,3900,0.0,22,20,1,0,2,90.90909091
2010021033,22,3600,0.0,33,28,7,0,5,84.84848485
2010021033,5,3595,2.0,29,28,3,0,1,96.55172414
2010021034,16,3784,0.0,42,38,1,1,4,90.47619048
2010021034,15,3830,0.0,30,27,5,0,3,90.0
2010021035,26,3598,0.0,23,21,7,0,2,91.30434783
2010021035,25,3544,0.0,30,27,5,1,3,90.0
2010021036,9,1330,0.0,17,13,0,0,4,76.47058824
2010021036,9,2270,0.0,16,14,2,0,2,87.5
2010021036,7,3585,0.0,38,34,6,0,4,89.47368421
2010021037,27,3600,0.0,38,36,13,2,2,94.73684211
2010021037,24,2400,0.0,21,17,1,0,4,80.95238095
2010021037,24,1025,0.0,9,9,0,0,0,100.0
2010021038,14,3600,0.0,32,30,5,0,2,93.75
2010021038,10,673,0.0,7,6,0,0,1,85.71428571
2010021038,10,2927,0.0,29,24,0,1,5,82.75862069
2010021039,28,1955,0.0,16,14,2,0,2,87.5
2010021039,28,1645,0.0,18,14,4,0,4,77.77777778
2010021039,16,3591,0.0,36,33,5,2,3,91.66666667
2010021040,30,3568,0.0,21,18,1,2,3,85.71428571
2010021040,23,3600,0.0,35,33,10,0,2,94.28571429
2010021041,12,3595,0.0,40,40,5,1,0,100.0
2010021041,7,3528,0.0,33,32,5,1,1,96.96969697
2010021042,11,3541,0.0,23,20,2,1,3,86.95652174
2010021042,1,3600,0.0,20,18,2,0,2,90.0
2010021043,2,2400,0.0,36,31,11,2,5,86.11111111
2010021043,2,1200,0.0,11,10,2,0,1,90.90909091
2010021043,3,3598,0.0,28,25,6,2,3,89.28571429
2010021044,6,3900,0.0,36,34,11,0,2,94.44444444
2010021044,29,3900,0.0,29,27,0,1,2,93.10344828
2010021045,15,3596,0.0,26,24,3,1,2,92.30769231
2010021045,8,3582,0.0,41,37,3,4,4,90.24390244
2010021046,5,3590,0.0,22,21,0,0,1,95.45454545
2010021046,9,3595,0.0,41,36,6,0,5,87.80487805
2010021047,4,3586,0.0,22,20,1,1,2,90.90909091
2010021047,13,3508,0.0,31,28,2,2,3,90.32258065
2010021048,26,3600,0.0,32,30,0,1,2,93.75
2010021048,18,3543,0.0,17,14,1,0,3,82.35294118
2010021049,28,3600,0.0,37,34,8,1,3,91.89189189
2010021049,25,3567,0.0,37,33,5,1,4,89.18918919
2010021050,27,3594,0.0,27,24,2,1,3,88.88888889
2010021050,20,3539,0.0,25,21,0,0,4,84.0
2010021051,10,3600,0.0,37,36,6,1,1,97.2972973
2010021051,12,3511,0.0,19,16,2,1,3,84.21052632
2010021052,15,3545,0.0,35,32,2,1,3,91.42857143
2010021052,17,3600,0.0,28,26,5,0,2,92.85714286
2010021053,21,3498,0.0,39,36,0,1,3,92.30769231
2010021053,23,3600,0.0,29,27,1,2,2,93.10344828
2010021054,19,3514,0.0,24,22,4,0,2,91.66666667
2010021054,24,3597,0.0,31,30,2,1,1,96.77419355
2010021055,4,3888,0.0,25,22,1,1,3,88.0
2010021055,11,3876,0.0,24,21,2,1,3,87.5
2010021056,17,3600,0.0,37,37,12,1,0,100.0
2010021056,29,3519,0.0,27,25,8,0,2,92.59259259
2010021057,14,3900,0.0,29,27,3,1,2,93.10344828
2010021057,8,3900,0.0,37,35,2,1,2,94.59459459
2010021058,1,3556,0.0,24,22,5,1,2,91.66666667
2010021058,9,3600,0.0,34,33,7,1,1,97.05882353
2010021059,10,3459,0.0,25,22,3,0,3,88.0
2010021059,13,3600,0.0,24,24,3,0,0,100.0
2010021060,6,3817,0.0,31,27,5,0,4,87.09677419
2010021060,18,3817,0.0,38,35,4,1,3,92.10526316
2010021061,16,1399,0.0,10,7,2,0,3,70.0
2010021061,16,2185,0.0,17,15,5,2,2,88.23529412
2010021061,25,3600,0.0,23,23,3,2,0,100.0
2010021062,21,3594,0.0,28,23,2,2,5,82.14285714
2010021062,20,3593,0.0,29,27,8,2,2,93.10344828
2010021063,27,3600,0.0,36,35,8,2,1,97.22222222
2010021063,22,3480,0.0,17,14,4,2,3,82.35294118
2010021064,19,3600,0.0,17,17,0,0,0,100.0
2010021064,26,3600,0.0,39,35,11,0,4,89.74358974
2010021065,30,3540,0.0,50,47,11,0,3,94.0
2010021065,28,3575,0.0,30,28,1,0,2,93.33333333
2010021066,15,3600,0.0,33,33,3,0,0,100.0
2010021066,1,3600,0.0,12,9,0,1,3,75.0
2010021067,8,1096,0.0,12,7,1,0,5,58.33333333
2010021067,8,2504,0.0,19,18,4,2,1,94.73684211
2010021067,3,3583,0.0,25,22,5,0,3,88.0
2010021068,2,3838,0.0,35,32,3,2,3,91.42857143
2010021068,12,3828,0.0,37,35,3,0,2,94.59459459
2010021069,27,3586,2.0,47,46,11,2,1,97.87234043
2010021069,23,3576,2.0,28,26,6,1,2,92.85714286
2010021070,29,3866,0.0,36,32,2,0,4,88.88888889
2010021070,30,3866,0.0,33,28,0,1,5,84.84848485
2010021071,11,1200,0.0,11,8,3,0,3,72.72727273
2010021071,11,2400,0.0,17,12,0,2,5,70.58823529
2010021071,7,3586,0.0,31,29,2,2,2,93.5483871
2010021072,6,702,0.0,7,6,0,0,1,85.71428571
2010021072,6,2898,0.0,22,18,6,0,4,81.81818182
2010021072,10,3591,0.0,37,35,4,0,2,94.59459459
2010021073,14,3808,0.0,34,31,1,1,3,91.17647059
2010021073,9,3808,0.0,37,35,1,0,2,94.59459459
2010021074,2,3879,0.0,32,29,1,3,3,90.625
2010021074,13,3900,0.0,21,18,3,0,3,85.71428571
2010021075,17,3561,0.0,38,36,3,2,2,94.73684211
2010021075,18,3600,0.0,40,39,6,1,1,97.5
2010021076,4,3900,0.0,30,28,8,0,2,93.33333333
2010021076,25,3900,0.0,30,28,0,4,2,93.33333333
2010021077,21,3900,0.0,33,31,5,0,2,93.93939394
2010021077,22,3886,0.0,27,25,2,0,2,92.59259259
2010021078,24,3692,0.0,32,31,7,0,1,96.875
2010021078,26,3682,0.0,25,23,2,0,2,92.0
2010021079,19,461,2.0,10,7,0,0,3,70.0
2010021079,19,3091,0.0,24,22,0,1,2,91.66666667
2010021079,28,3600,0.0,45,42,1,0,3,93.33333333
2010021080,3,3600,0.0,40,38,4,1,2,95.0
2010021080,5,3578,0.0,26,22,3,0,4,84.61538462
2010021081,18,3627,0.0,38,35,3,0,3,92.10526316
2010021081,7,3627,0.0,26,22,0,1,4,84.61538462
2010021082,1,3600,0.0,13,13,2,0,0,100.0
2010021082,29,3600,0.0,31,28,8,0,3,90.32258065
2010021083,8,3600,0.0,31,30,7,0,1,96.77419355
2010021083,30,1641,0.0,19,14,3,0,5,73.68421053
2010021083,30,1945,0.0,13,10,1,0,3,76.92307692
2010021084,16,3593,0.0,23,22,0,0,1,95.65217391
2010021084,27,3530,0.0,28,26,1,0,2,92.85714286
2010021085,20,3407,0.0,28,26,5,1,2,92.85714286
2010021085,20,349,0.0,5,2,1,0,3,40.0
2010021085,24,3757,0.0,41,37,4,0,4,90.24390244
2010021086,5,3900,0.0,41,37,6,2,4,90.24390244
2010021086,17,1991,0.0,15,11,1,0,4,73.33333333
2010021086,17,1904,0.0,10,10,0,0,0,100.0
2010021087,20,3880,0.0,27,26,5,0,1,96.2962963
2010021087,26,3897,0.0,28,27,10,0,1,96.42857143
2010021088,1,3572,0.0,29,26,9,0,3,89.65517241
2010021088,6,3600,0.0,31,30,1,2,1,96.77419355
2010021089,13,3512,0.0,33,32,1,0,1,96.96969697
2010021089,3,3597,0.0,22,22,0,2,0,100.0
2010021090,15,3900,0.0,33,29,4,0,4,87.87878788
2010021090,4,2618,0.0,14,13,0,1,1,92.85714286
2010021090,4,1282,0.0,9,6,1,0,3,66.66666667
2010021091,9,3561,0.0,24,20,6,1,4,83.33333333
2010021091,12,3600,0.0,39,36,9,1,3,92.30769231
2010021092,7,3581,0.0,31,31,6,2,0,100.0
2010021092,8,3538,0.0,23,22,6,0,1,95.65217391
2010021093,2,3600,0.0,38,36,7,0,2,94.73684211
2010021093,14,3549,0.0,27,23,5,2,4,85.18518519
2010021094,22,3461,0.0,30,27,5,2,3,90.0
2010021094,18,3600,0.0,20,19,4,1,1,95.0
2010021095,10,3589,0.0,29,29,7,2,0,100.0
2010021095,30,3600,0.0,17,14,2,1,3,82.35294118
2010021096,29,3897,0.0,32,28,4,1,4,87.5
2010021096,21,3828,0.0,33,29,6,1,4,87.87878788
2010021097,19,3527,0.0,23,21,2,0,2,91.30434783
2010021097,27,3600,0.0,30,29,4,0,1,96.66666667
2010021098,23,3600,0.0,40,39,8,1,1,97.5
2010021098,17,3505,0.0,33,31,2,0,2,93.93939394
2010021099,13,3595,0.0,31,27,5,0,4,87.09677419
2010021099,16,3600,0.0,23,23,2,0,0,100.0
2010021100,24,3624,0.0,26,23,3,2,3,88.46153846
2010021100,25,3702,0.0,26,22,2,0,4,84.61538462
2010021101,20,3600,0.0,38,32,4,0,6,84.21052632
2010021101,28,3600,0.0,25,22,1,0,3,88.0
2010021102,8,2669,0.0,33,28,11,2,5,84.84848485
2010021102,8,928,0.0,8,6,0,0,2,75.0
2010021102,6,3600,0.0,24,24,6,1,0,100.0
2010021103,11,3600,0.0,15,14,0,1,1,93.33333333
2010021103,2,3544,0.0,34,32,1,1,2,94.11764706
2010021104,9,3884,0.0,30,29,3,0,1,96.66666667
2010021104,3,3900,0.0,30,29,5,0,1,96.66666667
2010021105,5,3900,0.0,20,19,2,0,1,95.0
2010021105,4,3900,0.0,31,30,1,1,1,96.77419355
2010021106,22,3598,0.0,30,26,6,4,4,86.66666667
2010021106,19,3600,0.0,12,12,1,3,0,100.0
2010021107,24,2756,0.0,19,17,6,1,2,89.47368421
2010021107,24,697,0.0,9,6,0,0,3,66.66666667
2010021107,18,3600,0.0,38,34,12,0,4,89.47368421
2010021108,10,3600,0.0,28,25,1,1,3,89.28571429
2010021108,21,3296,0.0,26,23,1,0,3,88.46153846
2010021108,21,227,0.0,1,0,0,0,1,0.0
2010021109,29,3598,0.0,23,20,6,0,3,86.95652174
2010021109,27,3600,0.0,28,28,3,2,0,100.0
2010021110,28,3853,0.0,38,35,10,1,3,92.10526316
2010021110,26,3898,0.0,28,25,2,0,3,89.28571429
2010021111,1,3900,0.0,26,26,4,0,0,100.0
2010021111,5,3900,0.0,21,21,5,0,0,100.0
2010021112,13,3600,0.0,32,28,3,1,4,87.5
2010021112,7,3600,0.0,24,22,3,1,2,91.66666667
2010021113,15,3512,0.0,23,21,4,1,2,91.30434783
2010021113,9,3600,0.0,31,31,5,2,0,100.0
2010021114,23,3600,0.0,31,30,1,0,1,96.77419355
2010021114,11,3522,0.0,25,23,0,1,2,92.0
2010021115,12,3600,0.0,21,18,5,1,3,85.71428571
2010021115,14,3561,2.0,39,35,6,3,4,89.74358974
2010021116,3,3600,0.0,26,26,0,0,0,100.0
2010021116,6,3507,0.0,23,22,10,0,1,95.65217391
2010021117,21,3587,0.0,25,21,4,0,4,84.0
2010021117,26,3600,0.0,21,20,5,0,1,95.23809524
2010021118,1,3559,0.0,28,26,1,1,2,92.85714286
2010021118,7,3600,0.0,30,30,2,0,0,100.0
2010021119,15,3582,0.0,18,18,5,0,0,100.0
2010021119,8,3487,0.0,33,31,4,0,2,93.93939394
2010021120,4,3600,0.0,37,36,7,0,1,97.2972973
2010021120,2,3580,0.0,22,18,0,1,4,81.81818182
2010021121,14,3600,0.0,35,33,3,1,2,94.28571429
2010021121,12,3551,0.0,31,28,2,0,3,90.32258065
2010021122,10,3558,0.0,28,25,1,1,3,89.28571429
2010021122,17,2768,0.0,17,15,4,0,2,88.23529412
2010021122,17,829,0.0,7,7,0,0,0,100.0
2010021123,25,3562,0.0,31,28,1,1,3,90.32258065
2010021123,18,3600,0.0,30,28,3,1,2,93.33333333
2010021124,19,3594,0.0,16,13,0,0,3,81.25
2010021124,30,3600,0.0,47,41,6,0,6,87.23404255
2010021125,24,3600,0.0,28,27,4,0,1,96.42857143
2010021125,16,3542,0.0,25,23,6,0,2,92.0
2010021126,28,3600,0.0,27,26,4,0,1,96.2962963
2010021126,27,3600,0.0,32,28,1,0,4,87.5
2010021127,20,3900,0.0,21,17,0,0,4,80.95238095
2010021127,22,3900,0.0,31,27,4,0,4,87.09677419
2010021128,13,3583,0.0,24,23,1,0,1,95.83333333
2010021128,13,300,0.0,4,4,0,0,0,100.0
2010021128,5,3900,0.0,38,37,2,1,1,97.36842105
2010021129,9,3900,0.0,47,43,4,3,4,91.4893617
2010021129,11,3900,0.0,28,24,0,0,4,85.71428571
2010021130,23,3600,0.0,40,39,9,1,1,97.5
2010021130,29,3600,0.0,24,20,6,0,4,83.33333333
2010021131,6,3600,0.0,28,27,1,1,1,96.42857143
2010021131,4,3530,0.0,36,34,3,1,2,94.44444444
2010021132,16,3624,0.0,35,33,8,1,2,94.28571429
2010021132,17,3636,0.0,41,38,2,2,3,92.68292683
2010021133,21,3499,0.0,42,37,8,0,5,88.0952381
2010021133,24,3596,0.0,35,31,3,1,4,88.57142857
2010021134,16,3600,0.0,34,31,0,1,3,91.17647059
2010021134,6,3600,0.0,32,32,4,0,0,100.0
2010021135,7,3547,0.0,35,31,6,0,4,88.57142857
2010021135,10,3600,0.0,31,28,2,1,3,90.32258065
2010021136,4,3600,0.0,27,25,6,1,2,92.59259259
2010021136,5,3600,0.0,24,19,4,2,5,79.16666667
2010021137,12,3900,0.0,40,38,6,1,2,95.0
2010021137,15,3887,0.0,26,24,9,2,2,92.30769231
2010021138,13,3900,0.0,32,30,2,2,2,93.75
2010021138,29,3881,0.0,31,29,6,0,2,93.5483871
2010021139,11,3558,0.0,30,28,9,0,2,93.33333333
2010021139,8,3600,0.0,28,27,3,4,1,96.42857143
2010021140,9,3549,0.0,30,26,2,1,4,86.66666667
2010021140,14,3600,0.0,33,31,5,1,2,93.93939394
2010021141,30,3900,0.0,29,27,4,0,2,93.10344828
2010021141,19,3883,0.0,28,26,9,0,2,92.85714286
2010021142,23,3574,0.0,17,16,3,1,1,94.11764706
2010021142,18,3531,0.0,31,29,9,1,2,93.5483871
2010021143,26,3597,0.0,32,32,2,1,0,100.0
2010021143,22,3448,0.0,33,31,9,0,2,93.93939394
2010021144,25,3896,0.0,27,26,0,0,1,96.2962963
2010021144,27,3900,0.0,45,44,5,0,1,97.77777778
2010021145,3,3527,0.0,35,34,0,0,1,97.14285714
2010021145,7,3600,0.0,23,23,2,0,0,100.0
2010021146,2,3524,0.0,20,17,5,1,3,85.0
2010021146,1,3573,0.0,29,27,3,1,2,93.10344828
2010021147,8,2400,0.0,26,22,0,0,4,84.61538462
2010021147,8,1200,0.0,9,7,5,0,2,77.77777778
2010021147,12,3599,0.0,40,38,1,0,2,95.0
2010021148,19,3600,0.0,44,41,7,1,3,93.18181818
2010021148,17,877,0.0,8,5,0,1,3,62.5
2010021148,17,2723,0.0,39,32,4,0,7,82.05128205
2010021149,24,3593,0.0,25,23,7,1,2,92.0
2010021149,20,3562,0.0,21,18,6,1,3,85.71428571
2010021150,10,3895,0.0,38,35,8,1,3,92.10526316
2010021150,6,3896,0.0,31,28,5,2,3,90.32258065
2010021151,3,2400,0.0,22,18,0,0,4,81.81818182
2010021151,3,1200,0.0,11,9,1,0,2,81.81818182
2010021151,2,3600,0.0,27,25,9,0,2,92.59259259
2010021152,11,3600,0.0,43,43,10,2,0,100.0
2010021152,4,3536,0.0,22,21,3,0,1,95.45454545
2010021153,29,3750,0.0,33,29,1,0,4,87.87878788
2010021153,15,3738,0.0,23,20,2,0,3,86.95652174
2010021154,5,3536,0.0,24,22,1,0,2,91.66666667
2010021154,14,3599,0.0,37,36,5,2,1,97.2972973
2010021155,9,3600,0.0,38,37,9,0,1,97.36842105
2010021155,13,3600,0.0,23,19,0,1,4,82.60869565
2010021156,22,3541,0.0,22,18,9,3,4,81.81818182
2010021156,30,3600,0.0,35,33,5,2,2,94.28571429
2010021157,18,3600,0.0,29,27,0,0,2,93.10344828
2010021157,21,3530,0.0,34,31,4,0,3,91.17647059
2010021158,26,3569,0.0,35,32,6,1,3,91.42857143
2010021158,23,3598,0.0,19,18,6,0,1,94.73684211
2010021159,25,1050,0.0,19,17,5,0,2,89.47368421
2010021159,25,2550,0.0,33,29,3,2,4,87.87878788
2010021159,28,3600,0.0,29,29,2,3,0,100.0
2010021160,4,3477,0.0,24,20,0,0,4,83.33333333
2010021160,1,3595,0.0,36,34,1,0,2,94.44444444
2010021161,16,3900,0.0,34,31,13,1,3,91.17647059
2010021161,29,3900,0.0,29,26,7,2,3,89.65517241
2010021162,20,3600,0.0,27,25,5,3,2,92.59259259
2010021162,19,3548,0.0,25,22,7,1,3,88.0
2010021163,21,3900,0.0,38,35,8,0,3,92.10526316
2010021163,27,3891,0.0,20,17,2,0,3,85.0
2010021164,11,3509,0.0,24,21,0,1,3,87.5
2010021164,6,3600,2.0,30,28,0,1,2,93.33333333
2010021165,14,3599,0.0,30,29,7,1,1,96.66666667
2010021165,30,3477,0.0,23,20,4,0,3,86.95652174
2010021166,17,3776,0.0,34,31,10,1,3,91.17647059
2010021166,18,3775,0.0,41,37,2,1,4,90.24390244
2010021167,25,3546,0.0,31,29,0,0,2,93.5483871
2010021167,26,3600,0.0,25,24,0,0,1,96.0
2010021168,10,3562,0.0,25,23,2,0,2,92.0
2010021168,9,3512,0.0,30,26,10,0,4,86.66666667
2010021169,8,3600,0.0,21,20,0,0,1,95.23809524
2010021169,1,3592,0.0,29,26,4,2,3,89.65517241
2010021170,12,3600,0.0,31,29,2,0,2,93.5483871
2010021170,2,3542,0.0,25,22,3,2,3,88.0
2010021171,7,3799,0.0,35,30,2,2,5,85.71428571
2010021171,15,3758,0.0,38,34,2,0,4,89.47368421
2010021172,5,3589,0.0,30,28,3,0,2,93.33333333
2010021172,13,3591,0.0,33,30,4,1,3,90.90909091
2010021173,22,3600,0.0,41,40,9,0,1,97.56097561
2010021173,23,3595,0.0,34,30,2,4,4,88.23529412
2010021174,24,3563,0.0,32,29,3,2,3,90.625
2010021174,28,3600,0.0,22,20,2,0,2,90.90909091
2010021175,3,3874,0.0,34,32,3,0,2,94.11764706
2010021175,4,3900,0.0,34,32,6,2,2,94.11764706
2010021176,7,3747,0.0,36,35,9,0,1,97.22222222
2010021176,12,3776,0.0,31,29,5,1,2,93.5483871
2010021177,30,3529,0.0,34,30,6,1,4,88.23529412
2010021177,17,3596,0.0,29,27,4,0,2,93.10344828
2010021178,19,3600,0.0,24,23,3,0,1,95.83333333
2010021178,29,2400,0.0,21,17,0,0,4,80.95238095
2010021178,29,1200,0.0,12,10,3,0,2,83.33333333
2010021179,14,3600,0.0,31,31,3,2,0,100.0
2010021179,16,3545,2.0,14,13,2,0,1,92.85714286
2010021180,20,3600,0.0,35,34,4,0,1,97.14285714
2010021180,21,3510,0.0,36,34,1,1,2,94.44444444
2010021181,25,3600,0.0,27,24,4,0,3,88.88888889
2010021181,24,3512,0.0,31,27,7,0,4,87.09677419
2010021182,6,3580,0.0,25,21,4,0,4,84.0
2010021182,3,3563,0.0,30,27,1,3,3,90.0
2010021183,26,1530,0.0,16,12,0,1,4,75.0
2010021183,26,2067,0.0,19,17,0,0,2,89.47368421
2010021183,28,3600,0.0,32,31,3,0,1,96.875
2010021184,14,3600,0.0,24,20,3,1,4,83.33333333
2010021184,7,3600,0.0,25,23,3,0,2,92.0
2010021185,15,3900,0.0,21,19,0,0,2,90.47619048
2010021185,10,3900,0.0,41,39,9,0,2,95.12195122
2010021186,1,3600,0.0,27,23,1,0,4,85.18518519
2010021186,5,3600,0.0,24,22,1,0,2,91.66666667
2010021187,16,3679,0.0,35,33,7,0,2,94.28571429
2010021187,8,3674,0.0,43,42,14,1,1,97.6744186
2010021188,4,3561,0.0,35,31,4,2,4,88.57142857
2010021188,9,3600,0.0,29,27,5,1,2,93.10344828
2010021189,21,3538,0.0,28,26,5,0,2,92.85714286
2010021189,19,3600,0.0,27,26,5,0,1,96.2962963
2010021190,11,2284,0.0,11,9,0,0,2,81.81818182
2010021190,11,1316,0.0,13,9,0,0,4,69.23076923
2010021190,18,3575,0.0,36,33,1,0,3,91.66666667
2010021191,29,3580,0.0,28,27,8,0,1,96.42857143
2010021191,25,3600,2.0,23,23,7,2,0,100.0
2010021192,23,3564,0.0,22,20,7,0,2,90.90909091
2010021192,23,29,0.0,0,0,0,0,0,
2010021192,22,3594,0.0,26,26,2,0,0,100.0
2010021193,2,3561,0.0,33,30,3,0,3,90.90909091
2010021193,6,3583,0.0,32,30,5,2,2,93.75
2010021194,10,1137,0.0,11,11,7,0,0,100.0
2010021194,10,2400,0.0,21,18,3,0,3,85.71428571
2010021194,1,3600,0.0,24,22,1,1,2,91.66666667
2010021195,13,3468,0.0,24,20,5,2,4,83.33333333
2010021195,15,3600,0.0,33,31,5,1,2,93.93939394
2010021196,17,3600,0.0,32,29,6,0,3,90.625
2010021196,12,3600,0.0,42,42,9,0,0,100.0
2010021197,19,3799,0.0,39,35,5,0,4,89.74358974
2010021197,16,3799,0.0,24,21,2,0,3,87.5
2010021198,22,3600,0.0,47,41,4,1,6,87.23404255
2010021198,20,3591,0.0,23,22,2,0,1,95.65217391
2010021199,28,3597,0.0,34,28,4,2,6,82.35294118
2010021199,24,1761,0.0,15,14,3,0,1,93.33333333
2010021199,24,1836,0.0,23,22,8,0,1,95.65217391
2010021200,27,3900,0.0,33,31,4,1,2,93.93939394
2010021200,26,3866,0.0,35,33,7,0,2,94.28571429
2010021201,11,3600,0.0,29,29,2,1,0,100.0
2010021201,3,3593,0.0,26,23,1,1,3,88.46153846
2010021202,8,3633,0.0,32,29,1,2,3,90.625
2010021202,9,3673,0.0,29,27,2,0,2,93.10344828
2010021203,21,3497,0.0,37,33,3,0,4,89.18918919
2010021203,25,3600,0.0,23,21,0,4,2,91.30434783
2010021204,30,1062,0.0,5,5,1,1,0,100.0
2010021204,30,2538,0.0,23,18,4,0,5,78.26086957
2010021204,23,3595,0.0,29,29,9,0,0,100.0
2010021205,5,3900,0.0,38,35,11,0,3,92.10526316
2010021205,2,3824,0.0,38,35,7,1,3,92.10526316
2010021206,16,3600,0.0,28,26,0,0,2,92.85714286
2010021206,17,3548,0.0,29,25,1,2,4,86.20689655
2010021207,4,3676,0.0,29,25,1,1,4,86.20689655
2010021207,7,2400,0.0,19,16,0,1,3,84.21052632
2010021207,7,1276,0.0,8,8,0,0,0,100.0
2010021208,12,3597,0.0,19,18,0,0,1,94.73684211
2010021208,11,3600,2.0,32,26,2,0,6,81.25
2010021209,13,3514,0.0,33,29,6,1,4,87.87878788
2010021209,14,3599,0.0,25,23,5,0,2,92.0
2010021210,29,3600,0.0,25,21,2,0,4,84.0
2010021210,18,3600,0.0,45,44,1,1,1,97.77777778
2010021211,25,3600,0.0,17,15,0,0,2,88.23529412
2010021211,21,3522,0.0,28,25,5,0,3,89.28571429
2010021212,30,3593,0.0,29,28,9,2,1,96.55172414
2010021212,22,3573,0.0,26,24,5,0,2,92.30769231
2010021213,28,3523,0.0,26,22,4,1,4,84.61538462
2010021213,27,3588,0.0,27,24,6,0,3,88.88888889
2010021214,26,3522,0.0,28,26,5,0,2,92.85714286
2010021214,24,3600,0.0,24,23,3,1,1,95.83333333
2010021215,1,3600,0.0,29,24,0,0,5,82.75862069
2010021215,3,3600,0.0,26,24,0,0,2,92.30769231
2010021216,9,3554,0.0,29,26,7,0,3,89.65517241
2010021216,6,3600,0.0,32,31,1,1,1,96.875
2010021217,8,3600,0.0,28,27,2,1,1,96.42857143
2010021217,10,3599,0.0,34,30,2,5,4,88.23529412
2010021218,2,3490,0.0,38,32,8,0,6,84.21052632
2010021218,4,725,0.0,10,7,2,1,3,70.0
2010021218,4,2868,0.0,26,25,6,1,1,96.15384615
2010021219,14,3600,0.0,44,42,13,0,2,95.45454545
2010021219,12,3516,0.0,33,29,5,0,4,87.87878788
2010021220,15,3538,0.0,23,22,0,0,1,95.65217391
2010021220,13,3600,0.0,28,28,1,2,0,100.0
2010021221,7,1768,0.0,15,12,3,0,3,80.0
2010021221,7,1832,0.0,21,20,8,1,1,95.23809524
2010021221,29,3500,0.0,30,25,4,0,5,83.33333333
2010021222,18,3575,0.0,25,23,0,0,2,92.0
2010021222,19,3600,0.0,24,24,3,1,0,100.0
2010021223,23,3761,0.0,36,34,6,0,2,94.44444444
2010021223,20,3756,0.0,39,36,5,4,3,92.30769231
2010021224,24,3600,0.0,44,43,17,3,1,97.72727273
2010021224,26,3527,0.0,20,17,3,1,3,85.0
2010021225,27,3521,0.0,37,34,8,0,3,91.89189189
2010021225,28,3600,0.0,36,35,6,1,1,97.22222222
2010021226,6,3600,0.0,32,29,5,0,3,90.625
2010021226,1,3600,0.0,26,24,4,0,2,92.30769231
2010021227,5,3599,0.0,39,37,4,2,2,94.87179487
2010021227,11,3554,0.0,19,15,2,1,4,78.94736842
2010021228,22,3837,0.0,25,21,4,0,4,84.0
2010021228,21,3837,0.0,28,25,1,3,3,89.28571429
2010021229,17,3600,0.0,36,33,2,0,3,91.66666667
2010021229,16,3536,0.0,31,27,0,1,4,87.09677419
2010021230,25,3531,0.0,22,18,2,0,4,81.81818182
2010021230,30,3589,0.0,29,26,11,0,3,89.65517241
2010030111,3,4704,0.0,33,31,4,0,2,93.93939394
2010030111,15,4704,0.0,25,24,1,0,1,96.0
2010030112,3,3466,0.0,18,16,2,1,2,88.88888889
2010030112,15,3600,0.0,22,22,2,1,0,100.0
2010030113,15,3491,0.0,35,32,9,1,3,91.42857143
2010030113,3,3600,0.0,25,23,3,0,2,92.0
2010030114,15,5556,0.0,39,36,4,1,3,92.30769231
2010030114,3,5556,0.0,53,49,5,1,4,92.45283019
2010030115,3,3409,0.0,27,24,2,1,3,88.88888889
2010030115,15,3593,0.0,27,26,5,0,1,96.2962963
2010030121,7,3600,0.0,35,35,11,0,0,100.0
2010030121,4,3513,0.0,25,24,1,1,1,96.0
2010030122,7,3526,0.0,34,29,13,3,5,85.29411765
2010030122,4,750,0.0,7,4,3,0,3,57.14285714
2010030122,4,2800,0.0,21,20,4,3,1,95.23809524
2010030123,4,3600,0.0,37,35,10,0,2,94.59459459
2010030123,7,3541,0.0,25,22,1,1,3,88.0
2010030124,4,3523,2.0,29,28,6,1,1,96.55172414
2010030124,7,3597,2.0,32,32,1,2,0,100.0
2010030125,7,3916,0.0,39,36,12,0,3,92.30769231
2010030125,4,2995,0.0,21,20,1,1,1,95.23809524
2010030125,4,936,0.0,11,8,1,0,3,72.72727273
2010030126,4,1188,0.0,8,5,2,1,3,62.5
2010030126,4,2683,0.0,25,24,6,0,1,96.0
2010030126,7,3883,0.0,49,44,7,0,5,89.79591837
2010030127,7,1031,0.0,8,7,0,0,1,87.5
2010030127,7,2519,0.0,28,24,2,1,4,85.71428571
2010030127,4,3588,0.0,28,26,5,0,2,92.85714286
2010030131,8,3600,0.0,31,31,5,0,0,100.0
2010030131,6,3595,0.0,20,18,3,1,2,90.0
2010030132,8,3599,0.0,35,34,5,1,1,97.14285714
2010030132,6,3486,0.0,26,23,1,1,3,88.46153846
2010030133,6,3600,0.0,36,34,2,1,2,94.44444444
2010030133,8,3560,0.0,24,21,3,1,3,87.5
2010030134,6,3719,0.0,38,34,2,0,4,89.47368421
2010030134,8,3719,0.0,35,30,0,0,5,85.71428571
2010030135,8,5325,0.0,51,49,4,1,2,96.07843137
2010030135,6,5340,0.0,45,44,1,1,1,97.77777778
2010030136,6,3546,0.0,27,25,9,0,2,92.59259259
2010030136,8,3600,0.0,32,31,2,2,1,96.875
2010030137,8,3926,0.0,34,30,2,0,4,88.23529412
2010030137,6,3943,0.0,37,34,2,1,3,91.89189189
2010030141,14,3537,0.0,39,37,10,0,2,94.87179487
2010030141,5,3595,0.0,32,32,3,1,0,100.0
2010030142,14,3600,0.0,36,35,8,0,1,97.22222222
2010030142,5,3552,0.0,20,16,1,2,4,80.0
2010030143,5,3600,0.0,27,25,5,0,2,92.59259259
2010030143,14,3526,0.0,30,27,5,0,3,90.0
2010030144,5,5018,0.0,31,29,3,0,2,93.5483871
2010030144,14,5018,0.0,53,50,4,1,3,94.33962264
2010030145,14,3600,0.0,33,31,6,1,2,93.93939394
2010030145,5,2069,2.0,11,7,3,0,4,63.63636364
2010030145,5,1510,0.0,14,10,0,0,4,71.42857143
2010030146,5,3530,0.0,21,17,4,0,4,80.95238095
2010030146,14,3564,0.0,29,27,8,0,2,93.10344828
2010030147,14,3600,0.0,36,36,9,1,0,100.0
2010030147,5,3507,0.0,23,22,4,0,1,95.65217391
2010030151,16,3480,0.0,33,31,2,2,2,93.93939394
2010030151,23,3600,0.0,32,32,4,0,0,100.0
2010030152,16,3510,0.0,27,23,0,1,4,85.18518519
2010030152,23,3600,0.0,26,23,0,0,3,88.46153846
2010030153,23,3600,0.0,32,30,7,0,2,93.75
2010030153,16,3508,0.0,26,23,1,2,3,88.46153846
2010030154,23,2643,0.0,28,22,5,0,6,78.57142857
2010030154,23,955,0.0,7,6,1,0,1,85.71428571
2010030154,16,3568,0.0,23,21,5,0,2,91.30434783
2010030155,16,3600,0.0,36,36,6,0,0,100.0
2010030155,23,1275,0.0,12,8,1,1,4,66.66666667
2010030155,23,2314,0.0,14,13,1,2,1,92.85714286
2010030156,23,1979,0.0,13,12,0,0,1,92.30769231
2010030156,23,2551,0.0,20,17,5,0,3,85.0
2010030156,16,4530,0.0,35,32,1,0,3,91.42857143
2010030157,16,3916,0.0,38,36,5,2,2,94.73684211
2010030157,23,3922,0.0,32,31,1,1,1,96.875
2010030161,26,4484,0.0,45,42,4,0,3,93.33333333
2010030161,28,4484,0.0,35,33,0,0,2,94.28571429
2010030162,26,3600,0.0,34,34,8,4,0,100.0
2010030162,28,3573,0.0,23,19,3,0,4,82.60869565
2010030163,28,2545,0.0,12,11,0,1,1,91.66666667
2010030163,28,1244,0.0,10,6,3,1,4,60.0
2010030163,26,3789,0.0,36,30,5,0,6,83.33333333
2010030164,28,3581,0.0,38,35,7,2,3,92.10526316
2010030164,26,3600,0.0,27,21,10,2,6,77.77777778
2010030165,26,3600,0.0,52,51,14,0,1,98.07692308
2010030165,28,2944,0.0,18,18,0,0,0,100.0
2010030165,28,522,0.0,4,1,0,0,3,25.0
2010030166,28,3742,0.0,29,26,8,1,3,89.65517241
2010030166,26,3742,0.0,35,31,3,0,4,88.57142857
2010030171,27,3511,0.0,36,32,6,2,4,88.88888889
2010030171,17,3600,0.0,28,26,3,0,2,92.85714286
2010030172,27,3538,0.0,31,27,2,0,4,87.09677419
2010030172,17,3600,0.0,33,30,6,0,3,90.90909091
2010030173,17,3600,0.0,30,28,3,2,2,93.33333333
2010030173,27,3473,0.0,34,30,6,1,4,88.23529412
2010030174,17,3600,0.0,27,24,1,0,3,88.88888889
2010030174,27,3501,0.0,39,34,5,0,5,87.17948718
2010030181,18,3538,0.0,28,27,7,0,1,96.42857143
2010030181,24,2456,0.0,24,20,3,0,4,83.33333333
2010030181,24,1144,0.0,6,6,1,2,0,100.0
2010030182,18,3545,0.0,27,23,3,0,4,85.18518519
2010030182,24,3592,0.0,34,31,9,0,3,91.17647059
2010030183,24,3580,0.0,37,33,11,0,4,89.18918919
2010030183,18,3600,0.0,16,13,2,0,3,81.25
2010030184,24,3600,0.0,22,19,2,1,3,86.36363636
2010030184,18,2801,0.0,29,23,6,0,6,79.31034483
2010030184,18,794,0.0,9,9,1,0,0,100.0
2010030185,18,3696,0.0,26,23,3,0,3,88.46153846
2010030185,24,3711,0.0,37,33,5,0,4,89.18918919
2010030186,24,3533,0.0,29,26,4,0,3,89.65517241
2010030186,18,3600,0.0,27,25,6,0,2,92.59259259
2010030211,14,3584,0.0,28,26,5,3,2,92.85714286
2010030211,15,3556,0.0,23,20,2,5,3,86.95652174
2010030212,14,3961,0.0,37,35,12,1,2,94.59459459
2010030212,15,3944,0.0,23,20,4,2,3,86.95652174
2010030213,15,3483,0.0,30,26,2,1,4,86.66666667
2010030213,14,3596,0.0,32,29,1,1,3,90.625
2010030214,15,3469,0.0,37,32,3,0,5,86.48648649
2010030214,14,3600,0.0,36,33,4,1,3,91.66666667
2010030221,6,3600,0.0,34,31,7,4,3,91.17647059
2010030221,4,1366,0.0,10,8,1,0,2,80.0
2010030221,4,2197,0.0,23,18,3,0,5,78.26086957
2010030222,6,4440,2.0,54,52,11,2,2,96.2962963
2010030222,4,539,0.0,6,6,3,0,0,100.0
2010030222,4,3901,0.0,35,32,2,1,3,91.42857143
2010030223,4,1470,0.0,8,7,1,0,1,87.5
2010030223,4,2114,0.0,20,16,0,1,4,80.0
2010030223,6,3600,0.0,38,37,1,1,1,97.36842105
2010030224,4,3499,0.0,25,22,4,1,3,88.0
2010030224,6,3599,0.0,23,22,4,0,1,95.65217391
2010030231,18,3509,0.0,30,29,13,0,1,96.66666667
2010030231,23,3598,0.0,20,20,4,1,0,100.0
2010030232,18,5690,0.0,33,32,0,0,1,96.96969697
2010030232,23,5691,0.0,46,44,7,0,2,95.65217391
2010030233,23,4245,0.0,30,28,3,1,2,93.33333333
2010030233,18,4243,0.0,47,44,3,0,3,93.61702128
2010030234,23,3599,0.0,21,19,5,0,2,90.47619048
2010030234,18,3571,0.0,27,24,3,0,3,88.88888889
2010030235,18,3600,0.0,34,31,2,0,3,91.17647059
2010030235,23,3541,0.0,23,19,2,1,4,82.60869565
2010030236,23,3586,0.0,24,23,7,2,1,95.83333333
2010030236,18,3515,0.0,19,17,3,0,2,89.47368421
2010030241,17,4011,2.0,46,44,13,2,2,95.65217391
2010030241,28,4023,0.0,25,24,5,0,1,96.0
2010030242,17,3537,0.0,37,35,7,1,2,94.59459459
2010030242,28,3592,0.0,34,33,7,1,1,97.05882353
2010030243,28,4159,0.0,41,38,6,0,3,92.68292683
2010030243,17,4145,0.0,38,34,5,3,4,89.47368421
2010030244,28,3521,0.0,40,36,4,0,4,90.0
2010030244,17,3598,0.0,28,25,3,0,3,89.28571429
2010030245,17,3595,0.0,42,39,8,0,3,92.85714286
2010030245,28,3527,0.0,22,18,0,0,4,81.81818182
2010030246,28,3522,0.0,44,42,9,1,2,95.45454545
2010030246,17,3600,0.0,25,24,5,0,1,96.0
2010030247,17,3516,0.0,30,27,9,1,3,90.0
2010030247,28,3600,0.0,40,38,2,1,2,95.0
2010030311,14,3600,0.0,33,31,4,0,2,93.93939394
2010030311,6,3583,0.0,33,29,10,0,4,87.87878788
2010030312,14,1129,0.0,8,8,3,0,0,100.0
2010030312,14,2400,0.0,27,21,9,2,6,77.77777778
2010030312,6,3600,0.0,41,36,6,3,5,87.80487805
2010030313,6,3600,0.0,31,31,5,0,0,100.0
2010030313,14,3471,0.0,25,23,3,0,2,92.0
2010030314,6,3552,0.0,36,32,2,2,4,88.88888889
2010030314,14,2522,0.0,21,21,2,0,0,100.0
2010030314,14,1078,0.0,9,6,0,0,3,66.66666667
2010030315,14,3558,0.0,19,17,2,2,2,89.47368421
2010030315,6,3566,0.0,34,33,4,1,1,97.05882353
2010030316,6,3512,0.0,26,21,5,0,5,80.76923077
2010030316,14,3600,0.0,20,16,4,0,4,80.0
2010030317,14,3574,0.0,38,37,0,0,1,97.36842105
2010030317,6,3600,0.0,24,24,0,0,0,100.0
2010030321,28,3508,0.0,38,35,4,0,3,92.10526316
2010030321,23,3600,0.0,29,27,0,0,2,93.10344828
2010030322,28,3600,0.0,38,31,6,0,7,81.57894737
2010030322,23,3586,0.0,31,28,1,2,3,90.32258065
2010030323,23,3523,0.0,38,34,16,1,4,89.47368421
2010030323,28,3586,0.0,30,27,9,0,3,90.0
2010030324,23,3600,0.0,35,33,8,1,2,94.28571429
2010030324,28,3452,0.0,13,9,1,2,4,69.23076923
2010030325,28,5410,0.0,34,31,4,0,3,91.17647059
2010030325,23,5358,0.0,56,54,8,1,2,96.42857143
2010030411,6,3568,0.0,34,33,7,0,1,97.05882353
2010030411,23,3586,0.0,36,36,12,2,0,100.0
2010030412,6,3611,0.0,33,30,2,1,3,90.90909091
2010030412,23,3611,0.0,30,28,6,0,2,93.33333333
2010030413,23,3600,0.0,38,30,11,5,8,78.94736842
2010030413,6,3600,0.0,41,40,12,3,1,97.56097561
2010030414,23,2597,0.0,20,16,3,0,4,80.0
2010030414,23,945,0.0,9,9,0,1,0,100.0
2010030414,6,3600,2.0,38,38,4,1,0,100.0
2010030415,6,3528,0.0,25,24,5,2,1,96.0
2010030415,23,3600,0.0,31,31,7,0,0,100.0
2010030416,23,515,0.0,8,5,1,0,3,62.5
2010030416,23,2994,0.0,32,30,9,0,2,93.75
2010030416,6,3525,0.0,38,36,11,0,2,94.73684211
2010030417,6,3600,0.0,37,37,2,0,0,100.0
2010030417,23,3575,0.0,20,17,1,1,3,85.0
2011020001,4,3600,0.0,23,22,5,0,1,95.65217391
2011020001,6,3555,0.0,29,27,2,3,2,93.10344828
2011020002,8,3496,0.0,18,16,5,1,2,88.88888889
2011020002,10,3598,0.0,32,32,6,1,0,100.0
2011020003,5,3900,0.0,36,33,3,0,3,91.66666667
2011020003,23,3894,0.0,28,25,0,0,3,89.28571429
2011020004,14,3600,0.0,33,32,3,1,1,96.96969697
2011020004,12,3596,0.0,34,29,5,1,5,85.29411765
2011020005,9,3589,0.0,39,34,10,1,5,87.17948718
2011020005,17,3600,0.0,32,29,1,1,3,90.625
2011020006,18,3600,0.0,34,32,8,1,2,94.11764706
2011020006,29,3526,0.0,31,28,2,1,3,90.32258065
2011020007,24,3600,0.0,25,21,7,0,4,84.0
2011020007,7,3600,0.0,30,29,6,1,1,96.66666667
2011020008,16,3442,0.0,33,31,3,1,2,93.93939394
2011020008,25,3574,0.0,38,37,10,1,1,97.36842105
2011020009,3,3848,0.0,30,27,7,0,3,90.0
2011020009,26,3839,0.0,26,24,1,1,2,92.30769231
2011020010,14,3593,0.0,42,38,5,1,4,90.47619048
2011020010,6,3599,0.0,26,25,8,0,1,96.15384615
2011020011,9,2400,0.0,24,20,7,1,4,83.33333333
2011020011,9,1145,0.0,11,9,4,0,2,81.81818182
2011020011,10,3596,0.0,32,27,6,4,5,84.375
2011020012,4,3594,0.0,20,20,2,2,0,100.0
2011020012,1,3600,0.0,29,26,7,2,3,89.65517241
2011020013,12,3727,0.0,36,32,4,0,4,88.88888889
2011020013,15,3739,0.0,31,28,10,0,3,90.32258065
2011020014,13,3597,0.0,27,27,6,0,0,100.0
2011020014,2,3493,0.0,29,27,3,1,2,93.10344828
2011020015,18,3600,0.0,33,31,4,1,2,93.93939394
2011020015,19,3526,0.0,15,12,5,0,3,80.0
2011020016,29,1082,0.0,3,3,0,1,0,100.0
2011020016,29,2400,0.0,23,19,0,2,4,82.60869565
2011020016,30,3595,0.0,31,29,7,0,2,93.5483871
2011020017,25,3528,0.0,30,26,6,0,4,86.66666667
2011020017,16,3596,0.0,21,19,1,2,2,90.47619048
2011020018,17,3593,0.0,29,29,3,0,0,100.0
2011020018,21,3596,0.0,38,36,3,0,2,94.73684211
2011020019,5,3598,0.0,20,17,2,2,3,85.0
2011020019,20,3538,0.0,36,32,8,0,4,88.88888889
2011020020,3,3900,0.0,28,27,7,2,1,96.42857143
2011020020,24,3900,0.0,15,14,3,2,1,93.33333333
2011020021,27,3493,0.0,52,46,12,0,6,88.46153846
2011020021,28,3595,0.0,29,26,6,2,3,89.65517241
2011020022,7,3600,0.0,33,31,1,1,2,93.93939394
2011020022,26,3495,0.0,26,22,4,0,4,84.61538462
2011020023,8,3597,0.0,31,30,7,0,1,96.77419355
2011020023,52,3586,0.0,22,17,3,1,5,77.27272727
2011020024,5,3896,0.0,35,34,9,2,1,97.14285714
2011020024,22,3891,0.0,34,33,12,0,1,97.05882353
2011020025,21,3600,0.0,30,30,1,1,0,100.0
2011020025,6,3530,0.0,36,35,5,0,1,97.22222222
2011020026,12,3550,0.0,25,22,5,2,3,88.0
2011020026,1,3599,0.0,26,24,6,2,2,92.30769231
2011020027,30,3503,0.0,14,12,1,0,2,85.71428571
2011020027,2,3600,0.0,21,20,4,1,1,95.23809524
2011020028,20,3600,0.0,35,30,2,1,5,85.71428571
2011020028,19,3592,0.0,17,15,2,0,2,88.23529412
2011020029,14,3900,0.0,43,38,10,1,5,88.37209302
2011020029,15,3897,0.0,28,23,7,1,5,82.14285714
2011020030,23,3600,0.0,25,23,8,0,2,92.0
2011020030,29,3509,0.0,25,22,6,0,3,88.0
2011020031,27,3879,0.0,25,24,6,2,1,96.0
2011020031,25,3874,0.0,41,40,11,2,1,97.56097561
2011020032,13,3491,0.0,29,25,7,0,4,86.20689655
2011020032,5,3597,0.0,34,32,5,1,2,94.11764706
2011020033,30,3900,0.0,44,41,10,0,3,93.18181818
2011020033,9,3900,0.0,27,24,2,0,3,88.88888889
2011020034,21,3872,0.0,33,31,7,1,2,93.93939394
2011020034,29,3900,0.0,32,30,6,1,2,93.75
2011020035,23,3502,0.0,27,22,7,2,5,81.48148148
2011020035,4,3600,0.0,40,36,10,2,4,90.0
2011020036,6,3500,0.0,34,31,7,3,3,91.17647059
2011020036,12,3592,0.0,28,26,7,0,2,92.85714286
2011020037,26,3900,0.0,37,36,3,0,1,97.2972973
2011020037,1,1200,0.0,11,10,0,0,1,90.90909091
2011020037,1,2700,0.0,16,16,0,0,0,100.0
2011020038,14,1607,0.0,18,13,0,0,5,72.22222222
2011020038,14,1988,0.0,16,16,5,3,0,100.0
2011020038,2,3600,0.0,35,34,1,1,1,97.14285714
2011020039,15,3753,0.0,41,39,6,0,2,95.12195122
2011020039,5,3758,0.0,19,16,1,0,3,84.21052632
2011020040,20,3600,0.0,36,35,14,2,1,97.22222222
2011020040,8,3599,0.0,21,17,3,1,4,80.95238095
2011020041,21,3600,0.0,16,15,2,0,1,93.75
2011020041,9,3600,0.0,39,32,9,1,7,82.05128205
2011020042,23,3494,0.0,37,35,11,1,2,94.59459459
2011020042,17,3600,0.0,25,25,6,0,0,100.0
2011020043,27,3594,0.0,25,23,7,1,2,92.0
2011020043,18,3570,0.0,30,26,1,0,4,86.66666667
2011020044,22,3900,0.0,35,34,4,0,1,97.14285714
2011020044,30,3900,0.0,22,21,1,2,1,95.45454545
2011020045,52,3512,0.0,32,28,2,0,4,87.5
2011020045,16,3600,0.0,30,27,6,0,3,90.0
2011020046,19,3543,0.0,24,21,3,0,3,87.5
2011020046,25,3595,0.0,38,36,7,2,2,94.73684211
2011020047,12,3600,0.0,42,39,13,3,3,92.85714286
2011020047,7,3532,0.0,34,30,10,3,4,88.23529412
2011020048,28,3529,0.0,23,22,3,2,1,95.65217391
2011020048,24,3600,0.0,31,31,7,0,0,100.0
2011020049,20,3519,0.0,25,22,5,0,3,88.0
2011020049,10,3593,0.0,32,30,3,2,2,93.75
2011020050,21,3895,0.0,43,38,5,1,5,88.37209302
2011020050,8,3900,0.0,30,25,2,3,5,83.33333333
2011020051,3,3539,0.0,33,30,9,2,3,90.90909091
2011020051,2,3572,0.0,31,29,8,3,2,93.5483871
2011020052,26,3698,0.0,34,32,7,0,2,94.11764706
2011020052,4,3658,0.0,26,23,9,0,3,88.46153846
2011020053,7,3600,0.0,31,29,2,0,2,93.5483871
2011020053,5,3511,0.0,28,25,3,0,3,89.28571429
2011020054,9,3553,0.0,26,24,4,0,2,92.30769231
2011020054,15,3570,0.0,34,33,1,2,1,97.05882353
2011020055,52,3600,0.0,34,30,8,2,4,88.23529412
2011020055,27,3597,0.0,19,18,4,2,1,94.73684211
2011020056,14,3897,0.0,38,36,14,0,2,94.73684211
2011020056,13,3891,0.0,30,28,4,0,2,93.33333333
2011020057,1,3885,0.0,31,29,6,0,2,93.5483871
2011020057,18,3900,0.0,41,39,7,1,2,95.12195122
2011020058,17,3846,0.0,14,12,0,0,2,85.71428571
2011020058,30,3851,0.0,41,38,5,0,3,92.68292683
2011020059,29,3590,0.0,33,29,6,1,4,87.87878788
2011020059,25,3600,0.0,15,13,6,2,2,86.66666667
2011020060,6,3900,0.0,29,27,1,2,2,93.10344828
2011020060,16,3900,0.0,37,35,7,1,2,94.59459459
2011020061,23,3600,0.0,30,27,5,0,3,90.0
2011020061,22,3512,0.0,26,22,4,1,4,84.61538462
2011020062,19,3600,0.0,36,34,6,0,2,94.44444444
2011020062,28,3555,0.0,19,16,4,0,3,84.21052632
2011020063,19,3516,0.0,23,19,9,0,4,82.60869565
2011020063,24,3600,0.0,30,28,5,1,2,93.33333333
2011020064,21,3669,0.0,29,27,3,0,2,93.10344828
2011020064,10,3662,0.0,24,21,1,0,3,87.5
2011020065,13,3584,0.0,39,35,4,3,4,89.74358974
2011020065,14,3583,0.0,33,26,11,1,7,78.78787879
2011020066,5,3530,0.0,34,32,5,1,2,94.11764706
2011020066,52,3600,0.0,29,28,3,0,1,96.55172414
2011020067,18,3544,0.0,24,22,5,0,2,91.66666667
2011020067,22,3595,0.0,12,11,4,0,1,91.66666667
2011020068,24,3600,0.0,43,41,13,1,2,95.34883721
2011020068,28,3483,0.0,22,19,3,0,3,86.36363636
2011020069,12,3600,0.0,34,33,5,5,1,97.05882353
2011020069,6,3600,2.0,23,19,6,0,4,82.60869565
2011020070,13,3562,0.0,31,29,1,0,2,93.5483871
2011020070,15,3592,0.0,20,20,3,0,0,100.0
2011020071,25,3600,0.0,40,38,9,0,2,95.0
2011020071,29,3507,0.0,18,15,2,0,3,83.33333333
2011020072,7,3587,0.0,41,40,10,0,1,97.56097561
2011020072,8,3554,0.0,22,20,0,0,2,90.90909091
2011020073,4,3586,0.0,23,21,5,0,2,91.30434783
2011020073,9,2394,0.0,20,17,3,2,3,85.0
2011020073,9,1200,0.0,10,6,2,0,4,60.0
2011020074,5,3598,0.0,26,24,9,0,2,92.30769231
2011020074,30,3514,0.0,25,21,3,3,4,84.0
2011020075,22,3541,0.0,28,26,1,1,2,92.85714286
2011020075,20,3600,0.0,25,24,10,0,1,96.0
2011020076,3,3600,0.0,40,40,11,0,0,100.0
2011020076,23,3587,2.0,19,15,0,2,4,78.94736842
2011020077,16,3595,0.0,16,14,1,0,2,87.5
2011020077,27,3600,0.0,35,30,4,3,5,85.71428571
2011020078,19,2423,0.0,18,14,4,0,4,77.77777778
2011020078,19,1177,0.0,6,5,0,0,1,83.33333333
2011020078,26,3600,0.0,27,27,3,0,0,100.0
2011020079,52,3900,0.0,23,20,2,1,3,86.95652174
2011020079,10,3900,0.0,29,26,4,0,3,89.65517241
2011020080,10,3600,0.0,43,37,7,3,6,86.04651163
2011020080,6,3600,0.0,28,26,6,0,2,92.85714286
2011020081,15,3595,0.0,42,40,5,2,2,95.23809524
2011020081,4,3600,0.0,28,23,3,0,5,82.14285714
2011020082,8,3512,2.0,32,29,3,0,3,90.625
2011020082,5,3595,0.0,28,27,6,3,1,96.42857143
2011020083,52,3383,0.0,29,26,9,1,3,89.65517241
2011020083,9,3598,0.0,36,35,7,0,1,97.22222222
2011020084,2,3600,0.0,30,26,2,2,4,86.66666667
2011020084,14,3600,0.0,17,16,1,1,1,94.11764706
2011020085,7,3588,0.0,22,22,1,0,0,100.0
2011020085,13,3600,0.0,38,35,2,0,3,92.10526316
2011020086,16,3600,0.0,32,31,5,0,1,96.875
2011020086,21,3514,0.0,29,27,1,1,2,93.10344828
2011020087,3,3898,0.0,35,33,4,0,2,94.28571429
2011020087,20,3898,0.0,29,26,0,1,3,89.65517241
2011020088,30,3842,0.0,31,30,3,1,1,96.77419355
2011020088,22,3900,0.0,31,30,6,0,1,96.77419355
2011020089,18,1200,0.0,16,12,2,0,4,75.0
2011020089,18,2400,0.0,24,23,12,1,1,95.83333333
2011020089,23,3593,0.0,26,25,4,1,1,96.15384615
2011020090,26,3600,0.0,28,28,3,1,0,100.0
2011020090,27,3454,0.0,22,20,5,0,2,90.90909091
2011020091,28,3872,0.0,19,16,3,1,3,84.21052632
2011020091,1,3900,0.0,41,38,12,1,3,92.68292683
2011020092,29,3532,0.0,32,28,9,3,4,87.5
2011020092,17,3590,0.0,34,32,6,0,2,94.11764706
2011020093,12,3834,0.0,43,40,1,0,3,93.02325581
2011020093,19,3838,0.0,29,27,8,0,2,93.10344828
2011020094,25,3600,0.0,36,35,5,1,1,97.22222222
2011020094,24,3543,0.0,19,16,2,0,3,84.21052632
2011020095,18,3600,0.0,33,33,4,0,0,100.0
2011020095,20,3509,0.0,14,12,2,0,2,85.71428571
2011020096,30,3879,0.0,32,29,5,2,3,90.625
2011020096,23,3879,0.0,23,21,6,0,2,91.30434783
2011020097,28,3600,0.0,39,37,3,0,2,94.87179487
2011020097,6,3543,0.0,29,26,2,1,3,89.65517241
2011020098,10,1189,0.0,10,9,1,1,1,90.0
2011020098,10,2483,0.0,18,15,2,3,3,83.33333333
2011020098,8,3683,2.0,27,22,5,1,5,81.48148148
2011020099,29,3600,0.0,27,23,0,2,4,85.18518519
2011020099,9,3552,0.0,21,18,1,0,3,85.71428571
2011020100,19,3598,0.0,36,34,4,1,2,94.44444444
2011020100,4,3459,0.0,25,21,1,1,4,84.0
2011020101,1,3600,0.0,29,25,6,0,4,86.20689655
2011020101,5,3600,0.0,24,23,1,0,1,95.83333333
2011020102,17,3600,0.0,25,18,0,2,7,72.0
2011020102,15,3600,0.0,33,32,5,1,1,96.96969697
2011020103,12,3532,0.0,24,19,6,3,5,79.16666667
2011020103,52,403,0.0,5,3,0,0,2,60.0
2011020103,52,3131,0.0,19,18,10,0,1,94.73684211
2011020104,7,3574,0.0,25,23,0,1,2,92.0
2011020104,14,3600,0.0,21,21,3,2,0,100.0
2011020105,2,3533,0.0,32,29,3,2,3,90.625
2011020105,13,1200,0.0,18,18,11,0,0,100.0
2011020105,13,2400,0.0,10,8,0,0,2,80.0
2011020106,21,3900,0.0,38,34,8,0,4,89.47368421
2011020106,16,3895,0.0,24,20,0,0,4,83.33333333
2011020107,3,2905,0.0,24,22,3,1,2,91.66666667
2011020107,3,582,0.0,3,3,0,0,0,100.0
2011020107,22,3600,0.0,19,19,4,1,0,100.0
2011020108,25,3487,0.0,24,23,3,0,1,95.83333333
2011020108,26,3559,0.0,28,28,1,0,0,100.0
2011020109,27,3600,0.0,33,29,10,0,4,87.87878788
2011020109,24,1807,0.0,16,16,7,0,0,100.0
2011020109,24,1676,0.0,19,14,1,0,5,73.68421053
2011020110,10,3537,0.0,30,26,5,1,4,86.66666667
2011020110,4,3590,0.0,26,24,1,1,2,92.30769231
2011020111,13,3600,0.0,41,40,11,0,1,97.56097561
2011020111,8,3539,0.0,31,29,6,0,2,93.5483871
2011020112,3,3600,0.0,28,27,1,1,1,96.42857143
2011020112,52,3508,0.0,17,15,2,0,2,88.23529412
2011020113,14,3600,0.0,39,36,2,0,3,92.30769231
2011020113,7,3550,0.0,23,19,3,1,4,82.60869565
2011020114,5,3600,0.0,33,33,1,0,0,100.0
2011020114,2,3511,0.0,28,26,5,0,2,92.85714286
2011020115,9,3900,0.0,34,32,5,0,2,94.11764706
2011020115,12,3898,0.0,28,26,1,2,2,92.85714286
2011020116,17,3510,0.0,31,28,7,0,3,90.32258065
2011020116,29,153,0.0,0,0,0,0,0,
2011020116,29,3441,0.0,31,30,5,2,1,96.77419355
2011020117,28,3600,0.0,20,19,2,1,1,95.0
2011020117,18,3525,0.0,35,33,7,1,2,94.28571429
2011020118,24,3900,0.0,35,33,2,2,2,94.28571429
2011020118,16,3900,0.0,31,29,8,0,2,93.5483871
2011020119,23,1615,0.0,14,11,5,0,3,78.57142857
2011020119,23,1897,0.0,8,8,1,0,0,100.0
2011020119,22,3600,0.0,37,35,2,1,2,94.59459459
2011020120,25,3894,0.0,35,33,3,1,2,94.28571429
2011020120,27,3900,0.0,36,34,5,0,2,94.44444444
2011020121,1,3600,0.0,31,31,0,0,0,100.0
2011020121,26,3600,0.0,23,20,3,0,3,86.95652174
2011020122,4,3586,0.0,28,23,6,1,5,82.14285714
2011020122,8,3600,0.0,22,21,2,0,1,95.45454545
2011020123,21,3540,0.0,34,31,4,0,3,91.17647059
2011020123,20,3600,0.0,36,34,1,0,2,94.44444444
2011020124,19,3597,0.0,32,32,1,0,0,100.0
2011020124,23,3599,0.0,31,28,4,0,3,90.32258065
2011020125,8,3600,0.0,30,29,2,0,1,96.66666667
2011020125,6,3532,0.0,35,33,3,3,2,94.28571429
2011020126,29,3540,0.0,26,22,2,1,4,84.61538462
2011020126,7,3600,0.0,43,41,9,0,2,95.34883721
2011020127,10,3600,0.0,30,28,5,1,2,93.33333333
2011020127,3,3504,0.0,36,32,2,1,4,88.88888889
2011020128,52,3083,0.0,43,36,9,0,7,83.72093023
2011020128,52,507,0.0,5,4,0,1,1,80.0
2011020128,4,2045,0.0,10,6,0,1,4,60.0
2011020128,4,1479,0.0,15,10,2,0,5,66.66666667
2011020129,2,0,0.0,0,0,0,0,0,
2011020129,2,3885,0.0,32,30,7,0,2,93.75
2011020129,5,3900,0.0,19,17,5,1,2,89.47368421
2011020130,13,3575,0.0,38,34,5,1,4,89.47368421
2011020130,9,3594,0.0,25,22,4,1,3,88.0
2011020131,14,1584,0.0,10,10,2,0,0,100.0
2011020131,14,1930,0.0,17,12,1,0,5,70.58823529
2011020131,18,3600,0.0,32,29,5,0,3,90.625
2011020132,24,3600,0.0,25,23,8,1,2,92.0
2011020132,30,3581,0.0,16,13,3,0,3,81.25
2011020133,26,3598,0.0,33,30,9,1,3,90.90909091
2011020133,25,3567,0.0,28,24,8,1,4,85.71428571
2011020134,15,3526,0.0,19,17,5,0,2,89.47368421
2011020134,22,3586,0.0,35,34,5,2,1,97.14285714
2011020135,1,3600,0.0,42,37,5,0,5,88.0952381
2011020135,27,3591,0.0,34,31,2,1,3,91.17647059
2011020136,16,3600,0.0,33,30,6,2,3,90.90909091
2011020136,12,3600,0.0,30,30,7,0,0,100.0
2011020137,28,3594,2.0,32,30,3,0,2,93.75
2011020137,17,3547,0.0,29,26,9,1,3,89.65517241
2011020138,22,3600,0.0,41,40,5,3,1,97.56097561
2011020138,21,3477,0.0,19,16,1,0,3,84.21052632
2011020139,19,3548,0.0,17,15,0,0,2,88.23529412
2011020139,20,3600,0.0,29,28,5,0,1,96.55172414
2011020140,9,3889,0.0,28,24,4,2,4,85.71428571
2011020140,3,3900,0.0,40,36,3,3,4,90.0
2011020141,13,3600,0.0,26,24,1,0,2,92.30769231
2011020141,7,3538,0.0,36,33,2,0,3,91.66666667
2011020142,5,3519,0.0,29,25,1,2,4,86.20689655
2011020142,10,3600,0.0,37,34,7,0,3,91.89189189
2011020143,6,3504,0.0,26,23,6,0,3,88.46153846
2011020143,6,7,0.0,0,0,0,0,0,
2011020143,8,3600,0.0,28,26,2,1,2,92.85714286
2011020144,28,3667,0.0,37,35,4,2,2,94.59459459
2011020144,2,3663,0.0,30,27,4,0,3,90.0
2011020145,12,3600,0.0,34,29,4,2,5,85.29411765
2011020145,4,3593,0.0,25,24,4,1,1,96.0
2011020146,52,3507,0.0,27,26,4,0,1,96.2962963
2011020146,14,3600,0.0,28,28,4,1,0,100.0
2011020147,24,3600,0.0,29,26,2,0,3,89.65517241
2011020147,18,3600,0.0,20,20,1,0,0,100.0
2011020148,17,3521,0.0,20,19,3,2,1,95.0
2011020148,30,3595,0.0,36,36,5,0,0,100.0
2011020149,1,3512,0.0,22,20,3,1,2,90.90909091
2011020149,25,3600,0.0,32,31,2,0,1,96.875
2011020150,29,3500,0.0,37,33,8,0,4,89.18918919
2011020150,16,3600,0.0,29,27,8,1,2,93.10344828
2011020151,26,3856,0.0,33,30,4,1,3,90.90909091
2011020151,27,3856,0.0,39,37,4,0,2,94.87179487
2011020152,15,2400,0.0,26,22,3,0,4,84.61538462
2011020152,15,1200,0.0,17,14,5,0,3,82.35294118
2011020152,23,3591,0.0,32,28,8,0,4,87.5
2011020153,24,3536,0.0,21,18,2,2,3,85.71428571
2011020153,29,3595,0.0,20,19,6,0,1,95.0
2011020154,10,3510,0.0,30,27,6,1,3,90.0
2011020154,9,3600,0.0,25,23,5,0,2,92.0
2011020155,26,3554,0.0,16,13,5,0,3,81.25
2011020155,21,3599,0.0,32,30,6,0,2,93.75
2011020156,19,3507,0.0,30,26,1,0,4,86.66666667
2011020156,22,3600,0.0,30,28,1,0,2,93.33333333
2011020157,28,3597,0.0,31,26,10,0,5,83.87096774
2011020157,3,3600,0.0,26,24,5,1,2,92.30769231
2011020158,52,3849,0.0,42,39,9,0,3,92.85714286
2011020158,13,3890,0.0,31,28,2,0,3,90.32258065
2011020159,18,3738,0.0,35,30,11,0,5,85.71428571
2011020159,16,3712,0.0,28,24,5,2,4,85.71428571
2011020160,9,3442,0.0,41,36,8,2,5,87.80487805
2011020160,6,3598,0.0,26,23,1,0,3,88.46153846
2011020161,24,3738,0.0,40,35,3,0,5,87.5
2011020161,15,3718,2.0,15,11,1,0,4,73.33333333
2011020162,14,3541,2.0,31,27,6,0,4,87.09677419
2011020162,12,3578,0.0,30,28,3,1,2,93.33333333
2011020163,30,3664,0.0,37,36,4,1,1,97.2972973
2011020163,17,3693,0.0,27,25,8,0,2,92.59259259
2011020164,23,3600,0.0,29,28,4,3,1,96.55172414
2011020164,20,1189,0.0,3,3,2,0,0,100.0
2011020164,20,2395,0.0,18,13,1,0,5,72.22222222
2011020165,4,3600,0.0,31,29,8,0,2,93.5483871
2011020165,7,3165,0.0,15,15,2,1,0,100.0
2011020165,7,383,0.0,11,8,0,0,3,72.72727273
2011020166,10,3600,2.0,22,19,4,1,3,86.36363636
2011020166,1,3511,0.0,23,18,0,0,5,78.26086957
2011020167,27,3600,0.0,40,39,4,0,1,97.5
2011020167,21,3588,0.0,27,24,1,0,3,88.88888889
2011020168,52,3600,0.0,34,34,3,0,0,100.0
2011020168,2,3529,0.0,25,23,0,1,2,92.0
2011020169,24,3899,0.0,25,24,8,1,1,96.0
2011020169,3,3878,0.0,28,27,5,1,1,96.42857143
2011020170,1,3900,0.0,23,20,4,2,3,86.95652174
2011020170,4,3900,0.0,39,36,2,2,3,92.30769231
2011020171,10,3600,0.0,39,38,9,1,1,97.43589744
2011020171,29,2068,0.0,7,7,1,0,0,100.0
2011020171,29,1526,0.0,11,7,0,0,4,63.63636364
2011020172,16,3900,0.0,43,41,1,1,2,95.34883721
2011020172,13,3900,0.0,33,31,2,0,2,93.93939394
2011020173,20,3600,0.0,29,28,5,1,1,96.55172414
2011020173,17,3564,0.0,21,18,3,0,3,85.71428571
2011020174,23,3600,0.0,45,40,8,2,5,88.88888889
2011020174,30,3600,0.0,25,24,9,0,1,96.0
2011020175,18,3600,0.0,35,35,5,2,0,100.0
2011020175,27,3557,0.0,30,28,1,0,2,93.33333333
2011020176,22,3600,0.0,19,19,3,0,0,100.0
2011020176,26,3600,0.0,27,24,7,0,3,88.88888889
2011020177,5,3900,0.0,37,34,4,0,3,91.89189189
2011020177,28,3776,0.0,30,29,0,0,1,96.66666667
2011020177,28,124,0.0,6,4,0,0,2,66.66666667
2011020178,15,3587,0.0,25,24,5,0,1,96.0
2011020178,12,3600,2.0,32,27,8,1,5,84.375
2011020179,20,3536,0.0,44,42,13,2,2,95.45454545
2011020179,7,3600,0.0,30,29,6,1,1,96.66666667
2011020180,8,3600,0.0,34,33,4,0,1,97.05882353
2011020180,9,3501,0.0,26,24,2,0,2,92.30769231
2011020181,16,3846,0.0,32,27,0,1,5,84.375
2011020181,14,3846,0.0,32,28,4,1,4,87.5
2011020182,23,3527,0.0,28,25,3,1,3,89.28571429
2011020182,19,3600,0.0,30,28,3,0,2,93.33333333
2011020183,21,3835,0.0,29,22,4,0,7,75.86206897
2011020183,25,3835,0.0,40,34,5,3,6,85.0
2011020184,6,3595,0.0,25,25,2,0,0,100.0
2011020184,10,1485,0.0,6,4,0,4,2,66.66666667
2011020184,10,2112,0.0,14,9,0,0,5,64.28571429
2011020185,7,3900,0.0,27,25,0,0,2,92.59259259
2011020185,9,3900,0.0,33,31,3,0,2,93.93939394
2011020186,52,3688,0.0,28,25,5,1,3,89.28571429
2011020186,1,3688,0.0,23,21,2,0,2,91.30434783
2011020187,15,3557,0.0,34,30,5,1,4,88.23529412
2011020187,2,3579,0.0,28,25,1,0,3,89.28571429
2011020188,8,3564,0.0,28,24,8,0,4,85.71428571
2011020188,3,3579,2.0,28,25,3,1,3,89.28571429
2011020189,29,411,0.0,5,3,0,0,2,60.0
2011020189,29,3189,2.0,28,21,3,0,7,75.0
2011020189,4,3598,0.0,35,33,2,0,2,94.28571429
2011020190,24,563,0.0,5,5,3,0,0,100.0
2011020190,24,3037,0.0,45,40,6,1,5,88.88888889
2011020190,17,3600,0.0,22,22,5,0,0,100.0
2011020191,19,3514,0.0,26,24,5,0,2,92.30769231
2011020191,30,3600,0.0,31,30,3,0,1,96.77419355
2011020192,22,3531,0.0,29,26,4,3,3,89.65517241
2011020192,27,3600,0.0,26,24,1,0,2,92.30769231
2011020193,5,3900,0.0,26,24,3,1,2,92.30769231
2011020193,26,3900,0.0,33,31,8,0,2,93.93939394
2011020194,18,3764,0.0,38,35,11,0,3,92.10526316
2011020194,28,3762,0.0,35,31,3,2,4,88.57142857
2011020195,25,3600,0.0,32,30,6,1,2,93.75
2011020195,12,2172,0.0,13,12,0,0,1,92.30769231
2011020195,12,1427,0.0,14,10,1,0,4,71.42857143
2011020196,14,2979,0.0,29,29,2,0,0,100.0
2011020196,14,921,0.0,12,9,0,0,3,75.0
2011020196,13,3900,0.0,37,34,6,0,3,91.89189189
2011020197,52,3511,0.0,26,24,8,1,2,92.30769231
2011020197,3,3600,0.0,23,23,5,0,0,100.0
2011020198,23,3600,0.0,40,38,11,1,2,95.0
2011020198,16,3600,0.0,38,32,6,1,6,84.21052632
2011020199,20,3600,0.0,33,32,1,0,1,96.96969697
2011020199,21,3548,0.0,23,21,2,0,2,91.30434783
2011020200,2,2668,0.0,24,22,0,0,2,91.66666667
2011020200,2,847,0.0,12,9,2,0,3,75.0
2011020200,6,3600,0.0,26,24,8,0,2,92.30769231
2011020201,26,3518,0.0,38,34,16,0,4,89.47368421
2011020201,28,3579,0.0,31,29,6,2,2,93.5483871
2011020202,52,3875,0.0,45,39,13,1,6,86.66666667
2011020202,7,3872,0.0,31,26,2,4,5,83.87096774
2011020203,13,3599,0.0,39,38,5,0,1,97.43589744
2011020203,10,2207,0.0,21,18,0,0,3,85.71428571
2011020203,10,1393,0.0,7,5,0,0,2,71.42857143
2011020204,12,3578,0.0,36,33,8,0,3,91.66666667
2011020204,1,3600,0.0,27,25,4,2,2,92.59259259
2011020205,25,3600,0.0,32,30,2,0,2,93.75
2011020205,15,3600,0.0,36,31,7,1,5,86.11111111
2011020206,22,3600,0.0,29,28,3,0,1,96.55172414
2011020206,8,3560,0.0,13,11,4,1,2,84.61538462
2011020207,21,1928,0.0,13,12,1,0,1,92.30769231
2011020207,21,1613,0.0,16,13,1,0,3,81.25
2011020207,17,3600,0.0,26,24,7,1,2,92.30769231
2011020208,16,3598,0.0,23,20,1,0,3,86.95652174
2011020208,19,3595,0.0,29,29,9,0,0,100.0
2011020209,30,3598,0.0,41,41,12,1,0,100.0
2011020209,20,3481,0.0,25,23,6,0,2,92.0
2011020210,18,3513,0.0,30,26,4,0,4,86.66666667
2011020210,26,3589,0.0,30,27,8,1,3,90.0
2011020211,3,3600,0.0,31,29,3,1,2,93.5483871
2011020211,9,3539,0.0,19,16,0,0,3,84.21052632
2011020212,4,3750,0.0,24,22,6,0,2,91.66666667
2011020212,14,3734,2.0,15,14,4,2,1,93.33333333
2011020213,18,3600,0.0,33,31,9,1,2,93.93939394
2011020213,24,3501,0.0,32,28,0,3,4,87.5
2011020214,22,3584,0.0,28,22,1,0,6,78.57142857
2011020214,6,3600,0.0,30,27,10,2,3,90.0
2011020215,16,3599,0.0,30,27,12,0,3,90.0
2011020215,29,3587,0.0,36,30,2,0,6,83.33333333
2011020216,10,3900,2.0,40,38,5,0,2,95.0
2011020216,19,3897,0.0,22,20,4,0,2,90.90909091
2011020217,13,3572,0.0,27,25,4,2,2,92.59259259
2011020217,52,2400,0.0,15,11,3,0,4,73.33333333
2011020217,52,1191,0.0,4,4,0,0,0,100.0
2011020218,2,3737,2.0,51,47,9,1,4,92.15686275
2011020218,21,3759,0.0,33,30,1,1,3,90.90909091
2011020219,8,3705,0.0,34,32,2,0,2,94.11764706
2011020219,27,3704,0.0,36,33,8,1,3,91.66666667
2011020220,23,3596,0.0,30,28,11,0,2,93.33333333
2011020220,26,3537,0.0,32,29,12,4,3,90.625
2011020221,30,3525,0.0,36,33,7,0,3,91.66666667
2011020221,28,3594,0.0,22,21,4,1,1,95.45454545
2011020222,15,3595,0.0,33,32,4,3,1,96.96969697
2011020222,1,3483,0.0,20,17,5,0,3,85.0
2011020223,12,3600,0.0,40,35,3,0,5,87.5
2011020223,3,3600,0.0,35,34,4,1,1,97.14285714
2011020224,25,3526,0.0,32,29,6,1,3,90.625
2011020224,5,3585,0.0,20,19,1,2,1,95.0
2011020225,9,145,0.0,6,4,0,0,2,66.66666667
2011020225,9,3455,0.0,15,12,5,0,3,80.0
2011020225,7,3600,0.0,37,36,0,1,1,97.2972973
2011020226,22,3600,0.0,30,27,9,0,3,90.0
2011020226,17,3600,0.0,24,24,5,1,0,100.0
2011020227,20,3529,0.0,30,27,2,0,3,90.0
2011020227,16,3600,0.0,25,24,2,1,1,96.0
2011020228,23,2400,0.0,19,15,3,0,4,78.94736842
2011020228,23,1136,0.0,2,2,0,1,0,100.0
2011020228,24,3600,0.0,41,38,7,1,3,92.68292683
2011020229,7,1184,0.0,13,10,0,1,3,76.92307692
2011020229,7,2400,0.0,22,19,7,1,3,86.36363636
2011020229,6,3600,0.0,23,21,2,0,2,91.30434783
2011020230,9,3595,0.0,33,31,6,1,2,93.93939394
2011020230,10,3570,0.0,22,19,2,2,3,86.36363636
2011020231,1,3899,2.0,17,15,4,0,2,88.23529412
2011020231,15,3900,0.0,19,17,6,1,2,89.47368421
2011020232,5,3511,0.0,26,21,3,2,5,80.76923077
2011020232,12,3600,0.0,40,37,5,1,3,92.5
2011020233,25,3600,0.0,40,35,7,0,5,87.5
2011020233,17,3600,0.0,27,25,5,1,2,92.59259259
2011020234,52,3506,0.0,27,25,4,1,2,92.59259259
2011020234,29,3595,0.0,36,35,1,3,1,97.22222222
2011020235,8,3737,0.0,26,25,5,3,1,96.15384615
2011020235,18,3751,0.0,25,23,3,0,2,92.0
2011020236,14,3477,0.0,24,21,5,0,3,87.5
2011020236,19,3591,0.0,19,19,8,0,0,100.0
2011020237,20,3579,0.0,39,36,7,3,3,92.30769231
2011020237,21,3489,0.0,20,16,2,1,4,80.0
2011020238,30,1904,0.0,21,17,4,0,4,80.95238095
2011020238,30,1696,0.0,15,14,5,0,1,93.33333333
2011020238,26,3580,0.0,26,24,4,2,2,92.30769231
2011020239,27,3593,0.0,31,31,6,0,0,100.0
2011020239,28,3593,0.0,23,20,5,0,3,86.95652174
2011020240,4,3600,0.0,33,31,9,1,2,93.93939394
2011020240,13,3520,0.0,35,32,9,2,3,91.42857143
2011020241,22,3588,0.0,34,29,4,1,5,85.29411765
2011020241,16,3591,0.0,23,20,2,0,3,86.95652174
2011020242,30,3600,0.0,34,32,3,0,2,94.11764706
2011020242,24,2263,0.0,11,11,2,0,0,100.0
2011020242,24,1207,0.0,15,12,2,0,3,80.0
2011020243,2,3561,0.0,35,32,7,0,3,91.42857143
2011020243,23,3584,0.0,24,23,0,0,1,95.83333333
2011020244,4,3593,0.0,20,17,1,0,3,85.0
2011020244,12,1901,0.0,11,10,1,1,1,90.90909091
2011020244,12,1618,0.0,17,13,4,1,4,76.47058824
2011020245,7,3875,0.0,27,25,8,1,2,92.59259259
2011020245,8,3900,0.0,32,30,8,1,2,93.75
2011020246,14,1929,0.0,22,18,0,2,4,81.81818182
2011020246,14,1666,0.0,17,16,0,0,1,94.11764706
2011020246,52,3600,0.0,32,30,10,1,2,93.75
2011020247,1,3549,0.0,37,33,2,1,4,89.18918919
2011020247,6,3600,0.0,30,27,5,1,3,90.0
2011020248,27,3900,0.0,37,35,2,1,2,94.59459459
2011020248,10,3900,0.0,35,33,1,0,2,94.28571429
2011020249,3,3588,0.0,33,31,10,0,2,93.93939394
2011020249,2,3541,0.0,29,26,4,1,3,89.65517241
2011020250,21,3600,0.0,33,27,5,0,6,81.81818182
2011020250,5,3600,0.0,27,24,2,1,3,88.88888889
2011020251,30,3600,0.0,45,43,7,3,2,95.55555556
2011020251,29,3514,0.0,23,20,7,0,3,86.95652174
2011020252,17,3600,0.0,37,35,5,0,2,94.59459459
2011020252,19,3600,0.0,22,21,6,0,1,95.45454545
2011020253,15,3588,0.0,30,28,2,1,2,93.33333333
2011020253,18,3600,0.0,40,39,3,0,1,97.5
2011020254,13,3600,0.0,25,25,4,0,0,100.0
2011020254,25,3600,0.0,30,24,3,0,6,80.0
2011020255,9,3600,0.0,39,38,12,2,1,97.43589744
2011020255,20,3508,0.0,32,29,8,1,3,90.625
2011020256,12,3600,0.0,36,32,4,0,4,88.88888889
2011020256,8,3600,0.0,25,25,5,0,0,100.0
2011020257,1,3600,0.0,32,29,5,0,3,90.625
2011020257,7,3027,0.0,19,14,2,0,5,73.68421053
2011020257,7,478,0.0,2,2,0,0,0,100.0
2011020258,16,3600,0.0,29,28,0,0,1,96.55172414
2011020258,23,3600,0.0,27,22,2,0,5,81.48148148
2011020259,24,3889,0.0,37,36,7,2,1,97.2972973
2011020259,26,3874,0.0,24,23,6,0,1,95.83333333
2011020260,29,3889,0.0,27,26,1,0,1,96.2962963
2011020260,6,3900,0.0,31,30,2,0,1,96.77419355
2011020261,8,3545,0.0,33,29,1,0,4,87.87878788
2011020261,2,3103,0.0,27,24,2,3,3,88.88888889
2011020261,2,475,0.0,2,2,2,0,0,100.0
2011020262,27,3581,0.0,42,40,9,1,2,95.23809524
2011020262,4,3593,0.0,31,30,4,0,1,96.77419355
2011020263,5,3482,0.0,17,14,5,0,3,82.35294118
2011020263,14,3600,0.0,34,33,9,2,1,97.05882353
2011020264,13,3570,0.0,30,27,3,2,3,90.0
2011020264,19,3600,0.0,21,20,3,1,1,95.23809524
2011020265,10,3509,0.0,21,18,5,0,3,85.71428571
2011020265,18,3600,0.0,39,38,1,2,1,97.43589744
2011020266,21,3500,0.0,18,17,2,1,1,94.44444444
2011020266,30,3600,0.0,27,27,3,0,0,100.0
2011020267,15,3548,2.0,31,27,6,2,4,87.09677419
2011020267,15,41,0.0,0,0,0,0,0,
2011020267,52,3600,0.0,32,31,10,2,1,96.875
2011020268,9,3600,0.0,24,22,1,0,2,91.66666667
2011020268,22,1200,0.0,7,4,1,0,3,57.14285714
2011020268,22,2400,0.0,9,7,2,0,2,77.77777778
2011020269,26,3591,2.0,38,35,10,0,3,92.10526316
2011020269,24,3507,0.0,35,31,3,0,4,88.57142857
2011020270,17,2364,0.0,21,17,3,1,4,80.95238095
2011020270,17,1200,0.0,7,6,0,1,1,85.71428571
2011020270,28,3600,0.0,42,40,4,0,2,95.23809524
2011020271,7,3600,0.0,34,34,7,2,0,100.0
2011020271,12,3560,0.0,20,19,3,0,1,95.0
2011020272,25,3560,0.0,44,42,8,0,2,95.45454545
2011020272,21,3598,0.0,24,24,0,3,0,100.0
2011020273,16,3600,0.0,26,21,1,0,5,80.76923077
2011020273,20,3600,0.0,32,30,4,0,2,93.75
2011020274,4,3515,0.0,39,34,14,1,5,87.17948718
2011020274,52,3597,0.0,31,27,6,0,4,87.09677419
2011020275,17,3567,0.0,24,23,9,0,1,95.83333333
2011020275,26,3594,0.0,38,34,5,2,4,89.47368421
2011020276,27,3600,0.0,45,43,2,0,2,95.55555556
2011020276,7,3544,0.0,28,25,1,1,3,89.28571429
2011020277,15,2058,0.0,11,8,3,1,3,72.72727273
2011020277,15,1529,0.0,18,14,2,0,4,77.77777778
2011020277,10,3600,0.0,41,40,9,1,1,97.56097561
2011020278,3,3593,0.0,31,27,6,0,4,87.09677419
2011020278,8,3582,0.0,17,17,1,3,0,100.0
2011020279,6,3600,0.0,23,23,1,5,0,100.0
2011020279,2,1200,0.0,13,10,1,0,3,76.92307692
2011020279,2,2381,0.0,17,14,2,1,3,82.35294118
2011020280,1,3595,0.0,23,21,6,0,2,91.30434783
2011020280,14,3508,0.0,24,20,9,1,4,83.33333333
2011020281,5,3534,0.0,31,28,4,1,3,90.32258065
2011020281,13,3600,0.0,41,39,5,0,2,95.12195122
2011020282,29,3763,0.0,30,27,2,1,3,90.0
2011020282,18,3763,0.0,29,25,6,0,4,86.20689655
2011020283,19,3900,0.0,32,30,4,0,2,93.75
2011020283,30,3895,0.0,27,25,1,0,2,92.59259259
2011020284,28,3584,0.0,31,30,8,0,1,96.77419355
2011020284,25,3600,0.0,38,34,3,0,4,89.47368421
2011020285,16,748,0.0,7,5,1,0,2,71.42857143
2011020285,16,2852,0.0,27,20,6,0,7,74.07407407
2011020285,22,3600,0.0,36,34,8,0,2,94.44444444
2011020286,10,3534,0.0,41,38,4,0,3,92.68292683
2011020286,12,3600,0.0,25,23,1,3,2,92.0
2011020287,28,3585,0.0,37,36,3,3,1,97.2972973
2011020287,21,3573,0.0,17,14,3,1,3,82.35294118
2011020288,17,3600,0.0,34,32,4,0,2,94.11764706
2011020288,24,3538,0.0,29,26,9,0,3,89.65517241
2011020289,9,3687,0.0,27,25,3,3,2,92.59259259
2011020289,23,3738,0.0,29,28,5,0,1,96.55172414
2011020290,12,3600,0.0,32,30,3,1,2,93.75
2011020290,4,3486,0.0,31,27,5,1,4,87.09677419
2011020291,2,3585,0.0,36,31,4,1,5,86.11111111
2011020291,5,3600,0.0,29,29,6,0,0,100.0
2011020292,27,3526,0.0,31,27,8,0,4,87.09677419
2011020292,15,3596,0.0,23,20,0,1,3,86.95652174
2011020293,20,3590,0.0,29,26,5,0,3,89.65517241
2011020293,29,3595,0.0,28,27,1,2,1,96.42857143
2011020294,6,3597,0.0,33,33,10,0,0,100.0
2011020294,8,3526,0.0,18,17,1,1,1,94.44444444
2011020295,1,3520,0.0,36,32,8,1,4,88.88888889
2011020295,13,3597,0.0,25,22,4,0,3,88.0
2011020296,22,3485,0.0,34,31,3,1,3,91.17647059
2011020296,25,3600,0.0,18,17,5,1,1,94.44444444
2011020297,10,3600,0.0,28,27,3,0,1,96.42857143
2011020297,14,2668,0.0,21,15,3,1,6,71.42857143
2011020297,14,932,0.0,5,4,0,0,1,80.0
2011020298,26,3600,0.0,25,23,6,3,2,92.0
2011020298,19,3476,0.0,28,25,4,1,3,89.28571429
2011020299,22,3569,0.0,32,30,8,0,2,93.75
2011020299,18,1200,0.0,13,10,2,0,3,76.92307692
2011020299,18,2387,0.0,19,16,0,0,3,84.21052632
2011020300,6,3890,0.0,34,31,9,2,3,91.17647059
2011020300,7,3900,0.0,39,36,5,7,3,92.30769231
2011020301,29,3895,0.0,24,23,6,2,1,95.83333333
2011020301,1,3896,0.0,36,35,10,1,1,97.22222222
2011020302,4,1200,0.0,9,6,0,0,3,66.66666667
2011020302,4,2554,0.0,23,23,2,1,0,100.0
2011020302,2,3751,0.0,33,29,5,0,4,87.87878788
2011020303,19,3835,0.0,33,31,0,0,2,93.93939394
2011020303,5,3847,0.0,43,40,6,2,3,93.02325581
2011020304,52,3712,0.0,37,33,5,0,4,89.18918919
2011020304,15,3712,0.0,25,22,3,1,3,88.0
2011020305,8,3900,0.0,33,30,2,4,3,90.90909091
2011020305,12,3900,0.0,34,31,3,4,3,91.17647059
2011020306,20,3600,0.0,30,25,1,1,5,83.33333333
2011020306,17,3600,0.0,22,19,1,1,3,86.36363636
2011020307,3,3538,0.0,38,36,11,0,2,94.73684211
2011020307,13,3600,0.0,20,19,6,0,1,95.0
2011020308,18,3572,0.0,30,27,7,1,3,90.0
2011020308,30,3568,0.0,25,23,10,0,2,92.0
2011020309,26,3750,0.0,38,35,0,3,3,92.10526316
2011020309,25,3735,0.0,24,22,4,2,2,91.66666667
2011020310,23,3588,0.0,24,24,5,0,0,100.0
2011020310,21,3577,0.0,28,26,4,1,2,92.85714286
2011020311,24,3600,0.0,29,25,6,1,4,86.20689655
2011020311,27,3580,2.0,21,19,0,3,2,90.47619048
2011020312,16,3533,0.0,21,20,0,1,1,95.23809524
2011020312,28,3595,0.0,34,34,9,1,0,100.0
2011020313,17,3886,0.0,43,41,4,1,2,95.34883721
2011020313,6,3900,0.0,31,29,1,1,2,93.5483871
2011020314,1,3596,0.0,23,23,6,1,0,100.0
2011020314,2,3492,0.0,23,22,1,4,1,95.65217391
2011020315,8,3549,0.0,36,33,6,3,3,91.66666667
2011020315,4,3600,0.0,24,23,5,0,1,95.83333333
2011020316,22,3600,0.0,32,30,8,3,2,93.75
2011020316,30,3576,0.0,28,24,4,1,4,85.71428571
2011020317,3,3600,0.0,21,18,3,0,3,85.71428571
2011020317,15,3597,0.0,33,27,5,0,6,81.81818182
2011020318,16,3578,0.0,28,23,6,2,5,82.14285714
2011020318,24,858,0.0,9,8,5,0,1,88.88888889
2011020318,24,2613,0.0,33,28,10,0,5,84.84848485
2011020319,9,551,0.0,8,4,1,0,4,50.0
2011020319,9,3021,0.0,32,30,7,2,2,93.75
2011020319,5,3588,0.0,27,24,4,1,3,88.88888889
2011020320,52,3600,0.0,21,20,4,0,1,95.23809524
2011020320,12,3521,0.0,29,27,2,2,2,93.10344828
2011020321,7,1469,0.0,18,14,1,0,4,77.77777778
2011020321,7,2131,0.0,16,15,6,1,1,93.75
2011020321,29,3596,0.0,29,28,7,0,1,96.55172414
2011020322,14,3742,0.0,24,23,2,0,1,95.83333333
2011020322,13,3749,0.0,31,29,1,1,2,93.5483871
2011020323,20,3526,0.0,24,22,0,3,2,91.66666667
2011020323,19,3600,0.0,24,24,7,0,0,100.0
2011020324,10,3898,0.0,29,26,3,0,3,89.65517241
2011020324,25,3900,0.0,23,20,5,0,3,86.95652174
2011020325,23,3595,0.0,22,22,3,0,0,100.0
2011020325,27,3599,0.0,37,32,8,0,5,86.48648649
2011020326,2,3600,0.0,26,24,2,0,2,92.30769231
2011020326,1,3508,0.0,26,23,2,3,3,88.46153846
2011020327,4,3514,0.0,32,30,6,0,2,93.75
2011020327,3,3600,0.0,29,29,3,1,0,100.0
2011020328,22,3584,0.0,28,24,2,1,4,85.71428571
2011020328,21,3600,0.0,33,31,5,0,2,93.93939394
2011020329,52,3544,0.0,35,32,6,2,3,91.42857143
2011020329,6,3600,0.0,42,40,5,1,2,95.23809524
2011020330,15,3600,0.0,28,23,4,0,5,82.14285714
2011020330,7,3600,0.0,27,26,5,0,1,96.2962963
2011020331,5,3728,0.0,27,24,7,0,3,88.88888889
2011020331,8,3729,0.0,42,38,7,2,4,90.47619048
2011020332,13,3598,0.0,34,29,2,4,5,85.29411765
2011020332,14,3600,0.0,25,24,6,0,1,96.0
2011020333,18,3600,0.0,37,33,4,1,4,89.18918919
2011020333,17,3600,0.0,19,18,5,0,1,94.73684211
2011020334,25,3269,0.0,36,33,2,1,3,91.66666667
2011020334,25,331,0.0,3,3,0,0,0,100.0
2011020334,27,3600,0.0,26,26,0,0,0,100.0
2011020335,23,3600,0.0,45,43,12,0,2,95.55555556
2011020335,28,3505,0.0,27,24,2,0,3,88.88888889
2011020336,16,3598,0.0,27,26,3,0,1,96.2962963
2011020336,26,3500,0.0,27,25,3,0,2,92.59259259
2011020337,12,3510,0.0,25,21,3,1,4,84.0
2011020337,9,3585,0.0,37,34,16,0,3,91.89189189
2011020338,19,3593,0.0,24,23,6,2,1,95.83333333
2011020338,29,3554,0.0,29,27,3,0,2,93.10344828
2011020339,20,3600,0.0,21,19,5,0,2,90.47619048
2011020339,30,3075,0.0,27,25,4,0,2,92.59259259
2011020339,30,525,0.0,8,5,0,0,3,62.5
2011020340,10,3600,0.0,28,26,6,0,2,92.85714286
2011020340,24,3505,0.0,27,23,4,1,4,85.18518519
2011020341,14,3548,0.0,23,21,2,0,2,91.30434783
2011020341,30,3588,0.0,33,32,4,3,1,96.96969697
2011020342,25,3600,0.0,36,35,3,4,1,97.22222222
2011020342,21,3546,0.0,34,32,1,2,2,94.11764706
2011020343,18,3600,0.0,18,17,2,0,1,94.44444444
2011020343,22,3514,0.0,31,29,3,0,2,93.5483871
2011020344,28,3483,0.0,33,31,4,0,2,93.93939394
2011020344,26,3600,0.0,33,33,9,1,0,100.0
2011020345,2,3598,0.0,31,30,6,1,1,96.77419355
2011020345,7,3535,0.0,30,28,5,0,2,93.33333333
2011020346,5,3549,0.0,30,26,5,0,4,86.66666667
2011020346,3,3594,2.0,27,24,3,1,3,88.88888889
2011020347,19,3600,0.0,19,18,0,2,1,94.73684211
2011020347,15,3543,0.0,30,28,7,0,2,93.33333333
2011020348,13,3600,0.0,27,26,4,0,1,96.2962963
2011020348,12,3528,0.0,20,18,1,2,2,90.0
2011020349,9,3599,0.0,43,39,12,1,4,90.69767442
2011020349,52,3588,0.0,33,28,8,2,5,84.84848485
2011020350,27,3600,0.0,25,24,1,1,1,96.0
2011020350,16,2702,0.0,21,17,3,0,4,80.95238095
2011020350,16,898,0.0,3,3,0,0,0,100.0
2011020351,18,3559,0.0,29,28,3,0,1,96.55172414
2011020351,20,3598,0.0,26,26,5,0,0,100.0
2011020352,29,3496,0.0,33,30,2,2,3,90.90909091
2011020352,23,3600,0.0,48,47,7,2,1,97.91666667
2011020353,6,3592,0.0,37,34,3,1,3,91.89189189
2011020353,10,3519,0.0,39,34,6,0,5,87.17948718
2011020354,14,3545,0.0,35,31,9,6,4,88.57142857
2011020354,17,3596,0.0,23,21,2,2,2,91.30434783
2011020355,1,3596,0.0,25,19,1,0,6,76.0
2011020355,21,3600,0.0,19,18,1,1,1,94.73684211
2011020356,30,3900,0.0,30,28,3,0,2,93.33333333
2011020356,22,3900,0.0,29,27,14,0,2,93.10344828
2011020357,8,3560,0.0,26,23,8,1,3,88.46153846
2011020357,24,3568,0.0,20,19,7,0,1,95.0
2011020358,5,3600,0.0,17,16,1,2,1,94.11764706
2011020358,15,3567,0.0,35,33,5,0,2,94.28571429
2011020359,3,3589,0.0,31,28,1,0,3,90.32258065
2011020359,12,3493,0.0,27,22,4,0,5,81.48148148
2011020360,27,3523,0.0,31,30,4,1,1,96.77419355
2011020360,52,3590,0.0,33,33,3,1,0,100.0
2011020361,9,3527,0.0,32,29,1,0,3,90.625
2011020361,25,3600,0.0,35,33,3,0,2,94.28571429
2011020362,29,3872,0.0,35,32,0,0,3,91.42857143
2011020362,20,3900,0.0,33,30,5,0,3,90.90909091
2011020363,18,1829,0.0,18,13,1,0,5,72.22222222
2011020363,18,1771,0.0,19,19,0,0,0,100.0
2011020363,23,2333,0.0,15,12,0,0,3,80.0
2011020363,23,1199,0.0,5,2,2,0,3,40.0
2011020364,13,3521,0.0,26,24,5,0,2,92.30769231
2011020364,26,3587,0.0,42,41,13,0,1,97.61904762
2011020365,8,3900,0.0,41,38,0,0,3,92.68292683
2011020365,28,3889,0.0,32,29,3,0,3,90.625
2011020366,17,3600,0.0,28,27,7,0,1,96.42857143
2011020366,7,3580,0.0,35,32,8,0,3,91.42857143
2011020367,1,497,0.0,4,1,0,0,3,25.0
2011020367,1,2965,0.0,12,11,1,1,1,91.66666667
2011020367,30,2400,0.0,22,22,5,0,0,100.0
2011020367,30,1200,0.0,9,7,1,1,2,77.77777778
2011020368,2,3900,0.0,36,32,3,2,4,88.88888889
2011020368,16,3895,0.0,41,37,7,1,4,90.24390244
2011020369,19,3900,0.0,35,33,3,1,2,94.28571429
2011020369,21,3888,0.0,37,35,1,0,2,94.59459459
2011020370,29,3549,0.0,33,28,0,0,5,84.84848485
2011020370,22,3596,0.0,39,36,9,0,3,92.30769231
2011020371,4,3809,0.0,22,19,1,1,3,86.36363636
2011020371,24,3807,0.0,47,43,17,2,4,91.4893617
2011020372,8,3600,0.0,27,26,6,4,1,96.2962963
2011020372,26,3539,0.0,27,25,5,1,2,92.59259259
2011020373,10,3600,0.0,30,26,2,1,4,86.66666667
2011020373,6,3600,0.0,22,21,3,0,1,95.45454545
2011020374,9,3595,0.0,35,32,8,0,3,91.42857143
2011020374,15,3561,0.0,34,32,4,1,2,94.11764706
2011020375,5,3600,0.0,32,30,9,1,2,93.75
2011020375,12,3506,0.0,40,37,1,0,3,92.5
2011020376,1,3525,0.0,19,16,2,0,3,84.21052632
2011020376,52,3600,0.0,25,23,6,0,2,92.0
2011020377,3,3600,0.0,26,24,1,1,2,92.30769231
2011020377,14,3547,0.0,35,32,2,0,3,91.42857143
2011020378,16,3577,0.0,25,23,3,0,2,92.0
2011020378,19,3566,0.0,35,31,3,0,4,88.57142857
2011020379,7,3594,0.0,34,32,6,1,2,94.11764706
2011020379,18,3480,0.0,14,11,2,0,3,78.57142857
2011020380,4,3600,0.0,38,36,6,2,2,94.73684211
2011020380,27,1200,0.0,17,13,1,1,4,76.47058824
2011020380,27,2400,2.0,13,13,3,1,0,100.0
2011020381,2,1200,0.0,13,13,0,0,0,100.0
2011020381,2,2400,0.0,21,17,3,2,4,80.95238095
2011020381,25,3525,0.0,27,22,3,0,5,81.48148148
2011020382,20,3600,0.0,29,26,1,1,3,89.65517241
2011020382,22,3500,0.0,31,27,4,1,4,87.09677419
2011020383,13,3600,0.0,26,23,0,0,3,88.46153846
2011020383,28,3596,0.0,35,30,8,1,5,85.71428571
2011020384,17,3538,0.0,34,31,11,2,3,91.17647059
2011020384,21,3583,0.0,29,27,6,1,2,93.10344828
2011020385,30,3600,0.0,27,24,2,0,3,88.88888889
2011020385,24,3537,0.0,35,31,1,1,4,88.57142857
2011020386,20,2799,0.0,32,27,6,0,5,84.375
2011020386,20,801,0.0,4,4,1,0,0,100.0
2011020386,23,3580,0.0,22,21,4,0,1,95.45454545
2011020387,10,3578,0.0,32,30,6,0,2,93.75
2011020387,3,3506,0.0,29,26,4,0,3,89.65517241
2011020388,6,3583,0.0,46,45,8,0,1,97.82608696
2011020388,5,3528,0.0,27,24,3,0,3,88.88888889
2011020389,14,3499,0.0,31,27,2,1,4,87.09677419
2011020389,9,3597,0.0,33,31,4,0,2,93.93939394
2011020390,15,3536,0.0,30,25,7,0,5,83.33333333
2011020390,13,3600,0.0,32,28,5,0,4,87.5
2011020391,27,3900,0.0,35,32,4,0,3,91.42857143
2011020391,16,1268,0.0,16,13,0,0,3,81.25
2011020391,16,2602,0.0,11,11,1,0,0,100.0
2011020392,1,3760,0.0,31,29,2,3,2,93.5483871
2011020392,10,3760,0.0,26,23,4,0,3,88.46153846
2011020393,14,3590,0.0,34,29,4,2,5,85.29411765
2011020393,2,3598,0.0,24,23,5,1,1,95.83333333
2011020394,29,3882,0.0,20,18,1,0,2,90.0
2011020394,8,3900,0.0,28,26,4,0,2,92.85714286
2011020395,17,3533,0.0,26,23,4,0,3,88.46153846
2011020395,19,3596,0.0,29,27,5,0,2,93.10344828
2011020396,27,3600,0.0,32,30,5,0,2,93.75
2011020396,18,3553,0.0,35,32,0,1,3,91.42857143
2011020397,6,3503,0.0,35,33,6,0,2,94.28571429
2011020397,52,3600,0.0,40,39,11,2,1,97.5
2011020398,12,517,0.0,2,2,0,0,0,100.0
2011020398,12,3062,0.0,32,26,0,0,6,81.25
2011020398,20,3586,0.0,34,28,2,0,6,82.35294118
2011020399,21,620,0.0,2,2,0,1,0,100.0
2011020399,21,2980,0.0,21,15,4,0,6,71.42857143
2011020399,23,1428,0.0,13,13,0,0,0,100.0
2011020399,23,2154,0.0,20,20,7,2,0,100.0
2011020400,26,3582,0.0,27,24,5,0,3,88.88888889
2011020400,24,3599,0.0,39,37,5,0,2,94.87179487
2011020401,30,71,0.0,8,7,0,0,1,87.5
2011020401,30,3529,0.0,34,34,5,0,0,100.0
2011020401,28,3520,0.0,21,19,1,0,2,90.47619048
2011020402,15,3600,0.0,34,31,8,1,3,91.17647059
2011020402,9,3555,2.0,43,39,5,2,4,90.69767442
2011020403,4,3757,0.0,24,20,1,1,4,83.33333333
2011020403,7,3741,0.0,34,29,4,0,5,85.29411765
2011020404,12,3600,0.0,25,22,6,0,3,88.0
2011020404,22,3471,0.0,33,28,8,1,5,84.84848485
2011020405,13,3600,0.0,40,40,7,1,0,100.0
2011020405,6,3530,0.0,29,28,1,1,1,96.55172414
2011020406,9,3879,0.0,31,27,7,3,4,87.09677419
2011020406,1,1200,0.0,9,7,2,0,2,77.77777778
2011020406,1,2685,0.0,20,18,2,1,2,90.0
2011020407,16,3694,0.0,33,31,12,1,2,93.93939394
2011020407,2,3694,0.0,28,25,2,0,3,89.28571429
2011020408,14,3900,0.0,30,28,6,2,2,93.33333333
2011020408,3,3900,0.0,31,29,4,1,2,93.5483871
2011020409,5,3506,0.0,29,26,6,2,3,89.65517241
2011020409,4,3589,0.0,27,25,2,2,2,92.59259259
2011020410,18,3622,0.0,24,21,1,0,3,87.5
2011020410,29,3705,0.0,22,18,3,0,4,81.81818182
2011020411,23,3849,0.0,23,20,5,0,3,86.95652174
2011020411,8,3898,0.0,31,28,8,1,3,90.32258065
2011020412,27,929,0.0,11,7,2,0,4,63.63636364
2011020412,27,2666,0.0,21,20,8,1,1,95.23809524
2011020412,17,3600,0.0,32,30,7,1,2,93.75
2011020413,24,3597,0.0,23,20,1,0,3,86.95652174
2011020413,19,3600,0.0,23,21,3,0,2,91.30434783
2011020414,21,3520,0.0,35,32,12,0,3,91.42857143
2011020414,20,3578,0.0,18,16,1,1,2,88.88888889
2011020415,30,3588,0.0,44,42,2,1,2,95.45454545
2011020415,26,3487,0.0,24,20,6,0,4,83.33333333
2011020416,25,2393,0.0,25,20,2,0,5,80.0
2011020416,25,1200,0.0,11,11,1,0,0,100.0
2011020416,28,3582,0.0,20,18,2,1,2,90.0
2011020417,10,3544,0.0,25,21,9,0,4,84.0
2011020417,15,3600,0.0,28,26,2,0,2,92.85714286
2011020418,13,3739,0.0,20,18,8,0,2,90.0
2011020418,7,3739,0.0,23,22,3,1,1,95.65217391
2011020419,12,1649,0.0,7,7,0,0,0,100.0
2011020419,12,1886,0.0,30,26,3,1,4,86.66666667
2011020419,52,3597,0.0,25,23,2,1,2,92.0
2011020420,21,3600,0.0,35,31,4,1,4,88.57142857
2011020420,22,3595,0.0,29,28,5,0,1,96.55172414
2011020421,8,3588,0.0,29,28,4,2,1,96.55172414
2011020421,1,3518,0.0,24,22,8,0,2,91.66666667
2011020422,3,3600,0.0,33,32,2,3,1,96.96969697
2011020422,7,3600,0.0,33,29,3,0,4,87.87878788
2011020423,23,3592,0.0,25,24,4,0,1,96.0
2011020423,9,3596,0.0,28,24,9,0,4,85.71428571
2011020424,5,3600,0.0,27,24,5,1,3,88.88888889
2011020424,2,3600,0.0,31,25,5,1,6,80.64516129
2011020425,14,3548,0.0,31,27,5,2,4,87.09677419
2011020425,4,2805,0.0,16,14,2,0,2,87.5
2011020425,4,781,0.0,3,3,0,0,0,100.0
2011020426,52,2472,0.0,26,19,4,0,7,73.07692308
2011020426,52,1128,0.0,3,3,0,0,0,100.0
2011020426,17,3600,0.0,30,29,0,1,1,96.66666667
2011020427,6,1200,0.0,11,11,2,0,0,100.0
2011020427,6,2400,0.0,25,22,7,4,3,88.0
2011020427,29,3589,0.0,29,24,5,0,5,82.75862069
2011020428,28,3460,0.0,19,18,4,1,1,94.73684211
2011020428,19,3600,0.0,24,24,5,0,0,100.0
2011020429,24,3560,0.0,28,25,5,0,3,89.28571429
2011020429,18,3590,0.0,17,15,3,0,2,88.23529412
2011020430,30,3600,0.0,36,35,4,0,1,97.22222222
2011020430,27,3600,0.0,20,16,1,0,4,80.0
2011020431,22,3474,0.0,33,31,8,1,2,93.93939394
2011020431,20,3600,0.0,21,21,5,0,0,100.0
2011020432,25,3600,0.0,27,26,3,1,1,96.2962963
2011020432,26,3531,0.0,28,26,9,1,2,92.85714286
2011020433,13,2400,0.0,22,16,1,2,6,72.72727273
2011020433,13,1200,0.0,11,11,0,1,0,100.0
2011020433,3,3600,0.0,21,20,8,0,1,95.23809524
2011020434,28,3866,0.0,34,31,4,0,3,91.17647059
2011020434,16,3855,0.0,37,35,7,0,2,94.59459459
2011020435,1,3600,0.0,36,32,10,0,4,88.88888889
2011020435,14,1256,0.0,12,9,1,0,3,75.0
2011020435,14,2277,0.0,10,8,3,1,2,80.0
2011020436,26,3600,0.0,22,19,3,1,3,86.36363636
2011020436,6,3600,0.0,41,41,5,1,0,100.0
2011020437,9,3639,2.0,29,27,4,1,2,93.10344828
2011020437,7,3645,0.0,44,41,14,1,3,93.18181818
2011020438,12,3644,0.0,38,36,5,0,2,94.73684211
2011020438,10,3640,0.0,19,18,3,1,1,94.73684211
2011020439,25,3600,0.0,34,34,7,1,0,100.0
2011020439,3,3530,0.0,28,27,1,0,1,96.42857143
2011020440,17,3600,0.0,26,25,8,0,1,96.15384615
2011020440,5,3530,0.0,24,21,3,1,3,87.5
2011020441,4,3592,0.0,32,31,3,0,1,96.875
2011020441,15,1200,0.0,12,11,0,0,1,91.66666667
2011020441,15,2400,0.0,21,17,1,3,4,80.95238095
2011020442,23,3900,0.0,30,29,3,1,1,96.66666667
2011020442,29,182,0.0,1,1,1,0,0,100.0
2011020442,29,3692,0.0,31,30,7,0,1,96.77419355
2011020443,2,3591,0.0,28,24,11,0,4,85.71428571
2011020443,8,3600,0.0,32,29,1,1,3,90.625
2011020444,1,3900,0.0,26,24,0,0,2,92.30769231
2011020444,13,3900,0.0,34,32,4,0,2,94.11764706
2011020445,20,3516,0.0,45,43,3,0,2,95.55555556
2011020445,18,3600,0.0,36,35,0,0,1,97.22222222
2011020446,30,3520,0.0,27,25,5,0,2,92.59259259
2011020446,52,3600,0.0,35,34,5,1,1,97.14285714
2011020447,28,3826,0.0,33,30,0,0,3,90.90909091
2011020447,21,3886,0.0,30,27,2,0,3,90.0
2011020448,6,3600,0.0,49,47,15,0,2,95.91836735
2011020448,9,3600,0.0,29,24,0,1,5,82.75862069
2011020449,16,3900,0.0,30,27,5,1,3,90.0
2011020449,30,3892,0.0,31,28,1,0,3,90.32258065
2011020450,27,3585,0.0,28,24,7,1,4,85.71428571
2011020450,24,3600,0.0,20,19,1,2,1,95.0
2011020451,25,3591,0.0,27,25,3,2,2,92.59259259
2011020451,2,3521,0.0,29,26,10,1,3,89.65517241
2011020452,23,3561,0.0,41,37,14,0,4,90.24390244
2011020452,12,3584,0.0,36,33,2,1,3,91.66666667
2011020453,26,3600,0.0,25,24,4,0,1,96.0
2011020453,29,3504,0.0,41,39,4,0,2,95.12195122
2011020454,4,3596,0.0,31,28,13,1,3,90.32258065
2011020454,8,3520,0.0,25,21,5,0,4,84.0
2011020455,20,3619,0.0,34,29,0,0,5,85.29411765
2011020455,14,3630,0.0,27,23,6,1,4,85.18518519
2011020456,3,3573,0.0,35,32,1,0,3,91.42857143
2011020456,19,3600,0.0,26,25,0,0,1,96.15384615
2011020457,17,3548,2.0,21,17,0,0,4,80.95238095
2011020457,18,3600,0.0,40,37,2,0,3,92.5
2011020458,15,3596,0.0,26,26,4,0,0,100.0
2011020458,52,3553,0.0,28,27,5,0,1,96.42857143
2011020459,22,3486,0.0,42,38,1,0,4,90.47619048
2011020459,27,3582,0.0,20,18,1,0,2,90.0
2011020460,21,3541,0.0,34,29,5,0,5,85.29411765
2011020460,28,3600,0.0,27,23,4,2,4,85.18518519
2011020461,25,3600,0.0,31,25,3,1,6,80.64516129
2011020461,1,3600,0.0,36,33,5,0,3,91.66666667
2011020462,10,3524,0.0,29,24,4,0,5,82.75862069
2011020462,7,3600,0.0,33,29,5,1,4,87.87878788
2011020463,5,2395,0.0,19,14,5,0,5,73.68421053
2011020463,5,1163,0.0,5,4,3,0,1,80.0
2011020463,9,3600,0.0,36,32,3,1,4,88.88888889
2011020464,20,3898,0.0,41,39,6,0,2,95.12195122
2011020464,13,3900,0.0,26,24,6,1,2,92.30769231
2011020465,24,3600,0.0,24,20,3,1,4,83.33333333
2011020465,16,3596,0.0,25,24,3,0,1,96.0
2011020466,6,3591,0.0,31,31,12,1,0,100.0
2011020466,4,1626,0.0,20,15,5,2,5,75.0
2011020466,4,1972,0.0,17,16,3,1,1,94.11764706
2011020467,23,3600,0.0,29,26,1,1,3,89.65517241
2011020467,10,3554,0.0,36,31,2,0,5,86.11111111
2011020468,1,3600,0.0,26,23,2,2,3,88.46153846
2011020468,8,3525,0.0,35,30,7,2,5,85.71428571
2011020469,7,1817,0.0,11,8,1,0,3,72.72727273
2011020469,7,1783,0.0,15,10,1,0,5,66.66666667
2011020469,5,3600,0.0,19,16,2,0,3,84.21052632
2011020470,24,3510,0.0,31,26,2,0,5,83.87096774
2011020470,52,3600,0.0,36,33,1,1,3,91.66666667
2011020471,26,512,0.0,7,4,0,0,3,57.14285714
2011020471,26,3072,0.0,20,15,4,0,5,75.0
2011020471,17,3600,2.0,29,27,6,0,2,93.10344828
2011020472,14,3600,0.0,28,26,6,0,2,92.85714286
2011020472,29,3549,0.0,28,25,1,0,3,89.28571429
2011020473,19,3900,0.0,20,19,0,2,1,95.0
2011020473,18,3900,0.0,40,39,6,0,1,97.5
2011020474,2,3900,0.0,21,20,1,0,1,95.23809524
2011020474,30,3900,0.0,36,35,2,1,1,97.22222222
2011020475,3,3600,0.0,23,21,3,1,2,91.30434783
2011020475,27,3600,0.0,30,27,3,0,3,90.0
2011020476,15,3542,0.0,28,26,3,4,2,92.85714286
2011020476,21,3596,0.0,26,25,3,1,1,96.15384615
2011020477,22,3550,0.0,37,34,7,2,3,91.89189189
2011020477,28,3588,0.0,25,23,2,2,2,92.0
2011020478,12,3788,0.0,25,22,2,1,3,88.0
2011020478,13,3788,0.0,26,24,3,0,2,92.30769231
2011020479,20,3501,0.0,25,21,6,1,4,84.0
2011020479,16,3594,0.0,24,22,7,0,2,91.66666667
2011020480,29,3575,0.0,33,28,2,2,5,84.84848485
2011020480,19,3600,0.0,32,28,1,0,4,87.5
2011020481,8,3539,0.0,31,28,4,0,3,90.32258065
2011020481,6,3600,0.0,35,33,2,0,2,94.28571429
2011020482,26,3889,0.0,33,31,7,1,2,93.93939394
2011020482,10,3900,0.0,42,40,4,1,2,95.23809524
2011020483,24,3580,0.0,33,28,2,1,5,84.84848485
2011020483,25,3596,0.0,28,25,1,1,3,89.28571429
2011020484,4,3880,0.0,27,25,1,1,2,92.59259259
2011020484,21,3900,0.0,33,31,3,0,2,93.93939394
2011020485,17,3600,0.0,23,21,2,1,2,91.30434783
2011020485,22,3494,0.0,28,25,8,0,3,89.28571429
2011020486,30,3600,0.0,33,29,2,0,4,87.87878788
2011020486,23,3600,0.0,33,33,1,1,0,100.0
2011020487,3,3600,0.0,31,30,5,0,1,96.77419355
2011020487,1,3467,0.0,20,17,0,0,3,85.0
2011020488,16,3511,0.0,28,25,9,0,3,89.28571429
2011020488,5,3600,0.0,38,36,6,4,2,94.73684211
2011020489,18,3600,0.0,23,19,4,1,4,82.60869565
2011020489,15,3600,0.0,21,20,3,0,1,95.23809524
2011020490,7,3590,0.0,38,35,4,1,3,92.10526316
2011020490,9,3600,0.0,23,22,5,0,1,95.65217391
2011020491,27,2606,0.0,20,19,5,1,1,95.0
2011020491,27,991,0.0,8,8,0,1,0,100.0
2011020491,13,3538,0.0,22,20,3,1,2,90.90909091
2011020492,2,2320,0.0,19,17,0,0,2,89.47368421
2011020492,2,1580,0.0,19,19,0,0,0,100.0
2011020492,52,3900,0.0,33,31,2,0,2,93.93939394
2011020493,30,3537,0.0,30,28,3,0,2,93.33333333
2011020493,20,3581,0.0,30,29,0,1,1,96.66666667
2011020494,27,3600,0.0,37,34,7,0,3,91.89189189
2011020494,12,3533,0.0,19,15,1,0,4,78.94736842
2011020495,8,3565,0.0,27,23,1,1,4,85.18518519
2011020495,16,3600,0.0,21,20,5,0,1,95.23809524
2011020496,4,3597,0.0,31,30,0,2,1,96.77419355
2011020496,25,3600,0.0,30,26,7,0,4,86.66666667
2011020497,19,3522,0.0,22,19,4,2,3,86.36363636
2011020497,21,3600,0.0,39,37,10,2,2,94.87179487
2011020498,17,3486,0.0,25,21,0,1,4,84.0
2011020498,23,3600,0.0,40,38,5,0,2,95.0
2011020499,14,3219,0.0,35,31,4,1,4,88.57142857
2011020499,14,381,0.0,8,5,2,0,3,62.5
2011020499,28,3576,0.0,24,22,6,0,2,91.66666667
2011020500,7,3530,0.0,31,28,6,1,3,90.32258065
2011020500,10,3600,0.0,42,40,12,2,2,95.23809524
2011020501,2,3558,0.0,24,21,3,0,3,87.5
2011020501,3,3580,0.0,26,24,4,0,2,92.30769231
2011020502,13,3711,0.0,26,22,0,5,4,84.61538462
2011020502,9,3722,0.0,35,32,8,0,3,91.42857143
2011020503,29,3591,0.0,38,32,2,1,6,84.21052632
2011020503,18,3600,0.0,31,26,9,0,5,83.87096774
2011020504,8,3597,0.0,34,30,4,4,4,88.23529412
2011020504,52,3600,0.0,27,27,8,0,0,100.0
2011020505,17,3535,0.0,27,24,1,0,3,88.88888889
2011020505,20,3600,0.0,31,29,2,0,2,93.5483871
2011020506,30,3600,0.0,31,27,5,2,4,87.09677419
2011020506,22,3597,0.0,31,30,9,0,1,96.77419355
2011020507,24,3900,0.0,34,32,2,0,2,94.11764706
2011020507,26,3898,0.0,22,20,3,0,2,90.90909091
2011020508,13,1200,0.0,14,10,0,0,4,71.42857143
2011020508,13,2400,0.0,21,17,2,0,4,80.95238095
2011020508,6,3600,0.0,30,30,0,2,0,100.0
2011020509,15,3895,0.0,28,25,3,2,3,89.28571429
2011020509,1,3884,0.0,25,22,1,0,3,88.0
2011020510,10,3600,0.0,33,30,4,0,3,90.90909091
2011020510,2,3545,0.0,26,22,2,0,4,84.61538462
2011020511,4,3482,0.0,24,20,4,0,4,83.33333333
2011020511,3,3597,0.0,30,28,5,0,2,93.33333333
2011020512,9,3696,0.0,38,36,5,0,2,94.73684211
2011020512,12,3696,0.0,23,22,2,0,1,95.65217391
2011020513,5,3593,2.0,19,18,2,1,1,94.73684211
2011020513,52,3594,0.0,39,35,10,0,4,89.74358974
2011020514,18,750,0.0,7,4,0,0,3,57.14285714
2011020514,18,2818,0.0,21,19,7,1,2,90.47619048
2011020514,25,3552,0.0,37,34,11,2,3,91.89189189
2011020515,14,3802,0.0,29,27,4,2,2,93.10344828
2011020515,21,3797,0.0,30,29,1,0,1,96.66666667
2011020516,19,3600,0.0,26,24,4,0,2,92.30769231
2011020516,27,3561,0.0,18,15,0,0,3,83.33333333
2011020517,20,3600,0.0,30,29,3,1,1,96.66666667
2011020517,23,3556,0.0,30,28,0,0,2,93.33333333
2011020518,26,3900,0.0,35,34,8,0,1,97.14285714
2011020518,28,3900,0.0,29,28,2,1,1,96.55172414
2011020519,21,3600,0.0,22,20,5,2,2,90.90909091
2011020519,30,3557,0.0,32,28,14,2,4,87.5
2011020520,15,675,0.0,6,3,0,0,3,50.0
2011020520,15,2828,0.0,17,16,3,1,1,94.11764706
2011020520,7,3600,0.0,22,20,6,0,2,90.90909091
2011020521,2,3550,0.0,30,28,5,0,2,93.33333333
2011020521,3,3600,0.0,28,28,2,0,0,100.0
2011020522,1,3543,0.0,33,30,4,0,3,90.90909091
2011020522,12,3600,0.0,25,23,2,1,2,92.0
2011020523,25,1161,0.0,12,11,0,0,1,91.66666667
2011020523,25,2400,0.0,25,22,2,2,3,88.0
2011020523,19,3600,0.0,23,20,1,0,3,86.95652174
2011020524,17,3600,0.0,32,31,5,2,1,96.875
2011020524,18,3600,0.0,22,18,1,1,4,81.81818182
2011020525,29,3600,0.0,22,18,1,0,4,81.81818182
2011020525,16,3566,0.0,38,37,3,1,1,97.36842105
2011020526,22,3484,0.0,26,21,6,1,5,80.76923077
2011020526,23,3590,0.0,21,18,7,1,3,85.71428571
2011020527,27,2826,0.0,29,25,3,0,4,86.20689655
2011020527,27,720,0.0,6,6,2,0,0,100.0
2011020527,26,3600,0.0,29,26,0,2,3,89.65517241
2011020528,24,3600,0.0,38,36,6,0,2,94.73684211
2011020528,28,3517,0.0,23,20,5,0,3,86.95652174
2011020529,12,3496,0.0,52,48,9,2,4,92.30769231
2011020529,5,3587,0.0,18,16,1,0,2,88.88888889
2011020530,20,3899,0.0,28,27,6,1,1,96.42857143
2011020530,29,3874,0.0,26,25,3,2,1,96.15384615
2011020531,8,3563,0.0,35,33,5,1,2,94.28571429
2011020531,9,1323,0.0,7,3,0,1,4,42.85714286
2011020531,9,2277,0.0,21,19,5,1,2,90.47619048
2011020532,4,3600,0.0,16,11,0,0,5,68.75
2011020532,14,3600,0.0,32,31,1,0,1,96.875
2011020533,10,1453,0.0,8,5,0,0,3,62.5
2011020533,10,2014,0.0,18,16,1,3,2,88.88888889
2011020533,13,3600,0.0,32,29,2,0,3,90.625
2011020534,19,3529,0.0,32,29,6,0,3,90.625
2011020534,17,3600,0.0,31,29,5,0,2,93.5483871
2011020535,52,3600,0.0,33,32,1,0,1,96.96969697
2011020535,21,3600,0.0,26,22,1,0,4,84.61538462
2011020536,7,3512,0.0,23,20,5,1,3,86.95652174
2011020536,1,3600,0.0,23,22,4,0,1,95.65217391
2011020537,3,3595,0.0,23,19,2,2,4,82.60869565
2011020537,15,3600,0.0,32,31,8,1,1,96.875
2011020538,30,3895,0.0,25,24,4,1,1,96.0
2011020538,18,3894,0.0,35,34,1,0,1,97.14285714
2011020539,26,3600,0.0,38,38,7,0,0,100.0
2011020539,16,3471,0.0,38,36,10,1,2,94.73684211
2011020540,6,3658,0.0,22,21,1,0,1,95.45454545
2011020540,27,3658,0.0,29,27,0,0,2,93.10344828
2011020541,23,3803,0.0,35,33,8,1,2,94.28571429
2011020541,28,3803,0.0,30,27,7,0,3,90.0
2011020542,20,3566,0.0,33,31,2,0,2,93.93939394
2011020542,2,3600,0.0,30,29,1,0,1,96.66666667
2011020543,4,3600,0.0,26,24,6,0,2,92.30769231
2011020543,5,3563,0.0,22,19,6,0,3,86.36363636
2011020544,10,3777,0.0,34,30,4,0,4,88.23529412
2011020544,12,3789,0.0,24,21,7,0,3,87.5
2011020545,8,3536,0.0,22,18,4,0,4,81.81818182
2011020545,14,3600,0.0,34,31,7,0,3,91.17647059
2011020546,22,2400,0.0,19,15,0,1,4,78.94736842
2011020546,22,1117,0.0,8,8,0,0,0,100.0
2011020546,30,3600,2.0,30,27,3,0,3,90.0
2011020547,26,3664,0.0,27,26,2,2,1,96.2962963
2011020547,52,3669,0.0,31,31,10,1,0,100.0
2011020548,29,3600,0.0,37,36,6,0,1,97.2972973
2011020548,25,3501,0.0,28,25,7,2,3,89.28571429
2011020549,27,3556,0.0,35,32,11,2,3,91.42857143
2011020549,21,3598,0.0,27,25,2,0,2,92.59259259
2011020550,23,3600,0.0,32,30,7,1,2,93.75
2011020550,24,1918,0.0,15,14,3,3,1,93.33333333
2011020550,24,1679,0.0,16,12,0,0,4,75.0
2011020551,7,3509,0.0,21,18,3,0,3,85.71428571
2011020551,15,3597,0.0,26,25,0,0,1,96.15384615
2011020552,20,3811,0.0,49,45,7,1,4,91.83673469
2011020552,9,2611,0.0,17,17,1,1,0,100.0
2011020552,9,1200,0.0,15,12,4,0,3,80.0
2011020553,3,3600,0.0,28,27,5,0,1,96.42857143
2011020553,13,2547,0.0,11,10,1,0,1,90.90909091
2011020553,13,937,0.0,14,11,0,0,3,78.57142857
2011020554,18,3900,0.0,36,35,6,0,1,97.22222222
2011020554,19,3900,0.0,34,33,2,1,1,97.05882353
2011020555,17,3527,0.0,28,25,7,0,3,89.28571429
2011020555,16,3599,0.0,28,26,2,0,2,92.85714286
2011020556,5,3524,0.0,20,18,5,1,2,90.0
2011020556,1,3600,0.0,30,29,8,0,1,96.66666667
2011020557,22,3600,0.0,29,25,0,2,4,86.20689655
2011020557,2,3600,0.0,29,28,3,0,1,96.55172414
2011020558,12,3600,2.0,32,27,3,2,5,84.375
2011020558,14,3600,0.0,26,24,1,0,2,92.30769231
2011020559,8,3556,0.0,34,32,1,1,2,94.11764706
2011020559,13,1456,0.0,10,9,3,0,1,90.0
2011020559,13,2144,0.0,18,17,1,0,1,94.44444444
2011020560,27,3586,0.0,30,28,1,0,2,93.33333333
2011020560,30,3529,0.0,29,26,5,0,3,89.65517241
2011020561,9,3900,0.0,28,26,5,1,2,92.85714286
2011020561,7,3900,0.0,46,44,13,3,2,95.65217391
2011020562,10,3522,0.0,35,32,6,0,3,91.42857143
2011020562,52,3598,0.0,24,22,3,1,2,91.66666667
2011020563,19,3600,0.0,31,28,5,0,3,90.32258065
2011020563,17,3600,0.0,31,31,6,1,0,100.0
2011020564,15,3600,0.0,37,35,4,0,2,94.59459459
2011020564,29,3467,0.0,26,22,1,0,4,84.61538462
2011020565,6,3495,0.0,27,23,4,1,4,85.18518519
2011020565,25,3600,0.0,20,18,1,0,2,90.0
2011020566,21,3600,0.0,20,18,3,2,2,90.0
2011020566,24,3548,0.0,26,22,0,0,4,84.61538462
2011020567,23,3600,0.0,33,29,4,2,4,87.87878788
2011020567,26,3600,0.0,28,27,6,1,1,96.42857143
2011020568,20,3542,0.0,26,22,3,0,4,84.61538462
2011020568,18,3600,0.0,20,17,2,0,3,85.0
2011020569,3,3600,0.0,36,34,2,0,2,94.44444444
2011020569,4,3520,0.0,33,30,1,1,3,90.90909091
2011020570,1,3840,0.0,32,29,1,0,3,90.625
2011020570,9,3833,0.0,29,27,2,1,2,93.10344828
2011020571,22,3600,0.0,42,39,11,2,3,92.85714286
2011020571,16,3518,0.0,30,26,4,0,4,86.66666667
2011020572,28,3900,0.0,29,27,8,0,2,93.10344828
2011020572,23,3900,2.0,35,33,10,0,2,94.28571429
2011020573,21,3900,0.0,32,31,7,0,1,96.875
2011020573,26,3876,0.0,21,20,3,0,1,95.23809524
2011020574,22,3528,0.0,33,29,2,2,4,87.87878788
2011020574,7,3597,0.0,26,23,5,0,3,88.46153846
2011020575,14,1577,0.0,21,18,7,1,3,85.71428571
2011020575,14,2023,0.0,21,17,5,1,4,80.95238095
2011020575,10,3600,2.0,24,21,3,1,3,87.5
2011020576,20,3534,0.0,21,18,2,0,3,85.71428571
2011020576,15,3600,0.0,19,18,3,1,1,94.73684211
2011020577,2,3894,0.0,40,37,7,0,3,92.5
2011020577,12,3900,0.0,36,33,3,0,3,91.66666667
2011020578,27,3495,0.0,30,27,3,2,3,90.0
2011020578,19,3600,0.0,35,34,1,0,1,97.14285714
2011020579,17,3600,0.0,29,25,3,0,4,86.20689655
2011020579,25,3527,0.0,31,26,0,1,5,83.87096774
2011020580,52,2799,0.0,24,18,4,1,6,75.0
2011020580,52,791,0.0,7,6,2,0,1,85.71428571
2011020580,8,3600,0.0,27,24,2,0,3,88.88888889
2011020581,6,3600,0.0,31,30,4,0,1,96.77419355
2011020581,1,3600,0.0,27,21,1,1,6,77.77777778
2011020582,30,3523,0.0,34,32,2,3,2,94.11764706
2011020582,23,3600,0.0,28,28,4,0,0,100.0
2011020583,28,3600,0.0,27,26,4,0,1,96.2962963
2011020583,24,3504,0.0,36,33,7,0,3,91.66666667
2011020584,20,1455,0.0,21,15,0,0,6,71.42857143
2011020584,20,2145,0.0,21,18,0,0,3,85.71428571
2011020584,6,3600,0.0,25,25,2,0,0,100.0
2011020585,52,3586,0.0,25,21,2,0,4,84.0
2011020585,10,3560,0.0,24,24,3,0,0,100.0
2011020586,13,3809,0.0,41,38,3,0,3,92.68292683
2011020586,3,3809,0.0,21,19,0,0,2,90.47619048
2011020587,16,3570,0.0,46,41,5,0,5,89.13043478
2011020587,4,3600,0.0,34,30,0,1,4,88.23529412
2011020588,14,3543,0.0,23,20,3,0,3,86.95652174
2011020588,9,3589,0.0,36,35,6,1,1,97.22222222
2011020589,22,3538,0.0,37,33,4,0,4,89.18918919
2011020589,19,3600,0.0,32,29,14,2,3,90.625
2011020590,25,3594,0.0,25,24,1,1,1,96.0
2011020590,18,3599,0.0,30,26,5,1,4,86.66666667
2011020591,27,3638,0.0,28,27,1,0,1,96.42857143
2011020591,26,3638,0.0,22,22,2,1,0,100.0
2011020592,29,3529,0.0,39,37,9,0,2,94.87179487
2011020592,28,3600,0.0,24,23,0,3,1,95.83333333
2011020593,13,3560,0.0,27,24,4,0,3,88.88888889
2011020593,1,3584,0.0,24,22,2,1,2,91.66666667
2011020594,3,3600,0.0,38,37,3,1,1,97.36842105
2011020594,5,3519,0.0,21,18,0,1,3,85.71428571
2011020595,7,3529,0.0,34,31,4,1,3,91.17647059
2011020595,12,3600,0.0,33,31,4,0,2,93.93939394
2011020596,21,3600,0.0,27,27,2,0,0,100.0
2011020596,16,3600,0.0,22,18,0,0,4,81.81818182
2011020597,2,3456,0.0,20,16,4,0,4,80.0
2011020597,24,3600,0.0,21,19,1,0,2,90.47619048
2011020598,23,3596,0.0,39,36,6,4,3,92.30769231
2011020598,6,3547,0.0,36,32,9,4,4,88.88888889
2011020599,9,3894,0.0,39,36,7,0,3,92.30769231
2011020599,4,3889,0.0,37,35,5,3,2,94.59459459
2011020600,22,3539,0.0,33,30,3,0,3,90.90909091
2011020600,25,3600,0.0,26,25,2,0,1,96.15384615
2011020601,29,3580,0.0,31,31,16,1,0,100.0
2011020601,26,3471,0.0,18,17,7,0,1,94.44444444
2011020602,52,3657,0.0,32,31,3,1,1,96.875
2011020602,7,3640,2.0,41,39,6,3,2,95.12195122
2011020603,17,3524,0.0,18,14,0,0,4,77.77777778
2011020603,10,3586,0.0,40,37,1,0,3,92.5
2011020604,14,3569,0.0,28,25,1,1,3,89.28571429
2011020604,8,3600,0.0,24,23,1,0,1,95.83333333
2011020605,1,3600,0.0,42,41,6,0,1,97.61904762
2011020605,5,3499,0.0,27,24,0,3,3,88.88888889
2011020606,21,3598,0.0,39,35,8,0,4,89.74358974
2011020606,19,3600,0.0,15,15,4,1,0,100.0
2011020607,12,3600,0.0,36,31,4,1,5,86.11111111
2011020607,18,3567,0.0,29,27,1,4,2,93.10344828
2011020608,2,3600,0.0,25,20,4,0,5,80.0
2011020608,27,3600,0.0,32,31,5,0,1,96.875
2011020609,30,3486,0.0,36,33,7,1,3,91.66666667
2011020609,20,3600,0.0,28,27,7,0,1,96.42857143
2011020610,15,3549,0.0,38,34,2,0,4,89.47368421
2011020610,28,3600,0.0,30,28,0,0,2,93.33333333
2011020611,4,3586,0.0,37,32,2,0,5,86.48648649
2011020611,9,3600,0.0,37,33,3,2,4,89.18918919
2011020612,17,3788,0.0,31,29,5,0,2,93.5483871
2011020612,16,3773,0.0,27,24,0,1,3,88.88888889
2011020613,29,2376,0.0,10,8,4,0,2,80.0
2011020613,29,1200,0.0,16,12,2,0,4,75.0
2011020613,24,1137,0.0,8,7,0,1,1,87.5
2011020613,24,2451,0.0,10,7,0,0,3,70.0
2011020614,23,3566,0.0,22,20,4,1,2,90.90909091
2011020614,13,3600,0.0,26,25,4,0,1,96.15384615
2011020615,15,1200,0.0,8,7,2,0,1,87.5
2011020615,15,2400,0.0,27,23,1,0,4,85.18518519
2011020615,26,3600,0.0,22,20,4,0,2,90.90909091
2011020616,52,3600,0.0,42,37,8,3,5,88.0952381
2011020616,6,3600,0.0,32,29,4,1,3,90.625
2011020617,7,3495,0.0,28,26,9,0,2,92.85714286
2011020617,10,3600,0.0,32,32,0,3,0,100.0
2011020618,17,3600,0.0,30,25,1,0,5,83.33333333
2011020618,2,3600,0.0,24,23,6,1,1,95.83333333
2011020619,27,3900,0.0,32,31,1,0,1,96.875
2011020619,3,3885,0.0,19,18,0,0,1,94.73684211
2011020620,9,3600,0.0,30,29,1,0,1,96.66666667
2011020620,5,1275,0.0,8,5,0,1,3,62.5
2011020620,5,2325,0.0,15,13,5,0,2,86.66666667
2011020621,4,3600,0.0,36,35,5,1,1,97.22222222
2011020621,12,3515,0.0,37,35,8,1,2,94.59459459
2011020622,19,3600,0.0,19,19,1,2,0,100.0
2011020622,8,3600,0.0,25,22,5,1,3,88.0
2011020623,23,3900,0.0,31,27,5,0,4,87.09677419
2011020623,14,3870,0.0,28,24,3,2,4,85.71428571
2011020624,28,3900,0.0,31,27,6,1,4,87.09677419
2011020624,30,3900,0.0,38,34,5,0,4,89.47368421
2011020625,29,3586,0.0,24,20,2,0,4,83.33333333
2011020625,16,3574,0.0,34,32,5,0,2,94.11764706
2011020626,18,3597,0.0,33,32,4,0,1,96.96969697
2011020626,21,3600,0.0,26,22,2,0,4,84.61538462
2011020627,1,452,0.0,5,3,2,0,2,60.0
2011020627,1,3072,0.0,9,5,0,1,4,55.55555556
2011020627,20,3600,0.0,38,35,5,1,3,92.10526316
2011020628,25,3560,0.0,25,21,3,0,4,84.0
2011020628,24,3600,0.0,28,26,2,0,2,92.85714286
2011020629,5,3522,0.0,21,20,1,0,1,95.23809524
2011020629,15,3600,0.0,30,30,0,0,0,100.0
2011020630,1,3658,0.0,23,22,2,0,1,95.65217391
2011020630,22,3666,0.0,25,23,2,0,2,92.0
2011020631,8,3539,0.0,30,28,4,1,2,93.33333333
2011020631,6,3596,0.0,34,33,1,3,1,97.05882353
2011020632,4,3598,0.0,35,33,3,1,2,94.28571429
2011020632,2,3552,2.0,22,19,5,0,3,86.36363636
2011020633,9,3600,0.0,34,34,4,1,0,100.0
2011020633,3,3599,0.0,24,21,3,1,3,87.5
2011020634,12,3600,0.0,36,34,4,0,2,94.44444444
2011020634,14,2690,0.0,24,22,2,0,2,91.66666667
2011020634,14,910,0.0,8,5,0,0,3,62.5
2011020635,27,3900,0.0,42,40,5,1,2,95.23809524
2011020635,17,3900,0.0,27,25,2,0,2,92.59259259
2011020636,23,3646,0.0,33,31,5,2,2,93.93939394
2011020636,19,3646,0.0,21,18,6,2,3,85.71428571
2011020637,21,3622,0.0,35,32,7,0,3,91.42857143
2011020637,18,3592,0.0,29,27,3,1,2,93.10344828
2011020638,28,3600,0.0,24,24,1,0,0,100.0
2011020638,52,3526,0.0,37,35,3,0,2,94.59459459
2011020639,30,2187,0.0,21,17,2,0,4,80.95238095
2011020639,30,1350,0.0,8,8,0,1,0,100.0
2011020639,16,3600,0.0,23,21,1,0,2,91.30434783
2011020640,24,3711,0.0,19,18,2,0,1,94.73684211
2011020640,20,3711,0.0,23,23,0,0,0,100.0
2011020641,25,3900,0.0,41,37,6,0,4,90.24390244
2011020641,26,3891,0.0,38,34,7,0,4,89.47368421
2011020642,14,3545,0.0,19,16,5,0,3,84.21052632
2011020642,15,3600,0.0,31,28,3,1,3,90.32258065
2011020643,27,3549,0.0,32,28,5,0,4,87.5
2011020643,29,3596,0.0,35,32,1,0,3,91.42857143
2011020644,10,3537,0.0,25,22,2,1,3,88.0
2011020644,7,3600,0.0,26,24,3,0,2,92.30769231
2011020645,5,3596,0.0,26,25,2,0,1,96.15384615
2011020645,13,3600,0.0,41,37,8,1,4,90.24390244
2011020646,24,3600,0.0,33,33,2,0,0,100.0
2011020646,22,1854,0.0,14,11,2,0,3,78.57142857
2011020646,22,1746,0.0,14,12,2,0,2,85.71428571
2011020647,16,3817,0.0,43,40,1,1,3,93.02325581
2011020647,17,3861,0.0,27,25,3,0,2,92.59259259
2011020648,21,3600,0.0,22,21,5,0,1,95.45454545
2011020648,25,3510,0.0,23,21,2,0,2,91.30434783
2011020649,3,3600,0.0,20,20,6,1,0,100.0
2011020649,10,3600,0.0,30,27,4,2,3,90.0
2011020650,9,3849,0.0,35,33,6,6,2,94.28571429
2011020650,8,3872,0.0,25,23,7,0,2,92.0
2011020651,7,3575,0.0,39,36,1,1,3,92.30769231
2011020651,2,3600,0.0,25,23,3,0,2,92.0
2011020652,6,3531,0.0,20,17,0,0,3,85.0
2011020652,12,3600,0.0,35,33,2,0,2,94.28571429
2011020653,1,3596,0.0,23,22,4,1,1,95.65217391
2011020653,52,3517,0.0,25,23,2,0,2,92.0
2011020654,28,3600,0.0,26,25,2,0,1,96.15384615
2011020654,29,3573,0.0,33,31,11,0,2,93.93939394
2011020655,30,3900,0.0,49,47,11,2,2,95.91836735
2011020655,19,3900,0.0,31,29,5,1,2,93.5483871
2011020656,4,3547,0.0,24,21,2,0,3,87.5
2011020656,18,3600,0.0,38,36,5,3,2,94.73684211
2011020657,26,3600,0.0,30,29,3,0,1,96.66666667
2011020657,20,3552,0.0,23,20,1,0,3,86.95652174
2011020658,5,3600,0.0,20,17,1,1,3,85.0
2011020658,14,3568,0.0,43,38,9,0,5,88.37209302
2011020659,12,3501,0.0,24,22,1,1,2,91.66666667
2011020659,15,3600,0.0,44,43,8,0,1,97.72727273
2011020660,3,3590,0.0,29,25,0,0,4,86.20689655
2011020660,8,3600,0.0,29,28,1,2,1,96.55172414
2011020661,28,3533,0.0,40,36,0,1,4,90.0
2011020661,16,3600,0.0,24,21,4,0,3,87.5
2011020662,26,3773,0.0,33,31,4,0,2,93.93939394
2011020662,22,3773,0.0,21,20,3,0,1,95.23809524
2011020663,24,3600,0.0,23,21,2,0,2,91.30434783
2011020663,23,3459,0.0,34,30,5,1,4,88.23529412
2011020664,18,3600,0.0,37,36,5,0,1,97.2972973
2011020664,2,3452,0.0,32,29,1,0,3,90.625
2011020665,21,3600,0.0,33,27,4,0,6,81.81818182
2011020665,27,3600,0.0,39,38,0,3,1,97.43589744
2011020666,52,3600,0.0,25,25,2,2,0,100.0
2011020666,9,3557,0.0,35,33,7,0,2,94.28571429
2011020667,6,3881,0.0,40,38,11,0,2,95.0
2011020667,13,3897,0.0,35,33,2,0,2,94.28571429
2011020668,7,2128,0.0,12,12,4,0,0,100.0
2011020668,7,1472,0.0,14,9,0,0,5,64.28571429
2011020668,17,3586,0.0,27,27,4,1,0,100.0
2011020669,25,3501,0.0,32,31,7,0,1,96.875
2011020669,19,3597,0.0,22,22,3,0,0,100.0
2011020670,9,3600,0.0,39,37,3,1,2,94.87179487
2011020670,10,3556,0.0,21,18,1,0,3,85.71428571
2011020671,52,1874,0.0,5,4,0,0,1,80.0
2011020671,52,1726,0.0,15,11,1,0,4,73.33333333
2011020671,1,3600,0.0,21,20,1,0,1,95.23809524
2011020672,18,3558,0.0,28,26,0,2,2,92.85714286
2011020672,3,3600,0.0,27,27,1,0,0,100.0
2011020673,30,3600,0.0,34,29,5,1,5,85.29411765
2011020673,4,3597,0.0,26,25,0,2,1,96.15384615
2011020674,12,3900,0.0,41,40,2,2,1,97.56097561
2011020674,5,3889,0.0,26,25,4,0,1,96.15384615
2011020675,2,3597,0.0,17,17,3,1,0,100.0
2011020675,15,3600,0.0,28,25,2,0,3,89.28571429
2011020676,22,3572,0.0,24,21,1,0,3,87.5
2011020676,29,3600,0.0,23,21,1,0,2,91.30434783
2011020677,6,3556,0.0,30,26,8,0,4,86.66666667
2011020677,14,3593,0.0,29,26,6,0,3,89.65517241
2011020678,17,3881,0.0,27,25,0,0,2,92.59259259
2011020678,25,3900,0.0,32,30,1,0,2,93.75
2011020679,26,3900,0.0,33,31,8,0,2,93.93939394
2011020679,23,3900,0.0,41,39,1,0,2,95.12195122
2011020680,20,3900,0.0,31,30,2,0,1,96.77419355
2011020680,28,3900,0.0,28,27,0,0,1,96.42857143
2011020681,15,3600,0.0,31,31,9,1,0,100.0
2011020681,8,3591,0.0,16,13,3,2,3,81.25
2011020682,7,3600,0.0,35,29,6,0,6,82.85714286
2011020682,16,3595,0.0,27,25,4,1,2,92.59259259
2011020683,13,3833,0.0,44,40,4,1,4,90.90909091
2011020683,21,3835,0.0,29,26,4,0,3,89.65517241
2011020684,27,3600,0.0,21,15,1,0,6,71.42857143
2011020684,24,3600,0.0,27,25,5,0,2,92.59259259
2011020685,30,3600,0.0,33,29,8,0,4,87.87878788
2011020685,10,3595,0.0,21,20,1,0,1,95.23809524
2011020686,6,3600,0.0,31,30,0,0,1,96.77419355
2011020686,1,3531,0.0,24,21,0,0,3,87.5
2011020687,5,3600,0.0,31,30,1,1,1,96.77419355
2011020687,3,3575,0.0,35,32,2,0,3,91.42857143
2011020688,2,3600,0.0,41,40,9,1,1,97.56097561
2011020688,4,3482,0.0,26,23,1,2,3,88.46153846
2011020689,18,3600,0.0,38,38,4,0,0,100.0
2011020689,29,3550,0.0,24,22,2,0,2,91.66666667
2011020690,22,3524,0.0,38,37,9,0,1,97.36842105
2011020690,19,3600,0.0,15,15,3,0,0,100.0
2011020691,7,3600,0.0,33,29,2,0,4,87.87878788
2011020691,52,3600,0.0,26,25,3,0,1,96.15384615
2011020692,17,3900,0.0,33,31,3,0,2,93.93939394
2011020692,27,3895,0.0,35,33,9,0,2,94.28571429
2011020693,20,3900,0.0,32,31,2,1,1,96.875
2011020693,26,3900,0.0,25,24,2,0,1,96.0
2011020694,9,3600,0.0,37,36,5,0,1,97.2972973
2011020694,28,3600,0.0,21,17,3,1,4,80.95238095
2011020695,8,3900,0.0,38,34,2,4,4,89.47368421
2011020695,5,3872,0.0,29,25,5,0,4,86.20689655
2011020696,15,3586,0.0,33,30,2,2,3,90.90909091
2011020696,12,3593,0.0,23,23,1,0,0,100.0
2011020697,13,3517,0.0,22,19,7,0,3,86.36363636
2011020697,16,3600,0.0,19,18,4,1,1,94.73684211
2011020698,14,3600,0.0,28,27,4,0,1,96.42857143
2011020698,25,3549,0.0,22,20,7,1,2,90.90909091
2011020699,3,3891,0.0,34,32,2,0,2,94.11764706
2011020699,6,3896,0.0,33,30,4,3,3,90.90909091
2011020700,4,3595,0.0,31,30,8,1,1,96.77419355
2011020700,1,3570,0.0,19,16,3,1,3,84.21052632
2011020701,28,3544,0.0,30,26,2,0,4,86.66666667
2011020701,23,3580,0.0,26,23,1,0,3,88.46153846
2011020702,8,3600,0.0,33,32,8,1,1,96.96969697
2011020702,10,3528,0.0,23,20,4,1,3,86.95652174
2011020703,12,3824,0.0,40,38,8,1,2,95.0
2011020703,2,3838,0.0,33,32,3,1,1,96.96969697
2011020704,29,3900,0.0,31,29,3,0,2,93.5483871
2011020704,17,3869,0.0,19,17,2,0,2,89.47368421
2011020705,9,3506,0.0,29,27,7,0,2,93.10344828
2011020705,24,3596,0.0,32,31,4,1,1,96.875
2011020706,13,3900,0.0,44,41,7,0,3,93.18181818
2011020706,52,3895,0.0,23,20,5,1,3,86.95652174
2011020707,7,3539,0.0,26,23,1,1,3,88.46153846
2011020707,19,3577,0.0,21,19,0,0,2,90.47619048
2011020708,16,2163,0.0,17,13,1,0,4,76.47058824
2011020708,16,1437,0.0,6,5,0,0,1,83.33333333
2011020708,18,3600,0.0,22,20,1,0,2,90.90909091
2011020709,14,3551,0.0,36,33,2,0,3,91.66666667
2011020709,27,3520,0.0,21,17,3,1,4,80.95238095
2011020710,25,1200,0.0,7,6,2,0,1,85.71428571
2011020710,25,2384,0.0,19,15,1,0,4,78.94736842
2011020710,30,3600,0.0,25,23,0,0,2,92.0
2011020711,20,3600,0.0,23,21,1,0,2,91.30434783
2011020711,22,2384,0.0,16,12,5,0,4,75.0
2011020711,22,1172,0.0,6,5,4,0,1,83.33333333
2011020712,21,3600,0.0,26,25,3,1,1,96.15384615
2011020712,26,3600,2.0,31,28,3,0,3,90.32258065
2011020713,6,3900,0.0,38,33,12,0,5,86.84210526
2011020713,4,3900,2.0,37,32,7,2,5,86.48648649
2011020714,15,3691,0.0,27,23,4,0,4,85.18518519
2011020714,5,3691,0.0,20,17,2,1,3,85.0
2011020715,21,3507,0.0,18,15,0,1,3,83.33333333
2011020715,24,3600,0.0,45,43,7,2,2,95.55555556
2011020716,2,3600,0.0,35,32,10,0,3,91.42857143
2011020716,10,3600,0.0,25,25,0,0,0,100.0
2011020717,52,3516,0.0,16,14,1,1,2,87.5
2011020717,12,3600,0.0,30,29,1,3,1,96.66666667
2011020718,19,3564,0.0,28,25,1,0,3,89.28571429
2011020718,17,3574,2.0,22,21,2,1,1,95.45454545
2011020719,29,3600,0.0,29,25,4,0,4,86.20689655
2011020719,18,3588,0.0,26,25,3,1,1,96.15384615
2011020720,28,3900,0.0,18,17,2,0,1,94.44444444
2011020720,22,3900,0.0,45,44,6,0,1,97.77777778
2011020721,9,2400,0.0,26,22,6,0,4,84.61538462
2011020721,9,1200,0.0,8,8,0,1,0,100.0
2011020721,26,3568,0.0,28,27,5,1,1,96.42857143
2011020722,7,3900,0.0,28,27,3,0,1,96.42857143
2011020722,1,3884,0.0,14,13,2,0,1,92.85714286
2011020723,10,3726,0.0,32,29,0,0,3,90.625
2011020723,2,3647,0.0,21,17,0,0,4,80.95238095
2011020724,52,3454,0.0,31,28,6,0,3,90.32258065
2011020724,3,3600,0.0,22,22,2,0,0,100.0
2011020725,6,3531,0.0,22,18,0,0,4,81.81818182
2011020725,15,3600,0.0,32,29,3,0,3,90.625
2011020726,29,3516,0.0,31,27,6,0,4,87.09677419
2011020726,14,3595,0.0,24,22,4,3,2,91.66666667
2011020727,4,3900,0.0,25,23,3,1,2,92.0
2011020727,13,3899,0.0,37,35,4,1,2,94.59459459
2011020728,5,3900,0.0,34,32,4,0,2,94.11764706
2011020728,19,3900,0.0,39,37,4,1,2,94.87179487
2011020729,18,3600,0.0,25,24,0,0,1,96.0
2011020729,16,3588,0.0,25,23,3,2,2,92.0
2011020730,24,3496,0.0,16,15,0,1,1,93.75
2011020730,25,3600,0.0,27,27,3,0,0,100.0
2011020731,30,3600,0.0,26,24,3,0,2,92.30769231
2011020731,21,3544,0.0,34,31,3,0,3,91.17647059
2011020732,28,3600,0.0,25,25,2,0,0,100.0
2011020732,20,3511,0.0,27,26,1,0,1,96.2962963
2011020733,9,3557,0.0,26,23,2,2,3,88.46153846
2011020733,27,3600,0.0,34,32,2,0,2,94.11764706
2011020734,22,3900,0.0,35,33,3,0,2,94.28571429
2011020734,23,3900,0.0,32,30,0,1,2,93.75
2011020735,17,1189,0.0,12,8,0,0,4,66.66666667
2011020735,17,2400,0.0,13,10,0,0,3,76.92307692
2011020735,8,3596,0.0,28,26,2,0,2,92.85714286
2011020736,9,3561,0.0,30,26,6,0,4,86.66666667
2011020736,6,3600,0.0,33,30,0,0,3,90.90909091
2011020737,3,3900,0.0,29,26,2,2,3,89.65517241
2011020737,1,3888,0.0,26,23,3,1,3,88.46153846
2011020738,52,3900,0.0,28,27,3,0,1,96.42857143
2011020738,4,3900,0.0,24,23,2,0,1,95.83333333
2011020739,10,3900,0.0,35,31,0,1,4,88.57142857
2011020739,5,3865,0.0,39,35,4,2,4,89.74358974
2011020740,2,3573,0.0,23,21,3,1,2,91.30434783
2011020740,12,3536,0.0,24,21,1,0,3,87.5
2011020741,7,3586,0.0,28,27,1,0,1,96.42857143
2011020741,8,3570,0.0,39,37,7,0,2,94.87179487
2011020742,15,3765,0.0,31,27,2,0,4,87.09677419
2011020742,14,3763,0.0,29,26,3,0,3,89.65517241
2011020743,18,3600,0.0,25,21,1,0,4,84.0
2011020743,30,3580,0.0,30,25,1,0,5,83.33333333
2011020744,17,3600,0.0,29,28,5,3,1,96.55172414
2011020744,20,3504,0.0,25,22,5,1,3,88.0
2011020745,24,3600,0.0,26,25,1,1,1,96.15384615
2011020745,27,2030,0.0,18,15,0,0,3,83.33333333
2011020745,27,1515,0.0,11,11,3,0,0,100.0
2011020746,21,3504,0.0,23,20,1,1,3,86.95652174
2011020746,22,3600,0.0,33,31,2,0,2,93.93939394
2011020747,16,3817,0.0,33,30,0,0,3,90.90909091
2011020747,23,3817,0.0,39,37,2,0,2,94.87179487
2011020748,29,3600,0.0,43,37,4,0,6,86.04651163
2011020748,28,3600,0.0,30,30,2,2,0,100.0
2011020749,3,3900,0.0,34,34,10,1,0,100.0
2011020749,7,3900,0.0,29,29,2,2,0,100.0
2011020750,5,3539,0.0,24,23,1,0,1,95.83333333
2011020750,10,3600,0.0,25,25,4,3,0,100.0
2011020751,15,3542,0.0,37,34,3,1,3,91.89189189
2011020751,13,3597,0.0,28,26,1,1,2,92.85714286
2011020752,25,3600,0.0,35,33,9,0,2,94.28571429
2011020752,24,3596,0.0,26,20,3,1,6,76.92307692
2011020753,29,3600,0.0,33,30,9,0,3,90.90909091
2011020753,26,3600,0.0,22,20,5,0,2,90.90909091
2011020754,12,3600,0.0,47,47,3,3,0,100.0
2011020754,6,3582,0.0,31,28,2,0,3,90.32258065
2011020755,8,3538,0.0,21,17,3,3,4,80.95238095
2011020755,1,3600,0.0,30,27,3,3,3,90.0
2011020756,18,3557,0.0,27,24,3,0,3,88.88888889
2011020756,4,3600,0.0,27,26,3,0,1,96.2962963
2011020757,52,3794,0.0,31,30,1,1,1,96.77419355
2011020757,14,3794,0.0,24,22,1,1,2,91.66666667
2011020758,30,3600,0.0,37,37,2,0,0,100.0
2011020758,21,3494,0.0,21,20,0,0,1,95.23809524
2011020759,16,2615,0.0,28,23,10,0,5,82.14285714
2011020759,16,977,0.0,13,10,2,0,3,76.92307692
2011020759,22,3600,0.0,47,43,4,2,4,91.4893617
2011020760,17,3884,0.0,25,22,2,1,3,88.0
2011020760,23,3900,0.0,43,40,7,0,3,93.02325581
2011020761,25,3600,0.0,37,32,3,0,5,86.48648649
2011020761,28,3600,0.0,21,19,2,0,2,90.47619048
2011020762,2,3755,0.0,24,23,1,0,1,95.83333333
2011020762,9,3755,0.0,32,30,3,0,2,93.75
2011020763,52,3517,0.0,30,28,3,2,2,93.33333333
2011020763,13,3600,0.0,21,20,0,0,1,95.23809524
2011020764,26,3549,0.0,33,32,4,0,1,96.96969697
2011020764,19,3600,0.0,22,22,3,1,0,100.0
2011020765,16,3470,0.0,32,29,16,0,3,90.625
2011020765,20,3599,0.0,27,26,1,0,1,96.2962963
2011020766,29,3834,0.0,35,33,10,1,2,94.28571429
2011020766,24,3835,0.0,21,18,4,1,3,85.71428571
2011020767,5,3600,0.0,29,28,4,3,1,96.55172414
2011020767,6,3558,0.0,28,26,8,0,2,92.85714286
2011020768,1,3600,0.0,41,37,12,1,4,90.24390244
2011020768,4,1744,0.0,8,8,3,0,0,100.0
2011020768,4,1702,0.0,23,17,10,1,6,73.91304348
2011020769,15,3598,0.0,30,30,1,2,0,100.0
2011020769,8,3591,0.0,23,20,1,0,3,86.95652174
2011020770,23,3836,0.0,46,44,7,5,2,95.65217391
2011020770,21,3900,0.0,29,27,5,0,2,93.10344828
2011020771,10,3597,0.0,49,49,6,1,0,100.0
2011020771,9,3597,0.0,40,35,10,2,5,87.5
2011020772,7,3900,0.0,38,35,6,0,3,92.10526316
2011020772,2,3900,0.0,37,34,0,1,3,91.89189189
2011020773,26,3531,0.0,22,20,4,2,2,90.90909091
2011020773,12,3600,0.0,25,24,0,2,1,96.0
2011020774,13,292,0.0,1,1,0,0,0,100.0
2011020774,13,3198,0.0,32,27,6,0,5,84.375
2011020774,14,3600,0.0,20,17,2,1,3,85.0
2011020775,19,3569,0.0,36,34,1,0,2,94.44444444
2011020775,18,3600,0.0,43,42,5,0,1,97.6744186
2011020776,30,3900,0.0,26,25,0,1,1,96.15384615
2011020776,25,3886,0.0,34,33,4,0,1,97.05882353
2011020777,28,3462,0.0,23,19,4,0,4,82.60869565
2011020777,27,3597,0.0,35,32,2,1,3,91.42857143
2011020778,17,1200,0.0,9,6,1,0,3,66.66666667
2011020778,17,2700,0.0,23,22,3,0,1,95.65217391
2011020778,22,3889,0.0,39,35,4,4,4,89.74358974
2011020779,6,3600,0.0,36,35,5,2,1,97.22222222
2011020779,15,3560,0.0,29,26,5,0,3,89.65517241
2011020780,5,2191,0.0,12,11,0,0,1,91.66666667
2011020780,5,1348,0.0,12,9,1,1,3,75.0
2011020780,1,3600,0.0,30,28,6,1,2,93.33333333
2011020781,4,3530,0.0,37,33,10,1,4,89.18918919
2011020781,3,3596,0.0,23,21,5,0,2,91.30434783
2011020782,52,3515,0.0,23,20,0,0,3,86.95652174
2011020782,8,3597,0.0,23,23,4,0,0,100.0
2011020783,22,3507,0.0,30,25,0,0,5,83.33333333
2011020783,10,3600,0.0,30,27,0,0,3,90.0
2011020784,17,3547,0.0,22,20,1,0,2,90.90909091
2011020784,27,3594,0.0,31,30,5,2,1,96.77419355
2011020785,20,3900,0.0,33,31,10,1,2,93.93939394
2011020785,24,3900,0.0,26,24,4,1,2,92.30769231
2011020786,1,3595,0.0,30,30,4,1,0,100.0
2011020786,3,3530,0.0,22,21,5,1,1,95.45454545
2011020787,2,3900,0.0,45,45,7,2,0,100.0
2011020787,4,3899,0.0,18,18,0,0,0,100.0
2011020788,13,3600,0.0,24,20,0,1,4,83.33333333
2011020788,15,3600,0.0,42,42,10,0,0,100.0
2011020789,30,3573,0.0,37,34,8,2,3,91.89189189
2011020789,29,3591,0.0,29,28,3,1,1,96.55172414
2011020790,5,3900,0.0,30,28,1,4,2,93.33333333
2011020790,8,3887,0.0,34,32,4,3,2,94.11764706
2011020791,19,3600,0.0,29,28,2,0,1,96.55172414
2011020791,9,229,0.0,4,2,0,0,2,50.0
2011020791,9,3317,0.0,14,13,0,0,1,92.85714286
2011020792,26,3600,0.0,25,24,2,0,1,96.0
2011020792,14,3518,0.0,20,17,2,0,3,85.0
2011020793,23,3892,0.0,40,37,11,0,3,92.5
2011020793,18,3900,0.0,31,28,0,0,3,90.32258065
2011020794,10,3566,0.0,29,27,3,1,2,93.10344828
2011020794,52,3592,0.0,18,17,0,0,1,94.44444444
2011020795,27,3600,0.0,29,28,9,0,1,96.55172414
2011020795,25,3600,0.0,24,20,3,1,4,83.33333333
2011020796,16,3588,0.0,28,24,0,0,4,85.71428571
2011020796,21,3600,0.0,31,29,0,0,2,93.5483871
2011020797,6,1312,0.0,10,7,0,0,3,70.0
2011020797,6,2288,0.0,19,16,4,0,3,84.21052632
2011020797,7,3600,0.0,36,36,0,1,0,100.0
2011020798,22,3487,0.0,30,26,3,4,4,86.66666667
2011020798,17,3600,0.0,17,15,4,1,2,88.23529412
2011020799,12,3731,0.0,34,31,1,1,3,91.17647059
2011020799,24,3734,0.0,33,31,1,0,2,93.93939394
2011020800,20,3600,0.0,37,34,1,0,3,91.89189189
2011020800,28,3485,0.0,36,32,4,0,4,88.88888889
2011020801,19,1746,0.0,12,9,1,0,3,75.0
2011020801,19,2139,0.0,15,15,2,3,0,100.0
2011020801,1,3898,0.0,26,23,3,0,3,88.46153846
2011020802,8,3600,0.0,33,31,5,0,2,93.93939394
2011020802,2,3532,0.0,31,28,0,0,3,90.32258065
2011020803,14,3757,0.0,31,27,4,0,4,87.09677419
2011020803,3,3757,0.0,17,14,1,1,3,82.35294118
2011020804,10,3493,0.0,39,35,11,3,4,89.74358974
2011020804,4,3596,0.0,27,24,2,0,3,88.88888889
2011020805,52,3832,0.0,34,32,4,0,2,94.11764706
2011020805,15,3900,0.0,27,25,3,1,2,92.59259259
2011020806,25,3600,0.0,28,26,4,0,2,92.85714286
2011020806,29,3520,0.0,34,31,5,0,3,91.17647059
2011020807,18,3481,0.0,29,25,8,1,4,86.20689655
2011020807,9,3600,0.0,27,24,4,2,3,88.88888889
2011020808,26,2400,0.0,11,9,0,2,2,81.81818182
2011020808,26,1183,0.0,11,11,0,0,0,100.0
2011020808,13,3600,0.0,23,22,3,1,1,95.65217391
2011020809,23,3600,0.0,24,22,7,0,2,91.66666667
2011020809,30,3561,0.0,19,15,3,0,4,78.94736842
2011020810,20,3785,0.0,35,33,2,0,2,94.28571429
2011020810,27,3785,0.0,24,23,2,0,1,95.83333333
2011020811,52,3600,0.0,39,31,2,0,8,79.48717949
2011020811,5,3600,0.0,25,20,0,0,5,80.0
2011020812,25,3900,0.0,32,30,4,0,2,93.75
2011020812,7,3869,0.0,26,24,2,0,2,92.30769231
2011020813,24,3900,0.0,24,23,6,2,1,95.83333333
2011020813,17,3894,0.0,30,29,6,0,1,96.66666667
2011020814,12,3898,0.0,33,29,0,5,4,87.87878788
2011020814,21,3898,0.0,42,39,4,0,3,92.85714286
2011020815,16,3550,0.0,27,22,9,1,5,81.48148148
2011020815,28,3591,0.0,33,30,2,1,3,90.90909091
2011020816,18,3900,0.0,41,38,4,0,3,92.68292683
2011020816,6,3898,0.0,22,19,3,0,3,86.36363636
2011020817,13,3592,0.0,28,27,3,0,1,96.42857143
2011020817,1,3544,0.0,19,17,2,0,2,89.47368421
2011020818,26,3696,0.0,25,23,3,2,2,92.0
2011020818,2,3696,0.0,35,34,2,2,1,97.14285714
2011020819,3,3598,0.0,33,31,7,2,2,93.93939394
2011020819,4,3579,0.0,26,21,5,1,5,80.76923077
2011020820,22,3617,0.0,42,39,3,1,3,92.85714286
2011020820,9,3617,0.0,40,36,11,0,4,90.0
2011020821,14,3600,0.0,27,26,1,2,1,96.2962963
2011020821,7,3520,0.0,28,26,5,0,2,92.85714286
2011020822,8,3600,0.0,32,32,5,0,0,100.0
2011020822,10,2400,0.0,15,11,0,1,4,73.33333333
2011020822,10,1200,0.0,3,2,0,1,1,66.66666667
2011020823,21,3798,0.0,44,41,3,0,3,93.18181818
2011020823,19,3798,0.0,19,17,2,3,2,89.47368421
2011020824,29,3600,0.0,35,34,1,2,1,97.14285714
2011020824,30,3540,0.0,18,16,2,0,2,88.88888889
2011020825,16,3600,0.0,27,24,1,0,3,88.88888889
2011020825,27,3600,0.0,38,38,4,0,0,100.0
2011020826,23,3900,0.0,18,16,4,1,2,88.88888889
2011020826,20,3900,0.0,31,29,3,0,2,93.5483871
2011020827,13,3591,0.0,27,26,6,0,1,96.2962963
2011020827,2,1200,0.0,4,4,0,1,0,100.0
2011020827,2,2400,0.0,15,11,1,0,4,73.33333333
2011020828,15,3553,0.0,28,25,1,2,3,89.28571429
2011020828,3,3600,0.0,26,24,3,1,2,92.30769231
2011020829,4,3475,0.0,25,21,4,0,4,84.0
2011020829,17,3600,0.0,29,26,4,2,3,89.65517241
2011020830,24,3591,0.0,27,24,1,0,3,88.88888889
2011020830,29,3513,0.0,35,30,6,0,5,85.71428571
2011020831,26,3600,0.0,28,26,2,1,2,92.85714286
2011020831,25,3525,0.0,15,12,1,2,3,80.0
2011020832,14,3508,0.0,41,37,7,0,4,90.24390244
2011020832,5,3600,0.0,23,21,1,0,2,91.30434783
2011020833,28,3585,0.0,27,25,9,3,2,92.59259259
2011020833,19,3596,0.0,25,25,4,2,0,100.0
2011020834,28,3553,0.0,42,39,7,2,3,92.85714286
2011020834,15,3539,0.0,35,30,10,0,5,85.71428571
2011020835,12,3584,0.0,33,30,7,0,3,90.90909091
2011020835,8,3495,0.0,34,30,6,1,4,88.23529412
2011020836,23,3894,0.0,35,34,4,1,1,97.14285714
2011020836,27,3879,0.0,40,39,5,0,1,97.5
2011020837,3,3600,0.0,42,42,4,0,0,100.0
2011020837,6,3600,0.0,20,17,0,0,3,85.0
2011020838,1,3600,0.0,30,29,4,3,1,96.66666667
2011020838,7,3572,0.0,30,27,14,0,3,90.0
2011020839,19,3540,0.0,33,31,9,0,2,93.93939394
2011020839,29,3600,0.0,32,31,1,2,1,96.875
2011020840,9,3600,0.0,28,28,2,0,0,100.0
2011020840,14,3512,0.0,26,23,1,0,3,88.46153846
2011020841,25,3576,0.0,37,34,5,0,3,91.89189189
2011020841,17,3595,0.0,21,20,1,0,1,95.23809524
2011020842,16,3513,0.0,19,16,1,0,3,84.21052632
2011020842,18,3584,0.0,32,30,7,1,2,93.75
2011020843,24,3600,0.0,18,17,3,0,1,94.44444444
2011020843,30,3485,0.0,25,23,3,2,2,92.0
2011020844,2,3600,0.0,38,37,2,0,1,97.36842105
2011020844,52,3564,0.0,24,22,0,0,2,91.66666667
2011020845,10,3561,0.0,34,29,4,0,5,85.29411765
2011020845,20,3593,0.0,42,41,5,1,1,97.61904762
2011020846,24,3600,0.0,26,25,1,0,1,96.15384615
2011020846,5,3565,0.0,29,27,4,2,2,93.10344828
2011020847,6,3900,0.0,29,26,3,1,3,89.65517241
2011020847,8,3873,0.0,34,31,4,0,3,91.17647059
2011020848,9,3600,0.0,44,42,4,3,2,95.45454545
2011020848,13,1554,0.0,15,13,4,0,2,86.66666667
2011020848,13,2033,0.0,16,12,0,0,4,75.0
2011020849,10,3683,0.0,32,29,1,0,3,90.625
2011020849,22,3699,0.0,26,22,4,0,4,84.61538462
2011020850,21,966,0.0,9,8,0,0,1,88.88888889
2011020850,21,2586,0.0,21,20,0,0,1,95.23809524
2011020850,23,3600,0.0,30,29,4,0,1,96.66666667
2011020851,16,3592,0.0,24,22,5,0,2,91.66666667
2011020851,3,3460,0.0,22,18,4,2,4,81.81818182
2011020852,7,1609,0.0,18,15,5,2,3,83.33333333
2011020852,7,1942,0.0,17,13,0,0,4,76.47058824
2011020852,4,3600,0.0,29,27,8,0,2,93.10344828
2011020853,28,3859,0.0,25,19,0,0,6,76.0
2011020853,14,3867,0.0,50,45,6,0,5,90.0
2011020854,2,3600,0.0,26,21,1,0,5,80.76923077
2011020854,19,3600,0.0,27,26,6,0,1,96.2962963
2011020855,52,3900,0.0,25,22,4,0,3,88.0
2011020855,30,3900,0.0,27,24,1,0,3,88.88888889
2011020856,20,3690,0.0,32,29,0,1,3,90.625
2011020856,25,3721,0.0,27,25,9,0,2,92.59259259
2011020857,27,3585,2.0,28,28,3,2,0,100.0
2011020857,26,3521,0.0,21,20,7,0,1,95.23809524
2011020858,24,3900,0.0,27,25,2,1,2,92.59259259
2011020858,1,3900,0.0,38,36,3,1,2,94.73684211
2011020859,28,3503,2.0,25,22,2,1,3,88.0
2011020859,12,3600,0.0,37,35,2,0,2,94.59459459
2011020860,8,3900,0.0,30,27,4,1,3,90.0
2011020860,7,3899,0.0,19,16,3,0,3,84.21052632
2011020861,15,3593,2.0,23,22,1,0,1,95.65217391
2011020861,13,3533,0.0,41,39,11,0,2,95.12195122
2011020862,18,3594,0.0,31,29,0,0,2,93.5483871
2011020862,17,3600,0.0,21,20,1,0,1,95.23809524
2011020863,6,3526,0.0,25,21,5,1,4,84.0
2011020863,52,3600,0.0,33,31,2,0,2,93.93939394
2011020864,21,3600,0.0,27,26,6,1,1,96.2962963
2011020864,22,3512,0.0,23,20,3,1,3,86.95652174
2011020865,5,3598,0.0,31,27,3,1,4,87.09677419
2011020865,4,2217,0.0,13,10,3,0,3,76.92307692
2011020865,4,1383,0.0,17,14,0,0,3,82.35294118
2011020866,16,3600,0.0,34,33,4,2,1,97.05882353
2011020866,29,1470,0.0,8,6,0,1,2,75.0
2011020866,29,2130,0.0,20,16,0,0,4,80.0
2011020867,30,3600,0.0,34,30,9,0,4,88.23529412
2011020867,19,3600,0.0,13,13,0,0,0,100.0
2011020868,12,2400,0.0,21,18,1,0,3,85.71428571
2011020868,12,1148,0.0,10,9,1,0,1,90.0
2011020868,2,3592,0.0,36,33,4,1,3,91.66666667
2011020869,15,3537,0.0,23,21,4,0,2,91.30434783
2011020869,14,3600,0.0,24,23,1,0,1,95.83333333
2011020870,10,1874,0.0,18,14,0,0,4,77.77777778
2011020870,10,1726,0.0,18,16,3,0,2,88.88888889
2011020870,23,3600,0.0,26,24,3,0,2,92.30769231
2011020871,25,3658,0.0,33,31,12,0,2,93.93939394
2011020871,27,3675,0.0,31,30,5,1,1,96.77419355
2011020872,20,3600,0.0,28,28,4,0,0,100.0
2011020872,26,3533,0.0,18,17,2,0,1,94.44444444
2011020873,5,1372,0.0,12,9,1,0,3,75.0
2011020873,5,2228,0.0,12,9,1,0,3,75.0
2011020873,7,3593,0.0,26,24,10,2,2,92.30769231
2011020874,28,3506,0.0,28,25,2,1,3,89.28571429
2011020874,17,3597,0.0,33,31,9,0,2,93.93939394
2011020875,19,3586,0.0,26,24,2,0,2,92.30769231
2011020875,16,3600,0.0,30,29,1,1,1,96.66666667
2011020876,6,3510,0.0,29,27,1,0,2,93.10344828
2011020876,30,3600,0.0,48,48,1,0,0,100.0
2011020877,1,3600,0.0,22,21,4,0,1,95.45454545
2011020877,8,3477,0.0,25,22,0,0,3,88.0
2011020878,24,3600,0.0,31,31,5,0,0,100.0
2011020878,13,3537,0.0,26,25,5,0,1,96.15384615
2011020879,29,3589,0.0,35,32,4,1,3,91.42857143
2011020879,3,3612,0.0,23,21,5,0,2,91.30434783
2011020880,18,3583,0.0,24,22,2,0,2,91.66666667
2011020880,25,3515,0.0,21,18,4,0,3,85.71428571
2011020881,23,3587,0.0,28,26,2,2,2,92.85714286
2011020881,22,1198,0.0,17,15,7,0,2,88.23529412
2011020881,22,2400,0.0,14,11,2,0,3,78.57142857
2011020882,21,3600,0.0,25,20,7,0,5,80.0
2011020882,52,3600,0.0,32,31,7,1,1,96.875
2011020883,9,3594,0.0,28,28,4,2,0,100.0
2011020883,2,3505,0.0,27,23,4,1,4,85.18518519
2011020883,2,95,0.0,5,3,0,0,2,60.0
2011020884,15,3289,0.0,33,30,7,1,3,90.90909091
2011020884,15,309,0.0,7,5,1,0,2,71.42857143
2011020884,12,3580,0.0,17,17,1,2,0,100.0
2011020885,2,3545,0.0,37,35,2,0,2,94.59459459
2011020885,7,3600,0.0,31,30,3,0,1,96.77419355
2011020886,1,3675,0.0,32,29,2,0,3,90.625
2011020886,10,3666,0.0,32,28,0,2,4,87.5
2011020887,3,3467,0.0,31,29,0,2,2,93.5483871
2011020887,5,3600,0.0,27,27,4,0,0,100.0
2011020888,28,2682,0.0,24,21,11,0,3,87.5
2011020888,28,918,0.0,11,8,0,0,3,72.72727273
2011020888,29,3600,0.0,41,38,3,0,3,92.68292683
2011020889,25,3600,0.0,31,31,9,0,0,100.0
2011020889,8,3585,0.0,36,33,2,1,3,91.66666667
2011020890,24,3510,0.0,16,13,1,0,3,81.25
2011020890,14,3600,0.0,30,28,4,2,2,93.33333333
2011020891,23,3504,0.0,28,25,3,0,3,89.28571429
2011020891,18,3591,0.0,33,32,6,1,1,96.96969697
2011020892,4,3796,0.0,26,22,0,0,4,84.61538462
2011020892,52,3851,0.0,55,50,10,0,5,90.90909091
2011020893,17,3528,0.0,29,27,7,0,2,93.10344828
2011020893,16,3600,0.0,32,31,7,0,1,96.875
2011020894,22,3600,0.0,22,21,0,0,1,95.45454545
2011020894,20,1200,0.0,8,7,3,0,1,87.5
2011020894,20,2400,0.0,34,29,3,1,5,85.29411765
2011020895,26,3900,0.0,29,25,10,0,4,86.20689655
2011020895,27,3882,0.0,29,25,4,0,4,86.20689655
2011020896,15,1644,0.0,14,14,0,2,0,100.0
2011020896,15,1928,0.0,11,7,1,0,4,63.63636364
2011020896,9,3598,0.0,35,33,5,2,2,94.28571429
2011020897,6,3600,0.0,32,30,0,0,2,93.75
2011020897,19,3528,0.0,19,15,0,0,4,78.94736842
2011020898,26,1200,0.0,11,8,0,1,3,72.72727273
2011020898,26,2400,0.0,16,15,0,0,1,93.75
2011020898,21,3600,0.0,33,32,6,1,1,96.96969697
2011020899,28,3600,0.0,30,29,0,3,1,96.66666667
2011020899,10,3521,0.0,25,23,0,0,2,92.0
2011020900,24,3900,0.0,32,30,0,2,2,93.75
2011020900,12,3900,0.0,37,35,6,3,2,94.59459459
2011020901,30,3900,0.0,43,41,5,0,2,95.34883721
2011020901,13,3898,0.0,28,26,5,0,2,92.85714286
2011020902,23,3870,0.0,36,33,5,0,3,91.66666667
2011020902,17,3897,0.0,43,40,3,4,3,93.02325581
2011020903,19,3900,0.0,27,25,1,0,2,92.59259259
2011020903,18,3900,0.0,24,22,0,0,2,91.66666667
2011020904,14,2146,0.0,16,16,1,0,0,100.0
2011020904,14,1368,0.0,18,14,0,0,4,77.77777778
2011020904,52,3600,0.0,25,22,4,1,3,88.0
2011020905,25,3600,0.0,27,26,1,0,1,96.2962963
2011020905,16,3505,0.0,25,22,0,1,3,88.0
2011020906,27,3900,0.0,24,21,3,0,3,87.5
2011020906,20,3900,0.0,29,26,1,0,3,89.65517241
2011020907,4,3442,0.0,30,28,3,2,2,93.33333333
2011020907,22,3600,0.0,35,35,9,0,0,100.0
2011020908,23,3600,0.0,31,30,3,0,1,96.77419355
2011020908,1,3533,0.0,16,14,1,0,2,87.5
2011020909,3,3900,0.0,27,24,6,0,3,88.88888889
2011020909,2,3900,0.0,36,33,4,1,3,91.66666667
2011020910,8,3486,0.0,23,20,6,0,3,86.95652174
2011020910,15,3600,0.0,31,30,2,1,1,96.77419355
2011020911,21,3600,0.0,28,28,6,0,0,100.0
2011020911,29,3580,0.0,25,20,3,0,5,80.0
2011020912,6,3900,0.0,27,26,0,0,1,96.2962963
2011020912,7,3900,0.0,36,35,1,0,1,97.22222222
2011020913,30,1433,0.0,14,11,0,0,3,78.57142857
2011020913,30,2105,0.0,10,10,2,1,0,100.0
2011020913,25,3600,0.0,29,28,8,1,1,96.55172414
2011020914,14,3579,2.0,34,26,3,2,8,76.47058824
2011020914,5,3600,0.0,35,34,7,0,1,97.14285714
2011020915,19,3900,0.0,41,39,3,0,2,95.12195122
2011020915,52,3900,0.0,16,14,1,1,2,87.5
2011020916,27,3600,0.0,22,21,0,1,1,95.45454545
2011020916,22,3506,0.0,20,17,0,0,3,85.0
2011020917,16,1609,0.0,10,6,1,0,4,60.0
2011020917,16,1991,0.0,20,20,0,1,0,100.0
2011020917,26,3593,0.0,19,19,7,0,0,100.0
2011020918,15,3596,0.0,30,28,5,1,2,93.33333333
2011020918,10,3494,0.0,36,32,0,1,4,88.88888889
2011020919,6,3600,0.0,30,27,0,0,3,90.0
2011020919,9,3568,0.0,37,33,5,0,4,89.18918919
2011020920,7,3779,0.0,28,25,1,1,3,89.28571429
2011020920,3,3774,0.0,20,18,2,1,2,90.0
2011020921,13,3900,0.0,28,26,1,2,2,92.85714286
2011020921,12,3900,0.0,44,42,3,0,2,95.45454545
2011020922,21,3587,0.0,31,28,1,0,3,90.32258065
2011020922,17,3518,0.0,27,23,3,0,4,85.18518519
2011020923,28,2636,0.0,13,11,0,0,2,84.61538462
2011020923,28,958,0.0,7,4,2,0,3,57.14285714
2011020923,18,3591,0.0,34,32,3,0,2,94.11764706
2011020924,4,3876,0.0,21,17,2,2,4,80.95238095
2011020924,20,3900,0.0,45,41,7,1,4,91.11111111
2011020925,14,3600,0.0,22,19,4,0,3,86.36363636
2011020925,1,3510,0.0,16,12,1,0,4,75.0
2011020926,29,3507,0.0,40,36,7,0,4,90.0
2011020926,5,3581,0.0,24,22,4,1,2,91.66666667
2011020927,23,3832,0.0,28,25,2,0,3,89.28571429
2011020927,25,3808,0.0,26,24,8,2,2,92.30769231
2011020928,2,3564,0.0,23,19,1,0,4,82.60869565
2011020928,9,3600,0.0,30,28,1,0,2,93.33333333
2011020929,8,3513,0.0,32,28,4,1,4,87.5
2011020929,13,3597,0.0,20,18,4,0,2,90.0
2011020930,28,3520,0.0,26,22,4,2,4,84.61538462
2011020930,30,3600,0.0,28,25,2,0,3,89.28571429
2011020931,16,3513,2.0,38,35,7,1,3,92.10526316
2011020931,24,3600,0.0,19,18,3,0,1,94.73684211
2011020932,1,3577,0.0,14,13,2,0,1,92.85714286
2011020932,3,3600,0.0,13,13,1,0,0,100.0
2011020933,26,3556,0.0,28,26,2,0,2,92.85714286
2011020933,18,3599,0.0,31,30,2,0,1,96.77419355
2011020934,22,3600,0.0,32,29,3,0,3,90.625
2011020934,52,3482,0.0,25,20,2,0,5,80.0
2011020935,24,3591,0.0,23,19,0,0,4,82.60869565
2011020935,21,3600,0.0,28,27,3,0,1,96.42857143
2011020936,19,3600,0.0,21,20,6,0,1,95.23809524
2011020936,20,3483,0.0,24,21,5,1,3,87.5
2011020937,9,3600,0.0,32,32,5,1,0,100.0
2011020937,6,3542,0.0,38,37,5,0,1,97.36842105
2011020938,13,3600,0.0,31,28,2,1,3,90.32258065
2011020938,10,3465,0.0,23,18,7,0,5,78.26086957
2011020939,2,3695,0.0,34,31,4,1,3,91.17647059
2011020939,15,3633,0.0,24,22,3,0,2,91.66666667
2011020940,18,3528,0.0,33,29,11,0,4,87.87878788
2011020940,12,3600,0.0,29,26,3,0,3,89.65517241
2011020941,17,3592,0.0,30,28,5,2,2,93.33333333
2011020941,29,3600,0.0,25,20,5,0,5,80.0
2011020942,8,3541,0.0,22,20,1,0,2,90.90909091
2011020942,14,3597,0.0,24,23,4,1,1,95.83333333
2011020943,26,3600,0.0,26,26,5,0,0,100.0
2011020943,30,3600,0.0,15,11,2,0,4,73.33333333
2011020944,27,3900,0.0,22,21,2,2,1,95.45454545
2011020944,23,3900,0.0,24,23,0,1,1,95.83333333
2011020945,4,3523,0.0,23,22,1,1,1,95.65217391
2011020945,28,3600,0.0,26,26,1,0,0,100.0
2011020946,5,3879,0.0,33,30,5,2,3,90.90909091
2011020946,25,3835,0.0,29,26,5,0,3,89.65517241
2011020947,10,3519,0.0,34,30,2,0,4,88.23529412
2011020947,16,1200,0.0,10,7,1,0,3,70.0
2011020947,16,2390,0.0,24,23,4,0,1,95.83333333
2011020948,19,3600,0.0,24,22,0,2,2,91.66666667
2011020948,22,1654,0.0,19,16,2,0,3,84.21052632
2011020948,22,1946,0.0,12,10,4,0,2,83.33333333
2011020949,7,3598,0.0,43,43,5,7,0,100.0
2011020949,24,3475,0.0,24,22,6,0,2,91.66666667
2011020950,1,3779,0.0,25,21,4,2,4,84.0
2011020950,6,3779,0.0,31,28,4,0,3,90.32258065
2011020951,30,3630,0.0,22,19,2,0,3,86.36363636
2011020951,30,172,0.0,6,5,3,0,1,83.33333333
2011020951,8,3900,0.0,30,26,5,1,4,86.66666667
2011020952,2,3516,0.0,29,24,1,0,5,82.75862069
2011020952,4,3598,0.0,24,21,3,0,3,87.5
2011020953,3,3592,0.0,23,21,5,0,2,91.30434783
2011020953,12,3452,0.0,25,22,2,0,3,88.0
2011020954,13,2675,0.0,24,20,2,0,4,83.33333333
2011020954,13,925,0.0,8,5,3,0,3,62.5
2011020954,52,3600,0.0,33,33,6,0,0,100.0
2011020955,29,3600,0.0,33,33,3,0,0,100.0
2011020955,21,3490,0.0,28,26,2,0,2,92.85714286
2011020956,20,3600,0.0,31,29,6,1,2,93.5483871
2011020956,27,3582,2.0,30,27,3,0,3,90.0
2011020957,19,3569,0.0,23,22,3,0,1,95.65217391
2011020957,23,3598,0.0,29,29,3,0,0,100.0
2011020958,7,3600,0.0,39,39,3,2,0,100.0
2011020958,28,3542,0.0,19,18,2,0,1,94.73684211
2011020959,1,3600,0.0,23,23,2,0,0,100.0
2011020959,15,3600,0.0,20,15,1,2,5,75.0
2011020960,16,3585,0.0,26,25,0,0,1,96.15384615
2011020960,9,3569,0.0,39,37,2,0,2,94.87179487
2011020961,3,3718,0.0,31,27,2,1,4,87.09677419
2011020961,14,3718,0.0,19,16,2,0,3,84.21052632
2011020962,30,2730,0.0,29,23,6,0,6,79.31034483
2011020962,30,870,0.0,6,6,2,1,0,100.0
2011020962,17,3600,0.0,19,19,3,2,0,100.0
2011020963,25,3600,0.0,20,19,0,0,1,95.0
2011020963,22,3570,0.0,14,12,3,0,2,85.71428571
2011020964,20,3574,0.0,38,35,6,0,3,92.10526316
2011020964,24,3597,0.0,29,27,4,0,2,93.10344828
2011020965,2,3600,0.0,34,32,6,0,2,94.11764706
2011020965,6,1741,0.0,12,11,1,0,1,91.66666667
2011020965,6,1780,0.0,13,11,0,0,2,84.61538462
2011020966,10,3600,0.0,22,21,2,1,1,95.45454545
2011020966,8,3575,0.0,42,39,5,0,3,92.85714286
2011020967,14,3747,0.0,28,25,1,0,3,89.28571429
2011020967,12,3761,0.0,23,19,1,2,4,82.60869565
2011020968,18,3600,0.0,40,39,6,0,1,97.5
2011020968,13,3504,0.0,23,20,0,1,3,86.95652174
2011020969,29,3593,0.0,32,30,4,1,2,93.75
2011020969,27,3549,2.0,25,21,4,2,4,84.0
2011020970,5,3600,2.0,36,35,5,2,1,97.22222222
2011020970,21,3523,2.0,27,23,7,3,4,85.18518519
2011020971,7,3600,0.0,35,32,4,0,3,91.42857143
2011020971,23,310,0.0,7,4,0,0,3,57.14285714
2011020971,23,3271,0.0,17,16,0,2,1,94.11764706
2011020972,24,3526,0.0,19,16,3,1,3,84.21052632
2011020972,26,3562,0.0,31,29,7,0,2,93.5483871
2011020973,19,3600,0.0,19,18,1,2,1,94.73684211
2011020973,28,3520,0.0,32,29,5,2,3,90.625
2011020974,1,3519,0.0,25,24,12,0,1,96.0
2011020974,2,3600,0.0,24,24,1,1,0,100.0
2011020975,6,3535,0.0,17,13,0,0,4,76.47058824
2011020975,3,3600,0.0,33,30,6,0,3,90.90909091
2011020976,16,3600,0.0,24,23,5,0,1,95.83333333
2011020976,17,1195,0.0,5,4,1,1,1,80.0
2011020976,17,2340,0.0,13,12,0,2,1,92.30769231
2011020977,9,3578,0.0,28,24,3,0,4,85.71428571
2011020977,13,3600,0.0,25,23,0,0,2,92.0
2011020978,25,3900,0.0,38,36,3,0,2,94.73684211
2011020978,20,3900,0.0,40,38,4,2,2,95.0
2011020979,4,3600,0.0,34,34,0,0,0,100.0
2011020979,15,3548,0.0,23,22,0,0,1,95.65217391
2011020980,21,3600,0.0,30,30,7,0,0,100.0
2011020980,30,3531,0.0,36,34,2,1,2,94.44444444
2011020981,27,3535,2.0,28,26,3,0,2,92.85714286
2011020981,5,3595,0.0,37,36,1,1,1,97.2972973
2011020982,7,3497,0.0,31,28,2,0,3,90.32258065
2011020982,52,3600,0.0,24,23,2,2,1,95.83333333
2011020983,22,3530,0.0,30,26,3,0,4,86.66666667
2011020983,24,3600,0.0,36,34,0,0,2,94.44444444
2011020984,6,3600,0.0,29,25,2,1,4,86.20689655
2011020984,10,3523,0.0,33,28,3,0,5,84.84848485
2011020985,3,3572,0.0,28,25,7,1,3,89.28571429
2011020985,1,3600,0.0,26,25,1,0,1,96.15384615
2011020986,17,3528,0.0,23,20,3,4,3,86.95652174
2011020986,4,3591,0.0,39,37,3,0,2,94.87179487
2011020987,12,3818,0.0,49,46,2,0,3,93.87755102
2011020987,15,3818,0.0,36,32,1,0,4,88.88888889
2011020988,27,234,0.0,7,5,0,0,2,71.42857143
2011020988,27,3279,0.0,25,24,6,3,1,96.0
2011020988,29,3600,0.0,40,38,4,1,2,95.0
2011020989,9,3600,0.0,28,25,2,0,3,89.28571429
2011020989,14,3290,0.0,30,25,1,0,5,83.33333333
2011020989,14,234,0.0,3,3,2,0,0,100.0
2011020990,16,3600,0.0,31,26,4,0,5,83.87096774
2011020990,19,3598,0.0,20,19,3,0,1,95.0
2011020991,26,3600,0.0,26,22,2,0,4,84.61538462
2011020991,18,955,0.0,4,4,0,0,0,100.0
2011020991,18,2577,0.0,24,19,0,0,5,79.16666667
2011020992,30,1468,0.0,18,15,0,0,3,83.33333333
2011020992,30,2132,0.0,21,17,5,0,4,80.95238095
2011020992,21,3591,0.0,22,21,1,1,1,95.45454545
2011020993,8,3511,0.0,34,29,1,1,5,85.29411765
2011020993,20,3590,0.0,28,24,0,0,4,85.71428571
2011020994,25,3600,0.0,31,29,4,1,2,93.5483871
2011020994,23,3499,0.0,28,24,2,0,4,85.71428571
2011020995,22,3900,0.0,30,28,1,1,2,93.33333333
2011020995,28,3900,0.0,26,24,1,0,2,92.30769231
2011020996,12,3656,0.0,42,39,15,1,3,92.85714286
2011020996,7,3656,0.0,24,22,3,1,2,91.66666667
2011020997,10,3548,0.0,33,30,4,0,3,90.90909091
2011020997,5,3600,0.0,24,22,7,1,2,91.66666667
2011020998,7,3407,0.0,28,25,3,0,3,89.28571429
2011020998,6,3600,0.0,20,19,0,0,1,95.0
2011020999,2,3600,0.0,20,15,1,0,5,75.0
2011020999,1,3589,0.0,30,29,4,0,1,96.66666667
2011021000,13,3595,0.0,35,30,5,3,5,85.71428571
2011021000,4,3581,0.0,28,28,3,0,0,100.0
2011021001,14,3849,0.0,32,29,2,0,3,90.625
2011021001,15,3849,0.0,26,24,1,0,2,92.30769231
2011021002,26,3514,0.0,36,33,14,0,3,91.66666667
2011021002,29,1732,0.0,13,13,0,1,0,100.0
2011021002,29,1868,0.0,17,16,0,0,1,94.11764706
2011021003,3,3510,0.0,21,18,1,0,3,85.71428571
2011021003,9,3600,0.0,26,25,6,0,1,96.15384615
2011021004,24,3481,0.0,27,24,5,0,3,88.88888889
2011021004,19,3600,0.0,25,24,4,0,1,96.0
2011021005,21,3540,0.0,30,27,1,0,3,90.0
2011021005,18,3600,0.0,17,15,0,0,2,88.23529412
2011021006,28,3896,0.0,35,32,1,0,3,91.42857143
2011021006,25,3887,0.0,48,45,10,0,3,93.75
2011021007,30,1898,0.0,24,24,5,0,0,100.0
2011021007,30,2002,0.0,17,15,0,0,2,88.23529412
2011021007,27,3900,0.0,24,22,0,0,2,91.66666667
2011021008,8,3538,0.0,27,24,3,0,3,88.88888889
2011021008,22,3546,0.0,30,26,1,2,4,86.66666667
2011021009,52,3530,0.0,45,42,6,0,3,93.33333333
2011021009,23,3600,0.0,32,30,4,0,2,93.75
2011021010,13,3884,0.0,34,33,4,0,1,97.05882353
2011021010,5,3887,0.0,29,28,5,1,1,96.55172414
2011021011,26,3553,0.0,15,11,0,1,4,73.33333333
2011021011,17,3600,0.0,24,21,5,0,3,87.5
2011021012,3,3514,0.0,21,18,1,0,3,85.71428571
2011021012,16,3600,0.0,25,22,6,0,3,88.0
2011021013,52,3487,0.0,27,22,0,0,5,81.48148148
2011021013,20,3600,0.0,45,42,6,1,3,93.33333333
2011021014,15,3592,0.0,33,30,4,0,3,90.90909091
2011021014,6,3520,0.0,30,26,7,0,4,86.66666667
2011021015,22,3900,0.0,32,30,2,0,2,93.75
2011021015,21,3900,0.0,30,28,3,1,2,93.33333333
2011021016,4,3900,0.0,29,29,2,0,0,100.0
2011021016,10,3888,0.0,27,27,0,2,0,100.0
2011021017,7,3900,0.0,36,33,1,1,3,91.66666667
2011021017,9,3900,0.0,41,38,6,0,3,92.68292683
2011021018,1,3600,0.0,24,23,2,0,1,95.83333333
2011021018,2,3502,0.0,35,33,5,2,2,94.28571429
2011021019,12,3600,0.0,38,36,0,0,2,94.73684211
2011021019,14,3522,0.0,25,22,2,0,3,88.0
2011021020,29,3600,0.0,29,25,9,0,4,86.20689655
2011021020,19,3600,0.0,22,21,4,0,1,95.45454545
2011021021,17,3540,0.0,20,17,4,0,3,85.0
2011021021,18,3600,0.0,37,35,6,2,2,94.59459459
2011021022,24,3587,0.0,22,21,3,0,1,95.45454545
2011021022,25,3594,0.0,21,21,3,0,0,100.0
2011021023,28,3589,0.0,29,26,2,0,3,89.65517241
2011021023,27,3600,2.0,42,42,8,0,0,100.0
2011021024,8,3600,2.0,33,32,4,3,1,96.96969697
2011021024,23,3600,0.0,35,31,8,0,4,88.57142857
2011021025,10,3487,0.0,23,21,3,0,2,91.30434783
2011021025,15,3600,0.0,23,23,0,0,0,100.0
2011021026,12,3509,0.0,32,31,2,1,1,96.875
2011021026,13,3600,0.0,34,34,1,2,0,100.0
2011021027,19,3600,0.0,34,33,15,2,1,97.05882353
2011021027,29,3547,0.0,26,24,3,5,2,92.30769231
2011021028,20,3600,0.0,27,24,2,0,3,88.88888889
2011021028,30,3519,0.0,25,21,0,0,4,84.0
2011021029,4,3600,0.0,31,27,6,0,4,87.09677419
2011021029,1,3600,0.0,19,18,2,0,1,94.73684211
2011021030,2,3894,4.0,36,32,8,2,4,88.88888889
2011021030,3,3894,0.0,19,16,1,0,3,84.21052632
2011021031,26,3878,0.0,37,35,3,0,2,94.59459459
2011021031,16,3900,0.0,29,27,3,0,2,93.10344828
2011021032,6,2400,0.0,22,20,3,0,2,90.90909091
2011021032,6,1200,0.0,10,7,3,0,3,70.0
2011021032,5,3588,0.0,36,34,3,0,2,94.44444444
2011021033,8,3640,0.0,36,33,1,1,3,91.66666667
2011021033,7,3721,0.0,28,26,2,0,2,92.85714286
2011021034,24,3712,0.0,33,30,2,0,3,90.90909091
2011021034,21,3712,0.0,40,38,0,0,2,95.0
2011021035,28,3600,0.0,22,20,1,0,2,90.90909091
2011021035,22,3550,0.0,33,30,1,1,3,90.90909091
2011021036,18,3900,0.0,35,31,1,2,4,88.57142857
2011021036,27,3900,2.0,35,31,2,0,4,88.57142857
2011021037,15,3900,0.0,30,26,8,0,4,86.66666667
2011021037,2,3900,0.0,28,24,0,0,4,85.71428571
2011021038,12,3472,0.0,28,24,2,0,4,85.71428571
2011021038,3,3600,0.0,29,27,4,1,2,93.10344828
2011021039,1,3585,0.0,28,26,3,0,2,92.85714286
2011021039,4,3600,0.0,17,17,5,1,0,100.0
2011021040,6,2485,0.0,12,8,2,0,4,66.66666667
2011021040,6,1115,0.0,5,3,2,0,2,60.0
2011021040,14,3600,2.0,34,33,2,0,1,97.05882353
2011021041,10,3578,0.0,26,22,4,0,4,84.61538462
2011021041,13,3600,0.0,28,26,4,0,2,92.85714286
2011021042,25,3600,0.0,25,25,4,0,0,100.0
2011021042,30,3526,0.0,25,24,1,0,1,96.0
2011021043,19,3900,0.0,46,43,11,0,3,93.47826087
2011021043,16,2693,0.0,18,18,1,0,0,100.0
2011021043,16,1195,0.0,6,3,0,0,3,50.0
2011021044,28,3860,0.0,22,19,3,1,3,86.36363636
2011021044,20,3860,0.0,31,29,9,0,2,93.5483871
2011021045,17,3586,0.0,26,22,3,0,4,84.61538462
2011021045,26,3600,0.0,24,22,4,0,2,91.66666667
2011021046,21,3807,0.0,24,20,1,0,4,83.33333333
2011021046,7,3900,0.0,42,38,7,0,4,90.47619048
2011021047,9,3900,0.0,26,24,1,1,2,92.30769231
2011021047,8,3900,0.0,37,35,4,0,2,94.59459459
2011021048,25,3600,0.0,28,23,1,0,5,82.14285714
2011021048,52,3591,0.0,30,28,0,1,2,93.33333333
2011021049,29,3574,0.0,26,24,3,3,2,92.30769231
2011021049,22,3597,0.0,22,22,3,0,0,100.0
2011021050,27,3591,0.0,43,39,5,0,4,90.69767442
2011021050,23,3508,0.0,33,28,1,0,5,84.84848485
2011021051,17,3600,0.0,24,20,1,1,4,83.33333333
2011021051,24,3589,0.0,23,23,6,0,0,100.0
2011021052,21,3900,0.0,33,33,0,0,0,100.0
2011021052,1,3900,0.0,28,28,0,1,0,100.0
2011021053,4,3600,0.0,31,29,1,0,2,93.5483871
2011021053,2,3519,0.0,22,19,0,1,3,86.36363636
2011021054,5,3600,0.0,31,29,0,0,2,93.5483871
2011021054,3,3600,0.0,32,27,7,0,5,84.375
2011021055,19,3531,0.0,30,28,8,0,2,93.33333333
2011021055,12,3600,0.0,40,40,7,3,0,100.0
2011021056,10,3600,0.0,35,34,9,1,1,97.14285714
2011021056,14,1948,0.0,10,7,2,0,3,70.0
2011021056,14,1570,0.0,18,18,6,0,0,100.0
2011021057,6,3595,0.0,29,23,2,0,6,79.31034483
2011021057,13,3600,2.0,26,24,0,0,2,92.30769231
2011021058,27,3600,0.0,19,15,2,1,4,78.94736842
2011021058,20,3561,0.0,28,27,3,0,1,96.42857143
2011021059,18,3900,0.0,35,34,4,0,1,97.14285714
2011021059,28,3895,0.0,33,32,1,1,1,96.96969697
2011021060,8,3777,0.0,33,31,8,1,2,93.93939394
2011021060,9,3742,0.0,14,13,5,2,1,92.85714286
2011021061,15,3514,0.0,28,25,9,0,3,89.28571429
2011021061,52,3600,0.0,22,20,2,1,2,90.90909091
2011021062,16,3600,0.0,22,21,0,0,1,95.45454545
2011021062,25,3599,0.0,31,27,4,0,4,87.09677419
2011021063,20,3542,0.0,25,22,7,1,3,88.0
2011021063,22,3595,0.0,19,18,0,0,1,94.73684211
2011021064,26,3594,0.0,20,18,2,0,2,90.0
2011021064,24,3579,0.0,42,39,2,1,3,92.85714286
2011021065,4,3898,0.0,33,31,1,2,2,93.93939394
2011021065,6,3900,0.0,29,27,5,1,2,93.10344828
2011021066,5,3600,0.0,14,12,2,1,2,85.71428571
2011021066,1,3600,0.0,44,39,5,0,5,88.63636364
2011021067,12,3600,0.0,26,23,1,0,3,88.46153846
2011021067,30,3582,0.0,33,29,0,0,4,87.87878788
2011021068,2,3900,0.0,30,28,9,1,2,93.33333333
2011021068,8,3899,0.0,38,36,1,0,2,94.73684211
2011021069,10,3600,0.0,30,29,3,0,1,96.66666667
2011021069,9,3498,0.0,18,15,1,1,3,83.33333333
2011021070,21,3600,0.0,42,41,11,2,1,97.61904762
2011021070,3,3546,0.0,19,17,2,0,2,89.47368421
2011021071,19,3600,0.0,23,22,2,0,1,95.65217391
2011021071,14,3527,0.0,21,18,5,0,3,85.71428571
2011021072,7,3874,0.0,17,15,0,0,2,88.23529412
2011021072,13,3900,0.0,26,24,2,0,2,92.30769231
2011021073,29,3534,0.0,38,34,2,0,4,89.47368421
2011021073,23,3587,0.0,36,33,8,1,3,91.66666667
2011021074,18,3600,0.0,27,23,1,0,4,85.18518519
2011021074,26,3594,0.0,21,19,3,0,2,90.47619048
2011021075,17,3803,0.0,35,32,3,0,3,91.42857143
2011021075,28,3803,0.0,28,26,2,0,2,92.85714286
2011021076,5,3899,0.0,27,24,4,0,3,88.88888889
2011021076,4,3899,0.0,40,38,6,1,2,95.0
2011021077,15,3578,0.0,28,24,0,0,4,85.71428571
2011021077,16,3600,0.0,18,16,0,0,2,88.88888889
2011021078,29,870,0.0,2,2,0,0,0,100.0
2011021078,29,3023,0.0,29,28,3,1,1,96.55172414
2011021078,20,3894,0.0,18,17,2,1,1,94.44444444
2011021079,27,3874,0.0,38,36,1,0,2,94.73684211
2011021079,22,3900,0.0,42,40,3,0,2,95.23809524
2011021080,18,3600,0.0,31,30,2,3,1,96.77419355
2011021080,24,3540,0.0,26,24,1,0,2,92.30769231
2011021081,12,3586,0.0,33,30,4,2,3,90.90909091
2011021081,52,3538,0.0,35,31,6,2,4,88.57142857
2011021082,10,762,0.0,9,5,0,0,4,55.55555556
2011021082,10,2835,0.0,15,11,0,0,4,73.33333333
2011021082,6,3600,0.0,13,13,2,0,0,100.0
2011021083,1,3544,0.0,27,23,3,1,4,85.18518519
2011021083,3,3595,0.0,22,20,3,1,2,90.90909091
2011021084,7,3563,0.0,27,24,4,1,3,88.88888889
2011021084,14,1696,0.0,15,11,0,0,4,73.33333333
2011021084,14,1904,0.0,23,20,12,0,3,86.95652174
2011021085,15,3600,0.0,33,30,1,2,3,90.90909091
2011021085,17,3558,0.0,21,17,4,1,4,80.95238095
2011021086,23,3510,0.0,33,32,3,0,1,96.96969697
2011021086,30,3584,0.0,33,33,4,0,0,100.0
2011021087,24,3600,0.0,30,27,5,0,3,90.0
2011021087,28,1823,0.0,26,22,5,0,4,84.61538462
2011021087,28,1635,0.0,14,13,0,0,1,92.85714286
2011021088,2,3600,0.0,14,12,0,0,2,85.71428571
2011021088,10,3574,0.0,33,29,2,1,4,87.87878788
2011021089,13,3600,0.0,36,35,4,0,1,97.22222222
2011021089,4,3521,0.0,13,11,2,1,2,84.61538462
2011021090,52,1970,0.0,24,19,7,0,5,79.16666667
2011021090,52,1630,0.0,11,8,0,0,3,72.72727273
2011021090,5,3575,0.0,30,26,2,0,4,86.66666667
2011021091,16,3600,0.0,25,24,1,0,1,96.0
2011021091,29,3600,0.0,27,22,1,0,5,81.48148148
2011021092,1,3600,0.0,34,34,4,3,0,100.0
2011021092,9,3536,2.0,34,33,7,3,1,97.05882353
2011021093,22,3600,0.0,44,41,6,1,3,93.18181818
2011021093,18,2353,0.0,12,10,2,1,2,83.33333333
2011021093,18,1228,0.0,7,4,0,0,3,57.14285714
2011021094,27,3900,0.0,33,30,3,0,3,90.90909091
2011021094,25,3900,0.0,30,27,5,0,3,90.0
2011021095,20,3831,0.0,33,31,0,0,2,93.93939394
2011021095,21,3831,0.0,32,31,4,0,1,96.875
2011021096,28,3477,0.0,41,37,5,0,4,90.24390244
2011021096,26,3600,0.0,22,20,0,1,2,90.90909091
2011021097,8,3488,0.0,31,28,3,1,3,90.32258065
2011021097,7,3600,0.0,34,34,2,0,0,100.0
2011021098,13,3525,0.0,39,36,6,3,3,92.30769231
2011021098,12,3600,0.0,31,30,4,1,1,96.77419355
2011021099,17,3762,0.0,34,32,5,0,2,94.11764706
2011021099,3,3762,0.0,27,26,3,1,1,96.2962963
2011021100,23,3762,0.0,37,35,5,2,2,94.59459459
2011021100,16,3762,0.0,24,23,2,1,1,95.83333333
2011021101,19,3554,0.0,22,18,5,0,4,81.81818182
2011021101,24,3600,0.0,38,35,5,3,3,92.10526316
2011021102,15,3900,0.0,28,27,0,1,1,96.42857143
2011021102,4,3900,0.0,31,30,6,1,1,96.77419355
2011021103,18,3600,0.0,23,18,0,0,5,78.26086957
2011021103,5,3597,0.0,30,29,0,0,1,96.66666667
2011021104,22,3900,0.0,21,19,5,1,2,90.47619048
2011021104,14,3900,0.0,36,34,0,0,2,94.44444444
2011021105,20,3895,0.0,30,28,7,0,2,93.33333333
2011021105,30,3889,0.0,29,27,6,1,2,93.10344828
2011021106,23,3600,0.0,26,25,0,1,1,96.15384615
2011021106,25,3527,0.0,28,26,6,1,2,92.85714286
2011021107,21,3523,0.0,25,22,6,2,3,88.0
2011021107,27,3600,0.0,41,39,4,1,2,95.12195122
2011021108,19,3900,0.0,37,37,2,0,0,100.0
2011021108,26,3895,0.0,35,35,6,1,0,100.0
2011021109,6,3538,0.0,27,25,1,0,2,92.59259259
2011021109,28,3593,0.0,17,16,1,0,1,94.11764706
2011021110,10,3900,0.0,46,43,5,0,3,93.47826087
2011021110,1,3900,0.0,17,14,0,0,3,82.35294118
2011021111,7,3588,0.0,27,26,5,1,1,96.2962963
2011021111,3,3600,0.0,26,22,0,0,4,84.61538462
2011021112,52,3757,0.0,23,20,2,0,3,86.95652174
2011021112,15,3743,0.0,42,38,7,2,4,90.47619048
2011021113,12,3600,0.0,26,21,3,0,5,80.76923077
2011021113,29,3600,0.0,40,39,6,1,1,97.5
2011021114,9,2696,0.0,23,20,4,0,3,86.95652174
2011021114,9,904,0.0,9,7,3,0,2,77.77777778
2011021114,8,3600,0.0,38,37,2,1,1,97.36842105
2011021115,22,3900,0.0,27,26,4,0,1,96.2962963
2011021115,13,3900,0.0,21,20,2,0,1,95.23809524
2011021116,20,3559,0.0,19,16,2,0,3,84.21052632
2011021116,25,3600,0.0,36,35,7,0,1,97.22222222
2011021117,6,3600,0.0,42,40,6,0,2,95.23809524
2011021117,26,3538,0.0,25,22,5,1,3,88.0
2011021118,30,3581,0.0,36,34,5,1,2,94.44444444
2011021118,7,3600,0.0,25,24,2,1,1,96.0
2011021119,3,3900,0.0,25,22,3,1,3,88.0
2011021119,10,3869,0.0,33,30,4,0,3,90.90909091
2011021120,5,3600,0.0,28,20,3,0,8,71.42857143
2011021120,9,1837,0.0,20,19,3,1,1,95.0
2011021120,9,1763,0.0,20,17,2,0,3,85.0
2011021121,8,3597,0.0,33,29,3,4,4,87.87878788
2011021121,4,3572,2.0,24,23,3,1,1,95.83333333
2011021122,2,3515,0.0,26,22,3,1,4,84.61538462
2011021122,14,3598,0.0,37,34,6,3,3,91.89189189
2011021123,12,3546,0.0,50,45,5,0,5,90.0
2011021123,17,3600,0.0,24,20,0,0,4,83.33333333
2011021124,52,3579,0.0,27,25,2,0,2,92.59259259
2011021124,18,3592,0.0,25,24,2,0,1,96.0
2011021125,23,3700,0.0,40,38,11,0,2,95.0
2011021125,21,3698,0.0,32,29,3,1,3,90.625
2011021126,27,3900,0.0,32,29,0,0,3,90.625
2011021126,28,3897,0.0,27,24,0,0,3,88.88888889
2011021127,22,3600,0.0,32,29,8,0,3,90.625
2011021127,29,1180,0.0,11,11,1,0,0,100.0
2011021127,29,2381,0.0,26,21,2,0,5,80.76923077
2011021128,30,3600,0.0,23,20,2,1,3,86.95652174
2011021128,15,3583,0.0,28,28,4,0,0,100.0
2011021129,2,3900,0.0,35,33,4,0,2,94.28571429
2011021129,13,3900,0.0,37,35,4,0,2,94.59459459
2011021130,1,3528,2.0,27,23,4,1,4,85.18518519
2011021130,5,3600,0.0,34,32,1,0,2,94.11764706
2011021131,18,3597,0.0,25,24,0,1,1,96.0
2011021131,16,2507,0.0,15,11,2,0,4,73.33333333
2011021131,16,1073,0.0,9,7,0,0,2,77.77777778
2011021132,6,3600,0.0,27,25,5,0,2,92.59259259
2011021132,24,3535,0.0,25,22,2,0,3,88.0
2011021133,19,3600,0.0,20,20,2,2,0,100.0
2011021133,27,3600,0.0,29,25,1,0,4,86.20689655
2011021134,14,3600,0.0,38,35,6,0,3,92.10526316
2011021134,4,3455,0.0,14,10,0,1,4,71.42857143
2011021135,29,1886,0.0,11,10,2,0,1,90.90909091
2011021135,29,1714,0.0,28,22,4,0,6,78.57142857
2011021135,17,3589,0.0,26,24,4,0,2,92.30769231
2011021136,9,3600,0.0,48,44,4,2,4,91.66666667
2011021136,52,3524,0.0,34,29,1,2,5,85.29411765
2011021137,25,3545,0.0,35,30,8,0,5,85.71428571
2011021137,20,3592,0.0,39,35,5,3,4,89.74358974
2011021138,26,3544,0.0,25,24,3,0,1,96.0
2011021138,23,3600,0.0,38,38,9,0,0,100.0
2011021139,21,3562,0.0,35,31,5,1,4,88.57142857
2011021139,28,3600,0.0,32,31,1,0,1,96.875
2011021140,14,3571,0.0,37,33,8,3,4,89.18918919
2011021140,6,3596,0.0,18,16,2,2,2,88.88888889
2011021141,12,3600,0.0,30,30,1,0,0,100.0
2011021141,10,2363,0.0,10,10,1,0,0,100.0
2011021141,10,1237,0.0,12,9,1,2,3,75.0
2011021142,16,3895,0.0,22,21,3,0,1,95.45454545
2011021142,1,3900,0.0,38,37,0,2,1,97.36842105
2011021143,2,1200,0.0,22,21,4,1,1,95.45454545
2011021143,2,2400,0.0,32,30,7,0,2,93.75
2011021143,5,2400,0.0,18,13,1,0,5,72.22222222
2011021143,5,1108,2.0,7,7,2,0,0,100.0
2011021144,7,3600,0.0,45,44,12,0,1,97.77777778
2011021144,15,2249,0.0,13,11,4,0,2,84.61538462
2011021144,15,1351,0.0,18,15,0,0,3,83.33333333
2011021145,13,3900,0.0,29,27,3,0,2,93.10344828
2011021145,8,3870,0.0,36,34,4,0,2,94.44444444
2011021146,18,3518,0.0,24,21,2,0,3,87.5
2011021146,19,3588,0.0,24,24,0,0,0,100.0
2011021147,3,3600,0.0,26,24,4,1,2,92.30769231
2011021147,30,3518,0.0,32,29,6,0,3,90.625
2011021148,3,3600,0.0,24,22,7,0,2,91.66666667
2011021148,52,3502,0.0,28,24,5,1,4,85.71428571
2011021149,17,3478,0.0,31,27,3,1,4,87.09677419
2011021149,29,3600,0.0,31,29,3,1,2,93.5483871
2011021150,26,3600,0.0,19,19,6,0,0,100.0
2011021150,20,3514,0.0,29,27,3,0,2,93.10344828
2011021151,25,3586,0.0,32,31,4,3,1,96.875
2011021151,22,3521,0.0,25,22,4,0,3,88.0
2011021152,21,3485,0.0,22,21,3,0,1,95.45454545
2011021152,23,3600,0.0,43,43,8,0,0,100.0
2011021153,28,3553,0.0,27,25,0,0,2,92.59259259
2011021153,24,3600,0.0,29,28,3,0,1,96.55172414
2011021154,15,2795,0.0,21,19,0,0,2,90.47619048
2011021154,15,1105,0.0,7,7,4,0,0,100.0
2011021154,6,3900,0.0,23,21,0,0,2,91.30434783
2011021155,4,3593,0.0,17,16,1,1,1,94.11764706
2011021155,10,3571,0.0,30,23,4,1,7,76.66666667
2011021156,14,2765,0.0,34,28,3,0,6,82.35294118
2011021156,14,835,0.0,4,4,1,0,0,100.0
2011021156,1,3595,0.0,20,16,2,2,4,80.0
2011021157,5,3507,0.0,23,19,1,3,4,82.60869565
2011021157,2,3600,0.0,29,26,9,2,3,89.65517241
2011021158,13,3615,0.0,25,22,2,2,3,88.0
2011021158,30,3572,0.0,27,25,7,0,2,92.59259259
2011021159,19,3900,0.0,40,37,1,0,3,92.5
2011021159,16,3900,0.0,20,17,2,0,3,85.0
2011021160,28,3473,0.0,33,31,2,0,2,93.93939394
2011021160,27,3600,0.0,38,38,1,1,0,100.0
2011021161,8,3600,0.0,29,25,3,1,4,86.20689655
2011021161,3,3600,0.0,20,19,3,1,1,95.0
2011021162,52,3616,0.0,33,30,10,0,3,90.90909091
2011021162,12,3596,0.0,35,31,5,1,4,88.57142857
2011021163,13,3552,0.0,28,25,6,0,3,89.28571429
2011021163,29,3600,0.0,31,30,9,0,1,96.77419355
2011021164,5,3597,0.0,28,25,2,1,3,89.28571429
2011021164,7,3554,0.0,33,29,2,1,4,87.87878788
2011021165,18,3600,0.0,32,31,12,0,1,96.875
2011021165,17,3560,0.0,26,23,2,1,3,88.46153846
2011021166,21,3594,2.0,39,38,8,0,1,97.43589744
2011021166,20,3491,0.0,23,20,0,2,3,86.95652174
2011021167,26,3596,0.0,14,13,0,0,1,92.85714286
2011021167,22,3600,0.0,32,28,3,0,4,87.5
2011021168,25,601,0.0,4,3,0,0,1,75.0
2011021168,25,2999,0.0,30,26,6,0,4,86.66666667
2011021168,23,3571,0.0,30,28,1,3,2,93.33333333
2011021169,6,3600,2.0,22,19,2,0,3,86.36363636
2011021169,2,3600,0.0,27,21,1,2,6,77.77777778
2011021170,9,3900,0.0,39,36,9,1,3,92.30769231
2011021170,4,3900,0.0,29,26,4,1,3,89.65517241
2011021171,7,3539,0.0,29,25,2,0,4,86.20689655
2011021171,10,3600,0.0,32,29,8,0,3,90.625
2011021172,8,3900,2.0,33,31,6,1,2,93.93939394
2011021172,15,3892,0.0,41,39,11,1,2,95.12195122
2011021173,1,3597,0.0,22,22,6,0,0,100.0
2011021173,12,3593,0.0,31,26,8,3,5,83.87096774
2011021174,52,3645,0.0,39,36,7,0,3,92.30769231
2011021174,14,3645,0.0,28,26,2,1,2,92.85714286
2011021175,29,3600,0.0,36,34,6,5,2,94.44444444
2011021175,19,3570,0.0,32,28,16,0,4,87.5
2011021176,16,3598,0.0,33,29,3,0,4,87.87878788
2011021176,18,3564,0.0,37,32,6,1,5,86.48648649
2011021177,26,3900,0.0,23,20,4,0,3,86.95652174
2011021177,30,3900,0.0,29,26,3,2,3,89.65517241
2011021178,24,3600,0.0,29,25,2,0,4,86.20689655
2011021178,27,3600,2.0,44,44,14,1,0,100.0
2011021179,20,3838,0.0,34,31,3,2,3,91.17647059
2011021179,23,3838,0.0,33,31,1,0,2,93.93939394
2011021180,25,3596,0.0,34,31,7,0,3,91.17647059
2011021180,28,3600,0.0,22,22,1,2,0,100.0
2011021181,9,3600,0.0,30,29,5,2,1,96.66666667
2011021181,2,3600,0.0,32,27,3,1,5,84.375
2011021182,6,3600,0.0,34,33,2,0,1,97.05882353
2011021182,3,3517,0.0,21,19,1,0,2,90.47619048
2011021183,13,3900,0.0,32,31,3,2,1,96.875
2011021183,17,3900,0.0,28,27,3,0,1,96.42857143
2011021184,30,3900,0.0,35,31,4,0,4,88.57142857
2011021184,16,3900,0.0,30,26,4,0,4,86.66666667
2011021185,4,3600,0.0,47,43,8,0,4,91.4893617
2011021185,5,3580,0.0,25,20,5,1,5,80.0
2011021186,22,3600,0.0,33,32,7,0,1,96.96969697
2011021186,24,3568,0.0,15,13,0,0,2,86.66666667
2011021187,15,3559,0.0,26,23,5,1,3,88.46153846
2011021187,14,3593,0.0,33,31,4,1,2,93.93939394
2011021188,22,3547,0.0,37,35,3,0,2,94.59459459
2011021188,26,3600,0.0,19,19,0,1,0,100.0
2011021189,5,3600,0.0,29,26,1,0,3,89.65517241
2011021189,6,3552,0.0,27,22,2,0,5,81.48148148
2011021190,10,3809,2.0,45,39,6,1,6,86.66666667
2011021190,7,3792,0.0,25,20,1,0,5,80.0
2011021191,2,3525,0.0,19,17,0,0,2,89.47368421
2011021191,1,3600,0.0,20,19,0,3,1,95.0
2011021192,3,3600,0.0,40,37,11,1,3,92.5
2011021192,4,3457,0.0,24,19,4,0,5,79.16666667
2011021193,12,3600,0.0,39,38,3,3,1,97.43589744
2011021193,9,3551,0.0,31,29,1,2,2,93.5483871
2011021194,52,3792,0.0,38,34,4,0,4,89.47368421
2011021194,13,3792,0.0,30,25,1,0,5,83.33333333
2011021195,30,3900,0.0,24,23,1,0,1,95.83333333
2011021195,18,3900,0.0,26,25,7,0,1,96.15384615
2011021196,28,3600,0.0,31,29,3,0,2,93.5483871
2011021196,25,3545,0.0,25,21,7,0,4,84.0
2011021197,24,3900,0.0,39,35,6,0,4,89.74358974
2011021197,23,1623,0.0,15,11,1,0,4,73.33333333
2011021197,23,2276,0.0,9,9,3,1,0,100.0
2011021198,29,3534,0.0,22,20,0,2,2,90.90909091
2011021198,27,3600,0.0,54,54,18,0,0,100.0
2011021199,14,3600,0.0,25,20,1,1,5,80.0
2011021199,8,3597,0.0,16,14,4,0,2,87.5
2011021200,17,3900,0.0,29,27,1,0,2,93.10344828
2011021200,19,3900,0.0,28,26,2,0,2,92.85714286
2011021201,14,3841,0.0,31,28,3,0,3,90.32258065
2011021201,10,3841,0.0,37,35,0,1,2,94.59459459
2011021202,52,3570,0.0,28,23,5,1,5,82.14285714
2011021202,2,3599,0.0,25,21,3,1,4,84.0
2011021203,7,3544,0.0,35,33,1,1,2,94.28571429
2011021203,4,3600,0.0,26,25,0,0,1,96.15384615
2011021204,3,3534,0.0,31,27,1,3,4,87.09677419
2011021204,5,3600,0.0,37,35,8,1,2,94.59459459
2011021205,13,3456,0.0,23,19,3,0,4,82.60869565
2011021205,13,91,0.0,1,1,0,0,0,100.0
2011021205,15,2061,0.0,14,12,0,0,2,85.71428571
2011021205,15,1539,0.0,13,13,0,0,0,100.0
2011021206,8,3896,0.0,29,28,6,4,1,96.55172414
2011021206,12,3900,0.0,31,30,6,1,1,96.77419355
2011021207,6,3600,0.0,45,44,9,2,1,97.77777778
2011021207,9,3456,0.0,27,24,4,2,3,88.88888889
2011021208,1,3600,0.0,24,23,2,0,1,95.83333333
2011021208,17,3536,0.0,21,19,3,0,2,90.47619048
2011021209,25,3490,0.0,31,29,2,0,2,93.5483871
2011021209,18,3600,0.0,28,28,3,2,0,100.0
2011021210,16,3858,0.0,23,22,5,1,1,95.65217391
2011021210,30,3888,0.0,23,22,6,0,1,95.65217391
2011021211,29,3600,0.0,37,35,3,0,2,94.59459459
2011021211,21,3435,0.0,27,23,4,0,4,85.18518519
2011021212,23,3521,0.0,28,25,5,0,3,89.28571429
2011021212,20,3600,0.0,34,32,8,1,2,94.11764706
2011021213,24,3672,0.0,26,24,2,0,2,92.30769231
2011021213,22,3672,0.0,17,14,0,0,3,82.35294118
2011021214,28,3900,0.0,36,31,7,1,5,86.11111111
2011021214,26,3900,2.0,31,26,11,1,5,83.87096774
2011021215,27,3600,0.0,32,31,11,1,1,96.875
2011021215,19,3600,0.0,32,28,5,0,4,87.5
2011021216,7,3900,0.0,40,37,5,2,3,92.5
2011021216,6,3900,0.0,28,25,0,1,3,89.28571429
2011021217,9,3584,0.0,34,31,1,1,3,91.17647059
2011021217,1,3595,0.0,33,31,4,0,2,93.93939394
2011021218,15,3600,0.0,36,35,6,3,1,97.22222222
2011021218,3,3598,0.0,17,13,0,0,4,76.47058824
2011021219,4,3600,0.0,23,19,3,0,4,82.60869565
2011021219,5,1680,0.0,6,5,2,0,1,83.33333333
2011021219,5,1920,0.0,15,14,1,3,1,93.33333333
2011021220,16,3878,0.0,32,30,1,3,2,93.75
2011021220,17,3881,0.0,33,31,6,0,2,93.93939394
2011021221,24,3600,0.0,23,18,3,1,5,78.26086957
2011021221,20,3600,0.0,25,23,4,0,2,92.0
2011021222,10,3529,0.0,26,23,5,0,3,88.46153846
2011021222,8,3600,0.0,31,30,4,1,1,96.77419355
2011021223,14,3668,0.0,31,28,5,0,3,90.32258065
2011021223,52,3628,0.0,25,21,1,0,4,84.0
2011021224,2,3600,0.0,37,30,3,3,7,81.08108108
2011021224,29,153,0.0,0,0,0,0,0,
2011021224,29,3438,0.0,38,35,4,0,3,92.10526316
2011021225,12,3590,0.0,25,22,3,2,3,88.0
2011021225,13,3579,0.0,35,34,0,0,1,97.14285714
2011021226,27,3600,0.0,24,23,4,0,1,95.83333333
2011021226,30,3600,0.0,28,24,8,0,4,85.71428571
2011021227,19,3597,0.0,35,33,1,3,2,94.28571429
2011021227,25,3545,0.0,35,32,4,0,3,91.42857143
2011021228,18,2525,0.0,35,34,4,2,1,97.14285714
2011021228,18,1066,0.0,10,10,0,0,0,100.0
2011021228,21,3600,0.0,29,23,0,0,6,79.31034483
2011021229,22,3600,0.0,42,39,8,0,3,92.85714286
2011021229,23,3600,0.0,17,17,0,2,0,100.0
2011021230,26,3838,0.0,23,20,0,0,3,86.95652174
2011021230,28,2385,0.0,25,23,2,0,2,92.0
2011021230,28,1438,0.0,6,6,0,0,0,100.0
2011030111,9,3526,0.0,31,27,6,1,4,87.09677419
2011030111,3,3597,0.0,32,30,3,0,2,93.75
2011030112,9,3666,0.0,29,27,10,2,2,93.10344828
2011030112,3,3677,0.0,32,29,6,4,3,90.625
2011030113,3,3600,0.0,39,39,4,0,0,100.0
2011030113,9,3525,0.0,23,22,4,3,1,95.65217391
2011030114,3,3762,0.0,31,28,6,1,3,90.32258065
2011030114,9,3762,0.0,33,31,10,0,2,93.93939394
2011030115,9,3598,0.0,41,41,7,4,0,100.0
2011030115,3,3539,0.0,29,28,3,3,1,96.55172414
2011030116,3,3600,0.0,27,25,6,2,2,92.59259259
2011030116,9,3485,0.0,22,19,5,0,3,86.36363636
2011030117,9,3570,0.0,29,27,1,0,2,93.10344828
2011030117,3,3588,0.0,27,26,3,2,1,96.2962963
2011030121,15,3678,2.0,30,29,9,1,1,96.66666667
2011030121,6,3678,0.0,17,17,2,0,0,100.0
2011030122,15,4976,0.0,44,43,3,1,1,97.72727273
2011030122,6,4976,0.0,39,37,7,1,2,94.87179487
2011030123,6,3600,0.0,32,29,4,0,3,90.625
2011030123,15,3539,0.0,29,25,4,0,4,86.20689655
2011030124,6,3528,0.0,21,19,5,0,2,90.47619048
2011030124,15,3592,0.0,45,44,0,1,1,97.77777778
2011030125,15,3600,0.0,37,34,3,0,3,91.89189189
2011030125,6,3538,0.0,32,28,2,0,4,87.5
2011030126,6,3790,0.0,39,36,7,1,3,92.30769231
2011030126,15,3793,0.0,31,27,4,0,4,87.09677419
2011030127,15,3777,0.0,32,31,4,0,1,96.875
2011030127,6,3773,0.0,27,25,1,2,2,92.59259259
2011030131,1,3579,0.0,26,24,4,2,2,92.30769231
2011030131,13,3533,0.0,38,35,16,0,3,92.10526316
2011030132,1,3524,0.0,23,20,6,0,3,86.95652174
2011030132,13,3588,0.0,25,23,1,0,2,92.0
2011030133,13,376,0.0,6,3,1,0,3,50.0
2011030133,13,3224,0.0,19,19,5,0,0,100.0
2011030133,1,1338,0.0,12,9,2,0,3,75.0
2011030133,1,2180,0.0,14,13,3,0,1,92.85714286
2011030134,13,3600,0.0,27,23,4,2,4,85.18518519
2011030134,1,3600,0.0,26,26,7,1,0,100.0
2011030135,1,3501,0.0,32,30,5,2,2,93.75
2011030135,13,3596,0.0,30,30,6,1,0,100.0
2011030136,13,3939,0.0,42,39,5,0,3,92.85714286
2011030136,1,3939,0.0,16,14,0,1,2,87.5
2011030137,1,5023,0.0,45,43,5,1,2,95.55555556
2011030137,13,5011,0.0,36,33,7,0,3,91.66666667
2011030141,4,3743,0.0,28,25,5,0,3,89.28571429
2011030141,5,3743,0.0,26,22,0,1,4,84.61538462
2011030142,4,3600,0.0,28,23,6,0,5,82.14285714
2011030142,5,3513,0.0,30,23,3,2,7,76.66666667
2011030143,5,1200,0.0,6,4,0,0,2,66.66666667
2011030143,5,2400,0.0,28,22,9,1,6,78.57142857
2011030143,4,3600,0.0,35,31,10,0,4,88.57142857
2011030144,5,3596,0.0,25,22,5,2,3,88.0
2011030144,4,1387,0.0,18,13,4,1,5,72.22222222
2011030144,4,2213,0.0,18,13,5,0,5,72.22222222
2011030145,4,3513,0.0,23,20,1,0,3,86.95652174
2011030145,5,3583,0.0,26,24,8,2,2,92.30769231
2011030146,5,3393,0.0,22,18,3,2,4,81.81818182
2011030146,4,3600,0.0,31,30,10,0,1,96.77419355
2011030151,26,3596,0.0,26,24,4,1,2,92.30769231
2011030151,23,3549,0.0,38,35,10,2,3,92.10526316
2011030152,26,3594,0.0,48,46,10,2,2,95.83333333
2011030152,23,3476,0.0,26,22,5,1,4,84.61538462
2011030153,23,3507,0.0,20,19,5,1,1,95.0
2011030153,26,3596,0.0,41,41,3,4,0,100.0
2011030154,23,3600,0.0,44,43,10,1,1,97.72727273
2011030154,26,3477,0.0,30,27,7,0,3,90.0
2011030155,26,3867,0.0,27,26,3,1,1,96.2962963
2011030155,23,3863,0.0,37,35,3,0,2,94.59459459
2011030161,28,5014,0.0,42,40,5,1,2,95.23809524
2011030161,19,5014,0.0,34,31,5,0,3,91.17647059
2011030162,28,3586,0.0,32,29,9,0,3,90.625
2011030162,19,1249,0.0,12,12,1,0,0,100.0
2011030162,19,2333,0.0,17,17,4,1,0,100.0
2011030163,19,3600,0.0,29,26,5,1,3,89.65517241
2011030163,28,3539,0.0,27,23,2,2,4,85.18518519
2011030164,19,3600,0.0,25,24,7,0,1,96.0
2011030164,28,3430,0.0,24,22,5,0,2,91.66666667
2011030165,28,3514,0.0,26,24,4,0,2,92.30769231
2011030165,19,3585,0.0,27,26,5,0,1,96.2962963
2011030171,16,4106,0.0,34,31,3,0,3,91.17647059
2011030171,27,4169,0.0,45,43,7,0,2,95.55555556
2011030172,16,4168,0.0,33,30,7,0,3,90.90909091
2011030172,27,4236,0.0,50,46,8,0,4,92.0
2011030173,27,4395,0.0,37,35,2,0,2,94.59459459
2011030173,16,4395,0.0,34,31,6,0,3,91.17647059
2011030174,27,3735,0.0,32,30,4,1,2,93.75
2011030174,16,3720,0.0,19,16,1,0,3,84.21052632
2011030175,16,3760,0.0,19,18,5,0,1,94.73684211
2011030175,27,3752,0.0,38,36,10,1,2,94.73684211
2011030176,27,3600,0.0,39,39,3,3,0,100.0
2011030176,16,3583,0.0,20,16,6,1,4,80.0
2011030181,17,3524,0.0,26,23,7,2,3,88.46153846
2011030181,18,3594,0.0,37,35,14,1,2,94.59459459
2011030182,17,3600,0.0,26,24,7,0,2,92.30769231
2011030182,18,3557,0.0,17,14,1,0,3,82.35294118
2011030183,18,3600,0.0,43,41,8,0,2,95.34883721
2011030183,17,3514,0.0,22,19,6,0,3,86.36363636
2011030184,18,3600,0.0,41,40,5,0,1,97.56097561
2011030184,17,3558,0.0,17,14,2,2,3,82.35294118
2011030185,17,3527,0.0,25,23,2,0,2,92.0
2011030185,18,3597,0.0,22,21,1,0,1,95.45454545
2011030211,15,3453,0.0,14,11,2,0,3,78.57142857
2011030211,3,3600,0.0,18,17,6,0,1,94.44444444
2011030212,15,3599,0.0,28,26,2,0,2,92.85714286
2011030212,3,3534,0.0,25,22,6,0,3,88.0
2011030213,3,6881,0.0,46,45,3,0,1,97.82608696
2011030213,15,6877,0.0,49,47,3,1,2,95.91836735
2011030214,3,3508,0.0,26,23,6,0,3,88.46153846
2011030214,15,3600,0.0,20,18,2,0,2,90.0
2011030215,15,3690,0.0,38,35,3,0,3,92.10526316
2011030215,3,3616,0.0,18,16,5,1,2,88.88888889
2011030216,3,3462,0.0,23,21,1,3,2,91.30434783
2011030216,15,3600,0.0,31,30,6,1,1,96.77419355
2011030217,15,3542,0.0,31,29,2,1,2,93.5483871
2011030217,3,3599,0.0,23,22,0,2,1,95.65217391
2011030221,1,3876,0.0,36,32,7,0,4,88.88888889
2011030221,4,3876,0.0,26,23,4,5,3,88.46153846
2011030222,1,3599,0.0,20,19,1,3,1,95.0
2011030222,4,3559,0.0,34,31,6,0,3,91.17647059
2011030223,4,4623,0.0,31,27,1,1,4,87.09677419
2011030223,1,4641,0.0,28,25,4,0,3,89.28571429
2011030224,4,3555,0.0,42,39,6,0,3,92.85714286
2011030224,1,3600,0.0,22,20,1,1,2,90.90909091
2011030225,1,3600,0.0,28,27,0,3,1,96.42857143
2011030225,4,3452,0.0,30,27,2,1,3,90.0
2011030231,26,3583,0.0,29,28,4,1,1,96.55172414
2011030231,19,3550,0.0,28,26,8,1,2,92.85714286
2011030232,26,3600,0.0,29,27,15,1,2,93.10344828
2011030232,19,3533,0.0,21,16,6,0,5,76.19047619
2011030232,19,67,0.0,0,0,0,0,0,
2011030233,19,3503,2.0,22,18,7,0,4,81.81818182
2011030233,26,3600,0.0,20,18,0,0,2,90.0
2011030234,19,3579,0.0,18,16,5,0,2,88.88888889
2011030234,26,3597,0.0,24,23,3,0,1,95.83333333
2011030241,18,4444,2.0,24,20,0,0,4,83.33333333
2011030241,27,4444,0.0,42,39,6,1,3,92.85714286
2011030242,18,3460,0.0,39,34,0,0,5,87.17948718
2011030242,27,3600,0.0,33,30,1,1,3,90.90909091
2011030243,27,3471,0.0,26,24,8,1,2,92.30769231
2011030243,18,3600,0.0,32,32,5,4,0,100.0
2011030244,27,3600,0.0,25,25,2,0,0,100.0
2011030244,18,3541,0.0,24,23,2,1,1,95.83333333
2011030245,18,3561,0.0,17,15,0,1,2,88.23529412
2011030245,27,3600,0.0,33,32,6,0,1,96.96969697
2011030311,1,3521,0.0,27,25,5,4,2,92.59259259
2011030311,3,3600,0.0,21,21,2,5,0,100.0
2011030312,1,3600,0.0,25,23,5,0,2,92.0
2011030312,3,3531,0.0,27,24,4,1,3,88.88888889
2011030313,3,3600,0.0,36,36,6,0,0,100.0
2011030313,1,3577,0.0,21,19,1,4,2,90.47619048
2011030314,3,3538,0.0,29,26,9,0,3,89.65517241
2011030314,1,3599,0.0,29,28,4,1,1,96.55172414
2011030315,1,3600,0.0,28,25,2,2,3,89.28571429
2011030315,3,3554,0.0,16,12,1,0,4,75.0
2011030316,3,3663,0.0,29,26,7,0,3,89.65517241
2011030316,1,3663,0.0,35,33,3,2,2,94.28571429
2011030321,26,3600,0.0,27,25,4,0,2,92.59259259
2011030321,27,3582,2.0,47,44,6,2,3,93.61702128
2011030322,26,3579,0.0,24,24,3,6,0,100.0
2011030322,27,3598,2.0,40,36,13,0,4,90.0
2011030323,27,3566,0.0,28,26,6,0,2,92.85714286
2011030323,26,3599,0.0,19,18,0,2,1,94.73684211
2011030324,27,3600,0.0,36,36,6,3,0,100.0
2011030324,26,3518,0.0,21,19,1,0,2,90.47619048
2011030325,26,4662,0.0,41,38,7,0,3,92.68292683
2011030325,27,4661,10.0,51,47,8,0,4,92.15686275
2011030411,26,4093,0.0,17,16,2,1,1,94.11764706
2011030411,1,4093,0.0,25,23,1,0,2,92.0
2011030412,26,4422,0.0,33,32,3,0,1,96.96969697
2011030412,1,4422,0.0,32,30,1,2,2,93.75
2011030413,1,3595,0.0,21,17,2,1,4,80.95238095
2011030413,26,3600,0.0,22,22,3,0,0,100.0
2011030414,1,3600,0.0,22,21,6,0,1,95.45454545
2011030414,26,3582,0.0,23,21,6,0,2,91.30434783
2011030415,26,3533,0.0,19,17,2,1,2,89.47368421
2011030415,1,3600,0.0,26,25,4,0,1,96.15384615
2011030416,1,3564,0.0,24,19,10,0,5,79.16666667
2011030416,26,3594,0.0,18,17,0,4,1,94.44444444
2012020001,5,3600,0.0,27,26,11,0,1,96.2962963
2012020001,4,3517,0.0,26,24,2,0,2,92.30769231
2012020002,9,3598,0.0,28,27,5,0,1,96.42857143
2012020002,52,3600,0.0,37,33,2,3,4,89.18918919
2012020003,16,3593,0.0,21,19,5,0,2,90.47619048
2012020003,26,3557,0.0,22,17,6,0,5,77.27272727
2012020004,3,3550,0.0,34,31,9,2,3,91.17647059
2012020004,6,3596,0.0,21,20,4,2,1,95.23809524
2012020005,10,3600,0.0,22,21,4,3,1,95.45454545
2012020005,8,3533,0.0,26,24,3,0,2,92.30769231
2012020006,1,3600,0.0,19,18,5,0,1,94.73684211
2012020006,2,3533,0.0,28,26,2,0,2,92.85714286
2012020007,15,3588,0.0,34,28,8,0,6,82.35294118
2012020007,14,3600,0.0,30,27,6,2,3,90.0
2012020008,12,2398,0.0,13,12,4,0,1,92.30769231
2012020008,12,1200,0.0,12,8,2,0,4,66.66666667
2012020008,13,3596,0.0,42,41,9,0,1,97.61904762
2012020009,17,2475,0.0,28,23,2,2,5,82.14285714
2012020009,17,1125,0.0,8,7,0,0,1,87.5
2012020009,19,3600,0.0,14,14,5,0,0,100.0
2012020010,29,3900,0.0,34,32,1,0,2,94.11764706
2012020010,18,3900,0.0,28,26,3,0,2,92.85714286
2012020011,27,3533,0.0,26,22,2,1,4,84.61538462
2012020011,25,3595,0.0,40,37,5,1,3,92.5
2012020012,21,3516,0.0,35,31,10,0,4,88.57142857
2012020012,30,3577,0.0,27,25,2,1,2,92.59259259
2012020013,24,3600,0.0,29,26,6,2,3,89.65517241
2012020013,23,2003,0.0,12,10,0,1,2,83.33333333
2012020013,23,1597,0.0,14,9,1,0,5,64.28571429
2012020014,4,3547,0.0,40,36,8,1,4,90.0
2012020014,7,3598,0.0,29,27,5,0,2,93.10344828
2012020015,5,3595,0.0,34,31,6,0,3,91.17647059
2012020015,3,1751,0.0,18,14,0,0,4,77.77777778
2012020015,3,1842,0.0,20,19,1,0,1,95.0
2012020016,28,3589,0.0,32,31,2,2,1,96.875
2012020016,20,3596,0.0,29,25,3,0,4,86.20689655
2012020017,25,3536,0.0,32,31,4,0,1,96.875
2012020017,30,3582,0.0,24,24,5,1,0,100.0
2012020018,22,3891,0.0,29,27,8,1,2,93.10344828
2012020018,23,3900,0.0,32,30,5,2,2,93.75
2012020019,16,3600,0.0,29,25,3,0,4,86.20689655
2012020019,27,3600,0.0,31,25,4,0,6,80.64516129
2012020020,52,3889,0.0,27,26,3,0,1,96.2962963
2012020020,6,3900,0.0,27,26,1,1,1,96.2962963
2012020021,14,3580,0.0,44,40,13,0,4,90.90909091
2012020021,2,3600,0.0,26,23,6,2,3,88.46153846
2012020022,19,1973,0.0,11,8,2,0,3,72.72727273
2012020022,19,1927,0.0,13,13,4,0,0,100.0
2012020022,18,3896,0.0,39,36,4,2,3,92.30769231
2012020023,7,3600,0.0,35,34,15,0,1,97.14285714
2012020023,10,3452,0.0,20,18,5,0,2,90.0
2012020024,13,3600,0.0,37,33,7,5,4,89.18918919
2012020024,9,3595,0.0,31,31,4,2,0,100.0
2012020025,17,3900,0.0,33,30,10,1,3,90.90909091
2012020025,29,3888,0.0,42,39,11,2,3,92.85714286
2012020026,24,3600,0.0,25,21,3,0,4,84.0
2012020026,20,3548,0.0,24,19,0,0,5,79.16666667
2012020027,52,3600,0.0,34,32,4,0,2,94.11764706
2012020027,15,3562,0.0,39,35,4,0,4,89.74358974
2012020028,14,3590,0.0,36,35,5,2,1,97.22222222
2012020028,12,3600,0.0,26,22,7,0,4,84.61538462
2012020029,13,3600,0.0,33,29,10,3,4,87.87878788
2012020029,8,3582,0.0,28,27,10,0,1,96.42857143
2012020030,4,3600,0.0,26,23,7,3,3,88.46153846
2012020030,1,3585,0.0,24,24,5,2,0,100.0
2012020031,25,3600,0.0,40,39,4,0,1,97.5
2012020031,17,3497,0.0,32,30,6,4,2,93.75
2012020032,18,3600,0.0,30,29,6,0,1,96.66666667
2012020032,30,3564,0.0,26,23,2,0,3,88.46153846
2012020033,19,3536,0.0,27,24,4,0,3,88.88888889
2012020033,16,3600,0.0,34,32,3,0,2,94.11764706
2012020034,26,3480,0.0,31,28,3,0,3,90.32258065
2012020034,21,3600,0.0,29,28,4,0,1,96.55172414
2012020035,28,3600,0.0,29,26,1,3,3,89.65517241
2012020035,22,1200,0.0,17,11,1,0,6,64.70588235
2012020035,22,2400,0.0,14,14,1,3,0,100.0
2012020036,10,3600,0.0,30,28,7,1,2,93.33333333
2012020036,5,3572,0.0,24,19,7,0,5,79.16666667
2012020037,6,3587,0.0,33,29,5,0,4,87.87878788
2012020037,3,3627,0.0,29,26,2,3,3,89.65517241
2012020038,20,3899,0.0,36,34,4,0,2,94.44444444
2012020038,23,3899,0.0,36,34,8,0,2,94.44444444
2012020039,29,3593,0.0,42,37,4,0,5,88.0952381
2012020039,27,660,0.0,4,4,1,0,0,100.0
2012020039,27,2940,0.0,22,21,11,0,1,95.45454545
2012020040,2,3600,0.0,43,39,10,0,4,90.69767442
2012020040,10,839,0.0,8,7,1,0,1,87.5
2012020040,10,2675,0.0,25,20,1,0,5,80.0
2012020041,3,3534,0.0,33,31,5,0,2,93.93939394
2012020041,4,3600,0.0,19,18,4,0,1,94.73684211
2012020042,8,3600,0.0,31,30,7,1,1,96.77419355
2012020042,15,3600,0.0,22,18,7,0,4,81.81818182
2012020043,7,3595,0.0,37,32,7,3,5,86.48648649
2012020043,12,3588,0.0,33,30,8,1,3,90.90909091
2012020044,9,3600,0.0,26,25,7,0,1,96.15384615
2012020044,13,3535,0.0,36,34,7,0,2,94.44444444
2012020045,18,3583,0.0,24,21,6,0,3,87.5
2012020045,19,3600,0.0,13,13,4,1,0,100.0
2012020046,16,3701,0.0,23,21,1,2,2,91.30434783
2012020046,25,3701,0.0,41,38,11,0,3,92.68292683
2012020047,29,3600,0.0,28,24,1,1,4,85.71428571
2012020047,21,3600,0.0,33,33,9,1,0,100.0
2012020048,26,3781,0.0,39,37,19,3,2,94.87179487
2012020048,22,3665,0.0,31,30,10,1,1,96.77419355
2012020049,27,3530,0.0,34,30,7,1,4,88.23529412
2012020049,28,3596,0.0,35,32,12,1,3,91.42857143
2012020050,2,3478,0.0,27,23,3,1,4,85.18518519
2012020050,6,3600,0.0,26,24,5,3,2,92.30769231
2012020051,12,3600,0.0,41,40,8,2,1,97.56097561
2012020051,7,3582,0.0,41,39,6,0,2,95.12195122
2012020052,15,3879,0.0,35,32,12,4,3,91.42857143
2012020052,1,3875,0.0,28,26,4,0,2,92.85714286
2012020053,9,3584,0.0,30,25,3,0,5,83.33333333
2012020053,14,3596,0.0,36,32,4,1,4,88.88888889
2012020054,30,3441,0.0,27,22,3,2,5,81.48148148
2012020054,17,3596,0.0,26,23,11,0,3,88.46153846
2012020055,5,3542,0.0,31,28,0,0,3,90.32258065
2012020055,52,3600,0.0,35,33,1,0,2,94.28571429
2012020056,23,3576,0.0,30,30,1,3,0,100.0
2012020056,24,3597,0.0,34,29,10,0,5,85.29411765
2012020057,21,1200,0.0,17,17,5,0,0,100.0
2012020057,21,2400,0.0,26,22,7,0,4,84.61538462
2012020057,28,3600,0.0,24,24,0,0,0,100.0
2012020058,10,3512,0.0,41,37,7,0,4,90.24390244
2012020058,3,3600,0.0,17,15,1,1,2,88.23529412
2012020059,16,3585,0.0,26,24,8,2,2,92.30769231
2012020059,29,3503,0.0,24,21,4,1,3,87.5
2012020060,4,3600,0.0,31,30,2,1,1,96.77419355
2012020060,13,1200,0.0,9,6,2,0,3,66.66666667
2012020060,13,2400,0.0,17,13,2,0,4,76.47058824
2012020061,19,3600,0.0,23,20,1,0,3,86.95652174
2012020061,25,3121,0.0,29,25,4,2,4,86.20689655
2012020061,25,363,0.0,3,3,0,0,0,100.0
2012020062,26,3600,0.0,33,31,7,0,2,93.93939394
2012020062,27,3476,0.0,31,27,2,1,4,87.09677419
2012020063,22,3490,0.0,35,31,9,0,4,88.57142857
2012020063,20,3579,0.0,20,17,1,0,3,85.0
2012020064,18,3883,0.0,22,20,3,0,2,90.90909091
2012020064,24,3898,0.0,21,19,4,0,2,90.47619048
2012020065,7,3524,0.0,30,27,6,1,3,90.0
2012020065,15,3600,0.0,24,22,2,0,2,91.66666667
2012020066,5,3896,0.0,32,31,3,1,1,96.875
2012020066,9,3900,0.0,34,33,7,1,1,97.05882353
2012020067,1,3861,0.0,32,28,5,1,4,87.5
2012020067,8,3862,0.0,25,22,2,2,3,88.0
2012020068,4,3548,0.0,26,21,3,0,5,80.76923077
2012020068,14,3600,0.0,25,24,5,1,1,96.0
2012020069,17,3765,0.0,27,25,3,4,2,92.59259259
2012020069,16,3765,0.0,30,29,5,0,1,96.66666667
2012020070,2,3719,0.0,35,30,0,0,5,85.71428571
2012020070,52,3718,0.0,25,21,0,0,4,84.0
2012020071,30,3736,0.0,34,29,4,1,5,85.29411765
2012020071,19,3720,0.0,16,12,0,2,4,75.0
2012020072,23,3600,0.0,27,23,11,1,4,85.18518519
2012020072,28,3578,0.0,24,23,7,0,1,95.83333333
2012020073,6,3600,2.0,32,29,7,2,3,90.625
2012020073,12,3586,0.0,37,33,5,4,4,89.18918919
2012020074,25,3556,0.0,27,25,10,1,2,92.59259259
2012020074,29,3600,0.0,25,24,1,1,1,96.0
2012020075,18,3600,0.0,25,21,4,0,4,84.0
2012020075,27,3581,0.0,21,21,1,0,0,100.0
2012020076,21,3548,0.0,26,23,6,0,3,88.46153846
2012020076,22,3582,0.0,38,37,5,2,1,97.36842105
2012020077,23,3900,0.0,28,26,2,0,2,92.85714286
2012020077,26,3856,0.0,23,21,2,0,2,91.30434783
2012020078,1,3893,0.0,28,27,4,0,1,96.42857143
2012020078,6,3900,0.0,26,25,6,0,1,96.15384615
2012020079,10,3898,0.0,32,29,1,0,3,90.625
2012020079,7,3898,0.0,24,20,3,0,4,83.33333333
2012020080,4,3524,0.0,28,26,2,3,2,92.85714286
2012020080,3,3600,0.0,27,26,6,0,1,96.2962963
2012020081,52,3561,0.0,26,22,3,1,4,84.61538462
2012020081,8,3600,0.0,21,18,9,1,3,85.71428571
2012020082,15,3514,0.0,27,24,10,0,3,88.88888889
2012020082,9,3596,0.0,33,31,4,0,2,93.93939394
2012020083,2,3600,0.0,38,37,3,0,1,97.36842105
2012020083,5,2400,0.0,17,13,0,2,4,76.47058824
2012020083,5,1200,0.0,7,7,0,0,0,100.0
2012020084,13,3600,0.0,33,28,5,0,5,84.84848485
2012020084,14,3600,0.0,28,26,7,3,2,92.85714286
2012020085,25,270,0.0,2,2,1,0,0,100.0
2012020085,25,3315,0.0,25,21,4,2,4,84.0
2012020085,17,3590,0.0,26,25,6,1,1,96.15384615
2012020086,29,3517,0.0,26,23,4,0,3,88.46153846
2012020086,30,3600,0.0,19,17,1,1,2,89.47368421
2012020087,24,3900,0.0,18,16,1,0,2,88.88888889
2012020087,28,3900,0.0,30,28,7,1,2,93.33333333
2012020088,8,3600,0.0,27,22,2,1,5,81.48148148
2012020088,9,3600,0.0,32,31,7,1,1,96.875
2012020089,16,3900,0.0,25,23,2,1,2,92.0
2012020089,30,405,0.0,4,2,0,0,2,50.0
2012020089,30,3495,0.0,28,28,2,1,0,100.0
2012020090,22,3832,0.0,28,27,0,1,1,96.42857143
2012020090,27,3767,0.0,21,19,2,1,2,90.47619048
2012020091,21,3598,0.0,23,20,3,1,3,86.95652174
2012020091,23,3600,0.0,24,24,5,1,0,100.0
2012020092,7,3596,0.0,42,38,8,0,4,90.47619048
2012020092,6,3529,0.0,31,25,2,0,6,80.64516129
2012020093,15,3561,0.0,40,37,9,1,3,92.5
2012020093,10,3600,0.0,22,20,2,2,2,90.90909091
2012020094,2,3721,2.0,32,28,9,0,4,87.5
2012020094,1,3721,0.0,35,30,11,2,5,85.71428571
2012020095,5,3600,0.0,28,28,5,1,0,100.0
2012020095,3,3600,0.0,29,26,9,0,3,89.65517241
2012020096,19,3600,0.0,25,24,5,2,1,96.0
2012020096,29,791,0.0,11,8,0,0,3,72.72727273
2012020096,29,2720,0.0,13,13,5,0,0,100.0
2012020097,52,3567,0.0,33,28,8,0,5,84.84848485
2012020097,13,3591,0.0,25,22,1,0,3,88.0
2012020098,21,3600,0.0,28,25,4,0,3,89.28571429
2012020098,20,3584,0.0,21,16,3,1,5,76.19047619
2012020099,18,3900,0.0,24,23,5,0,1,95.83333333
2012020099,26,3897,0.0,14,13,0,0,1,92.85714286
2012020100,22,3900,0.0,38,36,12,2,2,94.73684211
2012020100,28,3892,0.0,28,26,3,3,2,92.85714286
2012020101,4,3542,0.0,26,23,7,0,3,88.46153846
2012020101,15,3600,0.0,31,29,9,1,2,93.5483871
2012020102,9,3520,0.0,35,34,6,4,1,97.14285714
2012020102,12,3591,0.0,33,33,5,1,0,100.0
2012020103,52,1483,0.0,14,9,4,0,5,64.28571429
2012020103,52,2117,0.0,11,8,0,0,3,72.72727273
2012020103,14,3595,0.0,29,26,5,1,3,89.65517241
2012020104,19,969,0.0,11,9,1,1,2,81.81818182
2012020104,19,2579,0.0,19,17,3,1,2,89.47368421
2012020104,17,3593,0.0,26,23,7,3,3,88.46153846
2012020105,27,3900,0.0,24,21,1,2,3,87.5
2012020105,25,3882,0.0,34,31,5,0,3,91.17647059
2012020106,16,3892,0.0,22,21,6,2,1,95.45454545
2012020106,23,3900,0.0,28,27,5,1,1,96.42857143
2012020107,30,3527,0.0,31,28,3,0,3,90.32258065
2012020107,24,3600,0.0,27,26,3,1,1,96.2962963
2012020108,1,3600,0.0,30,25,3,0,5,83.33333333
2012020108,5,3600,0.0,16,15,2,0,1,93.75
2012020109,7,1200,0.0,11,9,4,1,2,81.81818182
2012020109,7,2400,0.0,21,17,5,0,4,80.95238095
2012020109,8,3585,0.0,31,30,5,3,1,96.77419355
2012020110,22,3473,0.0,39,37,18,0,2,94.87179487
2012020110,21,3596,0.0,26,25,2,1,1,96.15384615
2012020111,6,3600,0.0,21,21,2,0,0,100.0
2012020111,10,3537,0.0,34,33,2,0,1,97.05882353
2012020112,12,1252,0.0,12,8,2,0,4,66.66666667
2012020112,12,2249,0.0,12,11,0,3,1,91.66666667
2012020112,4,3577,0.0,42,39,8,3,3,92.85714286
2012020113,3,3600,0.0,32,30,0,1,2,93.75
2012020113,14,3504,0.0,30,27,0,0,3,90.0
2012020114,17,3600,0.0,28,24,7,2,4,85.71428571
2012020114,29,3600,0.0,34,32,6,1,2,94.11764706
2012020115,25,3561,0.0,34,32,12,0,2,94.11764706
2012020115,27,3600,0.0,17,17,0,0,0,100.0
2012020116,16,3876,0.0,47,45,8,0,2,95.74468085
2012020116,20,3900,0.0,19,17,0,0,2,89.47368421
2012020117,26,349,0.0,3,1,0,0,2,33.33333333
2012020117,26,3191,0.0,21,17,5,0,4,80.95238095
2012020117,24,3600,0.0,34,30,8,1,4,88.23529412
2012020118,18,3900,0.0,27,26,6,0,1,96.2962963
2012020118,28,3889,0.0,24,23,3,1,1,95.83333333
2012020119,5,3600,0.0,24,21,4,0,3,87.5
2012020119,15,3596,0.0,26,20,1,0,6,76.92307692
2012020120,9,3511,0.0,32,30,9,0,2,93.75
2012020120,8,3600,0.0,33,32,4,1,1,96.96969697
2012020121,13,3600,0.0,20,17,1,0,3,85.0
2012020121,7,3579,0.0,33,29,5,0,4,87.87878788
2012020122,1,3598,0.0,22,22,5,1,0,100.0
2012020122,2,3496,0.0,26,24,3,3,2,92.30769231
2012020123,12,3600,0.0,42,41,13,1,1,97.61904762
2012020123,10,3600,0.0,39,35,4,2,4,89.74358974
2012020124,25,3560,0.0,31,29,6,1,2,93.5483871
2012020124,21,3543,0.0,26,23,6,3,3,88.46153846
2012020125,30,3545,0.0,34,32,1,1,2,94.11764706
2012020125,27,3600,0.0,22,21,0,0,1,95.45454545
2012020126,23,3880,0.0,25,23,2,0,2,92.0
2012020126,22,3873,0.0,40,37,5,0,3,92.5
2012020127,28,3523,0.0,32,30,4,4,2,93.75
2012020127,24,3588,0.0,26,25,8,1,1,96.15384615
2012020128,3,3488,0.0,22,19,4,3,3,86.36363636
2012020128,1,3600,0.0,25,24,3,1,1,96.0
2012020129,5,3600,0.0,34,32,16,0,2,94.11764706
2012020129,2,3588,0.0,25,22,5,0,3,88.0
2012020130,10,3600,0.0,26,24,3,0,2,92.30769231
2012020130,15,3512,0.0,21,18,4,0,3,85.71428571
2012020131,26,3600,0.0,20,18,1,1,2,90.0
2012020131,29,3481,0.0,31,27,3,0,4,87.09677419
2012020132,7,3569,0.0,24,20,1,3,4,83.33333333
2012020132,9,3592,0.0,23,20,5,0,3,86.95652174
2012020133,14,3511,0.0,24,22,3,0,2,91.66666667
2012020133,4,3598,0.0,22,21,2,0,1,95.45454545
2012020134,20,1200,0.0,6,6,1,0,0,100.0
2012020134,20,2400,0.0,20,19,4,0,1,95.0
2012020134,17,3596,0.0,23,19,1,0,4,82.60869565
2012020135,13,3884,0.0,21,18,0,0,3,85.71428571
2012020135,52,3881,0.0,19,17,0,0,2,89.47368421
2012020136,18,3600,0.0,32,31,10,0,1,96.875
2012020136,19,1749,0.0,11,7,1,0,4,63.63636364
2012020136,19,1840,0.0,8,6,2,0,2,75.0
2012020137,16,3600,0.0,33,30,1,0,3,90.90909091
2012020137,28,3591,2.0,30,26,3,1,4,86.66666667
2012020138,6,3600,0.0,21,20,5,0,1,95.23809524
2012020138,8,3546,0.0,23,21,2,2,2,91.30434783
2012020139,24,3597,0.0,31,31,0,1,0,100.0
2012020139,21,3600,0.0,20,17,2,0,3,85.0
2012020140,25,3706,0.0,29,27,3,0,2,93.10344828
2012020140,22,3697,0.0,28,25,2,2,3,89.28571429
2012020141,8,3890,0.0,40,36,12,1,4,90.0
2012020141,7,3811,0.0,32,28,5,1,4,87.5
2012020142,14,3553,0.0,27,23,6,1,4,85.18518519
2012020142,1,3600,0.0,19,17,2,0,2,89.47368421
2012020143,2,3592,0.0,24,21,2,1,3,87.5
2012020143,3,3600,0.0,28,27,5,3,1,96.42857143
2012020144,13,3895,0.0,32,30,6,1,2,93.75
2012020144,4,3900,0.0,24,22,2,1,2,91.66666667
2012020145,15,1969,0.0,11,9,0,0,2,81.81818182
2012020145,15,1622,0.0,17,14,4,0,3,82.35294118
2012020145,5,3600,0.0,25,23,2,1,2,92.0
2012020146,20,3657,0.0,29,26,6,0,3,89.65517241
2012020146,29,3665,0.0,30,26,4,1,4,86.66666667
2012020147,12,3739,0.0,47,45,9,0,2,95.74468085
2012020147,9,3718,0.0,26,23,3,0,3,88.46153846
2012020148,10,3600,0.0,25,23,1,1,2,92.0
2012020148,52,3551,0.0,18,15,3,0,3,83.33333333
2012020149,17,3600,0.0,27,26,3,0,1,96.2962963
2012020149,19,3600,0.0,29,24,0,0,5,82.75862069
2012020150,26,3600,0.0,14,11,2,0,3,78.57142857
2012020150,18,3600,0.0,32,32,3,0,0,100.0
2012020151,23,3585,0.0,23,22,6,1,1,95.65217391
2012020151,30,1198,0.0,6,6,1,0,0,100.0
2012020151,30,2381,0.0,16,12,4,0,4,75.0
2012020152,16,3594,0.0,24,22,1,3,2,91.66666667
2012020152,27,2108,0.0,22,16,4,0,6,72.72727273
2012020152,27,1492,0.0,11,11,4,0,0,100.0
2012020153,24,2330,0.0,12,11,1,1,1,91.66666667
2012020153,24,1200,0.0,16,14,5,0,2,87.5
2012020153,25,3600,0.0,21,20,6,2,1,95.23809524
2012020154,14,3549,0.0,24,22,3,2,2,91.66666667
2012020154,6,3600,0.0,30,30,4,0,0,100.0
2012020155,5,3498,0.0,28,25,10,2,3,89.28571429
2012020155,1,3600,0.0,25,24,11,1,1,96.0
2012020156,12,3707,0.0,32,28,6,0,4,87.5
2012020156,4,3707,0.0,33,30,2,0,3,90.90909091
2012020157,52,3600,0.0,33,33,4,1,0,100.0
2012020157,9,3533,0.0,37,36,3,1,1,97.2972973
2012020158,22,3454,0.0,30,28,2,3,2,93.33333333
2012020158,17,3599,0.0,24,23,3,2,1,95.83333333
2012020159,27,3900,0.0,33,33,6,0,0,100.0
2012020159,28,3900,0.0,21,21,1,0,0,100.0
2012020160,10,3600,0.0,37,37,8,2,0,100.0
2012020160,8,3600,0.0,28,22,2,0,6,78.57142857
2012020161,7,3600,0.0,43,41,4,1,2,95.34883721
2012020161,2,3555,0.0,15,12,0,0,3,80.0
2012020162,13,2961,2.0,21,16,0,0,5,76.19047619
2012020162,13,632,0.0,4,4,0,1,0,100.0
2012020162,15,3600,0.0,27,27,3,1,0,100.0
2012020163,24,3900,0.0,31,26,4,0,5,83.87096774
2012020163,19,3900,0.0,23,18,1,0,5,78.26086957
2012020164,18,3861,0.0,32,30,7,0,2,93.75
2012020164,30,3861,2.0,26,25,13,0,1,96.15384615
2012020165,20,3600,0.0,31,26,5,1,5,83.87096774
2012020165,23,3580,0.0,34,33,4,0,1,97.05882353
2012020166,26,3589,0.0,31,28,6,1,3,90.32258065
2012020166,17,3600,0.0,47,45,7,0,2,95.74468085
2012020167,22,3600,0.0,40,39,16,1,1,97.5
2012020167,29,3519,0.0,13,11,3,0,2,84.61538462
2012020168,6,3600,0.0,26,25,3,2,1,96.15384615
2012020168,7,3541,0.0,38,36,4,1,2,94.73684211
2012020169,14,1802,0.0,13,11,0,0,2,84.61538462
2012020169,14,1798,0.0,19,16,4,0,3,84.21052632
2012020169,3,3600,0.0,20,19,2,1,1,95.0
2012020170,1,3600,0.0,24,23,2,0,1,95.83333333
2012020170,5,3508,0.0,23,20,1,0,3,86.95652174
2012020171,16,3600,0.0,17,17,0,0,0,100.0
2012020171,18,3600,0.0,27,24,3,0,3,88.88888889
2012020172,4,1575,0.0,14,10,3,0,4,71.42857143
2012020172,4,2025,0.0,10,9,3,0,1,90.0
2012020172,10,1440,0.0,13,12,0,1,1,92.30769231
2012020172,10,2160,0.0,33,32,8,1,1,96.96969697
2012020173,12,3600,0.0,28,24,3,0,4,85.71428571
2012020173,2,3568,0.0,30,25,5,0,5,83.33333333
2012020174,28,3600,0.0,36,30,5,3,6,83.33333333
2012020174,29,3594,0.0,27,25,2,1,2,92.59259259
2012020175,26,3598,0.0,22,21,4,1,1,95.45454545
2012020175,19,3600,0.0,23,19,2,1,4,82.60869565
2012020176,27,3841,0.0,43,41,5,1,2,95.34883721
2012020176,21,3841,0.0,30,27,5,1,3,90.0
2012020177,30,3900,0.0,24,23,3,0,1,95.83333333
2012020177,20,3900,0.0,24,23,10,0,1,95.83333333
2012020178,12,3600,0.0,28,26,2,2,2,92.85714286
2012020178,1,3533,0.0,24,21,5,0,3,87.5
2012020179,3,3868,0.0,40,37,8,2,3,92.5
2012020179,6,3809,0.0,29,26,3,2,3,89.65517241
2012020180,7,3583,0.0,31,29,7,1,2,93.5483871
2012020180,9,3557,0.0,42,42,11,2,0,100.0
2012020181,8,3895,0.0,24,21,2,1,3,87.5
2012020181,14,3880,0.0,34,31,9,1,3,91.17647059
2012020182,15,3627,2.0,32,27,9,0,5,84.375
2012020182,13,3632,0.0,29,23,1,0,6,79.31034483
2012020183,4,3600,0.0,26,24,3,1,2,92.30769231
2012020183,52,1121,0.0,11,10,4,0,1,90.90909091
2012020183,52,2400,0.0,12,10,0,0,2,83.33333333
2012020184,28,3728,0.0,25,24,2,2,1,96.0
2012020184,18,3728,0.0,25,25,4,0,0,100.0
2012020185,24,3900,0.0,30,28,7,0,2,93.33333333
2012020185,16,3900,0.0,31,29,9,2,2,93.5483871
2012020186,25,3600,0.0,36,35,10,0,1,97.22222222
2012020186,22,3600,0.0,29,25,5,0,4,86.20689655
2012020187,30,3535,0.0,30,28,2,0,2,93.33333333
2012020187,23,3600,0.0,26,25,7,1,1,96.15384615
2012020188,9,3600,0.0,30,26,4,0,4,86.66666667
2012020188,5,3593,0.0,29,27,5,1,2,93.10344828
2012020189,19,3652,0.0,18,15,1,0,3,83.33333333
2012020189,17,3651,0.0,25,21,2,0,4,84.0
2012020190,25,3582,0.0,22,16,1,0,6,72.72727273
2012020190,20,3600,0.0,34,30,5,1,4,88.23529412
2012020191,2,3900,0.0,39,36,7,0,3,92.30769231
2012020191,3,3900,0.0,31,28,1,0,3,90.32258065
2012020192,10,3455,0.0,33,30,4,2,3,90.90909091
2012020192,12,3600,0.0,23,22,4,0,1,95.65217391
2012020193,15,3600,0.0,30,27,1,0,3,90.0
2012020193,14,3534,0.0,39,35,0,1,4,89.74358974
2012020194,8,3730,0.0,26,26,2,0,0,100.0
2012020194,13,3729,0.0,32,31,3,0,1,96.875
2012020195,27,3600,0.0,29,26,1,0,3,89.65517241
2012020195,18,3600,0.0,19,19,4,1,0,100.0
2012020196,21,3896,0.0,29,26,1,0,3,89.65517241
2012020196,30,3900,0.0,32,29,2,0,3,90.625
2012020197,6,3499,0.0,26,22,5,0,4,84.61538462
2012020197,7,3600,0.0,32,30,2,0,2,93.75
2012020198,4,3511,0.0,18,14,1,0,4,77.77777778
2012020198,1,3600,0.0,28,25,0,0,3,89.28571429
2012020199,5,3600,0.0,26,25,1,0,1,96.15384615
2012020199,52,3531,0.0,27,25,2,0,2,92.59259259
2012020200,24,3590,0.0,28,26,4,0,2,92.85714286
2012020200,17,3556,0.0,36,32,5,3,4,88.88888889
2012020201,28,3591,0.0,37,33,6,2,4,89.18918919
2012020201,16,3589,0.0,28,27,2,0,1,96.42857143
2012020202,19,3600,0.0,32,30,4,1,2,93.75
2012020202,20,247,0.0,4,2,0,0,2,50.0
2012020202,20,3353,0.0,21,18,1,0,3,85.71428571
2012020203,25,2759,0.0,21,18,0,1,3,85.71428571
2012020203,25,829,0.0,7,7,4,0,0,100.0
2012020203,23,3527,0.0,29,25,10,2,4,86.20689655
2012020204,29,3521,0.0,22,20,4,0,2,90.90909091
2012020204,26,3597,0.0,13,12,2,0,1,92.30769231
2012020205,9,3589,0.0,28,26,5,0,2,92.85714286
2012020205,10,3595,0.0,34,34,8,0,0,100.0
2012020206,4,3549,0.0,28,25,7,1,3,89.28571429
2012020206,8,3600,0.0,19,18,5,1,1,94.73684211
2012020207,1,3600,0.0,33,28,5,1,5,84.84848485
2012020207,2,3589,0.0,31,30,6,2,1,96.77419355
2012020208,14,3636,0.0,30,25,3,1,5,83.33333333
2012020208,13,3659,0.0,36,30,2,0,6,83.33333333
2012020209,24,3900,0.0,34,32,7,0,2,94.11764706
2012020209,18,3900,2.0,22,20,1,2,2,90.90909091
2012020210,29,3584,0.0,34,30,13,2,4,88.23529412
2012020210,27,3600,0.0,20,17,2,0,3,85.0
2012020211,21,3546,0.0,55,50,5,2,5,90.90909091
2012020211,22,2400,0.0,17,16,4,0,1,94.11764706
2012020211,22,1200,0.0,12,9,0,0,3,75.0
2012020212,5,3580,0.0,33,30,4,0,3,90.90909091
2012020212,7,3557,0.0,35,31,4,0,4,88.57142857
2012020213,26,3530,0.0,37,34,8,0,3,91.89189189
2012020213,16,3600,0.0,27,25,3,1,2,92.59259259
2012020214,6,3600,0.0,24,22,1,0,2,91.66666667
2012020214,52,3527,0.0,26,23,0,0,3,88.46153846
2012020215,20,3596,0.0,30,27,6,1,3,90.0
2012020215,25,3504,0.0,26,22,5,0,4,84.61538462
2012020216,17,3549,0.0,24,21,1,0,3,87.5
2012020216,30,3600,0.0,31,29,4,0,2,93.5483871
2012020217,15,3514,0.0,40,38,7,3,2,95.0
2012020217,3,3594,0.0,28,27,9,0,1,96.42857143
2012020218,19,3900,0.0,31,28,3,0,3,90.32258065
2012020218,23,3900,0.0,23,20,3,0,3,86.95652174
2012020219,9,3900,0.0,31,30,10,1,1,96.77419355
2012020219,1,3894,0.0,30,29,0,2,1,96.66666667
2012020220,4,3600,0.0,19,19,1,1,0,100.0
2012020220,2,3600,0.0,25,18,6,0,7,72.0
2012020221,18,1997,0.0,18,12,1,0,6,66.66666667
2012020221,18,1458,0.0,10,10,0,0,0,100.0
2012020221,21,3600,0.0,38,33,6,0,5,86.84210526
2012020222,12,3600,0.0,26,23,7,0,3,88.46153846
2012020222,8,3584,0.0,19,19,2,0,0,100.0
2012020223,10,3600,0.0,37,37,1,1,0,100.0
2012020223,13,3588,0.0,33,30,5,0,3,90.90909091
2012020224,20,3600,0.0,37,33,2,0,4,89.18918919
2012020224,27,3600,0.0,30,30,4,0,0,100.0
2012020225,29,3529,0.0,29,26,4,0,3,89.65517241
2012020225,24,3600,0.0,27,25,3,0,2,92.59259259
2012020226,52,3600,0.0,30,29,5,0,1,96.66666667
2012020226,7,3497,0.0,28,26,0,2,2,92.85714286
2012020227,8,3600,0.0,25,24,3,1,1,96.0
2012020227,3,3557,0.0,17,15,1,0,2,88.23529412
2012020228,2,3490,0.0,26,23,7,0,3,88.46153846
2012020228,9,3600,0.0,38,37,4,0,1,97.36842105
2012020229,10,620,0.0,6,6,3,1,0,100.0
2012020229,10,2818,2.0,13,9,2,0,4,69.23076923
2012020229,14,3591,0.0,25,23,2,0,2,92.0
2012020230,28,3598,0.0,26,25,6,1,1,96.15384615
2012020230,19,3496,0.0,25,23,7,1,2,92.0
2012020231,17,682,0.0,7,5,3,0,2,71.42857143
2012020231,17,2962,2.0,18,16,5,0,2,88.88888889
2012020231,18,3627,0.0,29,26,4,0,3,89.65517241
2012020232,23,3861,0.0,43,40,4,3,3,93.02325581
2012020232,16,3900,0.0,32,29,2,3,3,90.625
2012020233,26,3600,0.0,24,23,4,0,1,95.83333333
2012020233,22,3568,0.0,37,35,2,0,2,94.59459459
2012020234,4,3600,0.0,32,27,8,0,5,84.375
2012020234,5,3533,0.0,32,26,9,0,6,81.25
2012020235,19,3883,0.0,20,19,3,0,1,95.0
2012020235,21,3883,0.0,33,33,3,0,0,100.0
2012020236,26,3600,0.0,27,26,8,0,1,96.2962963
2012020236,20,3529,0.0,33,30,2,0,3,90.90909091
2012020237,7,3455,0.0,36,33,9,2,3,91.66666667
2012020237,10,3600,0.0,32,31,3,0,1,96.875
2012020238,13,3563,0.0,34,32,3,0,2,94.11764706
2012020238,4,1906,0.0,15,11,1,0,4,73.33333333
2012020238,4,1694,0.0,11,10,1,0,1,90.90909091
2012020239,1,3578,0.0,19,17,5,0,2,89.47368421
2012020239,15,3513,0.0,37,34,5,0,3,91.89189189
2012020240,52,3567,0.0,30,27,3,0,3,90.0
2012020240,12,3584,0.0,23,19,4,0,4,82.60869565
2012020241,2,3792,0.0,33,30,6,0,3,90.90909091
2012020241,8,3792,0.0,25,21,1,0,4,84.0
2012020242,3,3898,0.0,37,35,3,2,2,94.59459459
2012020242,9,2503,0.0,21,21,5,0,0,100.0
2012020242,9,1397,0.0,13,11,0,0,2,84.61538462
2012020243,6,3600,0.0,26,24,3,0,2,92.30769231
2012020243,14,3512,0.0,26,22,0,1,4,84.61538462
2012020244,29,3600,0.0,30,28,10,0,2,93.33333333
2012020244,17,3575,0.0,24,21,3,2,3,87.5
2012020245,23,3600,0.0,25,22,2,0,3,88.0
2012020245,25,3600,0.0,22,18,1,1,4,81.81818182
2012020246,30,3600,0.0,28,27,1,2,1,96.42857143
2012020246,22,3553,0.0,28,25,2,0,3,89.28571429
2012020247,13,3524,0.0,40,37,9,0,3,92.5
2012020247,5,3600,2.0,23,22,2,0,1,95.65217391
2012020248,23,3600,0.0,23,23,4,0,0,100.0
2012020248,18,3525,0.0,24,23,0,0,1,95.83333333
2012020249,28,3518,0.0,34,32,4,1,2,94.11764706
2012020249,16,3600,0.0,27,26,10,0,1,96.2962963
2012020250,1,3599,0.0,26,21,1,0,5,80.76923077
2012020250,15,3595,0.0,22,21,5,0,1,95.45454545
2012020251,52,3509,0.0,38,34,5,1,4,89.47368421
2012020251,4,3581,0.0,37,34,7,1,3,91.89189189
2012020252,27,3894,0.0,43,41,8,4,2,95.34883721
2012020252,22,3897,0.0,36,34,7,1,2,94.44444444
2012020253,21,3600,0.0,26,22,5,1,4,84.61538462
2012020253,26,3600,0.0,24,23,2,0,1,95.83333333
2012020254,2,3600,0.0,35,35,10,0,0,100.0
2012020254,7,3600,2.0,32,28,4,0,4,87.5
2012020255,3,3600,0.0,18,15,3,1,3,83.33333333
2012020255,8,3600,0.0,17,17,0,0,0,100.0
2012020256,10,3584,0.0,35,32,0,1,3,91.42857143
2012020256,9,3600,0.0,28,26,2,0,2,92.85714286
2012020257,14,3591,0.0,34,32,3,0,2,94.11764706
2012020257,12,3600,0.0,39,34,5,0,5,87.17948718
2012020258,18,3582,0.0,27,23,3,0,4,85.18518519
2012020258,17,3600,0.0,33,33,0,0,0,100.0
2012020259,29,3540,0.0,23,21,2,0,2,91.30434783
2012020259,19,3600,0.0,20,19,5,0,1,95.0
2012020260,28,3515,0.0,28,25,7,2,3,89.28571429
2012020260,25,3600,0.0,32,31,9,1,1,96.875
2012020261,30,3525,0.0,26,24,1,1,2,92.30769231
2012020261,20,3598,0.0,31,30,1,0,1,96.77419355
2012020262,6,3600,0.0,35,34,7,2,1,97.14285714
2012020262,13,3549,0.0,31,28,0,2,3,90.32258065
2012020263,52,3600,0.0,26,24,4,0,2,92.30769231
2012020263,1,3422,0.0,27,23,2,1,4,85.18518519
2012020264,23,3600,0.0,28,20,5,0,8,71.42857143
2012020264,17,3596,0.0,21,18,2,1,3,85.71428571
2012020265,12,3578,0.0,25,23,2,1,2,92.0
2012020265,2,3564,0.0,27,24,4,0,3,88.88888889
2012020266,29,3567,0.0,27,26,3,0,1,96.2962963
2012020266,16,3600,0.0,28,28,10,0,0,100.0
2012020267,14,1200,0.0,10,7,0,0,3,70.0
2012020267,14,2337,0.0,11,10,1,0,1,90.90909091
2012020267,5,3600,0.0,30,27,0,1,3,90.0
2012020268,27,3573,0.0,31,26,4,1,5,83.87096774
2012020268,20,3596,0.0,27,23,3,0,4,85.18518519
2012020269,21,3854,0.0,39,35,9,2,4,89.74358974
2012020269,24,3854,0.0,23,20,3,2,3,86.95652174
2012020270,10,3597,0.0,25,23,2,0,2,92.0
2012020270,4,3484,0.0,21,18,1,0,3,85.71428571
2012020271,8,3900,0.0,24,23,0,1,1,95.83333333
2012020271,9,3900,0.0,45,44,7,0,1,97.77777778
2012020272,25,3621,0.0,31,26,9,1,5,83.87096774
2012020272,18,3628,0.0,24,20,3,0,4,83.33333333
2012020273,22,3699,0.0,34,31,1,3,3,91.17647059
2012020273,16,3704,0.0,19,17,3,0,2,89.47368421
2012020274,24,3510,0.0,24,20,0,0,4,83.33333333
2012020274,26,3599,0.0,26,24,5,0,2,92.30769231
2012020275,52,3600,0.0,33,30,1,2,3,90.90909091
2012020275,3,3539,0.0,32,28,5,0,4,87.5
2012020276,12,3600,0.0,40,37,3,1,3,92.5
2012020276,15,3593,0.0,33,33,1,2,0,100.0
2012020277,25,3783,0.0,20,16,1,0,4,80.0
2012020277,29,3783,0.0,39,34,3,1,5,87.17948718
2012020278,6,3600,0.0,37,36,5,2,1,97.2972973
2012020278,2,3510,0.0,33,30,6,0,3,90.90909091
2012020279,7,3600,0.0,31,30,9,0,1,96.77419355
2012020279,14,3521,0.0,21,19,1,0,2,90.47619048
2012020280,5,1803,0.0,13,12,4,0,1,92.30769231
2012020280,5,1734,2.0,22,18,5,0,4,81.81818182
2012020280,13,2398,0.0,19,15,2,0,4,78.94736842
2012020280,13,1200,0.0,15,15,5,0,0,100.0
2012020281,20,3627,0.0,30,28,10,0,2,93.33333333
2012020281,30,3624,0.0,21,20,4,2,1,95.23809524
2012020282,27,3600,0.0,31,29,4,0,2,93.5483871
2012020282,23,3551,0.0,21,18,1,1,3,85.71428571
2012020283,21,3900,0.0,41,39,13,1,2,95.12195122
2012020283,28,3896,0.0,27,25,1,0,2,92.59259259
2012020284,8,3597,0.0,23,21,2,0,2,91.30434783
2012020284,10,3600,0.0,40,35,7,0,5,87.5
2012020285,15,1505,0.0,14,14,1,0,0,100.0
2012020285,15,2095,0.0,18,14,1,0,4,77.77777778
2012020285,4,3595,0.0,24,23,5,0,1,95.83333333
2012020286,18,1200,0.0,7,7,0,1,0,100.0
2012020286,18,2400,0.0,21,16,4,0,5,76.19047619
2012020286,24,3580,0.0,21,20,1,1,1,95.23809524
2012020287,17,3548,0.0,29,27,4,0,2,93.10344828
2012020287,26,3600,0.0,33,32,8,0,1,96.96969697
2012020288,9,3818,0.0,46,44,9,2,2,95.65217391
2012020288,6,3818,0.0,31,30,5,0,1,96.77419355
2012020289,10,3671,0.0,27,23,0,0,4,85.18518519
2012020289,2,3671,0.0,28,23,0,0,5,82.14285714
2012020290,14,3600,0.0,42,38,10,0,4,90.47619048
2012020290,3,3600,0.0,25,24,5,1,1,96.0
2012020291,5,3514,0.0,29,25,7,1,4,86.20689655
2012020291,12,3600,0.0,27,26,4,0,1,96.2962963
2012020292,7,3873,0.0,43,40,4,0,3,93.02325581
2012020292,13,2894,0.0,15,15,0,1,0,100.0
2012020292,13,1006,0.0,10,7,1,0,3,70.0
2012020293,1,3555,0.0,20,18,1,2,2,90.0
2012020293,52,3600,0.0,23,22,2,2,1,95.65217391
2012020294,16,1200,0.0,6,6,1,0,0,100.0
2012020294,16,2400,0.0,15,15,5,0,0,100.0
2012020294,19,3600,0.0,23,20,0,1,3,86.95652174
2012020295,22,3600,0.0,34,33,6,2,1,97.05882353
2012020295,25,3597,0.0,38,33,14,1,5,86.84210526
2012020296,20,3511,0.0,36,31,7,2,5,86.11111111
2012020296,21,3600,0.0,23,19,2,1,4,82.60869565
2012020297,30,3597,0.0,28,25,3,0,3,89.28571429
2012020297,27,2400,0.0,19,15,4,1,4,78.94736842
2012020297,27,1104,0.0,4,4,3,0,0,100.0
2012020298,17,3900,0.0,26,25,1,0,1,96.15384615
2012020298,28,3900,0.0,34,33,3,0,1,97.05882353
2012020299,22,3494,0.0,30,26,1,0,4,86.66666667
2012020299,19,3600,0.0,17,15,3,0,2,88.23529412
2012020300,29,3799,0.0,35,31,1,0,4,88.57142857
2012020300,16,3803,0.0,22,19,0,0,3,86.36363636
2012020301,30,3489,0.0,29,26,0,1,3,89.65517241
2012020301,24,3600,0.0,33,31,7,1,2,93.93939394
2012020302,9,3540,0.0,41,39,9,2,2,95.12195122
2012020302,4,3600,0.0,34,33,8,1,1,97.05882353
2012020303,14,3490,0.0,27,24,6,0,3,88.88888889
2012020303,6,3600,0.0,22,20,7,1,2,90.90909091
2012020304,1,3900,0.0,23,20,2,2,3,86.95652174
2012020304,7,3898,0.0,31,28,10,0,3,90.32258065
2012020305,15,3600,0.0,35,35,11,3,0,100.0
2012020305,52,3596,0.0,21,18,1,0,3,85.71428571
2012020306,5,3652,0.0,39,33,2,2,6,84.61538462
2012020306,8,3652,0.0,36,29,1,1,7,80.55555556
2012020307,13,142,0.0,1,1,0,0,0,100.0
2012020307,13,3458,0.0,33,27,5,0,6,81.81818182
2012020307,12,3600,0.0,24,22,0,1,2,91.66666667
2012020308,24,3900,0.0,37,33,0,1,4,89.18918919
2012020308,27,3900,0.0,35,31,12,0,4,88.57142857
2012020309,26,3504,0.0,23,19,3,0,4,82.60869565
2012020309,23,3600,0.0,30,28,5,1,2,93.33333333
2012020310,18,3546,0.0,39,37,3,0,2,94.87179487
2012020310,28,3589,0.0,19,18,2,1,1,94.73684211
2012020311,16,3900,0.0,33,32,8,0,1,96.96969697
2012020311,17,3900,0.0,33,32,3,0,1,96.96969697
2012020312,9,3900,0.0,35,33,4,0,2,94.28571429
2012020312,2,3899,0.0,31,29,5,0,2,93.5483871
2012020313,21,3746,0.0,34,32,6,0,2,94.11764706
2012020313,29,3746,0.0,19,18,1,2,1,94.73684211
2012020314,19,3548,0.0,27,23,3,0,4,85.18518519
2012020314,25,3600,0.0,26,25,2,1,1,96.15384615
2012020315,12,1864,0.0,21,19,3,0,2,90.47619048
2012020315,12,1736,0.0,15,15,0,0,0,100.0
2012020315,13,3508,0.0,24,21,5,0,3,87.5
2012020316,8,3593,0.0,34,31,0,2,3,91.17647059
2012020316,6,3530,0.0,26,22,5,0,4,84.61538462
2012020317,7,3876,0.0,28,26,5,3,2,92.85714286
2012020317,3,3900,0.0,30,28,12,1,2,93.33333333
2012020318,22,3423,0.0,43,39,5,0,4,90.69767442
2012020318,30,3596,0.0,21,19,0,0,2,90.47619048
2012020319,23,3553,0.0,24,21,0,0,3,87.5
2012020319,20,3600,0.0,31,29,2,2,2,93.5483871
2012020320,1,3459,0.0,23,19,3,1,4,82.60869565
2012020320,10,3600,0.0,30,28,2,0,2,93.33333333
2012020321,14,2215,0.0,18,16,2,0,2,88.88888889
2012020321,14,1339,0.0,13,12,2,0,1,92.30769231
2012020321,5,3579,0.0,28,25,1,0,3,89.28571429
2012020322,24,3893,2.0,40,36,7,0,4,90.0
2012020322,27,3898,0.0,31,27,1,1,4,87.09677419
2012020323,18,546,0.0,3,3,0,0,0,100.0
2012020323,18,3051,0.0,13,8,0,0,5,61.53846154
2012020323,26,3600,0.0,19,18,2,0,1,94.73684211
2012020324,14,3600,0.0,27,25,5,1,2,92.59259259
2012020324,1,1545,0.0,13,12,1,0,1,92.30769231
2012020324,1,1993,0.0,11,8,1,0,3,72.72727273
2012020325,8,3559,0.0,23,18,3,1,5,78.26086957
2012020325,2,3596,0.0,32,29,6,0,3,90.625
2012020326,6,3634,0.0,26,22,2,0,4,84.61538462
2012020326,15,3637,0.0,33,30,1,3,3,90.90909091
2012020327,7,3569,0.0,28,24,5,1,4,85.71428571
2012020327,12,3600,0.0,40,37,4,0,3,92.5
2012020328,22,3885,0.0,38,35,6,1,3,92.10526316
2012020328,29,2669,0.0,21,21,3,0,0,100.0
2012020328,29,1231,0.0,8,5,0,0,3,62.5
2012020329,4,3487,0.0,20,16,3,0,4,80.0
2012020329,3,3600,0.0,25,23,2,1,2,92.0
2012020330,52,3600,0.0,26,22,1,0,4,84.61538462
2012020330,13,3600,0.0,31,30,0,0,1,96.77419355
2012020331,21,3488,0.0,33,31,0,1,2,93.93939394
2012020331,17,3600,0.0,37,36,1,0,1,97.2972973
2012020332,30,1200,0.0,17,13,1,0,4,76.47058824
2012020332,30,2322,0.0,15,14,3,0,1,93.33333333
2012020332,16,3600,0.0,23,20,2,0,3,86.95652174
2012020333,28,3884,0.0,38,36,10,1,2,94.73684211
2012020333,23,3900,0.0,30,28,7,0,2,93.33333333
2012020334,19,2769,0.0,21,16,3,0,5,76.19047619
2012020334,19,763,0.0,8,7,0,0,1,87.5
2012020334,26,2326,0.0,6,5,2,0,1,83.33333333
2012020334,26,1274,0.0,8,5,0,0,3,62.5
2012020335,9,3508,0.0,28,23,2,0,5,82.14285714
2012020335,10,3600,0.0,43,39,1,1,4,90.69767442
2012020336,21,3565,0.0,32,29,4,1,3,90.625
2012020336,16,3600,0.0,22,20,1,1,2,90.90909091
2012020337,28,3496,0.0,25,22,3,0,3,88.0
2012020337,20,3600,0.0,33,32,7,0,1,96.96969697
2012020338,27,3574,0.0,23,22,2,1,1,95.65217391
2012020338,24,3600,0.0,18,18,0,0,0,100.0
2012020339,10,3528,0.0,24,21,3,1,3,87.5
2012020339,6,3600,0.0,27,25,4,0,2,92.59259259
2012020340,7,3534,0.0,29,27,1,0,2,93.10344828
2012020340,7,366,0.0,4,4,0,0,0,100.0
2012020340,1,3889,2.0,25,23,1,1,2,92.0
2012020341,3,3632,0.0,29,28,0,3,1,96.55172414
2012020341,2,3642,0.0,37,35,2,0,2,94.59459459
2012020342,5,1200,0.0,18,14,6,0,4,77.77777778
2012020342,5,2400,0.0,14,14,3,0,0,100.0
2012020342,4,2147,0.0,16,12,4,0,4,75.0
2012020342,4,1373,0.0,6,5,0,0,1,83.33333333
2012020343,13,190,0.0,2,0,0,0,2,0.0
2012020343,13,3389,0.0,24,19,2,0,5,79.16666667
2012020343,15,3600,0.0,30,29,2,2,1,96.66666667
2012020344,8,3599,0.0,43,41,6,4,2,95.34883721
2012020344,12,3534,0.0,28,24,6,0,4,85.71428571
2012020345,23,3843,0.0,27,25,0,0,2,92.59259259
2012020345,29,3843,0.0,35,34,0,2,1,97.14285714
2012020346,52,3600,0.0,29,28,7,0,1,96.55172414
2012020346,14,3503,0.0,28,26,1,1,2,92.85714286
2012020347,22,3535,0.0,27,25,1,0,2,92.59259259
2012020347,17,3600,0.0,22,22,0,0,0,100.0
2012020348,19,3600,0.0,26,23,8,0,3,88.46153846
2012020348,27,3600,0.0,30,24,4,0,6,80.0
2012020349,25,3600,0.0,33,31,3,2,2,93.93939394
2012020349,26,3577,0.0,21,17,1,0,4,80.95238095
2012020350,9,3600,0.0,35,33,4,0,2,94.28571429
2012020350,3,3529,0.0,39,36,1,0,3,92.30769231
2012020351,52,3859,0.0,40,38,7,2,2,95.0
2012020351,13,3859,0.0,28,25,1,1,3,89.28571429
2012020352,22,1200,0.0,13,11,1,0,2,84.61538462
2012020352,22,2400,0.0,21,17,3,0,4,80.95238095
2012020352,18,3596,0.0,24,24,0,2,0,100.0
2012020353,16,2398,2.0,19,14,2,0,5,73.68421053
2012020353,16,1200,0.0,12,11,3,0,1,91.66666667
2012020353,21,3600,0.0,33,31,4,0,2,93.93939394
2012020354,20,3600,0.0,24,20,0,2,4,83.33333333
2012020354,24,3599,0.0,29,29,0,0,0,100.0
2012020355,4,3600,0.0,28,25,2,0,3,89.28571429
2012020355,6,3587,0.0,23,23,4,0,0,100.0
2012020356,15,3533,0.0,45,40,17,0,5,88.88888889
2012020356,2,3600,0.0,24,22,2,0,2,91.66666667
2012020357,17,3600,0.0,24,21,2,0,3,87.5
2012020357,29,3585,0.0,30,30,5,2,0,100.0
2012020358,19,3672,0.0,25,22,1,0,3,88.0
2012020358,28,934,0.0,7,6,1,0,1,85.71428571
2012020358,28,2734,0.0,28,25,2,2,3,89.28571429
2012020359,5,3900,0.0,26,22,2,0,4,84.61538462
2012020359,10,3900,0.0,41,37,4,1,4,90.24390244
2012020360,1,1116,0.0,3,3,0,0,0,100.0
2012020360,1,2400,0.0,18,13,3,0,5,72.22222222
2012020360,12,3600,0.0,34,31,6,0,3,91.17647059
2012020361,8,3600,0.0,23,20,0,0,3,86.95652174
2012020361,14,3527,0.0,29,25,5,0,4,86.20689655
2012020362,30,3900,0.0,25,24,1,0,1,96.0
2012020362,18,3900,2.0,29,28,6,0,1,96.55172414
2012020363,25,3559,0.0,21,19,1,0,2,90.47619048
2012020363,27,3600,0.0,21,20,2,1,1,95.23809524
2012020364,20,698,0.0,2,2,0,0,0,100.0
2012020364,20,2902,0.0,22,16,0,0,6,72.72727273
2012020364,26,3600,0.0,19,17,1,0,2,89.47368421
2012020365,3,3600,0.0,29,28,9,1,1,96.55172414
2012020365,15,1706,0.0,11,10,0,0,1,90.90909091
2012020365,15,1894,0.0,19,16,0,0,3,84.21052632
2012020366,29,3900,0.0,23,21,5,1,2,91.30434783
2012020366,17,3900,0.0,21,19,1,0,2,90.47619048
2012020367,8,3593,0.0,16,14,1,0,2,87.5
2012020367,13,3600,0.0,38,33,8,0,5,86.84210526
2012020368,52,3900,0.0,27,25,0,0,2,92.59259259
2012020368,1,3891,0.0,25,23,1,0,2,92.0
2012020369,2,1196,0.0,11,10,4,0,1,90.90909091
2012020369,2,2400,2.0,17,12,3,0,5,70.58823529
2012020369,5,3587,0.0,24,23,4,0,1,95.83333333
2012020370,22,1785,0.0,13,11,0,1,2,84.61538462
2012020370,22,1815,0.0,24,21,3,4,3,87.5
2012020370,16,2959,0.0,16,13,2,0,3,81.25
2012020370,16,559,0.0,9,6,0,0,3,66.66666667
2012020371,7,3546,0.0,28,25,7,1,3,89.28571429
2012020371,4,3600,0.0,20,18,1,2,2,90.0
2012020372,23,3479,0.0,32,28,4,1,4,87.5
2012020372,30,3600,0.0,27,25,7,1,2,92.59259259
2012020373,28,3899,0.0,42,39,2,2,3,92.85714286
2012020373,21,3899,0.0,38,36,11,1,2,94.73684211
2012020374,19,3574,0.0,21,18,6,1,3,85.71428571
2012020374,24,3600,0.0,31,29,2,3,2,93.5483871
2012020375,6,3900,0.0,32,30,1,1,2,93.75
2012020375,9,3900,0.0,35,33,6,1,2,94.28571429
2012020376,20,3560,0.0,21,19,1,0,2,90.47619048
2012020376,26,3600,0.0,24,23,5,0,1,95.83333333
2012020377,3,3476,0.0,22,19,2,0,3,86.36363636
2012020377,7,3600,0.0,33,32,4,2,1,96.96969697
2012020378,12,3600,0.0,26,26,2,1,0,100.0
2012020378,15,3585,0.0,35,32,8,0,3,91.42857143
2012020379,23,3900,0.0,27,26,3,1,1,96.2962963
2012020379,29,3900,0.0,38,37,6,1,1,97.36842105
2012020380,6,3546,2.0,34,31,5,1,3,91.17647059
2012020380,5,3600,0.0,16,14,0,0,2,87.5
2012020381,14,3600,0.0,39,37,10,0,2,94.87179487
2012020381,13,3548,0.0,13,10,1,0,3,76.92307692
2012020382,10,3076,0.0,28,24,4,0,4,85.71428571
2012020382,10,524,0.0,6,5,1,0,1,83.33333333
2012020382,52,3600,0.0,26,24,4,0,2,92.30769231
2012020383,28,3584,0.0,20,17,6,0,3,85.0
2012020383,19,3600,0.0,41,39,2,0,2,95.12195122
2012020384,24,3600,0.0,31,30,11,0,1,96.77419355
2012020384,30,3562,0.0,21,19,3,1,2,90.47619048
2012020385,18,3600,0.0,32,32,5,0,0,100.0
2012020385,25,3600,0.0,21,17,7,0,4,80.95238095
2012020386,22,3600,0.0,35,35,5,1,0,100.0
2012020386,21,3600,0.0,32,28,0,1,4,87.5
2012020387,26,3598,0.0,29,24,1,0,5,82.75862069
2012020387,27,3596,0.0,33,31,2,1,2,93.93939394
2012020388,9,3900,0.0,45,42,7,0,3,93.33333333
2012020388,8,3890,0.0,32,29,7,1,3,90.625
2012020389,4,3593,0.0,32,27,6,0,5,84.375
2012020389,1,3600,0.0,25,23,5,2,2,92.0
2012020390,17,3600,0.0,22,17,1,0,5,77.27272727
2012020390,20,3591,0.0,38,36,3,0,2,94.73684211
2012020391,13,3565,0.0,31,28,1,0,3,90.32258065
2012020391,6,3600,0.0,30,29,1,2,1,96.66666667
2012020392,5,3600,0.0,29,28,4,0,1,96.55172414
2012020392,10,3548,0.0,27,25,3,2,2,92.59259259
2012020393,15,3600,0.0,38,36,8,0,2,94.73684211
2012020393,12,3510,0.0,25,22,3,0,3,88.0
2012020394,16,3900,0.0,30,29,2,0,1,96.66666667
2012020394,29,3900,0.0,40,39,3,0,1,97.5
2012020395,2,3600,0.0,18,18,2,0,0,100.0
2012020395,14,3555,0.0,28,27,0,0,1,96.42857143
2012020396,3,3545,0.0,32,30,2,0,2,93.75
2012020396,52,3593,0.0,29,28,0,0,1,96.55172414
2012020397,27,3600,0.0,30,27,5,1,3,90.0
2012020397,19,3600,0.0,28,28,3,1,0,100.0
2012020398,21,3538,0.0,39,35,5,2,4,89.74358974
2012020398,30,3594,0.0,32,29,3,0,3,90.625
2012020399,24,3900,0.0,34,33,5,0,1,97.05882353
2012020399,25,3900,0.0,30,29,10,1,1,96.66666667
2012020400,18,2030,0.0,9,7,0,0,2,77.77777778
2012020400,18,1532,0.0,12,8,2,0,4,66.66666667
2012020400,23,3600,0.0,33,29,7,0,4,87.87878788
2012020401,26,1704,0.0,12,9,2,0,3,75.0
2012020401,26,1823,0.0,14,13,4,1,1,92.85714286
2012020401,28,3600,0.0,37,34,3,0,3,91.89189189
2012020402,1,3900,0.0,22,21,9,0,1,95.45454545
2012020402,4,3900,0.0,28,27,6,1,1,96.42857143
2012020403,18,3052,0.0,19,16,4,0,3,84.21052632
2012020403,18,480,0.0,2,0,0,0,2,0.0
2012020403,20,3600,0.0,20,17,2,0,3,85.0
2012020404,17,3809,0.0,32,30,3,0,2,93.75
2012020404,22,3801,0.0,28,25,8,0,3,89.28571429
2012020405,15,3600,0.0,38,34,0,0,4,89.47368421
2012020405,6,3600,0.0,33,32,3,0,1,96.96969697
2012020406,3,3600,0.0,27,24,3,0,3,88.88888889
2012020406,5,3600,0.0,23,23,2,0,0,100.0
2012020407,9,3834,0.0,36,33,6,2,3,91.66666667
2012020407,7,3834,0.0,34,30,2,0,4,88.23529412
2012020408,30,3598,0.0,32,28,2,1,4,87.5
2012020408,21,1200,0.0,14,10,4,0,4,71.42857143
2012020408,21,2309,0.0,14,12,1,0,2,85.71428571
2012020409,52,3900,0.0,32,28,1,2,4,87.5
2012020409,10,1500,0.0,7,7,0,0,0,100.0
2012020409,10,2400,2.0,26,22,3,0,4,84.61538462
2012020410,8,3588,0.0,33,32,1,0,1,96.96969697
2012020410,1,3496,0.0,22,20,4,0,2,90.90909091
2012020411,12,3600,0.0,26,22,2,1,4,84.61538462
2012020411,14,3600,0.0,22,21,0,0,1,95.45454545
2012020412,27,3900,0.0,23,23,0,1,0,100.0
2012020412,29,3853,0.0,39,39,4,1,0,100.0
2012020413,2,3600,0.0,30,27,4,0,3,90.0
2012020413,13,3510,0.0,25,21,0,0,4,84.0
2012020414,24,3624,0.0,21,19,4,0,2,90.47619048
2012020414,19,3633,0.0,28,27,7,2,1,96.42857143
2012020415,16,3600,0.0,19,18,1,1,1,94.73684211
2012020415,25,1919,0.0,17,13,3,0,4,76.47058824
2012020415,25,1681,0.0,17,13,2,0,4,76.47058824
2012020416,17,3598,0.0,35,33,6,0,2,94.28571429
2012020416,23,3596,0.0,26,21,0,2,5,80.76923077
2012020417,28,1575,0.0,6,5,1,0,1,83.33333333
2012020417,28,2025,0.0,18,14,0,0,4,77.77777778
2012020417,26,3600,0.0,22,20,1,0,2,90.90909091
2012020418,6,3572,0.0,18,16,0,0,2,88.88888889
2012020418,5,3600,0.0,32,31,5,0,1,96.875
2012020419,52,3600,0.0,42,38,7,0,4,90.47619048
2012020419,9,3577,0.0,26,25,6,1,1,96.15384615
2012020420,7,3521,0.0,25,20,5,1,5,80.0
2012020420,15,3600,0.0,30,27,2,2,3,90.0
2012020421,18,3445,0.0,21,18,2,0,3,85.71428571
2012020421,22,3600,0.0,31,29,2,0,2,93.5483871
2012020422,12,3900,0.0,36,35,3,1,1,97.22222222
2012020422,3,3900,0.0,30,29,1,0,1,96.66666667
2012020423,4,3520,0.0,26,23,2,0,3,88.46153846
2012020423,14,3590,0.0,30,28,5,2,2,93.33333333
2012020424,20,3515,0.0,24,20,3,0,4,83.33333333
2012020424,25,3600,0.0,19,16,4,0,3,84.21052632
2012020425,16,3600,0.0,19,17,1,1,2,89.47368421
2012020425,21,3600,0.0,32,27,1,1,5,84.375
2012020426,30,3600,0.0,36,35,4,0,1,97.22222222
2012020426,23,3483,0.0,25,22,3,0,3,88.0
2012020427,28,3559,0.0,27,23,2,1,4,85.18518519
2012020427,24,3600,0.0,35,32,4,0,3,91.42857143
2012020428,27,2841,0.0,22,18,4,1,4,81.81818182
2012020428,27,747,0.0,7,7,2,0,0,100.0
2012020428,26,3596,0.0,27,27,4,1,0,100.0
2012020429,3,3600,0.0,31,29,8,0,2,93.5483871
2012020429,1,3501,0.0,22,19,1,0,3,86.36363636
2012020430,9,3600,0.0,29,26,8,0,3,89.65517241
2012020430,2,3554,0.0,22,18,4,0,4,81.81818182
2012020431,13,3600,0.0,34,33,2,1,1,97.05882353
2012020431,12,3540,0.0,43,40,5,2,3,93.02325581
2012020432,18,3501,0.0,31,27,5,0,4,87.09677419
2012020432,29,3570,0.0,35,32,1,0,3,91.42857143
2012020433,7,3736,0.0,34,32,2,1,2,94.11764706
2012020433,8,3736,0.0,21,18,6,0,3,85.71428571
2012020434,15,3525,0.0,36,34,8,2,2,94.44444444
2012020434,5,3600,0.0,29,28,3,0,1,96.55172414
2012020435,6,3542,0.0,24,22,2,0,2,91.66666667
2012020435,52,3600,0.0,28,27,4,1,1,96.42857143
2012020436,19,3566,0.0,19,16,1,1,3,84.21052632
2012020436,23,3559,0.0,34,32,4,0,2,94.11764706
2012020437,27,3549,0.0,29,26,6,0,3,89.65517241
2012020437,26,3600,0.0,42,40,3,0,2,95.23809524
2012020438,14,1251,0.0,8,7,0,0,1,87.5
2012020438,14,2298,0.0,18,15,1,0,3,83.33333333
2012020438,10,3600,0.0,28,26,0,0,2,92.85714286
2012020439,30,3597,0.0,38,36,11,0,2,94.73684211
2012020439,17,3599,0.0,19,15,4,0,4,78.94736842
2012020440,25,3546,0.0,34,30,2,3,4,88.23529412
2012020440,21,3600,0.0,32,29,8,0,3,90.625
2012020441,28,3893,0.0,27,24,3,0,3,88.88888889
2012020441,22,3900,0.0,34,31,1,2,3,91.17647059
2012020442,16,3565,0.0,25,22,0,1,3,88.0
2012020442,24,3600,0.0,24,22,0,1,2,91.66666667
2012020443,10,3900,0.0,36,32,5,0,4,88.88888889
2012020443,7,3878,0.0,34,30,5,1,4,88.23529412
2012020444,8,3600,0.0,27,25,9,1,2,92.59259259
2012020444,2,3600,0.0,29,24,6,0,5,82.75862069
2012020445,13,3600,0.0,45,44,4,1,1,97.77777778
2012020445,3,3543,0.0,23,21,2,1,2,91.30434783
2012020446,1,3600,0.0,18,17,3,1,1,94.44444444
2012020446,12,3549,0.0,22,18,0,0,4,81.81818182
2012020446,12,51,0.0,0,0,0,0,0,
2012020447,6,3600,0.0,28,27,0,0,1,96.42857143
2012020447,9,3581,0.0,29,27,0,0,2,93.10344828
2012020448,15,3600,0.0,20,20,5,0,0,100.0
2012020448,52,3587,2.0,25,21,2,3,4,84.0
2012020449,20,3438,0.0,23,18,6,1,5,78.26086957
2012020449,18,3574,0.0,22,19,1,0,3,86.36363636
2012020450,23,3594,0.0,34,33,6,1,1,97.05882353
2012020450,27,2399,0.0,17,16,2,0,1,94.11764706
2012020450,27,1110,0.0,15,14,0,0,1,93.33333333
2012020451,25,3600,0.0,40,40,7,2,0,100.0
2012020451,26,3527,0.0,21,19,3,0,2,90.47619048
2012020452,5,3577,0.0,35,33,0,0,2,94.28571429
2012020452,2,3533,0.0,24,21,2,0,3,87.5
2012020453,20,3597,0.0,28,23,2,0,5,82.14285714
2012020453,29,3600,0.0,25,24,3,0,1,96.0
2012020454,15,3600,0.0,31,30,3,3,1,96.77419355
2012020454,52,1541,0.0,9,6,0,2,3,66.66666667
2012020454,52,2046,0.0,15,12,8,0,3,80.0
2012020455,17,3600,0.0,34,33,6,0,1,97.05882353
2012020455,24,1386,0.0,11,8,1,0,3,72.72727273
2012020455,24,2214,0.0,12,10,2,0,2,83.33333333
2012020456,14,2541,0.0,20,19,2,3,1,95.0
2012020456,14,1021,0.0,11,8,0,0,3,72.72727273
2012020456,9,3600,0.0,32,29,4,2,3,90.625
2012020457,28,3480,0.0,24,22,2,2,2,91.66666667
2012020457,30,3600,0.0,33,33,6,0,0,100.0
2012020458,23,3600,0.0,20,20,1,1,0,100.0
2012020458,26,3536,0.0,13,12,3,0,1,92.30769231
2012020459,6,2494,0.0,11,8,0,0,3,72.72727273
2012020459,6,1002,0.0,2,2,0,0,0,100.0
2012020459,10,3597,0.0,33,31,0,0,2,93.93939394
2012020460,7,3600,0.0,39,38,2,0,1,97.43589744
2012020460,8,3517,0.0,18,16,1,1,2,88.88888889
2012020461,13,3524,0.0,25,23,7,1,2,92.0
2012020461,1,3600,0.0,18,17,0,1,1,94.44444444
2012020462,29,615,0.0,11,7,0,0,4,63.63636364
2012020462,29,2936,0.0,12,12,0,1,0,100.0
2012020462,18,3600,0.0,23,21,3,1,2,91.30434783
2012020463,21,2123,0.0,16,15,5,0,1,93.75
2012020463,21,1477,0.0,15,11,3,0,4,73.33333333
2012020463,25,3600,0.0,35,33,4,2,2,94.28571429
2012020464,19,3600,0.0,19,19,0,0,0,100.0
2012020464,22,3600,0.0,25,22,2,0,3,88.0
2012020465,13,3553,0.0,35,34,3,0,1,97.14285714
2012020465,2,3600,0.0,26,26,3,0,0,100.0
2012020466,4,3753,0.0,35,33,5,0,2,94.28571429
2012020466,5,3753,0.0,28,27,0,0,1,96.42857143
2012020467,15,3900,0.0,32,30,1,0,2,93.75
2012020467,3,3900,0.0,24,22,2,1,2,91.66666667
2012020468,14,3538,0.0,24,21,3,1,3,87.5
2012020468,52,3600,0.0,25,23,4,1,2,92.0
2012020469,23,3600,0.0,28,26,3,2,2,92.85714286
2012020469,21,3552,0.0,30,27,2,0,3,90.0
2012020470,19,3541,0.0,17,14,0,0,3,82.35294118
2012020470,20,3600,0.0,38,36,4,0,2,94.73684211
2012020471,17,3590,0.0,34,33,6,1,1,97.05882353
2012020471,24,3562,0.0,21,19,6,0,2,90.47619048
2012020472,10,3900,0.0,29,27,1,4,2,93.10344828
2012020472,6,3900,0.0,25,23,2,1,2,92.0
2012020473,1,3892,0.0,14,12,0,0,2,85.71428571
2012020473,9,3900,0.0,34,32,1,0,2,94.11764706
2012020474,26,3582,0.0,25,21,2,0,4,84.0
2012020474,16,3524,0.0,36,31,2,2,5,86.11111111
2012020475,22,3535,0.0,26,23,3,0,3,88.46153846
2012020475,18,3600,0.0,26,24,3,0,2,92.30769231
2012020476,30,3600,0.0,26,22,5,0,4,84.61538462
2012020476,25,3552,0.0,41,35,3,1,6,85.36585366
2012020477,17,3600,0.0,30,28,5,3,2,93.33333333
2012020477,27,3522,0.0,35,32,5,0,3,91.42857143
2012020478,28,3600,0.0,27,24,1,2,3,88.88888889
2012020478,24,3559,0.0,38,34,5,2,4,89.47368421
2012020479,13,3508,0.0,31,28,3,1,3,90.32258065
2012020479,10,3554,0.0,42,40,2,1,2,95.23809524
2012020480,8,3544,0.0,25,24,6,0,1,96.0
2012020480,5,2400,0.0,25,25,2,0,0,100.0
2012020480,5,1200,0.0,12,12,1,0,0,100.0
2012020481,2,3600,0.0,22,20,1,1,2,90.90909091
2012020481,15,3499,0.0,31,28,6,1,3,90.32258065
2012020482,52,3591,0.0,39,38,8,0,1,97.43589744
2012020482,12,3600,0.0,35,31,0,1,4,88.57142857
2012020483,3,3600,0.0,34,32,1,4,2,94.11764706
2012020483,4,3567,0.0,31,26,1,0,5,83.87096774
2012020484,7,3557,0.0,25,23,7,0,2,92.0
2012020484,14,3598,0.0,14,13,2,0,1,92.85714286
2012020485,22,3600,0.0,43,43,7,0,0,100.0
2012020485,19,2083,0.0,12,12,0,0,0,100.0
2012020485,19,1517,0.0,7,4,0,0,3,57.14285714
2012020486,20,3509,0.0,35,33,7,1,2,94.28571429
2012020486,16,3600,0.0,16,16,3,0,0,100.0
2012020487,29,3900,0.0,34,34,6,1,0,100.0
2012020487,23,3900,0.0,17,17,1,0,0,100.0
2012020488,8,2398,0.0,26,22,1,3,4,84.61538462
2012020488,8,1422,0.0,15,14,6,1,1,93.33333333
2012020488,6,3900,0.0,28,23,4,1,5,82.14285714
2012020489,27,3763,0.0,37,33,5,0,4,89.18918919
2012020489,30,3758,0.0,27,24,1,2,3,88.88888889
2012020490,21,3511,0.0,27,23,5,1,4,85.18518519
2012020490,20,3600,0.0,30,27,2,0,3,90.0
2012020491,24,3600,0.0,29,25,3,0,4,86.20689655
2012020491,28,3600,0.0,22,22,5,1,0,100.0
2012020492,12,3570,0.0,34,30,6,1,4,88.23529412
2012020492,10,3600,0.0,22,19,4,0,3,86.36363636
2012020493,2,3892,0.0,36,33,5,0,3,91.66666667
2012020493,4,3836,0.0,36,33,6,0,3,91.66666667
2012020494,52,3600,0.0,43,39,0,1,4,90.69767442
2012020494,5,3600,0.0,20,20,4,0,0,100.0
2012020495,3,3568,0.0,28,26,3,2,2,92.85714286
2012020495,9,3598,0.0,24,24,2,1,0,100.0
2012020496,7,3897,0.0,40,36,6,0,4,90.0
2012020496,13,3886,0.0,40,36,9,1,4,90.0
2012020497,26,3600,0.0,22,20,4,0,2,90.90909091
2012020497,19,3576,0.0,39,36,4,1,3,92.30769231
2012020498,27,3600,0.0,38,34,6,0,4,89.47368421
2012020498,18,970,0.0,9,6,0,0,3,66.66666667
2012020498,18,2630,0.0,20,16,1,0,4,80.0
2012020499,29,3556,0.0,24,19,2,0,5,79.16666667
2012020499,22,2427,0.0,21,17,0,0,4,80.95238095
2012020499,22,1173,0.0,9,9,0,0,0,100.0
2012020500,21,3555,0.0,18,16,0,0,2,88.88888889
2012020500,23,3600,0.0,33,32,5,0,1,96.96969697
2012020501,17,3480,0.0,24,22,0,0,2,91.66666667
2012020501,28,3600,0.0,27,27,1,0,0,100.0
2012020502,1,3900,0.0,25,21,5,0,4,84.0
2012020502,14,3849,0.0,25,21,6,0,4,84.0
2012020503,24,3600,0.0,26,25,2,0,1,96.15384615
2012020503,16,3514,0.0,24,22,3,3,2,91.66666667
2012020504,30,3552,0.0,33,28,8,0,5,84.84848485
2012020504,25,152,0.0,0,0,0,0,0,
2012020504,25,3448,0.0,33,30,6,1,3,90.90909091
2012020505,29,3600,0.0,33,29,3,0,4,87.87878788
2012020505,20,1167,0.0,4,4,0,1,0,100.0
2012020505,20,2400,0.0,20,15,1,0,5,75.0
2012020506,6,3530,0.0,21,19,0,1,2,90.47619048
2012020506,4,3592,0.0,34,33,1,0,1,97.05882353
2012020507,2,3437,0.0,27,25,4,0,2,92.59259259
2012020507,5,3600,0.0,35,35,6,0,0,100.0
2012020508,12,3600,0.0,35,34,3,5,1,97.14285714
2012020508,52,3498,0.0,28,25,7,0,3,89.28571429
2012020509,18,3642,0.0,24,23,0,0,1,95.83333333
2012020509,21,3650,0.0,34,34,12,0,0,100.0
2012020510,26,3884,2.0,28,25,2,0,3,89.28571429
2012020510,30,3885,0.0,31,28,3,1,3,90.32258065
2012020511,15,3859,0.0,23,20,3,0,3,86.95652174
2012020511,7,3900,0.0,38,35,3,0,3,92.10526316
2012020512,3,3600,0.0,26,23,2,1,3,88.46153846
2012020512,8,3600,0.0,34,34,3,0,0,100.0
2012020513,10,3554,0.0,31,31,6,0,0,100.0
2012020513,9,3598,0.0,23,19,3,2,4,82.60869565
2012020514,1,3700,0.0,30,27,1,1,3,90.0
2012020514,13,3639,0.0,26,24,6,2,2,92.30769231
2012020515,23,3453,0.0,22,20,0,0,2,90.90909091
2012020515,23,125,0.0,2,0,0,0,2,0.0
2012020515,22,3600,0.0,23,23,6,0,0,100.0
2012020516,27,3899,0.0,34,32,3,0,2,94.11764706
2012020516,28,3900,0.0,29,27,0,0,2,93.10344828
2012020517,16,3600,0.0,34,33,5,0,1,97.05882353
2012020517,17,1432,0.0,14,10,0,0,4,71.42857143
2012020517,17,2168,0.0,12,9,0,0,3,75.0
2012020518,24,3840,0.0,18,16,1,0,2,88.88888889
2012020518,29,3840,0.0,30,29,1,0,1,96.66666667
2012020519,6,3600,0.0,26,26,5,0,0,100.0
2012020519,7,3473,0.0,31,29,0,3,2,93.5483871
2012020520,26,3597,0.0,15,13,1,0,2,86.66666667
2012020520,25,3543,0.0,40,37,2,0,3,92.5
2012020521,15,3691,0.0,34,29,4,3,5,85.29411765
2012020521,4,3612,0.0,29,25,6,1,4,86.20689655
2012020522,2,3600,0.0,25,24,0,0,1,96.0
2012020522,1,3473,0.0,21,18,1,0,3,85.71428571
2012020523,52,3545,0.0,35,31,3,0,4,88.57142857
2012020523,3,3600,0.0,28,26,7,0,2,92.85714286
2012020524,12,3534,0.0,28,25,2,0,3,89.28571429
2012020524,8,3597,0.0,19,18,2,0,1,94.73684211
2012020525,21,1699,0.0,7,7,0,0,0,100.0
2012020525,21,1794,0.0,13,10,0,0,3,76.92307692
2012020525,17,3594,0.0,24,22,4,0,2,91.66666667
2012020526,19,1187,0.0,5,5,0,0,0,100.0
2012020526,19,2413,0.0,20,19,4,0,1,95.0
2012020526,30,3575,0.0,24,20,2,0,4,83.33333333
2012020527,18,3900,0.0,40,38,7,0,2,95.0
2012020527,16,3900,0.0,27,25,0,0,2,92.59259259
2012020528,24,3600,0.0,26,26,4,0,0,100.0
2012020528,25,3555,0.0,29,26,2,0,3,89.65517241
2012020529,20,2612,0.0,14,13,0,0,1,92.85714286
2012020529,20,988,0.0,6,3,0,0,3,50.0
2012020529,22,3600,0.0,34,33,1,0,1,97.05882353
2012020530,23,3523,0.0,35,32,5,0,3,91.42857143
2012020530,28,3600,0.0,25,23,0,1,2,92.0
2012020531,9,3553,0.0,50,47,6,1,3,94.0
2012020531,6,3600,0.0,47,45,7,2,2,95.74468085
2012020532,52,3533,0.0,38,34,0,0,4,89.47368421
2012020532,2,3600,0.0,25,23,0,1,2,92.0
2012020533,15,3600,0.0,34,31,3,0,3,91.17647059
2012020533,12,1466,0.0,7,4,0,0,3,57.14285714
2012020533,12,2024,0.0,12,10,2,1,2,83.33333333
2012020534,7,3600,0.0,20,19,4,1,1,95.0
2012020534,5,2174,0.0,16,16,9,0,0,100.0
2012020534,5,1399,0.0,13,9,0,0,4,69.23076923
2012020535,13,3900,0.0,41,39,4,0,2,95.12195122
2012020535,14,3900,0.0,25,23,1,0,2,92.0
2012020536,21,3555,2.0,37,35,5,0,2,94.59459459
2012020536,18,3600,0.0,26,25,1,0,1,96.15384615
2012020537,26,3561,0.0,31,28,0,0,3,90.32258065
2012020537,27,3600,0.0,40,39,4,1,1,97.5
2012020538,5,3600,0.0,39,33,1,0,6,84.61538462
2012020538,3,3600,0.0,27,26,3,0,1,96.2962963
2012020539,8,3575,0.0,33,29,5,2,4,87.87878788
2012020539,4,3600,0.0,17,14,2,0,3,82.35294118
2012020540,22,3600,0.0,21,19,1,1,2,90.47619048
2012020540,20,3600,0.0,39,31,5,1,8,79.48717949
2012020541,25,3554,0.0,26,22,0,0,4,84.61538462
2012020541,24,3588,0.0,25,23,0,0,2,92.0
2012020542,30,3512,0.0,33,29,9,0,4,87.87878788
2012020542,28,3600,0.0,33,31,4,4,2,93.93939394
2012020543,1,3518,0.0,26,25,1,0,1,96.15384615
2012020543,6,3600,0.0,40,40,2,1,0,100.0
2012020544,4,3594,0.0,28,25,2,0,3,89.28571429
2012020544,10,3534,0.0,30,26,6,1,4,86.66666667
2012020545,2,3900,0.0,22,21,3,0,1,95.45454545
2012020545,15,3900,0.0,36,35,3,0,1,97.22222222
2012020546,14,3583,0.0,45,45,5,0,0,100.0
2012020546,12,3600,0.0,30,25,2,0,5,83.33333333
2012020547,52,3600,0.0,24,20,4,0,4,83.33333333
2012020547,8,3586,0.0,34,33,6,0,1,97.05882353
2012020548,29,3600,0.0,39,38,3,0,1,97.43589744
2012020548,18,3496,2.0,38,35,1,1,3,92.10526316
2012020549,19,3900,0.0,36,33,3,0,3,91.66666667
2012020549,16,3900,0.0,22,19,0,0,3,86.36363636
2012020550,22,3572,0.0,28,24,1,0,4,85.71428571
2012020550,23,3569,0.0,23,23,6,1,0,100.0
2012020551,17,3462,0.0,37,34,9,3,3,91.89189189
2012020551,27,3600,0.0,36,34,6,0,2,94.44444444
2012020552,30,187,0.0,2,0,0,0,2,0.0
2012020552,30,3413,0.0,12,11,2,0,1,91.66666667
2012020552,26,3600,0.0,23,23,1,0,0,100.0
2012020553,9,3459,0.0,30,26,3,1,4,86.66666667
2012020553,7,3600,0.0,37,35,5,0,2,94.59459459
2012020554,3,3900,0.0,27,26,3,1,1,96.2962963
2012020554,5,3900,0.0,35,34,3,0,1,97.14285714
2012020555,29,3535,0.0,18,16,3,0,2,88.88888889
2012020555,19,3600,0.0,27,26,1,2,1,96.2962963
2012020556,17,3862,0.0,35,33,3,2,2,94.28571429
2012020556,21,3882,0.0,31,28,3,1,3,90.32258065
2012020557,25,3575,0.0,28,27,5,0,1,96.42857143
2012020557,24,3595,0.0,25,22,7,0,3,88.0
2012020558,20,3505,0.0,41,39,5,1,2,95.12195122
2012020558,28,3600,0.0,24,23,1,0,1,95.83333333
2012020559,4,2400,0.0,16,12,1,0,4,75.0
2012020559,4,1200,0.0,9,9,1,1,0,100.0
2012020559,52,3587,0.0,31,30,4,2,1,96.77419355
2012020560,16,3600,0.0,20,20,1,0,0,100.0
2012020560,18,3518,0.0,30,29,1,1,1,96.66666667
2012020561,22,3503,0.0,38,35,5,0,3,92.10526316
2012020561,26,3592,0.0,24,23,5,0,1,95.83333333
2012020562,6,3543,0.0,29,27,0,0,2,93.10344828
2012020562,8,3600,0.0,27,26,0,0,1,96.2962963
2012020563,10,3593,0.0,28,27,1,1,1,96.42857143
2012020563,1,3529,0.0,18,16,2,1,2,88.88888889
2012020564,14,3533,0.0,27,24,1,2,3,88.88888889
2012020564,2,3600,0.0,21,19,3,0,2,90.47619048
2012020565,3,3600,0.0,49,48,5,1,1,97.95918367
2012020565,12,2360,0.0,30,27,8,1,3,90.0
2012020565,12,1110,0.0,8,8,6,0,0,100.0
2012020566,15,3597,0.0,30,27,1,0,3,90.0
2012020566,13,3497,0.0,31,27,5,0,4,87.09677419
2012020566,13,52,0.0,0,0,0,0,0,
2012020567,21,3600,0.0,28,24,1,1,4,85.71428571
2012020567,27,3600,0.0,24,24,6,1,0,100.0
2012020568,20,3505,0.0,21,17,0,0,4,80.95238095
2012020568,23,3583,0.0,38,36,2,0,2,94.73684211
2012020569,19,3600,0.0,28,28,2,1,0,100.0
2012020569,17,3516,0.0,25,24,2,1,1,96.0
2012020570,25,3900,0.0,36,32,4,1,4,88.88888889
2012020570,28,3900,0.0,34,30,7,2,4,88.23529412
2012020571,9,3540,0.0,17,15,1,0,2,88.23529412
2012020571,13,3600,0.0,41,40,6,0,1,97.56097561
2012020572,30,3600,0.0,24,24,3,0,0,100.0
2012020572,29,3600,0.0,24,21,3,1,3,87.5
2012020573,14,3549,0.0,37,34,2,0,3,91.89189189
2012020573,15,3600,0.0,30,28,3,0,2,93.33333333
2012020574,18,3565,0.0,39,35,2,0,4,89.74358974
2012020574,16,3600,0.0,22,19,2,0,3,86.36363636
2012020575,1,3900,0.0,26,24,2,1,2,92.30769231
2012020575,7,3900,0.0,39,37,9,1,2,94.87179487
2012020576,26,3860,0.0,22,19,4,0,3,86.36363636
2012020576,24,3900,0.0,38,35,2,1,3,92.10526316
2012020577,12,3119,0.0,32,28,4,0,4,87.5
2012020577,12,478,0.0,4,2,0,0,2,50.0
2012020577,6,3600,0.0,42,40,2,1,2,95.23809524
2012020578,3,3515,0.0,28,24,3,0,4,85.71428571
2012020578,10,3600,0.0,34,31,4,0,3,91.17647059
2012020579,20,3600,0.0,40,39,9,1,1,97.5
2012020579,21,3472,0.0,34,31,10,0,3,91.17647059
2012020580,27,3513,0.0,41,40,7,0,1,97.56097561
2012020580,23,3600,0.0,19,19,0,1,0,100.0
2012020581,22,3528,0.0,38,36,11,1,2,94.73684211
2012020581,24,3600,0.0,28,27,3,1,1,96.42857143
2012020582,4,3578,0.0,31,28,0,0,3,90.32258065
2012020582,2,3600,0.0,27,26,1,1,1,96.2962963
2012020583,5,3595,0.0,28,25,0,1,3,89.28571429
2012020583,12,3537,0.0,32,28,2,0,4,87.5
2012020584,28,764,0.0,4,4,0,0,0,100.0
2012020584,28,2825,0.0,26,22,5,0,4,84.61538462
2012020584,29,3600,0.0,30,30,4,0,0,100.0
2012020585,15,3600,0.0,29,27,2,0,2,93.10344828
2012020585,8,3557,0.0,27,24,1,0,3,88.88888889
2012020586,9,3522,0.0,24,21,6,0,3,87.5
2012020586,14,3600,2.0,33,31,2,1,2,93.93939394
2012020587,7,3501,0.0,29,26,3,1,3,89.65517241
2012020587,52,3600,0.0,30,29,5,0,1,96.66666667
2012020588,19,3598,0.0,15,15,0,0,0,100.0
2012020588,18,3547,0.0,26,25,1,0,1,96.15384615
2012020589,16,3600,0.0,20,20,1,0,0,100.0
2012020589,30,3523,0.0,31,30,2,0,1,96.77419355
2012020590,26,3600,0.0,31,26,3,2,5,83.87096774
2012020590,25,2742,0.0,22,22,8,0,0,100.0
2012020590,25,858,0.0,8,7,1,0,1,87.5
2012020591,6,3600,0.0,28,24,8,0,4,85.71428571
2012020591,1,3427,0.0,18,13,1,3,5,72.22222222
2012020592,10,3878,0.0,28,26,1,1,2,92.85714286
2012020592,3,3900,0.0,25,23,0,0,2,92.0
2012020593,23,3600,0.0,41,40,1,3,1,97.56097561
2012020593,20,3575,0.0,29,25,4,3,4,86.20689655
2012020594,27,3579,0.0,30,29,3,0,1,96.66666667
2012020594,22,3459,0.0,32,29,4,0,3,90.625
2012020595,21,3600,0.0,22,21,3,0,1,95.45454545
2012020595,24,1200,0.0,12,12,0,0,0,100.0
2012020595,24,2400,0.0,16,12,5,0,4,75.0
2012020596,2,3600,0.0,31,30,1,1,1,96.77419355
2012020596,6,3517,0.0,36,34,3,0,2,94.44444444
2012020597,8,3572,0.0,15,14,0,0,1,93.33333333
2012020597,7,1200,0.0,10,9,5,1,1,90.0
2012020597,7,2400,0.0,32,28,4,0,4,87.5
2012020598,9,3600,0.0,25,24,5,2,1,96.0
2012020598,4,3536,0.0,33,31,7,0,2,93.93939394
2012020599,12,3520,0.0,30,28,3,0,2,93.33333333
2012020599,15,3600,0.0,44,43,7,0,1,97.72727273
2012020600,5,3586,0.0,19,16,2,0,3,84.21052632
2012020600,14,3598,0.0,41,35,10,1,6,85.36585366
2012020601,28,3892,0.0,29,27,4,1,2,93.10344828
2012020601,17,3886,0.0,30,28,7,0,2,93.33333333
2012020602,13,1918,0.0,23,17,3,0,6,73.91304348
2012020602,13,1682,0.0,12,11,10,0,1,91.66666667
2012020602,52,3600,0.0,27,25,4,0,2,92.59259259
2012020603,19,3600,0.0,23,23,3,0,0,100.0
2012020603,30,3524,0.0,20,18,3,0,2,90.0
2012020604,21,936,0.0,12,12,2,0,0,100.0
2012020604,21,2960,0.0,25,23,5,1,2,92.0
2012020604,26,3895,0.0,28,26,1,0,2,92.85714286
2012020605,9,3600,0.0,33,33,7,1,0,100.0
2012020605,1,3449,0.0,11,9,0,0,2,81.81818182
2012020606,19,3600,0.0,19,15,0,0,4,78.94736842
2012020606,29,3600,0.0,32,31,5,0,1,96.875
2012020607,25,3600,0.0,28,26,3,0,2,92.85714286
2012020607,18,3600,0.0,18,13,3,0,5,72.22222222
2012020608,17,3888,0.0,28,26,5,1,2,92.85714286
2012020608,16,3900,0.0,29,27,6,0,2,93.10344828
2012020609,27,3876,0.0,25,22,2,0,3,88.0
2012020609,20,3876,0.0,31,29,3,1,2,93.5483871
2012020610,4,3507,0.0,21,20,0,0,1,95.23809524
2012020610,7,3600,0.0,29,29,1,0,0,100.0
2012020611,23,3597,0.0,26,22,1,0,4,84.61538462
2012020611,21,3600,0.0,27,24,5,0,3,88.88888889
2012020612,8,625,0.0,4,1,0,0,3,25.0
2012020612,8,2949,0.0,24,22,4,0,2,91.66666667
2012020612,10,3588,0.0,37,36,3,2,1,97.2972973
2012020613,3,3791,0.0,29,29,1,0,0,100.0
2012020613,2,3752,0.0,20,19,5,0,1,95.0
2012020614,14,1200,0.0,20,17,6,0,3,85.0
2012020614,14,2554,0.0,18,15,2,0,3,83.33333333
2012020614,15,3779,0.0,40,35,7,1,5,87.5
2012020615,6,3584,0.0,37,34,6,0,3,91.89189189
2012020615,12,3598,0.0,30,28,9,0,2,93.33333333
2012020616,5,3600,0.0,26,25,5,2,1,96.15384615
2012020616,13,3597,0.0,21,19,4,1,2,90.47619048
2012020617,29,3900,0.0,41,39,5,0,2,95.12195122
2012020617,30,3900,0.0,22,20,2,0,2,90.90909091
2012020618,28,3514,0.0,19,17,2,0,2,89.47368421
2012020618,25,3600,0.0,32,31,4,1,1,96.875
2012020619,20,3589,0.0,29,28,4,0,1,96.55172414
2012020619,22,3600,0.0,38,34,10,0,4,89.47368421
2012020620,24,3556,0.0,18,16,0,0,2,88.88888889
2012020620,26,3600,0.0,20,19,1,1,1,95.0
2012020621,16,3600,0.0,30,30,5,1,0,100.0
2012020621,19,3497,0.0,26,24,0,0,2,92.30769231
2012020622,14,3480,0.0,22,19,2,0,3,86.36363636
2012020622,7,3597,0.0,33,32,1,2,1,96.96969697
2012020623,17,3583,0.0,22,22,2,1,0,100.0
2012020623,18,3562,0.0,31,29,2,0,2,93.5483871
2012020624,9,3600,0.0,36,34,3,0,2,94.44444444
2012020624,6,3588,0.0,21,18,1,1,3,85.71428571
2012020625,1,3564,0.0,12,11,1,0,1,91.66666667
2012020625,10,3600,0.0,32,32,7,2,0,100.0
2012020626,4,3600,0.0,28,25,4,2,3,89.28571429
2012020626,8,2376,0.0,29,23,4,5,6,79.31034483
2012020626,8,1200,0.0,4,3,0,1,1,75.0
2012020627,25,3458,0.0,27,23,5,1,4,85.18518519
2012020627,16,3592,0.0,18,16,4,0,2,88.88888889
2012020628,23,3600,0.0,38,36,1,2,2,94.73684211
2012020628,18,3600,2.0,24,19,3,0,5,79.16666667
2012020629,29,3861,0.0,32,29,3,1,3,90.625
2012020629,21,3869,0.0,30,26,0,1,4,86.66666667
2012020630,30,3600,0.0,23,20,1,0,3,86.95652174
2012020630,20,3524,0.0,27,23,4,0,4,85.18518519
2012020631,28,3600,0.0,35,35,1,1,0,100.0
2012020631,27,3598,0.0,41,37,7,0,4,90.24390244
2012020632,13,1413,0.0,18,13,4,0,5,72.22222222
2012020632,13,2180,0.0,13,13,0,1,0,100.0
2012020632,2,3600,0.0,28,26,7,1,2,92.85714286
2012020633,10,3560,2.0,37,32,5,1,5,86.48648649
2012020633,15,3591,0.0,30,29,4,1,1,96.66666667
2012020634,12,3546,0.0,34,31,8,2,3,91.17647059
2012020634,9,3600,0.0,34,32,3,1,2,94.11764706
2012020635,3,3537,0.0,21,18,4,3,3,85.71428571
2012020635,4,3600,0.0,40,38,8,0,2,95.0
2012020636,14,3898,0.0,36,33,4,1,3,91.66666667
2012020636,52,3900,0.0,27,24,1,0,3,88.88888889
2012020637,23,3900,0.0,36,35,8,1,1,97.22222222
2012020637,19,3900,0.0,22,21,3,2,1,95.45454545
2012020638,30,3600,0.0,19,16,0,0,3,84.21052632
2012020638,22,3453,0.0,30,25,5,1,5,83.33333333
2012020639,26,3900,0.0,35,33,5,1,2,94.28571429
2012020639,28,3888,0.0,43,41,6,0,2,95.34883721
2012020640,8,2373,0.0,20,17,8,0,3,85.0
2012020640,8,1200,0.0,9,6,2,0,3,66.66666667
2012020640,5,3600,0.0,35,31,2,1,4,88.57142857
2012020641,7,3851,0.0,43,41,0,6,2,95.34883721
2012020641,6,3900,0.0,32,30,6,2,2,93.75
2012020642,17,3534,0.0,17,14,0,1,3,82.35294118
2012020642,20,3600,0.0,38,36,7,0,2,94.73684211
2012020643,29,3709,0.0,28,26,1,1,2,92.85714286
2012020643,24,3737,0.0,28,25,6,1,3,89.28571429
2012020644,2,3600,2.0,21,18,2,0,3,85.71428571
2012020644,10,3541,0.0,38,33,2,0,5,86.84210526
2012020645,13,3600,0.0,30,24,0,0,6,80.0
2012020645,3,3600,0.0,35,34,4,2,1,97.14285714
2012020646,14,3585,0.0,35,32,6,0,3,91.42857143
2012020646,8,3587,0.0,34,32,1,3,2,94.11764706
2012020647,15,3590,0.0,37,35,1,1,2,94.59459459
2012020647,9,3600,0.0,19,18,4,0,1,94.73684211
2012020648,1,3600,0.0,23,23,4,0,0,100.0
2012020648,4,3571,0.0,30,28,5,1,2,93.33333333
2012020649,12,3677,0.0,31,27,8,0,4,87.09677419
2012020649,52,3676,0.0,27,24,3,0,3,88.88888889
2012020650,27,3849,0.0,30,29,0,0,1,96.66666667
2012020650,19,3863,0.0,34,33,4,0,1,97.05882353
2012020651,23,3600,0.0,30,25,4,0,5,83.33333333
2012020651,25,3600,0.0,38,37,4,2,1,97.36842105
2012020652,29,3525,0.0,23,21,3,0,2,91.30434783
2012020652,26,3600,0.0,21,20,3,0,1,95.23809524
2012020653,30,2661,0.0,27,22,0,0,5,81.48148148
2012020653,30,939,0.0,2,1,0,0,1,50.0
2012020653,28,3600,0.0,28,27,0,0,1,96.42857143
2012020654,5,3600,0.0,40,38,1,1,2,95.0
2012020654,6,3519,0.0,24,21,6,0,3,87.5
2012020655,3,3600,0.0,28,24,4,0,4,85.71428571
2012020655,7,2327,0.0,15,11,0,0,4,73.33333333
2012020655,7,1273,0.0,14,10,0,0,4,71.42857143
2012020656,25,3523,0.0,20,18,2,0,2,90.0
2012020656,19,3600,0.0,22,21,1,0,1,95.45454545
2012020657,18,3649,0.0,30,25,1,2,5,83.33333333
2012020657,16,3630,0.0,27,23,3,0,4,85.18518519
2012020658,22,3600,0.0,34,33,7,0,1,97.05882353
2012020658,21,3401,0.0,24,20,5,1,4,83.33333333
2012020659,24,3538,0.0,30,28,6,1,2,93.33333333
2012020659,20,3600,0.0,33,32,2,1,1,96.96969697
2012020660,13,3600,0.0,33,27,0,0,6,81.81818182
2012020660,1,3592,0.0,13,11,0,0,2,84.61538462
2012020661,2,3870,0.0,28,24,4,1,4,85.71428571
2012020661,52,3893,0.0,33,29,5,0,4,87.87878788
2012020662,15,3600,0.0,36,35,7,2,1,97.22222222
2012020662,8,3600,0.0,25,20,2,0,5,80.0
2012020663,10,3600,0.0,50,49,5,0,1,98.0
2012020663,9,3578,0.0,22,18,2,1,4,81.81818182
2012020664,7,3600,0.0,42,40,4,0,2,95.23809524
2012020664,5,3544,0.0,32,29,0,0,3,90.625
2012020665,4,3600,0.0,29,26,3,1,3,89.65517241
2012020665,12,3485,0.0,38,33,3,1,5,86.84210526
2012020666,27,3900,0.0,38,36,4,2,2,94.73684211
2012020666,16,3898,0.0,31,29,6,0,2,93.5483871
2012020667,17,3892,0.0,14,13,5,0,1,92.85714286
2012020667,23,3898,0.0,34,33,5,0,1,97.05882353
2012020668,13,3570,0.0,38,36,4,1,2,94.73684211
2012020668,6,3600,0.0,28,28,1,0,0,100.0
2012020669,12,3600,0.0,37,35,5,0,2,94.59459459
2012020669,14,3579,0.0,28,25,7,0,3,89.28571429
2012020670,20,3600,0.0,35,34,7,0,1,97.14285714
2012020670,30,3566,0.0,23,20,1,0,3,86.95652174
2012020671,1,3450,0.0,22,18,4,0,4,81.81818182
2012020671,3,3587,0.0,27,26,1,1,1,96.2962963
2012020672,19,2243,0.0,19,15,0,0,4,78.94736842
2012020672,19,1357,0.0,12,11,0,0,1,91.66666667
2012020672,21,3600,0.0,32,29,5,1,3,90.625
2012020673,24,3577,0.0,28,27,4,0,1,96.42857143
2012020673,22,3481,0.0,30,27,7,0,3,90.0
2012020674,29,3598,0.0,35,32,1,0,3,91.42857143
2012020674,28,3479,0.0,22,18,2,0,4,81.81818182
2012020675,25,3848,0.0,31,27,5,2,4,87.09677419
2012020675,26,3848,0.0,27,24,7,0,3,88.88888889
2012020676,52,3600,0.0,25,24,0,0,1,96.0
2012020676,7,3548,0.0,39,37,7,0,2,94.87179487
2012020677,5,3599,0.0,35,34,7,0,1,97.14285714
2012020677,9,3530,0.0,24,21,12,1,3,87.5
2012020678,27,3531,0.0,22,19,2,0,3,86.36363636
2012020678,17,3600,0.0,34,34,4,0,0,100.0
2012020679,24,3588,0.0,24,24,4,0,0,100.0
2012020679,22,3600,0.0,28,25,4,0,3,89.28571429
2012020680,16,3450,2.0,32,29,5,0,3,90.625
2012020680,23,3553,0.0,25,24,0,1,1,96.0
2012020681,8,3546,0.0,24,21,1,0,3,87.5
2012020681,1,3600,0.0,21,19,2,0,2,90.47619048
2012020682,52,3577,0.0,40,36,2,1,4,90.0
2012020682,15,3600,0.0,27,24,3,0,3,88.88888889
2012020683,2,3900,0.0,32,29,0,0,3,90.625
2012020683,12,3900,0.0,39,36,0,0,3,92.30769231
2012020684,6,2341,0.0,16,13,2,0,3,81.25
2012020684,6,1259,0.0,13,11,0,0,2,84.61538462
2012020684,4,3600,0.0,41,39,5,1,2,95.12195122
2012020685,3,3518,0.0,15,13,1,0,2,86.66666667
2012020685,13,3594,0.0,38,36,2,0,2,94.73684211
2012020686,21,3505,0.0,34,31,3,0,3,91.17647059
2012020686,19,3591,0.0,18,17,5,0,1,94.44444444
2012020687,20,3529,0.0,32,28,3,0,4,87.5
2012020687,18,3582,0.0,18,15,1,0,3,83.33333333
2012020688,26,3561,0.0,25,23,3,1,2,92.0
2012020688,30,3600,0.0,23,22,0,0,1,95.65217391
2012020689,25,3496,0.0,37,34,5,1,3,91.89189189
2012020689,28,3600,0.0,26,24,3,1,2,92.30769231
2012020690,10,3568,0.0,25,21,2,1,4,84.0
2012020690,14,3600,0.0,28,26,2,0,2,92.85714286
2012020691,26,3558,0.0,36,33,3,1,3,91.66666667
2012020691,17,3600,0.0,24,23,1,0,1,95.83333333
2012020692,16,2771,0.0,14,14,3,0,0,100.0
2012020692,16,829,0.0,8,7,2,0,1,87.5
2012020692,22,3546,0.0,29,26,3,0,3,89.65517241
2012020693,28,3509,0.0,32,30,8,1,2,93.75
2012020693,27,3542,0.0,34,33,2,0,1,97.05882353
2012020694,2,3497,0.0,30,28,7,0,2,93.33333333
2012020694,4,3593,0.0,22,21,1,1,1,95.45454545
2012020695,9,3633,0.0,20,19,2,2,1,95.0
2012020695,15,3647,0.0,41,39,7,0,2,95.12195122
2012020696,3,3775,0.0,21,18,1,0,3,85.71428571
2012020696,12,3775,0.0,38,34,4,0,4,89.47368421
2012020697,5,3564,0.0,32,29,1,1,3,90.625
2012020697,1,3600,2.0,18,16,1,0,2,88.88888889
2012020698,10,3600,0.0,34,34,8,0,0,100.0
2012020698,13,3600,0.0,17,13,0,0,4,76.47058824
2012020699,18,3600,0.0,38,33,5,0,5,86.84210526
2012020699,17,3600,0.0,22,20,4,0,2,90.90909091
2012020700,8,3600,0.0,25,23,1,2,2,92.0
2012020700,52,3600,0.0,30,26,4,0,4,86.66666667
2012020701,20,3600,0.0,20,16,4,0,4,80.0
2012020701,19,3600,0.0,19,18,5,2,1,94.73684211
2012020702,29,3596,0.0,32,31,1,0,1,96.875
2012020702,25,3529,0.0,35,32,4,1,3,91.42857143
2012020703,24,3600,0.0,29,28,2,0,1,96.55172414
2012020703,23,3552,0.0,29,27,1,0,2,93.10344828
2012020704,2,3883,0.0,22,21,1,0,1,95.45454545
2012020704,7,3900,0.0,31,30,6,1,1,96.77419355
2012020705,22,3600,0.0,39,38,3,0,1,97.43589744
2012020705,30,2479,0.0,12,9,0,0,3,75.0
2012020705,30,1118,0.0,5,2,0,0,3,40.0
2012020706,20,3557,0.0,38,35,4,0,3,92.10526316
2012020706,16,3600,0.0,26,25,0,1,1,96.15384615
2012020707,21,3344,2.0,31,27,3,0,4,87.09677419
2012020707,21,556,0.0,6,6,0,0,0,100.0
2012020707,27,3900,0.0,28,24,4,3,4,85.71428571
2012020708,8,3600,0.0,17,16,4,0,1,94.11764706
2012020708,10,1041,0.0,5,5,3,0,0,100.0
2012020708,10,2543,0.0,23,19,4,1,4,82.60869565
2012020709,4,3599,0.0,44,43,8,1,1,97.72727273
2012020709,9,3554,0.0,25,23,0,0,2,92.0
2012020710,12,3600,0.0,35,27,3,0,8,77.14285714
2012020710,5,3600,0.0,30,27,1,0,3,90.0
2012020711,6,3803,0.0,37,34,9,0,3,91.89189189
2012020711,15,3802,0.0,34,32,6,1,2,94.11764706
2012020712,13,3600,0.0,31,28,2,3,3,90.32258065
2012020712,14,3553,0.0,31,27,1,0,4,87.09677419
2012020713,18,3548,0.0,46,44,6,0,2,95.65217391
2012020713,29,3600,0.0,20,19,0,0,1,95.0
2012020714,1,3600,0.0,21,17,0,2,4,80.95238095
2012020714,3,3600,0.0,20,20,5,3,0,100.0
2012020715,30,3600,0.0,30,29,4,0,1,96.66666667
2012020715,21,3502,0.0,32,30,7,0,2,93.75
2012020716,16,3524,0.0,28,25,5,0,3,89.28571429
2012020716,19,3589,0.0,23,22,2,0,1,95.65217391
2012020717,17,3600,0.0,17,17,0,1,0,100.0
2012020717,25,3600,0.0,37,34,5,0,3,91.89189189
2012020718,23,3595,0.0,37,30,8,1,7,81.08108108
2012020718,22,3600,0.0,30,28,4,0,2,93.33333333
2012020719,27,3600,0.0,46,43,2,0,3,93.47826087
2012020719,24,3497,0.0,30,26,0,4,4,86.66666667
2012020720,28,3520,0.0,27,24,2,0,3,88.88888889
2012020720,26,3596,0.0,25,23,0,0,2,92.0
2012030111,2,2289,0.0,11,10,1,0,1,90.90909091
2012030111,2,1311,0.0,15,11,5,0,4,73.33333333
2012030111,5,3590,0.0,26,26,6,1,0,100.0
2012030112,2,3600,0.0,33,30,9,0,3,90.90909091
2012030112,5,3546,0.0,42,38,5,0,4,90.47619048
2012030113,5,4124,0.0,36,32,5,0,4,88.88888889
2012030113,2,4121,0.0,25,20,1,1,5,80.0
2012030114,5,3550,0.0,24,18,3,0,6,75.0
2012030114,2,3600,0.0,31,27,2,1,4,87.09677419
2012030115,2,857,0.0,4,4,4,0,0,100.0
2012030115,2,2743,0.0,27,23,2,0,4,85.18518519
2012030115,5,3586,0.0,31,31,4,0,0,100.0
2012030116,5,4069,0.0,38,35,6,1,3,92.10526316
2012030116,2,4069,0.0,21,17,0,0,4,80.95238095
2012030121,9,3600,0.0,50,48,11,4,2,96.0
2012030121,8,3545,0.0,31,27,2,1,4,87.09677419
2012030122,9,3541,0.0,34,31,5,3,3,91.17647059
2012030122,8,3600,0.0,30,29,7,0,1,96.66666667
2012030123,8,3600,0.0,30,24,7,1,6,80.0
2012030123,9,3593,0.0,34,33,6,1,1,97.05882353
2012030124,8,3600,0.0,32,30,1,0,2,93.75
2012030124,8,152,0.0,2,1,0,0,1,50.0
2012030124,9,3690,0.0,28,26,2,0,2,92.85714286
2012030125,9,3600,0.0,34,33,8,1,1,97.05882353
2012030125,8,3600,0.0,29,23,6,2,6,79.31034483
2012030131,3,3495,0.0,30,27,6,1,3,90.0
2012030131,15,3594,0.0,36,35,8,1,1,97.22222222
2012030132,3,4072,0.0,38,37,5,0,1,97.36842105
2012030132,15,4079,0.0,24,24,2,0,0,100.0
2012030133,15,3500,2.0,30,26,11,1,4,86.66666667
2012030133,3,3600,0.0,31,28,1,0,3,90.32258065
2012030134,15,3523,0.0,34,30,4,2,4,88.23529412
2012030134,3,3600,0.0,30,27,2,1,3,90.0
2012030135,3,4164,0.0,35,33,3,0,2,94.28571429
2012030135,15,4164,0.0,25,24,7,0,1,96.0
2012030136,15,3510,0.0,29,28,7,0,1,96.55172414
2012030136,3,3600,0.0,27,27,0,0,0,100.0
2012030137,3,3600,0.0,35,35,2,1,0,100.0
2012030137,15,3600,0.0,27,22,3,0,5,81.48148148
2012030141,10,3600,0.0,40,36,13,1,4,90.0
2012030141,6,3600,0.0,20,19,3,0,1,95.0
2012030142,10,3600,0.0,41,39,0,4,2,95.12195122
2012030142,6,3496,0.0,32,28,3,0,4,87.5
2012030143,6,3592,0.0,47,45,4,1,2,95.74468085
2012030143,10,3570,0.0,37,33,2,0,4,89.18918919
2012030144,6,4386,0.0,48,45,4,0,3,93.75
2012030144,10,4371,0.0,45,41,8,2,4,91.11111111
2012030145,10,3600,0.0,44,43,3,0,1,97.72727273
2012030145,6,3529,0.0,33,31,3,0,2,93.93939394
2012030146,6,3503,0.0,26,24,3,0,2,92.30769231
2012030146,10,3600,0.0,30,29,1,0,1,96.66666667
2012030147,10,3965,0.0,35,30,0,0,5,85.71428571
2012030147,6,3901,0.0,28,24,7,0,4,85.71428571
2012030151,30,4595,0.0,37,35,5,0,2,94.59459459
2012030151,16,4595,0.0,27,26,6,1,1,96.2962963
2012030152,30,3583,0.0,47,43,7,1,4,91.4893617
2012030152,16,3600,0.0,28,26,7,0,2,92.85714286
2012030153,16,3735,0.0,37,34,5,1,3,91.89189189
2012030153,30,3733,0.0,27,25,1,2,2,92.59259259
2012030154,16,3600,0.0,25,25,7,0,0,100.0
2012030154,30,1191,0.0,6,5,0,1,1,83.33333333
2012030154,30,2393,0.0,18,16,1,1,2,88.88888889
2012030155,30,1586,0.0,18,15,0,0,3,83.33333333
2012030155,30,2014,0.0,15,13,1,0,2,86.66666667
2012030155,16,3600,0.0,22,21,4,0,1,95.45454545
2012030161,17,3533,0.0,26,24,0,0,2,92.30769231
2012030161,24,3600,0.0,22,21,5,0,1,95.45454545
2012030162,17,3681,0.0,32,28,7,3,4,87.5
2012030162,24,3681,0.0,32,27,8,0,5,84.375
2012030163,24,3600,0.0,23,23,9,3,0,100.0
2012030163,17,3600,2.0,29,25,7,0,4,86.20689655
2012030164,24,4510,0.0,49,46,2,1,3,93.87755102
2012030164,17,4510,0.0,33,31,6,1,2,93.93939394
2012030165,17,3714,0.0,34,31,6,0,3,91.17647059
2012030165,24,3714,0.0,31,29,3,0,2,93.5483871
2012030166,24,3664,0.0,29,25,5,0,4,86.20689655
2012030166,17,3664,0.0,37,34,0,3,3,91.89189189
2012030167,17,3600,0.0,33,31,6,1,2,93.93939394
2012030167,24,3551,0.0,32,29,0,0,3,90.625
2012030171,28,3600,0.0,30,29,3,0,1,96.66666667
2012030171,23,3497,0.0,28,25,9,0,3,89.28571429
2012030172,28,3888,0.0,31,29,1,2,2,93.5483871
2012030172,23,3931,0.0,33,30,4,0,3,90.90909091
2012030173,23,953,0.0,10,10,5,0,0,100.0
2012030173,23,2647,0.0,28,23,6,0,5,82.14285714
2012030173,28,3600,0.0,30,28,4,3,2,93.33333333
2012030174,23,4398,0.0,47,43,14,0,4,91.4893617
2012030174,28,4398,0.0,35,32,2,1,3,91.42857143
2012030181,26,4388,2.0,42,40,7,0,2,95.23809524
2012030181,19,4406,0.0,29,28,2,2,1,96.55172414
2012030182,26,3556,0.0,25,23,1,1,2,92.0
2012030182,19,3600,0.0,29,28,3,0,1,96.55172414
2012030183,19,3547,0.0,21,20,2,1,1,95.23809524
2012030183,26,3600,0.0,30,30,5,3,0,100.0
2012030184,19,3541,0.0,29,25,4,0,4,86.20689655
2012030184,26,3600,0.0,22,19,2,0,3,86.36363636
2012030185,26,4080,0.0,36,34,4,0,2,94.44444444
2012030185,19,4059,0.0,25,22,0,0,3,88.0
2012030186,19,3556,0.0,16,14,0,0,2,87.5
2012030186,26,3600,0.0,22,21,1,0,1,95.45454545
2012030211,9,3586,0.0,30,26,2,1,4,86.66666667
2012030211,5,3590,0.0,36,35,7,1,1,97.22222222
2012030212,9,1275,0.0,21,18,7,0,3,85.71428571
2012030212,9,2283,0.0,21,20,3,0,1,95.23809524
2012030212,5,3600,0.0,22,19,1,2,3,86.36363636
2012030213,5,5259,0.0,48,46,2,2,2,95.83333333
2012030213,9,5256,0.0,50,49,12,0,1,98.0
2012030214,5,3600,0.0,33,30,5,0,3,90.90909091
2012030214,9,2919,0.0,38,32,3,0,6,84.21052632
2012030214,9,681,0.0,4,3,1,0,1,75.0
2012030215,9,3600,0.0,33,27,10,0,6,81.81818182
2012030215,5,3595,0.0,31,29,9,0,2,93.5483871
2012030221,3,4540,0.0,48,45,10,1,3,93.75
2012030221,6,4540,0.0,35,33,3,0,2,94.28571429
2012030222,3,3600,0.0,32,27,1,2,5,84.375
2012030222,6,3600,0.0,37,35,7,1,2,94.59459459
2012030223,6,3600,0.0,24,23,2,0,1,95.83333333
2012030223,3,3534,0.0,34,32,0,0,2,94.11764706
2012030224,6,4019,0.0,32,28,5,1,4,87.5
2012030224,3,4023,0.0,40,37,6,0,3,92.5
2012030225,3,3547,0.0,31,29,2,2,2,93.5483871
2012030225,6,3600,0.0,29,28,1,2,1,96.55172414
2012030231,17,3549,0.0,41,38,4,1,3,92.68292683
2012030231,16,3600,0.0,21,20,4,1,1,95.23809524
2012030232,17,3600,0.0,20,19,2,0,1,95.0
2012030232,16,3600,0.0,30,26,6,1,4,86.66666667
2012030233,16,3526,0.0,30,27,6,0,3,90.0
2012030233,17,3600,0.0,40,39,8,2,1,97.5
2012030234,16,3515,0.0,26,25,6,1,1,96.15384615
2012030234,17,3587,0.0,28,28,1,2,0,100.0
2012030235,17,3600,0.0,45,41,4,3,4,91.11111111
2012030235,16,3592,0.0,26,25,6,0,1,96.15384615
2012030236,16,3598,0.0,38,35,5,0,3,92.10526316
2012030236,17,3515,0.0,28,24,5,1,4,85.71428571
2012030237,17,3815,0.0,35,33,3,1,2,94.28571429
2012030237,16,3815,0.0,27,26,4,0,1,96.2962963
2012030241,28,3488,0.0,20,18,0,0,2,90.0
2012030241,26,3600,0.0,35,35,4,0,0,100.0
2012030242,28,3532,0.0,31,27,8,1,4,87.09677419
2012030242,26,3597,0.0,31,28,6,1,3,90.32258065
2012030243,26,3689,10.0,40,38,4,1,2,95.0
2012030243,28,3689,0.0,27,26,3,0,1,96.2962963
2012030244,26,3534,0.0,23,21,4,0,2,91.30434783
2012030244,28,3598,0.0,23,22,1,1,1,95.65217391
2012030245,28,3491,0.0,28,26,2,2,2,92.85714286
2012030245,26,3600,0.0,24,24,4,1,0,100.0
2012030246,26,3504,0.0,26,24,4,0,2,92.30769231
2012030246,28,3600,0.0,25,24,3,0,1,96.0
2012030247,28,3503,0.0,18,16,2,0,2,88.88888889
2012030247,26,3600,2.0,26,25,1,0,1,96.15384615
2012030311,6,3600,0.0,29,29,9,1,0,100.0
2012030311,5,3600,0.0,30,27,4,3,3,90.0
2012030312,6,3600,0.0,27,26,3,0,1,96.2962963
2012030312,5,991,0.0,12,9,3,0,3,75.0
2012030312,5,2604,0.0,17,14,0,0,3,82.35294118
2012030313,5,5719,0.0,40,38,4,1,2,95.0
2012030313,6,5719,0.0,54,53,13,3,1,98.14814815
2012030314,5,3504,0.0,24,23,2,0,1,95.83333333
2012030314,6,3600,0.0,26,26,2,0,0,100.0
2012030321,26,3600,0.0,36,34,5,1,2,94.44444444
2012030321,16,3600,0.0,22,21,3,0,1,95.45454545
2012030322,26,1760,0.0,17,13,2,0,4,76.47058824
2012030322,26,1795,0.0,9,9,2,1,0,100.0
2012030322,16,3597,0.0,31,29,8,0,2,93.5483871
2012030323,16,3533,0.0,27,25,6,0,2,92.59259259
2012030323,26,3597,0.0,20,19,3,0,1,95.0
2012030324,16,3593,0.0,21,19,1,1,2,90.47619048
2012030324,26,3541,0.0,28,25,3,1,3,89.28571429
2012030325,26,5494,0.0,35,31,1,0,4,88.57142857
2012030325,16,5500,0.0,36,33,3,0,3,91.66666667
2012030411,6,6725,0.0,63,59,2,0,4,93.65079365
2012030411,16,6728,0.0,54,51,5,0,3,94.44444444
2012030412,6,4428,0.0,34,33,2,2,1,97.05882353
2012030412,16,4428,0.0,28,26,3,0,2,92.85714286
2012030413,16,3497,0.0,35,33,9,1,2,94.28571429
2012030413,6,3600,0.0,28,28,4,1,0,100.0
2012030414,16,4191,0.0,33,28,4,0,5,84.84848485
2012030414,6,4191,0.0,47,41,3,1,6,87.23404255
2012030415,6,3562,0.0,31,29,1,0,2,93.5483871
2012030415,16,3600,0.0,25,24,0,0,1,96.0
2012030416,16,3591,0.0,25,23,7,1,2,92.0
2012030416,6,3564,0.0,31,28,2,1,3,90.32258065
2013020001,10,3588,0.0,37,34,4,2,3,91.89189189
2013020001,8,3542,0.0,38,34,14,2,4,89.47368421
2013020002,15,3555,0.0,34,29,7,1,5,85.29411765
2013020002,16,3598,0.0,32,28,10,1,4,87.5
2013020003,52,3600,0.0,38,34,11,1,4,89.47368421
2013020003,22,3473,0.0,28,23,5,0,5,82.14285714
2013020004,10,3600,0.0,32,31,12,0,1,96.875
2013020004,4,3566,0.0,25,22,3,0,3,88.0
2013020005,7,3530,0.0,34,32,6,1,2,94.11764706
2013020005,17,3600,0.0,20,19,7,0,1,95.0
2013020006,24,3600,0.0,29,23,4,0,6,79.31034483
2013020006,21,3600,0.0,36,35,2,0,1,97.22222222
2013020007,14,3483,0.0,25,22,1,2,3,88.0
2013020007,6,3600,0.0,33,32,5,0,1,96.96969697
2013020008,1,3600,0.0,21,18,0,0,3,85.71428571
2013020008,5,3600,0.0,27,27,0,0,0,100.0
2013020009,20,3900,0.0,39,35,3,3,4,89.74358974
2013020009,15,2918,0.0,28,27,4,0,1,96.42857143
2013020009,15,982,0.0,11,8,0,0,3,72.72727273
2013020010,18,585,0.0,6,3,0,0,3,50.0
2013020010,18,3015,0.0,22,21,3,0,1,95.45454545
2013020010,19,3600,0.0,30,28,3,2,2,93.33333333
2013020011,26,3900,0.0,29,27,9,0,2,93.10344828
2013020011,30,3900,0.0,18,16,4,1,2,88.88888889
2013020012,13,3600,0.0,27,25,0,0,2,92.59259259
2013020012,25,3518,0.0,38,35,7,2,3,92.10526316
2013020013,3,3600,0.0,32,28,5,3,4,87.5
2013020013,27,3600,0.0,24,23,8,0,1,95.83333333
2013020014,23,3597,0.0,35,31,11,2,4,88.57142857
2013020014,28,3593,0.0,22,21,1,0,1,95.45454545
2013020015,9,3600,0.0,35,35,4,0,0,100.0
2013020015,7,3521,0.0,46,45,10,1,1,97.82608696
2013020016,2,3900,0.0,29,26,0,1,3,89.65517241
2013020016,1,3900,0.0,26,23,3,0,3,88.46153846
2013020017,17,3725,0.0,25,23,1,2,2,92.0
2013020017,12,3793,0.0,38,35,2,2,3,92.10526316
2013020018,20,3600,0.0,32,29,1,0,3,90.625
2013020018,29,3587,0.0,30,26,5,1,4,86.66666667
2013020019,26,2719,0.0,27,23,6,1,4,85.18518519
2013020019,26,860,0.0,5,5,2,0,0,100.0
2013020019,52,3600,0.0,36,33,6,1,3,91.66666667
2013020020,18,3546,0.0,35,33,3,1,2,94.28571429
2013020020,21,3588,0.0,27,26,6,1,1,96.2962963
2013020021,17,3600,0.0,37,33,5,1,4,89.18918919
2013020021,6,3600,0.0,26,25,3,0,1,96.15384615
2013020022,9,3900,0.0,42,38,7,0,4,90.47619048
2013020022,10,1856,0.0,21,17,1,0,4,80.95238095
2013020022,10,2044,0.0,15,15,0,0,0,100.0
2013020023,4,3598,2.0,34,30,11,1,4,88.23529412
2013020023,8,3593,0.0,23,22,6,4,1,95.65217391
2013020024,29,3900,0.0,30,28,4,0,2,93.33333333
2013020024,2,3900,0.0,29,27,1,0,2,93.10344828
2013020025,7,3597,0.0,34,31,3,2,3,91.17647059
2013020025,5,3600,0.0,21,20,4,1,1,95.23809524
2013020026,14,3885,0.0,39,37,7,0,2,94.87179487
2013020026,16,3895,0.0,16,14,0,0,2,87.5
2013020027,13,2398,0.0,28,23,6,0,5,82.14285714
2013020027,13,1198,0.0,6,4,0,0,2,66.66666667
2013020027,19,3584,0.0,19,19,2,0,0,100.0
2013020028,15,3522,0.0,21,19,1,0,2,90.47619048
2013020028,25,3600,0.0,26,25,5,0,1,96.15384615
2013020029,24,3895,0.0,33,30,2,2,3,90.90909091
2013020029,30,3886,0.0,30,26,5,1,4,86.66666667
2013020030,22,1453,0.0,12,12,6,0,0,100.0
2013020030,22,2036,0.0,31,26,8,0,5,83.87096774
2013020030,23,3596,0.0,23,21,4,1,2,91.30434783
2013020031,27,3520,2.0,50,47,12,1,3,94.0
2013020031,28,3600,0.0,23,22,2,2,1,95.65217391
2013020032,4,3513,0.0,34,32,5,0,2,94.11764706
2013020032,12,3597,0.0,18,17,1,0,1,94.44444444
2013020033,24,3600,0.0,17,15,1,0,2,88.23529412
2013020033,52,3576,0.0,34,31,5,0,3,91.17647059
2013020034,23,3773,0.0,36,32,5,0,4,88.88888889
2013020034,20,3713,0.0,28,23,0,0,5,82.14285714
2013020035,1,3889,0.0,27,23,9,0,4,85.18518519
2013020035,22,3900,0.0,25,21,2,0,4,84.0
2013020036,3,3600,0.0,29,28,3,2,1,96.55172414
2013020036,26,3561,0.0,28,25,1,2,3,89.28571429
2013020037,21,3597,0.0,28,27,5,0,1,96.42857143
2013020037,10,3564,0.0,33,31,4,0,2,93.93939394
2013020038,27,1200,0.0,8,7,1,1,1,87.5
2013020038,27,2400,0.0,20,15,2,0,5,75.0
2013020038,2,3600,0.0,34,33,0,1,1,97.05882353
2013020039,13,451,0.0,5,3,2,0,2,60.0
2013020039,13,3138,0.0,25,25,7,3,0,100.0
2013020039,4,3600,0.0,34,33,5,1,1,97.05882353
2013020040,12,3584,0.0,37,32,0,0,5,86.48648649
2013020040,5,3600,0.0,34,32,6,1,2,94.11764706
2013020041,14,3710,0.0,23,21,5,0,2,91.30434783
2013020041,7,3710,0.0,34,31,4,0,3,91.17647059
2013020042,30,2852,0.0,20,19,3,0,1,95.0
2013020042,30,674,0.0,5,3,1,0,2,60.0
2013020042,18,3599,0.0,34,32,5,0,2,94.11764706
2013020043,1,3738,0.0,32,29,2,0,3,90.625
2013020043,23,3738,0.0,23,21,1,0,2,91.30434783
2013020044,3,1759,0.0,26,22,0,1,4,84.61538462
2013020044,3,1841,0.0,21,16,1,0,5,76.19047619
2013020044,28,3600,0.0,20,18,3,0,2,90.0
2013020045,16,3578,0.0,34,31,2,0,3,91.17647059
2013020045,19,3600,0.0,28,26,1,0,2,92.85714286
2013020046,8,3522,0.0,25,22,1,0,3,88.0
2013020046,20,3600,0.0,35,33,5,0,2,94.28571429
2013020047,9,3628,0.0,32,28,3,0,4,87.5
2013020047,26,3622,0.0,25,22,6,0,3,88.0
2013020048,21,3598,0.0,39,39,7,3,0,100.0
2013020048,6,3552,0.0,29,28,7,1,1,96.55172414
2013020049,29,3585,0.0,27,26,0,1,1,96.2962963
2013020049,7,3600,0.0,33,29,7,0,4,87.87878788
2013020050,12,3600,0.0,32,30,5,0,2,93.75
2013020050,15,3521,0.0,36,33,5,0,3,91.66666667
2013020051,27,3600,0.0,30,28,1,0,2,93.33333333
2013020051,17,3555,0.0,37,34,2,1,3,91.89189189
2013020052,13,2954,0.0,24,18,5,0,6,75.0
2013020052,13,646,0.0,4,3,0,1,1,75.0
2013020052,14,3598,0.0,21,19,4,0,2,90.47619048
2013020053,10,3600,0.0,36,36,9,0,0,100.0
2013020053,18,3600,0.0,26,22,3,0,4,84.61538462
2013020054,52,3524,0.0,30,28,3,1,2,93.33333333
2013020054,30,3600,0.0,15,14,4,1,1,93.33333333
2013020055,8,3600,0.0,28,27,1,0,1,96.42857143
2013020055,22,3354,0.0,26,23,3,1,3,88.46153846
2013020056,28,3587,0.0,26,25,5,2,1,96.15384615
2013020056,23,3540,0.0,28,25,3,0,3,89.28571429
2013020057,3,3600,0.0,37,31,11,0,6,83.78378378
2013020057,24,3600,0.0,34,34,5,0,0,100.0
2013020058,27,3600,0.0,37,36,6,5,1,97.2972973
2013020058,4,3552,0.0,31,29,4,0,2,93.5483871
2013020059,26,3900,0.0,28,27,8,2,1,96.42857143
2013020059,12,3900,0.0,37,36,5,2,1,97.2972973
2013020060,5,3573,0.0,30,24,3,0,6,80.0
2013020060,13,3600,0.0,39,36,6,0,3,92.30769231
2013020061,2,3560,0.0,28,25,4,0,3,89.28571429
2013020061,16,3600,0.0,19,17,3,0,2,89.47368421
2013020062,25,1517,0.0,23,22,6,1,1,95.65217391
2013020062,25,2070,0.0,21,21,3,3,0,100.0
2013020062,52,3392,0.0,31,27,3,2,4,87.09677419
2013020063,1,3498,0.0,29,26,2,0,3,89.65517241
2013020063,20,3600,0.0,21,19,2,0,2,90.47619048
2013020064,22,3729,0.0,26,20,5,0,6,76.92307692
2013020064,10,3703,0.0,31,26,8,0,5,83.87096774
2013020065,4,3532,0.0,29,25,6,1,4,86.20689655
2013020065,17,3600,0.0,34,32,4,1,2,94.11764706
2013020066,5,3600,0.0,18,14,6,0,4,77.77777778
2013020066,14,3593,0.0,26,21,7,0,5,80.76923077
2013020067,21,3600,0.0,41,40,2,0,1,97.56097561
2013020067,15,3597,0.0,28,23,5,1,5,82.14285714
2013020068,6,3598,0.0,27,26,3,0,1,96.2962963
2013020068,29,3541,0.0,35,33,6,0,2,94.28571429
2013020069,7,3513,0.0,40,38,10,1,2,95.0
2013020069,16,3595,0.0,29,28,2,0,1,96.55172414
2013020070,3,1120,0.0,17,16,3,0,1,94.11764706
2013020070,3,2397,0.0,17,13,0,0,4,76.47058824
2013020070,19,3599,0.0,29,26,8,0,3,89.65517241
2013020071,2,3536,0.0,31,28,2,2,3,90.32258065
2013020071,18,3600,0.0,16,14,3,0,2,87.5
2013020072,25,3596,0.0,36,31,6,1,5,86.11111111
2013020072,30,3600,0.0,19,18,4,1,1,94.73684211
2013020073,8,3600,0.0,40,39,11,0,1,97.5
2013020073,23,3600,0.0,38,34,3,-1,4,89.47368421
2013020074,9,3498,4.0,50,47,17,0,3,94.0
2013020074,28,3600,0.0,23,21,5,0,2,91.30434783
2013020075,27,3600,0.0,34,31,12,1,3,91.17647059
2013020075,12,1792,0.0,20,18,1,0,2,90.0
2013020075,12,1724,0.0,12,9,1,0,3,75.0
2013020076,26,3600,0.0,20,20,3,0,0,100.0
2013020076,13,3600,0.0,29,26,1,1,3,89.65517241
2013020077,1,3524,0.0,34,32,4,6,2,94.11764706
2013020077,52,3600,0.0,24,24,5,0,0,100.0
2013020078,9,246,0.0,9,7,0,0,2,77.77777778
2013020078,9,3354,0.0,47,45,16,0,2,95.74468085
2013020078,24,3574,0.0,31,30,0,3,1,96.77419355
2013020079,17,3600,0.0,30,28,5,0,2,93.33333333
2013020079,6,3504,0.0,27,24,0,1,3,88.88888889
2013020080,22,3492,0.0,20,16,1,0,4,80.0
2013020080,15,3600,0.0,30,28,4,0,2,93.33333333
2013020081,30,3596,0.0,23,22,3,0,1,95.65217391
2013020081,7,3530,0.0,20,18,6,1,2,90.0
2013020082,30,1606,0.0,6,6,1,0,0,100.0
2013020082,30,1942,0.0,7,4,1,0,3,57.14285714
2013020082,10,3600,0.0,37,36,10,2,1,97.2972973
2013020083,7,3900,0.0,44,41,5,2,3,93.18181818
2013020083,2,3900,0.0,34,31,7,0,3,91.17647059
2013020084,23,3600,0.0,22,20,1,0,2,90.90909091
2013020084,4,3512,0.0,25,22,1,1,3,88.0
2013020085,22,3476,0.0,28,25,2,0,3,89.28571429
2013020085,5,3592,0.0,22,20,5,0,2,90.90909091
2013020086,16,3881,0.0,34,32,3,0,2,94.11764706
2013020086,12,3891,0.0,36,34,2,0,2,94.44444444
2013020087,29,3553,0.0,32,30,5,0,2,93.75
2013020087,17,3600,0.0,37,36,8,0,1,97.2972973
2013020088,26,2182,0.0,17,14,1,0,3,82.35294118
2013020088,26,1418,0.0,8,6,1,0,2,75.0
2013020088,14,3578,0.0,31,30,10,0,1,96.77419355
2013020089,28,3567,0.0,27,25,6,0,2,92.59259259
2013020089,19,2400,0.0,26,22,4,0,4,84.61538462
2013020089,19,1200,0.0,13,11,6,0,2,84.61538462
2013020090,13,3528,0.0,30,26,1,0,4,86.66666667
2013020090,18,3600,0.0,25,22,2,0,3,88.0
2013020091,8,3598,0.0,36,36,2,1,0,100.0
2013020091,52,3579,0.0,24,22,5,0,2,91.66666667
2013020092,25,3515,0.0,26,23,2,1,3,88.46153846
2013020092,21,3558,2.0,41,39,10,0,2,95.12195122
2013020093,9,3768,0.0,37,34,2,1,3,91.89189189
2013020093,27,3768,2.0,32,28,2,1,4,87.5
2013020094,3,3600,0.0,22,22,6,0,0,100.0
2013020094,15,3490,0.0,36,34,5,0,2,94.44444444
2013020095,20,3531,0.0,22,19,4,4,3,86.36363636
2013020095,24,3600,0.0,35,33,6,0,2,94.28571429
2013020096,23,3570,0.0,25,25,8,2,0,100.0
2013020096,7,3600,0.0,34,31,8,0,3,91.17647059
2013020097,12,3600,0.0,26,24,3,2,2,92.30769231
2013020097,10,32,0.0,1,1,0,0,0,100.0
2013020097,10,3503,0.0,37,34,8,1,3,91.89189189
2013020098,22,3521,0.0,40,37,8,1,3,92.5
2013020098,2,3598,0.0,29,27,8,3,2,93.10344828
2013020099,5,3600,2.0,25,24,4,0,1,96.0
2013020099,4,3514,0.0,34,31,8,0,3,91.17647059
2013020100,29,3529,0.0,35,31,4,2,4,88.57142857
2013020100,8,3600,0.0,33,30,8,0,3,90.90909091
2013020101,1,3546,0.0,22,18,3,2,4,81.81818182
2013020101,9,3583,0.0,42,40,11,0,2,95.23809524
2013020102,30,3597,0.0,29,27,9,0,2,93.10344828
2013020102,14,3567,0.0,26,25,3,0,1,96.15384615
2013020103,6,3590,0.0,29,27,1,1,2,93.10344828
2013020103,13,3574,0.0,40,37,3,0,3,92.5
2013020104,19,3900,0.0,29,27,6,0,2,93.10344828
2013020104,16,3894,0.0,28,26,1,2,2,92.85714286
2013020105,26,3900,0.0,35,34,5,0,1,97.14285714
2013020105,18,3900,0.0,30,29,7,2,1,96.66666667
2013020106,28,3900,0.0,31,28,6,2,3,90.32258065
2013020106,25,3900,0.0,35,32,11,0,3,91.42857143
2013020107,17,3590,0.0,40,38,5,0,2,95.0
2013020107,21,3473,0.0,28,24,2,0,4,85.71428571
2013020108,19,3896,0.0,29,26,2,0,3,89.65517241
2013020108,52,3900,0.0,32,29,3,0,3,90.625
2013020109,27,3900,0.0,39,37,10,1,2,94.87179487
2013020109,24,3898,0.0,32,30,7,0,2,93.75
2013020110,23,3900,0.0,28,25,1,0,3,89.28571429
2013020110,5,3883,0.0,39,36,1,1,3,92.30769231
2013020111,22,3600,0.0,36,35,9,4,1,97.22222222
2013020111,9,3561,0.0,20,18,4,1,2,90.0
2013020112,21,3595,0.0,30,28,7,0,2,93.33333333
2013020112,7,3446,0.0,26,22,2,0,4,84.61538462
2013020113,18,3600,0.0,29,28,4,2,1,96.55172414
2013020113,8,3537,0.0,37,35,8,1,2,94.59459459
2013020114,6,3595,0.0,23,23,4,1,0,100.0
2013020114,14,2147,0.0,17,13,7,0,4,76.47058824
2013020114,14,1453,0.0,5,4,0,0,1,80.0
2013020115,30,3897,0.0,22,21,6,0,1,95.45454545
2013020115,13,3897,0.0,31,30,10,2,1,96.77419355
2013020116,3,3600,0.0,19,15,1,1,4,78.94736842
2013020116,1,3600,0.0,22,22,2,2,0,100.0
2013020117,12,3600,0.0,25,22,5,0,3,88.0
2013020117,2,3475,0.0,23,19,2,1,4,82.60869565
2013020118,29,3600,0.0,39,35,3,0,4,89.74358974
2013020118,15,3584,0.0,38,37,3,1,1,97.36842105
2013020119,10,3506,0.0,40,37,6,0,3,92.5
2013020119,16,3595,0.0,20,19,3,0,1,95.0
2013020120,17,3515,0.0,32,28,7,0,4,87.5
2013020120,27,3600,0.0,33,31,5,0,2,93.93939394
2013020121,20,3510,0.0,35,30,8,2,5,85.71428571
2013020121,28,3587,0.0,19,16,0,2,3,84.21052632
2013020122,25,3488,0.0,33,29,3,0,4,87.87878788
2013020122,26,3600,0.0,29,27,5,1,2,93.10344828
2013020123,23,3517,0.0,28,26,8,0,2,92.85714286
2013020123,29,3589,0.0,38,37,5,1,1,97.36842105
2013020124,18,3600,0.0,39,38,6,0,1,97.43589744
2013020124,52,3544,0.0,26,23,3,1,3,88.46153846
2013020125,25,3600,0.0,47,41,14,1,6,87.23404255
2013020125,24,1200,0.0,12,9,0,0,3,75.0
2013020125,24,2400,0.0,24,24,11,1,0,100.0
2013020126,28,3900,0.0,24,24,1,0,0,100.0
2013020126,17,3900,0.0,27,27,5,0,0,100.0
2013020127,21,3600,0.0,34,34,13,0,0,100.0
2013020127,5,3540,0.0,14,13,3,0,1,92.85714286
2013020128,20,3584,0.0,29,27,2,1,2,93.10344828
2013020128,26,3581,0.0,25,22,4,0,3,88.0
2013020129,24,3435,0.0,23,19,1,0,4,82.60869565
2013020129,10,3596,0.0,25,23,3,1,2,92.0
2013020130,23,3736,0.0,32,28,5,1,4,87.5
2013020130,2,3728,0.0,33,28,2,0,5,84.84848485
2013020131,1,3475,0.0,23,20,4,0,3,86.95652174
2013020131,29,3596,0.0,25,24,2,0,1,96.0
2013020132,22,3600,0.0,32,29,1,1,3,90.625
2013020132,8,3534,0.0,32,28,0,1,4,87.5
2013020133,16,3900,0.0,22,20,1,0,2,90.90909091
2013020133,13,3421,0.0,27,25,2,0,2,92.59259259
2013020133,13,479,0.0,2,2,0,0,0,100.0
2013020134,18,3561,0.0,28,27,4,0,1,96.42857143
2013020134,30,3600,0.0,16,16,0,1,0,100.0
2013020135,15,3880,0.0,47,43,3,6,4,91.4893617
2013020135,52,3900,0.0,32,28,7,0,4,87.5
2013020136,20,3517,2.0,32,29,3,0,3,90.625
2013020136,27,3600,0.0,24,22,2,1,2,91.66666667
2013020137,9,3598,0.0,32,31,4,0,1,96.875
2013020137,17,854,0.0,8,5,1,0,3,62.5
2013020137,17,2744,0.0,20,17,0,0,3,85.0
2013020138,6,3600,0.0,16,14,2,0,2,87.5
2013020138,7,3600,0.0,34,29,7,0,5,85.29411765
2013020139,28,3600,0.0,17,15,2,1,2,88.23529412
2013020139,6,3600,0.0,39,38,2,0,1,97.43589744
2013020140,23,3890,0.0,30,28,4,0,2,93.33333333
2013020140,1,3899,0.0,21,19,0,0,2,90.47619048
2013020141,3,3540,0.0,27,25,8,0,2,92.59259259
2013020141,4,3600,0.0,31,30,1,1,1,96.77419355
2013020142,24,3600,0.0,25,21,6,1,4,84.0
2013020142,8,3600,0.0,32,31,1,1,1,96.875
2013020143,16,3662,0.0,25,19,2,1,6,76.0
2013020143,14,3676,0.0,43,38,11,0,5,88.37209302
2013020144,52,3861,0.0,33,30,3,1,3,90.90909091
2013020144,18,3882,0.0,36,34,4,0,2,94.44444444
2013020145,12,247,0.0,5,5,4,0,0,100.0
2013020145,12,3336,0.0,21,19,4,0,2,90.47619048
2013020145,30,2400,0.0,21,20,5,0,1,95.23809524
2013020145,30,1200,0.0,7,7,1,0,0,100.0
2013020146,20,3572,2.0,34,29,5,0,5,85.29411765
2013020146,25,3600,0.0,29,28,2,1,1,96.55172414
2013020147,15,3600,0.0,31,30,7,0,1,96.77419355
2013020147,22,3587,0.0,26,22,2,1,4,84.61538462
2013020148,27,2359,0.0,22,20,7,2,2,90.90909091
2013020148,27,1200,0.0,15,11,2,2,4,73.33333333
2013020148,26,3600,0.0,28,24,4,0,4,85.71428571
2013020149,2,3600,0.0,42,39,11,0,3,92.85714286
2013020149,5,3541,0.0,25,21,1,1,4,84.0
2013020150,10,3582,0.0,35,31,7,1,4,88.57142857
2013020150,29,3595,0.0,25,23,8,0,2,92.0
2013020151,24,3600,0.0,27,26,7,2,1,96.2962963
2013020151,9,3555,0.0,28,26,5,1,2,92.85714286
2013020152,7,3600,0.0,45,44,2,0,1,97.77777778
2013020152,13,3529,0.0,20,18,3,0,2,90.0
2013020153,23,3885,0.0,24,22,1,0,2,91.66666667
2013020153,19,3883,0.0,21,18,5,0,3,85.71428571
2013020154,12,3500,0.0,34,30,5,0,4,88.23529412
2013020154,21,3600,0.0,30,28,7,0,2,93.33333333
2013020155,1,3584,0.0,28,25,1,1,3,89.28571429
2013020155,6,3555,0.0,32,28,8,1,4,87.5
2013020156,5,3523,0.0,29,26,5,1,3,89.65517241
2013020156,10,3600,0.0,38,37,8,1,1,97.36842105
2013020157,28,3566,0.0,22,22,1,2,0,100.0
2013020157,8,3561,0.0,37,35,4,0,2,94.59459459
2013020158,3,3887,0.0,34,32,10,3,2,94.11764706
2013020158,17,3884,0.0,40,37,4,0,3,92.5
2013020159,7,3515,0.0,39,36,10,2,3,92.30769231
2013020159,14,3580,0.0,22,20,6,0,2,90.90909091
2013020160,4,3600,0.0,28,26,1,0,2,92.85714286
2013020160,2,3585,0.0,31,27,2,0,4,87.09677419
2013020161,52,3889,0.0,36,35,2,1,1,97.22222222
2013020161,25,3897,0.0,38,37,3,2,1,97.36842105
2013020162,30,3600,0.0,36,33,6,0,3,91.66666667
2013020162,16,3502,0.0,25,20,5,1,5,80.0
2013020163,19,3600,0.0,23,22,2,0,1,95.65217391
2013020163,18,2868,0.0,26,21,1,1,5,80.76923077
2013020163,18,732,0.0,4,3,0,0,1,75.0
2013020164,22,3468,0.0,27,22,8,0,5,81.48148148
2013020164,22,39,0.0,1,1,0,0,0,100.0
2013020164,27,3592,0.0,30,26,2,0,4,86.66666667
2013020165,15,2830,0.0,19,17,3,0,2,89.47368421
2013020165,15,768,0.0,14,11,5,0,3,78.57142857
2013020165,20,3600,0.0,29,27,7,2,2,93.10344828
2013020166,28,3550,0.0,40,38,6,4,2,95.0
2013020166,9,3598,0.0,29,24,3,1,5,82.75862069
2013020167,14,3900,0.0,32,29,2,2,3,90.625
2013020167,13,3900,0.0,28,25,1,2,3,89.28571429
2013020168,24,3600,0.0,21,18,1,1,3,85.71428571
2013020168,29,3513,0.0,32,28,12,0,4,87.5
2013020169,52,3519,0.0,36,33,0,2,3,91.66666667
2013020169,21,3593,0.0,25,23,4,0,2,92.0
2013020170,22,3891,0.0,48,47,7,0,1,97.91666667
2013020170,26,3891,0.0,18,17,5,1,1,94.44444444
2013020171,25,3600,0.0,25,22,4,0,3,88.0
2013020171,7,3511,0.0,29,25,9,1,4,86.20689655
2013020172,5,3592,0.0,21,20,5,1,1,95.23809524
2013020172,12,3513,0.0,29,26,1,0,3,89.65517241
2013020173,8,3549,0.0,27,27,4,3,0,100.0
2013020173,3,3465,0.0,27,25,4,2,2,92.59259259
2013020174,16,3598,0.0,30,29,4,1,1,96.66666667
2013020174,30,3593,0.0,28,23,5,1,5,82.14285714
2013020175,15,3567,0.0,41,38,15,0,3,92.68292683
2013020175,23,3595,0.0,19,17,4,1,2,89.47368421
2013020176,3,3600,0.0,24,22,2,1,2,91.66666667
2013020176,2,3532,0.0,24,21,7,0,3,87.5
2013020177,24,3569,0.0,28,26,2,1,2,92.85714286
2013020177,4,3511,0.0,37,34,3,0,3,91.89189189
2013020178,25,3557,2.0,24,22,5,0,2,91.66666667
2013020178,8,3597,0.0,27,26,1,0,1,96.2962963
2013020179,14,3576,0.0,22,20,4,0,2,90.90909091
2013020179,1,3600,0.0,17,16,2,1,1,94.11764706
2013020180,9,3556,0.0,40,34,1,2,6,85.0
2013020180,16,1874,0.0,22,18,2,0,4,81.81818182
2013020180,16,1726,0.0,15,14,0,1,1,93.33333333
2013020181,52,3570,0.0,33,30,6,1,3,90.90909091
2013020181,19,3600,0.0,23,21,4,0,2,91.30434783
2013020182,10,3590,0.0,43,43,5,0,0,100.0
2013020182,22,3600,0.0,26,22,3,0,4,84.61538462
2013020183,26,3582,0.0,33,30,8,1,3,90.90909091
2013020183,27,3597,0.0,42,41,6,1,1,97.61904762
2013020184,6,3504,0.0,31,28,1,0,3,90.32258065
2013020184,5,3600,0.0,23,21,3,0,2,91.30434783
2013020185,10,3600,0.0,43,41,8,0,2,95.34883721
2013020185,20,3496,0.0,21,18,0,0,3,85.71428571
2013020186,17,3600,0.0,20,19,2,1,1,95.0
2013020186,23,3517,0.0,27,25,3,1,2,92.59259259
2013020187,28,3744,0.0,23,19,4,1,4,82.60869565
2013020187,26,3752,0.0,20,17,6,0,3,85.0
2013020188,24,3900,0.0,23,21,1,1,2,91.30434783
2013020188,6,3897,0.0,23,21,6,0,2,91.30434783
2013020189,7,3465,0.0,46,44,5,1,2,95.65217391
2013020189,3,3547,0.0,29,29,1,2,0,100.0
2013020190,18,3900,0.0,25,21,3,1,4,84.0
2013020190,27,3863,0.0,40,36,2,0,4,90.0
2013020191,15,3600,5.0,30,30,7,3,0,100.0
2013020191,4,2207,0.0,17,14,6,0,3,82.35294118
2013020191,4,1367,29.0,15,11,2,1,4,73.33333333
2013020192,29,2186,0.0,14,13,2,0,1,92.85714286
2013020192,29,1381,0.0,13,10,0,0,3,76.92307692
2013020192,5,3600,0.0,39,37,11,1,2,94.87179487
2013020193,14,3600,0.0,31,31,5,0,0,100.0
2013020193,12,3576,0.0,32,29,4,1,3,90.625
2013020194,2,3900,0.0,31,27,1,1,4,87.09677419
2013020194,9,3900,0.0,57,53,8,1,4,92.98245614
2013020195,19,3591,0.0,31,31,1,2,0,100.0
2013020195,13,3600,0.0,23,19,3,0,4,82.60869565
2013020196,8,3544,0.0,25,21,2,0,4,84.0
2013020196,30,3587,0.0,31,28,5,0,3,90.32258065
2013020197,21,3816,0.0,29,27,6,0,2,93.10344828
2013020197,25,3812,0.0,29,26,11,0,3,89.65517241
2013020198,17,3596,0.0,25,22,4,1,3,88.0
2013020198,20,3476,0.0,22,18,5,1,4,81.81818182
2013020199,16,3600,0.0,27,26,1,0,1,96.2962963
2013020199,52,1549,0.0,14,10,1,0,4,71.42857143
2013020199,52,2051,0.0,11,10,0,0,1,90.90909091
2013020200,18,3600,0.0,38,35,2,0,3,92.10526316
2013020200,26,3500,0.0,17,13,0,0,4,76.47058824
2013020201,24,3600,0.0,17,14,1,0,3,82.35294118
2013020201,7,3600,0.0,29,23,0,0,6,79.31034483
2013020202,19,3427,0.0,25,21,4,0,4,84.0
2013020202,14,3568,0.0,30,28,5,0,2,93.33333333
2013020203,4,3550,0.0,14,14,3,0,0,100.0
2013020203,1,3535,0.0,21,20,5,0,1,95.23809524
2013020204,6,3507,0.0,34,31,0,1,3,91.17647059
2013020204,2,3600,0.0,27,26,5,0,1,96.2962963
2013020205,12,3597,0.0,38,33,6,0,5,86.84210526
2013020205,3,3600,0.0,28,27,3,0,1,96.42857143
2013020206,13,3900,0.0,23,21,3,0,2,91.30434783
2013020206,15,3886,0.0,33,31,11,1,2,93.93939394
2013020207,5,3599,0.0,19,19,4,3,0,100.0
2013020207,29,3496,0.0,26,24,5,0,2,92.30769231
2013020208,10,3600,0.0,47,43,10,1,4,91.4893617
2013020208,23,3600,0.0,21,21,6,0,0,100.0
2013020209,8,3585,0.0,30,27,4,0,3,90.0
2013020209,21,3600,0.0,30,29,4,0,1,96.66666667
2013020210,17,3600,0.0,14,14,3,1,0,100.0
2013020210,22,2764,0.0,22,19,6,0,3,86.36363636
2013020210,22,832,0.0,9,7,1,0,2,77.77777778
2013020211,27,3882,0.0,50,48,20,0,2,96.0
2013020211,28,3882,0.0,30,28,7,0,2,93.33333333
2013020212,25,3900,0.0,36,33,6,2,3,91.66666667
2013020212,9,3692,0.0,36,33,5,1,3,91.66666667
2013020212,9,196,0.0,2,2,0,0,0,100.0
2013020213,20,3692,0.0,44,42,8,0,2,95.45454545
2013020213,16,3692,0.0,30,27,0,0,3,90.0
2013020214,1,3518,0.0,19,16,4,0,3,84.21052632
2013020214,30,3600,0.0,19,19,2,0,0,100.0
2013020215,24,3600,0.0,33,32,4,0,1,96.96969697
2013020215,3,3596,0.0,25,23,3,0,2,92.0
2013020216,17,3492,0.0,47,43,8,1,4,91.4893617
2013020216,52,3599,0.0,28,26,5,3,2,92.85714286
2013020217,25,3897,0.0,36,34,9,1,2,94.44444444
2013020217,6,3900,0.0,36,34,4,0,2,94.44444444
2013020218,2,3596,0.0,39,33,4,2,6,84.61538462
2013020218,15,3598,0.0,36,34,13,1,2,94.44444444
2013020219,9,3600,0.0,33,32,8,3,1,96.96969697
2013020219,29,3537,0.0,23,20,5,0,3,86.95652174
2013020220,19,3900,0.0,27,25,2,4,2,92.59259259
2013020220,8,3900,2.0,32,30,4,0,2,93.75
2013020221,22,3715,0.0,23,20,3,0,3,86.95652174
2013020221,13,3704,0.0,27,23,5,0,4,85.18518519
2013020222,4,3760,0.0,38,36,6,1,2,94.73684211
2013020222,12,3723,2.0,29,28,2,0,1,96.55172414
2013020223,20,3600,0.0,24,19,3,1,5,79.16666667
2013020223,30,3581,0.0,25,24,2,1,1,96.0
2013020224,23,3866,0.0,32,30,5,0,2,93.75
2013020224,27,3900,0.0,33,31,5,0,2,93.93939394
2013020225,7,3900,0.0,51,47,8,1,4,92.15686275
2013020225,28,3888,0.0,36,32,3,1,4,88.88888889
2013020226,5,3596,0.0,25,20,3,0,5,80.0
2013020226,3,3585,0.0,29,28,10,0,1,96.55172414
2013020227,52,3600,0.0,28,24,2,0,4,85.71428571
2013020227,16,3597,0.0,25,24,3,0,1,96.0
2013020228,18,3600,0.0,31,27,4,0,4,87.09677419
2013020228,21,3524,0.0,27,22,2,0,5,81.48148148
2013020229,27,3581,0.0,28,24,4,2,4,85.71428571
2013020229,24,3583,0.0,26,24,2,0,2,92.30769231
2013020230,13,3599,0.0,30,26,3,0,4,86.66666667
2013020230,6,3600,0.0,24,23,5,0,1,95.83333333
2013020231,8,3586,0.0,23,20,7,0,3,86.95652174
2013020231,9,3600,0.0,34,33,6,5,1,97.05882353
2013020232,1,3600,0.0,22,22,2,1,0,100.0
2013020232,4,3479,0.0,24,22,4,0,2,91.66666667
2013020233,30,3900,0.0,27,25,3,0,2,92.59259259
2013020233,15,3900,0.0,35,33,7,0,2,94.28571429
2013020234,2,3522,0.0,24,23,0,0,1,95.83333333
2013020234,12,3600,0.0,21,21,2,0,0,100.0
2013020235,3,3600,0.0,34,32,4,1,2,94.11764706
2013020235,29,3567,0.0,33,30,6,0,3,90.90909091
2013020236,25,3871,0.0,29,26,0,0,3,89.65517241
2013020236,17,3881,0.0,28,24,2,0,4,85.71428571
2013020237,22,3503,0.0,25,22,1,0,3,88.0
2013020237,14,3600,0.0,40,38,4,2,2,95.0
2013020238,20,3520,0.0,27,24,3,1,3,88.88888889
2013020238,19,3600,0.0,20,18,7,0,2,90.0
2013020239,7,3486,0.0,28,26,10,0,2,92.85714286
2013020239,26,3596,0.0,19,19,3,1,0,100.0
2013020240,23,3600,0.0,24,22,5,1,2,91.66666667
2013020240,28,1952,0.0,21,21,8,1,0,100.0
2013020240,28,1522,0.0,13,9,0,0,4,69.23076923
2013020241,1,3900,0.0,28,27,10,1,1,96.42857143
2013020241,10,3900,0.0,35,34,3,1,1,97.14285714
2013020242,18,503,0.0,8,5,0,0,3,62.5
2013020242,18,3097,0.0,24,22,3,3,2,91.66666667
2013020242,52,3600,0.0,41,41,12,0,0,100.0
2013020243,20,3520,0.0,26,23,2,2,3,88.46153846
2013020243,21,3600,0.0,32,30,2,1,2,93.75
2013020244,7,1200,0.0,12,12,0,0,0,100.0
2013020244,7,2400,0.0,34,28,2,0,6,82.35294118
2013020244,24,3600,0.0,27,25,1,0,2,92.59259259
2013020245,22,3497,0.0,34,30,9,1,4,88.23529412
2013020245,4,3600,0.0,26,24,2,0,2,92.30769231
2013020246,13,3563,0.0,32,29,5,2,3,90.625
2013020246,9,3600,0.0,28,26,2,2,2,92.85714286
2013020247,10,3577,0.0,33,31,5,0,2,93.93939394
2013020247,6,3597,0.0,34,33,10,0,1,97.05882353
2013020248,14,3824,0.0,27,25,8,0,2,92.59259259
2013020248,17,3826,0.0,34,31,3,0,3,91.17647059
2013020249,30,3900,0.0,29,27,5,1,2,93.10344828
2013020249,12,3859,0.0,30,28,7,0,2,93.33333333
2013020250,2,3522,2.0,28,24,2,0,4,85.71428571
2013020250,29,3597,0.0,26,24,3,0,2,92.30769231
2013020251,5,3539,0.0,32,30,6,0,2,93.75
2013020251,19,3600,0.0,20,19,3,0,1,95.0
2013020252,16,3600,0.0,33,31,9,0,2,93.93939394
2013020252,25,3586,0.0,30,26,0,0,4,86.66666667
2013020253,15,3872,0.0,35,32,5,1,3,91.42857143
2013020253,27,3900,2.0,32,29,9,1,3,90.625
2013020254,23,1906,0.0,18,14,0,0,4,77.77777778
2013020254,23,1694,0.0,14,13,5,0,1,92.85714286
2013020254,26,3600,0.0,26,25,3,1,1,96.15384615
2013020255,2,3600,0.0,31,27,7,0,4,87.09677419
2013020255,8,3600,0.0,26,24,2,2,2,92.30769231
2013020256,18,3596,0.0,23,18,5,1,5,78.26086957
2013020256,1,3591,0.0,15,15,5,0,0,100.0
2013020257,13,3517,2.0,29,25,3,0,4,86.20689655
2013020257,3,3600,0.0,27,24,4,0,3,88.88888889
2013020258,22,3600,0.0,36,31,4,0,5,86.11111111
2013020258,16,3600,0.0,23,19,3,2,4,82.60869565
2013020259,28,3899,0.0,46,42,5,1,4,91.30434783
2013020259,52,3900,0.0,34,30,5,2,4,88.23529412
2013020260,15,3600,0.0,37,33,9,1,4,89.18918919
2013020260,21,3600,0.0,34,33,8,1,1,97.05882353
2013020261,23,3547,0.0,22,20,1,0,2,90.90909091
2013020261,24,3600,0.0,36,35,7,0,1,97.22222222
2013020262,14,3574,0.0,25,23,0,2,2,92.0
2013020262,6,3600,0.0,28,28,2,0,0,100.0
2013020263,26,3820,0.0,17,15,2,1,2,88.23529412
2013020263,26,80,0.0,0,0,0,0,0,
2013020263,7,3900,0.0,45,43,12,0,2,95.55555556
2013020264,18,3460,0.0,33,30,5,1,3,90.90909091
2013020264,2,3597,0.0,33,32,1,1,1,96.96969697
2013020265,1,3600,0.0,35,33,5,0,2,94.28571429
2013020265,3,3541,0.0,28,25,3,2,3,89.28571429
2013020266,29,3694,2.0,34,30,2,0,4,88.23529412
2013020266,15,3694,0.0,27,24,1,0,3,88.88888889
2013020267,21,3518,0.0,28,26,0,0,2,92.85714286
2013020267,12,3600,0.0,34,33,6,0,1,97.05882353
2013020268,14,3900,0.0,29,28,6,0,1,96.55172414
2013020268,8,3898,0.0,45,44,8,1,1,97.77777778
2013020269,4,3600,0.0,24,24,2,0,0,100.0
2013020269,9,3593,0.0,31,26,2,0,5,83.87096774
2013020270,52,3900,0.0,43,41,5,2,2,95.34883721
2013020270,17,3890,0.0,21,19,3,0,2,90.47619048
2013020271,24,3504,0.0,25,22,2,0,3,88.0
2013020271,13,3597,0.0,34,32,2,1,2,94.11764706
2013020272,27,3656,0.0,39,37,2,0,2,94.87179487
2013020272,19,3656,0.0,19,16,0,0,3,84.21052632
2013020273,28,3673,0.0,13,11,1,0,2,84.61538462
2013020273,20,3673,0.0,35,32,2,0,3,91.42857143
2013020274,10,3884,0.0,34,33,8,0,1,97.05882353
2013020274,30,3269,0.0,20,19,4,1,1,95.0
2013020274,30,631,0.0,3,3,0,0,0,100.0
2013020275,4,3600,0.0,31,30,4,0,1,96.77419355
2013020275,5,3494,0.0,21,19,3,1,2,90.47619048
2013020276,25,3600,0.0,22,22,6,1,0,100.0
2013020276,22,3553,0.0,24,23,10,0,1,95.83333333
2013020277,29,3851,0.0,31,28,2,0,3,90.32258065
2013020277,6,3851,0.0,34,32,4,0,2,94.11764706
2013020278,26,3600,0.0,25,23,6,0,2,92.0
2013020278,2,3534,0.0,24,21,4,2,3,87.5
2013020279,24,3600,0.0,20,15,1,0,5,75.0
2013020279,14,3575,0.0,25,24,6,0,1,96.0
2013020280,27,3900,2.0,52,48,5,0,4,92.30769231
2013020280,16,3900,0.0,30,26,2,1,4,86.66666667
2013020281,21,2836,0.0,23,18,1,0,5,78.26086957
2013020281,21,764,0.0,6,4,2,0,2,66.66666667
2013020281,19,3597,0.0,24,21,5,0,3,87.5
2013020282,25,3600,0.0,28,25,4,6,3,89.28571429
2013020282,20,1712,0.0,17,13,0,1,4,76.47058824
2013020282,20,1888,0.0,15,12,2,0,3,80.0
2013020283,28,3743,0.0,35,34,1,0,1,97.14285714
2013020283,23,3750,0.0,30,28,3,1,2,93.33333333
2013020284,10,3551,0.0,26,24,8,0,2,92.30769231
2013020284,7,3600,0.0,33,32,5,0,1,96.96969697
2013020285,26,3600,0.0,26,26,2,0,0,100.0
2013020285,1,3516,0.0,20,19,2,1,1,95.0
2013020286,18,1200,0.0,8,8,2,0,0,100.0
2013020286,18,2388,0.0,25,21,4,0,4,84.0
2013020286,5,3600,0.0,18,17,2,0,1,94.44444444
2013020287,24,3900,0.0,23,21,1,0,2,91.30434783
2013020287,12,3900,0.0,30,28,4,1,2,93.33333333
2013020288,8,3900,0.0,25,23,3,0,2,92.0
2013020288,29,3900,0.0,40,38,12,0,2,95.0
2013020289,6,3539,0.0,31,27,6,1,4,87.09677419
2013020289,9,3600,0.0,32,30,2,0,2,93.75
2013020290,15,3863,0.0,37,34,7,0,3,91.89189189
2013020290,17,3900,0.0,33,30,9,1,3,90.90909091
2013020291,13,3517,0.0,20,17,6,0,3,85.0
2013020291,30,3600,0.0,24,22,4,0,2,91.66666667
2013020292,4,3900,0.0,38,36,5,0,2,94.73684211
2013020292,52,3895,0.0,34,32,5,0,2,94.11764706
2013020293,28,3599,0.0,31,30,3,0,1,96.77419355
2013020293,22,3501,0.0,37,34,11,0,3,91.89189189
2013020294,7,3552,0.0,22,18,2,0,4,81.81818182
2013020294,10,3575,0.0,35,33,4,1,2,94.28571429
2013020295,3,3598,0.0,22,22,1,2,0,100.0
2013020295,8,3567,0.0,34,33,2,0,1,97.05882353
2013020296,5,3567,0.0,21,18,3,1,3,85.71428571
2013020296,1,3600,0.0,28,27,11,0,1,96.42857143
2013020297,17,3866,0.0,41,37,12,0,4,90.24390244
2013020297,2,3644,0.0,22,19,0,0,3,86.36363636
2013020297,2,252,0.0,1,0,0,0,1,0.0
2013020298,12,3593,0.0,31,28,8,0,3,90.32258065
2013020298,19,3590,0.0,20,18,2,0,2,90.0
2013020299,16,923,0.0,8,6,2,0,2,75.0
2013020299,16,2667,0.0,22,17,4,0,5,77.27272727
2013020299,18,3600,0.0,41,39,6,0,2,95.12195122
2013020300,14,1305,0.0,14,11,3,0,3,78.57142857
2013020300,14,2201,0.0,15,13,2,0,2,86.66666667
2013020300,27,3600,0.0,30,27,3,0,3,90.0
2013020301,13,3600,0.0,33,32,0,1,1,96.96969697
2013020301,21,3598,0.0,33,29,10,0,4,87.87878788
2013020302,22,3600,0.0,35,33,2,1,2,94.28571429
2013020302,20,3518,0.0,23,20,4,0,3,86.95652174
2013020303,29,3600,0.0,30,29,8,0,1,96.66666667
2013020303,9,3590,0.0,22,18,2,1,4,81.81818182
2013020304,19,941,0.0,6,3,0,0,3,50.0
2013020304,19,2659,0.0,14,13,2,0,1,92.85714286
2013020304,15,3600,0.0,47,46,9,3,1,97.87234043
2013020305,26,3600,0.0,37,37,11,1,0,100.0
2013020305,3,3539,0.0,30,29,1,1,1,96.66666667
2013020306,28,3600,0.0,27,22,0,1,5,81.48148148
2013020306,16,3582,0.0,24,23,2,0,1,95.83333333
2013020307,52,3560,0.0,24,22,1,0,2,91.66666667
2013020307,30,3598,0.0,22,21,2,1,1,95.45454545
2013020308,25,3600,0.0,43,42,12,0,1,97.6744186
2013020308,23,3501,0.0,23,21,0,0,2,91.30434783
2013020309,6,3600,0.0,24,23,2,0,1,95.83333333
2013020309,12,3566,0.0,29,26,2,0,3,89.65517241
2013020310,24,3587,0.0,27,24,5,0,3,88.88888889
2013020310,5,3600,0.0,28,27,3,0,1,96.42857143
2013020311,20,3900,0.0,47,43,9,0,4,91.4893617
2013020311,52,3860,0.0,33,29,6,1,4,87.87878788
2013020312,19,3600,0.0,24,23,2,0,1,95.83333333
2013020312,7,3600,0.0,31,27,4,0,4,87.09677419
2013020313,2,3600,0.0,24,19,2,0,5,79.16666667
2013020313,10,3600,0.0,37,35,5,1,2,94.59459459
2013020314,9,3539,0.0,41,37,6,2,4,90.24390244
2013020314,4,3600,0.0,34,32,8,4,2,94.11764706
2013020315,30,2016,0.0,19,16,3,0,3,84.21052632
2013020315,30,1584,0.0,9,6,1,0,3,66.66666667
2013020315,8,3600,0.0,27,25,4,2,2,92.59259259
2013020316,18,3600,0.0,27,27,1,2,0,100.0
2013020316,17,3522,0.0,25,23,5,1,2,92.0
2013020317,6,3600,0.0,44,43,5,1,1,97.72727273
2013020317,3,3541,0.0,22,20,3,0,2,90.90909091
2013020318,16,797,0.0,7,4,0,1,3,57.14285714
2013020318,16,2803,0.0,16,14,3,0,2,87.5
2013020318,21,3600,0.0,37,36,5,0,1,97.2972973
2013020319,29,1890,0.0,14,11,2,0,3,78.57142857
2013020319,29,1710,0.0,18,14,1,0,4,77.77777778
2013020319,22,3600,0.0,14,14,0,0,0,100.0
2013020320,13,3898,0.0,29,27,2,0,2,93.10344828
2013020320,23,3892,0.0,36,34,7,1,2,94.44444444
2013020321,14,3578,0.0,31,26,5,0,5,83.87096774
2013020321,26,3600,0.0,21,19,3,0,2,90.47619048
2013020322,30,3600,0.0,37,34,0,2,3,91.89189189
2013020322,9,3549,0.0,25,21,4,0,4,84.0
2013020323,5,3600,0.0,18,18,4,4,0,100.0
2013020323,15,3579,0.0,40,36,4,1,4,90.0
2013020324,29,3745,0.0,24,23,0,0,1,95.83333333
2013020324,20,3745,0.0,18,16,3,0,2,88.88888889
2013020325,1,3687,0.0,25,22,4,1,3,88.0
2013020325,24,3718,0.0,25,21,3,1,4,84.0
2013020326,19,3900,0.0,31,29,2,0,2,93.5483871
2013020326,6,3900,0.0,26,24,2,0,2,92.30769231
2013020327,18,3600,0.0,26,24,5,0,2,92.30769231
2013020327,10,3449,0.0,28,24,5,0,4,85.71428571
2013020328,7,3530,0.0,45,42,8,6,3,93.33333333
2013020328,4,3593,0.0,30,29,7,2,1,96.66666667
2013020329,12,3584,0.0,47,43,7,0,4,91.4893617
2013020329,17,3572,0.0,27,24,4,1,3,88.88888889
2013020330,16,3575,0.0,25,22,5,1,3,88.0
2013020330,52,3577,0.0,32,27,7,1,5,84.375
2013020331,3,3600,0.0,43,41,9,0,2,95.34883721
2013020331,25,3505,0.0,27,24,0,2,3,88.88888889
2013020332,21,3858,0.0,44,41,5,0,3,93.18181818
2013020332,27,3858,0.0,30,26,2,2,4,86.66666667
2013020333,13,3561,0.0,34,31,4,2,3,91.17647059
2013020333,22,3598,0.0,25,24,5,2,1,96.0
2013020334,1,3750,0.0,35,34,10,1,1,97.14285714
2013020334,26,3750,0.0,15,13,1,0,2,86.66666667
2013020335,14,3576,0.0,36,31,5,0,5,86.11111111
2013020335,28,3600,0.0,37,36,3,0,1,97.2972973
2013020336,2,3545,0.0,34,30,4,0,4,88.23529412
2013020336,5,3600,0.0,35,32,5,2,3,91.42857143
2013020337,8,3600,2.0,27,25,3,2,2,92.59259259
2013020337,15,3508,0.0,31,28,9,0,3,90.32258065
2013020338,13,3895,0.0,24,21,3,1,3,87.5
2013020338,20,3900,0.0,26,23,0,1,3,88.46153846
2013020339,29,3600,0.0,35,29,9,1,6,82.85714286
2013020339,23,3600,0.0,16,14,6,0,2,87.5
2013020340,14,3894,0.0,42,41,4,5,1,97.61904762
2013020340,24,3894,0.0,31,31,6,0,0,100.0
2013020341,12,3688,0.0,38,35,11,0,3,92.10526316
2013020341,6,3688,0.0,24,22,1,2,2,91.66666667
2013020342,30,3900,0.0,39,37,1,0,2,94.87179487
2013020342,52,3900,0.0,35,33,2,0,2,94.28571429
2013020343,15,3900,0.0,28,27,1,0,1,96.42857143
2013020343,10,3900,0.0,50,49,10,0,1,98.0
2013020344,5,3548,0.0,29,26,8,0,3,89.65517241
2013020344,8,3600,0.0,31,29,4,0,2,93.5483871
2013020345,9,3600,0.0,36,34,9,0,2,94.44444444
2013020345,17,3598,2.0,29,25,12,0,4,86.20689655
2013020346,2,2092,0.0,13,12,0,1,1,92.30769231
2013020346,2,1428,0.0,16,13,2,0,3,81.25
2013020346,4,3600,2.0,38,36,4,1,2,94.73684211
2013020347,25,861,0.0,7,6,0,0,1,85.71428571
2013020347,25,2733,0.0,18,13,1,0,5,72.22222222
2013020347,19,3597,0.0,35,34,4,2,1,97.14285714
2013020348,3,3600,0.0,17,17,0,1,0,100.0
2013020348,18,3505,0.0,34,32,4,1,2,94.11764706
2013020349,24,3600,0.0,44,42,9,2,2,95.45454545
2013020349,27,1112,0.0,4,4,0,0,0,100.0
2013020349,27,2400,0.0,23,19,2,0,4,82.60869565
2013020350,16,3600,0.0,37,36,3,0,1,97.2972973
2013020350,23,3503,0.0,29,27,3,1,2,93.10344828
2013020351,21,3752,0.0,19,19,4,0,0,100.0
2013020351,26,3752,0.0,33,32,5,0,1,96.96969697
2013020352,1,3520,0.0,30,28,3,1,2,93.33333333
2013020352,28,3594,0.0,19,18,1,0,1,94.73684211
2013020353,17,3581,0.0,22,21,1,0,1,95.45454545
2013020353,7,3520,0.0,33,31,8,0,2,93.93939394
2013020354,9,3569,0.0,36,33,3,0,3,91.66666667
2013020354,12,3600,0.0,36,35,1,1,1,97.22222222
2013020355,5,3565,0.0,24,20,0,0,4,83.33333333
2013020355,6,3634,0.0,31,28,5,0,3,90.32258065
2013020356,29,3598,0.0,18,18,1,0,0,100.0
2013020356,10,3084,0.0,21,15,4,0,6,71.42857143
2013020356,10,516,0.0,1,1,1,0,0,100.0
2013020357,52,3600,0.0,26,25,2,1,1,96.15384615
2013020357,1,3532,0.0,21,19,4,0,2,90.47619048
2013020358,3,2400,0.0,22,18,2,1,4,81.81818182
2013020358,3,1200,0.0,3,2,0,0,1,66.66666667
2013020358,14,3600,0.0,37,37,12,0,0,100.0
2013020359,4,3493,0.0,31,28,5,1,3,90.32258065
2013020359,13,3600,0.0,39,38,9,0,1,97.43589744
2013020360,30,3570,0.0,20,18,4,0,2,90.0
2013020360,19,3600,0.0,22,22,5,0,0,100.0
2013020361,27,3560,0.0,28,25,0,0,3,89.28571429
2013020361,18,3600,0.0,31,29,1,0,2,93.5483871
2013020362,16,3588,0.0,25,24,2,0,1,96.0
2013020362,22,2048,0.0,13,12,2,0,1,92.30769231
2013020362,22,1549,0.0,14,10,4,0,4,71.42857143
2013020363,26,3648,0.0,39,37,12,0,2,94.87179487
2013020363,23,3648,0.0,22,19,0,0,3,86.36363636
2013020364,24,3518,0.0,32,27,5,1,5,84.375
2013020364,25,3600,0.0,31,28,2,1,3,90.32258065
2013020365,8,3600,0.0,25,24,3,0,1,96.0
2013020365,7,3504,0.0,31,28,2,0,3,90.32258065
2013020366,12,3600,0.0,22,19,0,0,3,86.36363636
2013020366,1,3449,0.0,22,18,1,0,4,81.81818182
2013020367,52,3596,0.0,30,28,6,0,2,93.33333333
2013020367,2,3565,0.0,29,26,1,1,3,89.65517241
2013020368,9,3591,0.0,33,29,1,1,4,87.87878788
2013020368,15,3499,0.0,40,35,6,0,5,87.5
2013020369,18,3600,0.0,19,19,1,0,0,100.0
2013020369,29,3600,0.0,29,25,3,1,4,86.20689655
2013020370,6,3600,0.0,28,22,7,0,6,78.57142857
2013020370,17,3600,0.0,17,16,5,0,1,94.11764706
2013020371,4,3547,0.0,34,31,3,0,3,91.17647059
2013020371,14,3600,0.0,21,19,1,0,2,90.47619048
2013020372,3,3600,0.0,33,31,0,0,2,93.93939394
2013020372,13,3542,0.0,21,17,3,0,4,80.95238095
2013020373,10,3900,0.0,48,43,6,0,5,89.58333333
2013020373,5,1213,0.0,11,8,0,0,3,72.72727273
2013020373,5,2687,0.0,13,11,4,1,2,84.61538462
2013020374,27,3600,0.0,29,28,2,0,1,96.55172414
2013020374,30,3585,0.0,25,23,4,0,2,92.0
2013020375,19,3600,0.0,26,25,5,1,1,96.15384615
2013020375,21,3535,0.0,34,31,1,2,3,91.17647059
2013020376,16,3600,0.0,22,20,1,0,2,90.90909091
2013020376,20,3595,0.0,30,27,3,0,3,90.0
2013020377,26,3900,0.0,40,38,3,2,2,95.0
2013020377,28,3898,0.0,40,38,10,1,2,95.0
2013020378,23,3600,0.0,39,37,2,1,2,94.87179487
2013020378,9,1780,0.0,15,11,1,0,4,73.33333333
2013020378,9,1820,0.0,13,12,1,0,1,92.30769231
2013020379,22,3600,0.0,33,33,4,0,0,100.0
2013020379,18,3489,0.0,27,25,3,0,2,92.59259259
2013020380,3,3519,0.0,28,25,0,2,3,89.28571429
2013020380,6,3600,0.0,19,17,2,0,2,89.47368421
2013020381,5,3600,0.0,21,21,5,0,0,100.0
2013020381,14,3574,0.0,28,26,4,0,2,92.85714286
2013020382,17,3600,0.0,29,29,0,1,0,100.0
2013020382,2,3600,0.0,30,25,2,0,5,83.33333333
2013020383,52,3522,0.0,34,32,4,3,2,94.11764706
2013020383,4,3600,0.0,26,25,3,1,1,96.15384615
2013020384,20,3086,2.0,38,33,8,0,5,86.84210526
2013020384,20,514,0.0,4,4,0,0,0,100.0
2013020384,24,3600,0.0,21,19,0,0,2,90.47619048
2013020385,19,2355,0.0,19,18,4,1,1,94.73684211
2013020385,19,1200,0.0,12,8,0,0,4,66.66666667
2013020385,28,3600,0.0,24,21,8,1,3,87.5
2013020386,8,3900,0.0,26,24,2,0,2,92.30769231
2013020386,15,3900,0.0,37,35,6,2,2,94.59459459
2013020387,21,3600,0.0,28,27,2,0,1,96.42857143
2013020387,30,3583,0.0,20,18,1,2,2,90.0
2013020388,10,3627,0.0,29,26,3,0,3,89.65517241
2013020388,7,3634,0.0,24,22,1,1,2,91.66666667
2013020389,1,3545,0.0,18,16,3,0,2,88.88888889
2013020389,12,3600,0.0,31,26,4,0,5,83.87096774
2013020390,22,2400,0.0,23,19,9,0,4,82.60869565
2013020390,22,1055,0.0,5,5,0,0,0,100.0
2013020390,29,3600,0.0,27,25,6,0,2,92.59259259
2013020391,16,3900,0.0,29,28,2,0,1,96.55172414
2013020391,25,3900,0.0,26,25,1,0,1,96.15384615
2013020392,23,1217,0.0,10,7,0,0,3,70.0
2013020392,23,2383,0.0,14,12,2,0,2,85.71428571
2013020392,3,3600,0.0,37,35,3,0,2,94.59459459
2013020393,29,3540,0.0,36,33,7,1,3,91.66666667
2013020393,6,3600,0.0,14,13,2,2,1,92.85714286
2013020394,10,3471,0.0,39,35,5,2,4,89.74358974
2013020394,8,3600,0.0,36,34,5,0,2,94.44444444
2013020395,5,3600,0.0,40,39,5,0,1,97.5
2013020395,13,2398,0.0,13,9,0,0,4,69.23076923
2013020395,13,1200,0.0,9,8,0,0,1,88.88888889
2013020396,7,3850,0.0,24,23,3,1,1,95.83333333
2013020396,1,3838,0.0,15,15,2,1,0,100.0
2013020397,15,3727,0.0,39,37,4,0,2,94.87179487
2013020397,2,3727,0.0,30,27,1,2,3,90.0
2013020398,4,3900,0.0,36,34,1,0,2,94.44444444
2013020398,18,3900,0.0,24,22,6,4,2,91.66666667
2013020399,16,3600,0.0,34,32,5,0,2,94.11764706
2013020399,27,3540,0.0,35,31,7,0,4,88.57142857
2013020400,30,3870,0.0,25,23,0,0,2,92.0
2013020400,21,3900,0.0,37,35,0,0,2,94.59459459
2013020401,20,3600,0.0,22,21,5,0,1,95.45454545
2013020401,26,3591,0.0,20,18,5,0,2,90.0
2013020402,24,3896,0.0,35,32,12,2,3,91.42857143
2013020402,28,3876,0.0,31,28,3,1,3,90.32258065
2013020403,23,3600,0.0,31,29,8,0,2,93.5483871
2013020403,12,3522,0.0,30,27,5,2,3,90.0
2013020404,17,3600,0.0,32,30,4,0,2,93.75
2013020404,9,3510,0.0,22,19,1,2,3,86.36363636
2013020405,22,2179,0.0,29,28,6,2,1,96.55172414
2013020405,22,1721,0.0,16,15,0,0,1,93.75
2013020405,25,3865,0.0,32,30,8,0,2,93.75
2013020406,52,3600,0.0,37,35,3,0,2,94.59459459
2013020406,3,3549,0.0,29,25,4,1,4,86.20689655
2013020407,1,3549,0.0,17,14,0,2,3,82.35294118
2013020407,8,3600,0.0,30,28,3,1,2,93.33333333
2013020408,4,3404,0.0,21,19,0,0,2,90.47619048
2013020408,30,3600,0.0,21,21,2,0,0,100.0
2013020409,19,3546,0.0,23,20,0,0,3,86.95652174
2013020409,26,3600,0.0,27,25,4,0,2,92.59259259
2013020410,28,3593,0.0,30,28,9,0,2,93.33333333
2013020410,10,3578,0.0,40,37,4,1,3,92.5
2013020411,5,3815,0.0,23,21,0,2,2,91.30434783
2013020411,2,3824,0.0,34,31,8,0,3,91.17647059
2013020412,12,3599,0.0,27,26,6,1,1,96.2962963
2013020412,15,1200,0.0,9,9,4,0,0,100.0
2013020412,15,2397,0.0,23,19,3,1,4,82.60869565
2013020413,14,3516,0.0,21,20,3,0,1,95.23809524
2013020413,29,947,0.0,8,8,1,0,0,100.0
2013020413,29,2653,0.0,18,18,1,0,0,100.0
2013020414,9,3600,0.0,32,30,2,2,2,93.75
2013020414,13,3485,0.0,45,41,10,1,4,91.11111111
2013020415,25,3600,0.0,50,47,5,0,3,94.0
2013020415,16,3471,0.0,18,14,0,1,4,77.77777778
2013020416,23,3600,0.0,31,30,4,0,1,96.77419355
2013020416,18,3448,0.0,33,30,11,0,3,90.90909091
2013020417,27,3596,0.0,33,31,7,0,2,93.93939394
2013020417,22,3597,0.0,33,27,6,0,6,81.81818182
2013020418,26,3845,0.0,28,26,8,0,2,92.85714286
2013020418,24,3895,0.0,51,49,14,0,2,96.07843137
2013020419,8,3886,0.0,34,31,5,2,3,91.17647059
2013020419,1,3900,0.0,30,27,3,1,3,90.0
2013020420,4,3581,0.0,35,32,10,0,3,91.42857143
2013020420,17,3534,0.0,33,28,3,2,5,84.84848485
2013020421,27,3600,0.0,18,14,2,2,4,77.77777778
2013020421,20,3596,4.0,30,29,5,0,1,96.66666667
2013020422,3,3600,0.0,28,27,0,0,1,96.42857143
2013020422,7,3508,0.0,31,28,3,0,3,90.32258065
2013020423,25,3858,0.0,24,21,3,0,3,87.5
2013020423,10,3858,0.0,50,48,8,1,2,96.0
2013020424,28,1191,0.0,3,2,0,0,1,66.66666667
2013020424,28,2397,0.0,27,23,2,0,4,85.18518519
2013020424,5,3600,0.0,45,44,11,0,1,97.77777778
2013020425,6,3521,0.0,27,25,6,0,2,92.59259259
2013020425,8,3600,0.0,33,32,4,0,1,96.96969697
2013020426,9,3524,0.0,22,19,3,0,3,86.36363636
2013020426,14,3600,0.0,34,33,5,2,1,97.05882353
2013020427,52,3600,0.0,26,21,2,0,5,80.76923077
2013020427,13,3579,0.0,31,29,1,0,2,93.5483871
2013020428,2,3594,0.0,26,21,1,1,5,80.76923077
2013020428,19,3597,0.0,23,22,1,0,1,95.65217391
2013020429,12,3600,2.0,22,20,7,1,2,90.90909091
2013020429,18,1114,0.0,9,9,1,0,0,100.0
2013020429,18,2400,0.0,13,9,1,1,4,69.23076923
2013020430,16,3511,0.0,23,19,2,0,4,82.60869565
2013020430,30,3599,0.0,19,16,2,0,3,84.21052632
2013020431,21,3525,0.0,28,20,7,0,8,71.42857143
2013020431,22,3598,0.0,35,33,6,1,2,94.28571429
2013020432,17,3600,0.0,11,10,2,0,1,90.90909091
2013020432,1,3541,2.0,21,18,4,0,3,85.71428571
2013020433,28,3546,0.0,34,30,2,1,4,88.23529412
2013020433,12,3600,0.0,25,22,3,0,3,88.0
2013020434,30,3600,0.0,41,37,6,1,4,90.24390244
2013020434,29,3600,0.0,20,20,4,1,0,100.0
2013020435,24,3900,0.0,25,23,4,0,2,92.0
2013020435,16,3873,0.0,26,24,0,4,2,92.30769231
2013020436,21,3598,2.0,28,26,6,0,2,92.85714286
2013020436,20,3543,0.0,25,22,5,0,3,88.0
2013020437,27,3821,0.0,32,29,2,0,3,90.625
2013020437,23,3821,0.0,39,37,2,1,2,94.87179487
2013020438,5,3585,0.0,21,18,5,3,3,85.71428571
2013020438,6,3584,0.0,30,28,7,0,2,93.33333333
2013020439,7,3534,0.0,19,16,1,0,3,84.21052632
2013020439,8,3600,0.0,25,23,0,0,2,92.0
2013020440,10,3900,0.0,50,47,6,2,3,94.0
2013020440,9,3889,0.0,31,28,3,0,3,90.32258065
2013020441,13,3600,0.0,23,22,4,0,1,95.65217391
2013020441,17,3567,0.0,37,35,2,1,2,94.59459459
2013020442,52,3664,0.0,29,28,1,0,1,96.55172414
2013020442,14,3664,0.0,36,34,9,0,2,94.44444444
2013020443,18,3600,0.0,33,28,5,0,5,84.84848485
2013020443,15,3600,0.0,36,34,1,1,2,94.44444444
2013020444,1,3675,0.0,24,21,4,1,3,87.5
2013020444,3,3600,0.0,24,20,0,0,4,83.33333333
2013020445,24,3600,0.0,28,26,5,0,2,92.85714286
2013020445,19,449,0.0,8,5,0,0,3,62.5
2013020445,19,3127,0.0,14,13,1,1,1,92.85714286
2013020446,4,2400,0.0,26,22,8,0,4,84.61538462
2013020446,4,1200,0.0,8,7,0,1,1,87.5
2013020446,25,3600,0.0,28,27,9,3,1,96.42857143
2013020447,20,3794,0.0,31,30,8,0,1,96.77419355
2013020447,22,3723,0.0,27,25,3,3,2,92.59259259
2013020448,2,3563,0.0,23,21,5,0,2,91.30434783
2013020448,26,3596,0.0,16,16,3,1,0,100.0
2013020449,28,3481,0.0,12,10,0,0,2,83.33333333
2013020449,30,3600,0.0,38,37,8,3,1,97.36842105
2013020450,6,3600,0.0,32,30,7,0,2,93.75
2013020450,10,3439,0.0,38,34,4,1,4,89.47368421
2013020451,15,3582,0.0,31,30,8,0,1,96.77419355
2013020451,3,3600,0.0,36,32,2,2,4,88.88888889
2013020452,13,3600,0.0,32,26,3,1,6,81.25
2013020452,16,825,0.0,4,4,0,1,0,100.0
2013020452,16,2775,0.0,31,29,7,1,2,93.5483871
2013020453,21,3368,0.0,21,18,3,0,3,85.71428571
2013020453,23,3600,0.0,29,28,0,0,1,96.55172414
2013020454,4,3900,0.0,34,30,4,0,4,88.23529412
2013020454,9,3900,0.0,29,25,1,0,4,86.20689655
2013020455,29,3508,0.0,30,28,4,0,2,93.33333333
2013020455,5,3600,0.0,33,32,1,0,1,96.96969697
2013020456,12,3586,0.0,25,24,2,1,1,96.0
2013020456,23,3578,0.0,31,31,3,0,0,100.0
2013020457,2,3600,0.0,31,26,3,1,5,83.87096774
2013020457,24,3600,0.0,37,35,6,0,2,94.59459459
2013020458,9,3884,0.0,36,35,8,0,1,97.22222222
2013020458,7,3895,0.0,36,35,4,1,1,97.22222222
2013020459,14,3900,0.0,31,26,7,2,5,83.87096774
2013020459,15,3167,0.0,34,32,3,1,2,94.11764706
2013020459,15,667,0.0,8,5,1,0,3,62.5
2013020460,1,3512,0.0,23,18,3,0,5,78.26086957
2013020460,29,3600,0.0,34,30,4,0,4,88.23529412
2013020461,26,3600,0.0,31,31,10,0,0,100.0
2013020461,8,1525,0.0,16,12,1,1,4,75.0
2013020461,8,2072,0.0,14,12,0,3,2,85.71428571
2013020462,17,3898,0.0,27,25,3,0,2,92.59259259
2013020462,13,3900,0.0,26,24,8,0,2,92.30769231
2013020463,18,3600,2.0,29,28,1,1,1,96.55172414
2013020463,3,3570,0.0,25,22,2,0,3,88.0
2013020464,19,3596,0.0,21,20,8,0,1,95.23809524
2013020464,52,3503,0.0,20,18,4,2,2,90.0
2013020465,16,3583,0.0,29,27,12,0,2,93.10344828
2013020465,25,1896,0.0,14,12,0,0,2,85.71428571
2013020465,25,1700,0.0,19,15,7,1,4,78.94736842
2013020466,27,3600,0.0,30,29,3,1,1,96.66666667
2013020466,21,3534,0.0,25,22,1,0,3,88.0
2013020467,6,3600,0.0,27,26,7,0,1,96.2962963
2013020467,20,3499,0.0,24,22,5,0,2,91.66666667
2013020468,12,3708,0.0,29,24,4,0,5,82.75862069
2013020468,22,3708,0.0,28,24,1,1,4,85.71428571
2013020469,2,3897,0.0,48,46,5,0,2,95.83333333
2013020469,28,3885,0.0,28,26,0,0,2,92.85714286
2013020470,26,3600,0.0,39,38,2,1,1,97.43589744
2013020470,10,3520,0.0,23,20,0,1,3,86.95652174
2013020471,4,1135,0.0,5,4,2,1,1,80.0
2013020471,4,2465,0.0,18,12,0,1,6,66.66666667
2013020471,16,3581,0.0,30,28,8,3,2,93.33333333
2013020472,30,3529,0.0,31,29,2,0,2,93.5483871
2013020472,24,3591,0.0,24,23,2,1,1,95.83333333
2013020473,29,1200,0.0,16,15,2,1,1,93.75
2013020473,29,2400,0.0,18,17,2,0,1,94.44444444
2013020473,3,670,0.0,13,10,3,0,3,76.92307692
2013020473,3,2867,0.0,14,13,0,0,1,92.85714286
2013020474,8,3506,0.0,27,25,5,0,2,92.59259259
2013020474,4,3600,4.0,21,20,0,1,1,95.23809524
2013020475,7,3516,0.0,32,30,3,0,2,93.75
2013020475,9,3600,0.0,41,40,9,1,1,97.56097561
2013020476,17,3898,0.0,27,26,4,1,1,96.2962963
2013020476,14,3900,0.0,29,28,7,1,1,96.55172414
2013020477,10,970,0.0,15,12,1,0,3,80.0
2013020477,10,2536,0.0,20,18,3,1,2,90.0
2013020477,19,3600,0.0,22,19,4,0,3,86.36363636
2013020478,25,3500,0.0,30,27,0,0,3,90.0
2013020478,18,3597,0.0,34,33,7,0,1,97.05882353
2013020479,21,3900,0.0,38,35,12,0,3,92.10526316
2013020479,52,3896,0.0,26,23,3,0,3,88.46153846
2013020480,12,3893,0.0,30,28,0,1,2,93.33333333
2013020480,20,3869,0.0,30,29,5,0,1,96.66666667
2013020481,2,3600,0.0,37,31,11,0,6,83.78378378
2013020481,27,3600,0.0,24,21,6,1,3,87.5
2013020482,6,3600,0.0,41,39,6,0,2,95.12195122
2013020482,22,2346,0.0,12,12,0,0,0,100.0
2013020482,22,1188,0.0,18,15,2,0,3,83.33333333
2013020483,30,3485,0.0,39,36,15,1,3,92.30769231
2013020483,28,3595,0.0,30,29,3,1,1,96.66666667
2013020484,1,3547,0.0,23,20,0,0,3,86.95652174
2013020484,5,3600,0.0,39,37,6,2,2,94.87179487
2013020485,15,3900,0.0,41,39,4,0,2,95.12195122
2013020485,13,3900,0.0,25,23,4,0,2,92.0
2013020486,22,3599,0.0,40,36,2,1,4,90.0
2013020486,23,3600,0.0,19,19,1,0,0,100.0
2013020487,20,3614,0.0,27,26,6,0,1,96.2962963
2013020487,7,3642,0.0,26,24,5,0,2,92.30769231
2013020488,26,3597,0.0,39,37,8,0,2,94.87179487
2013020488,9,258,0.0,4,2,0,0,2,50.0
2013020488,9,3342,0.0,22,19,3,1,3,86.36363636
2013020489,25,3600,0.0,38,34,5,4,4,89.47368421
2013020489,52,2400,0.0,24,19,7,0,5,79.16666667
2013020489,52,1122,0.0,8,7,0,0,1,87.5
2013020490,16,1200,0.0,7,5,0,0,2,71.42857143
2013020490,16,2400,0.0,25,20,3,1,5,80.0
2013020490,10,3595,0.0,28,25,3,3,3,89.28571429
2013020491,5,3600,0.0,29,28,13,0,1,96.55172414
2013020491,17,3600,0.0,25,21,4,1,4,84.0
2013020492,14,3292,0.0,19,16,3,0,3,84.21052632
2013020492,1,3600,0.0,33,33,3,0,0,100.0
2013020493,8,3709,0.0,21,21,3,0,0,100.0
2013020493,2,3711,0.0,25,24,1,0,1,96.0
2013020494,19,3619,0.0,33,30,13,1,3,90.90909091
2013020494,29,3620,0.0,31,27,2,1,4,87.09677419
2013020495,28,3465,0.0,23,20,4,0,3,86.95652174
2013020495,18,3600,0.0,38,36,6,0,2,94.73684211
2013020496,12,3600,0.0,38,37,3,2,1,97.36842105
2013020496,27,3545,0.0,32,30,4,0,2,93.75
2013020497,30,3900,0.0,27,26,4,0,1,96.2962963
2013020497,21,3900,0.0,27,26,3,0,1,96.2962963
2013020498,6,1101,0.0,7,5,0,1,2,71.42857143
2013020498,6,2494,0.0,23,19,3,0,4,82.60869565
2013020498,23,3600,0.0,41,39,1,0,2,95.12195122
2013020499,4,3899,0.0,33,29,5,0,4,87.87878788
2013020499,15,3888,0.0,28,24,6,1,4,85.71428571
2013020500,14,3600,0.0,28,28,5,1,0,100.0
2013020500,17,3546,0.0,26,24,1,0,2,92.30769231
2013020501,13,3600,0.0,18,17,6,0,1,94.44444444
2013020501,8,3533,0.0,25,23,4,1,2,92.0
2013020502,20,3900,2.0,32,29,4,0,3,90.625
2013020502,3,3900,0.0,21,18,4,1,3,85.71428571
2013020503,26,3550,0.0,40,37,2,2,3,92.5
2013020503,16,3600,0.0,22,21,4,2,1,95.45454545
2013020504,22,3542,0.0,34,31,3,1,3,91.17647059
2013020504,24,3598,0.0,25,23,4,0,2,92.0
2013020505,10,3536,0.0,30,28,0,1,2,93.33333333
2013020505,5,3600,0.0,26,25,6,0,1,96.15384615
2013020506,52,3600,0.0,24,22,1,0,2,91.66666667
2013020506,29,3523,0.0,32,29,8,1,3,90.625
2013020507,19,3839,0.0,32,29,3,0,3,90.625
2013020507,9,3839,0.0,32,30,3,1,2,93.75
2013020508,25,3592,0.0,48,42,14,1,6,87.5
2013020508,21,3594,0.0,33,31,9,1,2,93.93939394
2013020509,20,3464,0.0,31,29,2,1,2,93.5483871
2013020509,6,3600,0.0,21,21,6,0,0,100.0
2013020510,52,3532,0.0,31,27,5,0,4,87.09677419
2013020510,7,3600,0.0,27,25,1,1,2,92.59259259
2013020511,13,3600,0.0,29,28,3,1,1,96.55172414
2013020511,10,3471,2.0,23,20,5,0,3,86.95652174
2013020512,14,3807,0.0,34,32,4,0,2,94.11764706
2013020512,2,3900,0.0,36,34,0,1,2,94.44444444
2013020513,27,3547,0.0,27,25,3,0,2,92.59259259
2013020513,8,3600,0.0,27,26,5,0,1,96.2962963
2013020514,24,3597,0.0,18,16,0,0,2,88.88888889
2013020514,17,2503,0.0,19,17,4,0,2,89.47368421
2013020514,17,1097,0.0,11,8,2,0,3,72.72727273
2013020515,15,3600,0.0,35,30,6,2,5,85.71428571
2013020515,4,3595,0.0,26,24,1,0,2,92.30769231
2013020516,28,3600,0.0,22,20,5,0,2,90.90909091
2013020516,19,3464,0.0,27,23,2,0,4,85.18518519
2013020517,16,3597,0.0,28,27,13,0,1,96.42857143
2013020517,18,3479,0.0,27,24,5,0,3,88.88888889
2013020518,23,3900,0.0,32,30,3,1,2,93.75
2013020518,30,3889,0.0,31,29,2,0,2,93.5483871
2013020519,21,3515,0.0,28,25,6,1,3,89.28571429
2013020519,25,3587,0.0,27,25,7,2,2,92.59259259
2013020520,22,3450,0.0,39,37,3,0,2,94.87179487
2013020520,26,3600,0.0,24,24,3,0,0,100.0
2013020521,9,3600,0.0,33,28,4,1,5,84.84848485
2013020521,1,3591,0.0,25,23,1,2,2,92.0
2013020522,5,3900,0.0,32,29,5,1,3,90.625
2013020522,3,3900,0.0,32,29,5,0,3,90.625
2013020523,6,3464,0.0,23,19,4,0,4,82.60869565
2013020523,7,3600,0.0,36,34,3,0,2,94.44444444
2013020524,27,3900,0.0,27,26,2,2,1,96.2962963
2013020524,10,3900,0.0,35,34,2,2,1,97.14285714
2013020525,29,3519,0.0,39,34,4,1,5,87.17948718
2013020525,4,3551,0.0,29,25,4,1,4,86.20689655
2013020526,30,3600,0.0,36,31,6,2,5,86.11111111
2013020526,5,3600,0.0,26,24,7,0,2,92.30769231
2013020527,13,3598,0.0,34,32,5,0,2,94.11764706
2013020527,9,3506,0.0,35,31,5,1,4,88.57142857
2013020528,20,3648,0.0,38,35,9,0,3,92.10526316
2013020528,17,3657,0.0,22,20,3,1,2,90.90909091
2013020529,18,2031,0.0,14,10,0,0,4,71.42857143
2013020529,18,1433,0.0,19,19,3,0,0,100.0
2013020529,14,3600,0.0,30,28,6,1,2,93.33333333
2013020530,8,3594,0.0,29,24,9,1,5,82.75862069
2013020530,19,3600,0.0,26,25,8,0,1,96.15384615
2013020531,23,2543,0.0,19,15,3,0,4,78.94736842
2013020531,23,1057,0.0,7,7,1,0,0,100.0
2013020531,25,3598,0.0,28,27,6,2,1,96.42857143
2013020532,22,3484,0.0,38,35,5,1,3,92.10526316
2013020532,21,3590,0.0,29,27,2,0,2,93.10344828
2013020533,28,3586,0.0,32,28,0,1,4,87.5
2013020533,26,3587,0.0,32,31,9,0,1,96.875
2013020534,24,3757,0.0,21,19,3,2,2,90.47619048
2013020534,1,3732,2.0,24,21,6,1,3,87.5
2013020535,2,3600,0.0,24,21,7,0,3,87.5
2013020535,3,3576,0.0,19,15,3,0,4,78.94736842
2013020536,15,3600,0.0,41,39,11,1,2,95.12195122
2013020536,12,3538,0.0,28,25,6,1,3,89.28571429
2013020537,23,3900,0.0,26,24,2,0,2,92.30769231
2013020537,16,3900,0.0,24,22,7,0,2,91.66666667
2013020538,13,3597,0.0,32,27,3,0,5,84.375
2013020538,52,3597,0.0,23,21,4,0,2,91.30434783
2013020539,27,3743,2.0,40,37,8,1,3,92.5
2013020539,9,3742,0.0,38,34,8,4,4,89.47368421
2013020540,21,3884,0.0,39,37,6,0,2,94.87179487
2013020540,26,3888,0.0,25,23,1,0,2,92.0
2013020541,7,3481,0.0,38,35,2,3,3,92.10526316
2013020541,6,3587,0.0,35,34,4,0,1,97.14285714
2013020542,17,3900,0.0,23,19,6,0,4,82.60869565
2013020542,10,1200,0.0,12,9,0,0,3,75.0
2013020542,10,2700,0.0,26,25,2,2,1,96.15384615
2013020543,12,3736,0.0,50,47,7,0,3,94.0
2013020543,14,3735,0.0,27,25,3,0,2,92.59259259
2013020544,24,3584,0.0,21,18,1,0,3,85.71428571
2013020544,2,3549,0.0,30,26,1,0,4,86.66666667
2013020545,20,3481,0.0,23,19,5,0,4,82.60869565
2013020545,5,3581,0.0,30,27,5,1,3,90.0
2013020546,1,3643,0.0,22,18,4,0,4,81.81818182
2013020546,15,3629,0.0,37,32,2,0,5,86.48648649
2013020547,4,3443,0.0,28,23,4,2,5,82.14285714
2013020547,29,3600,0.0,36,33,11,2,3,91.66666667
2013020548,8,3703,0.0,34,31,4,0,3,91.17647059
2013020548,18,2826,0.0,18,17,1,0,1,94.44444444
2013020548,18,877,0.0,5,2,0,0,3,40.0
2013020549,19,3600,0.0,23,23,5,0,0,100.0
2013020549,22,3600,0.0,33,27,6,0,6,81.81818182
2013020550,25,3898,0.0,39,37,4,1,2,94.87179487
2013020550,28,3900,0.0,46,44,3,0,2,95.65217391
2013020551,30,3600,0.0,36,32,2,0,4,88.88888889
2013020551,3,3600,0.0,25,24,4,0,1,96.0
2013020552,52,3512,0.0,25,23,3,0,2,92.0
2013020552,23,990,0.0,6,6,0,0,0,100.0
2013020552,23,2610,0.0,16,15,2,0,1,93.75
2013020553,27,3821,0.0,32,30,4,0,2,93.75
2013020553,7,3827,0.0,37,36,5,2,1,97.2972973
2013020554,10,3893,0.0,43,42,10,1,1,97.6744186
2013020554,3,3900,0.0,26,25,4,0,1,96.15384615
2013020555,24,3587,0.0,19,17,1,0,2,89.47368421
2013020555,15,3534,0.0,29,26,8,1,3,89.65517241
2013020556,29,3597,0.0,33,30,10,0,3,90.90909091
2013020556,12,3555,0.0,25,21,3,2,4,84.0
2013020557,5,3587,0.0,29,24,2,1,5,82.75862069
2013020557,9,3600,0.0,27,27,10,1,0,100.0
2013020558,2,3600,2.0,23,23,0,0,0,100.0
2013020558,17,3600,0.0,19,16,0,1,3,84.21052632
2013020559,14,3600,0.0,29,28,3,0,1,96.55172414
2013020559,13,3600,0.0,36,30,5,0,6,83.33333333
2013020560,30,3583,0.0,30,27,8,0,3,90.0
2013020560,4,3600,0.0,27,26,0,1,1,96.2962963
2013020561,1,3600,0.0,37,32,4,1,5,86.48648649
2013020561,16,3600,0.0,12,10,1,1,2,83.33333333
2013020562,6,3597,0.0,34,32,1,0,2,94.11764706
2013020562,18,359,0.0,4,2,0,0,2,50.0
2013020562,18,3220,0.0,29,25,0,0,4,86.20689655
2013020563,19,3900,0.0,29,26,11,1,3,89.65517241
2013020563,20,3797,0.0,35,32,2,0,3,91.42857143
2013020564,52,3600,0.0,30,24,10,0,6,80.0
2013020564,22,3591,0.0,20,18,1,1,2,90.0
2013020565,25,3600,0.0,32,30,4,1,2,93.75
2013020565,26,3552,0.0,23,19,5,0,4,82.60869565
2013020566,21,3884,0.0,45,41,6,0,4,91.11111111
2013020566,28,3838,0.0,33,29,5,1,4,87.87878788
2013020567,9,3600,0.0,42,37,0,2,5,88.0952381
2013020567,6,3600,0.0,33,33,0,1,0,100.0
2013020568,7,3845,0.0,42,39,7,0,3,92.85714286
2013020568,10,3900,0.0,35,32,2,0,3,91.42857143
2013020569,29,3900,0.0,17,16,4,1,1,94.11764706
2013020569,1,3897,0.0,30,29,6,2,1,96.66666667
2013020570,3,3495,0.0,34,31,10,0,3,91.17647059
2013020570,15,3599,0.0,40,38,3,0,2,95.0
2013020571,5,3663,0.0,34,31,0,0,3,91.17647059
2013020571,12,3663,0.0,26,22,3,0,4,84.61538462
2013020572,21,2400,0.0,24,17,1,0,7,70.83333333
2013020572,21,1200,0.0,13,13,0,0,0,100.0
2013020572,16,3600,0.0,18,16,2,0,2,88.88888889
2013020573,30,3505,0.0,37,32,5,0,5,86.48648649
2013020573,52,424,0.0,6,3,0,0,3,50.0
2013020573,52,3172,0.0,23,22,1,0,1,95.65217391
2013020574,18,3598,0.0,34,30,3,0,4,88.23529412
2013020574,25,3600,2.0,34,33,4,1,1,97.05882353
2013020575,22,3595,0.0,27,27,2,1,0,100.0
2013020575,20,3517,0.0,27,26,2,1,1,96.2962963
2013020576,28,3900,0.0,37,34,5,0,3,91.89189189
2013020576,27,3900,0.0,32,29,5,0,3,90.625
2013020577,6,2260,0.0,18,17,1,0,1,94.44444444
2013020577,6,1206,0.0,12,9,3,0,3,75.0
2013020577,9,3600,2.0,32,29,8,0,3,90.625
2013020578,8,3900,0.0,24,23,3,0,1,95.83333333
2013020578,14,3900,0.0,21,20,1,0,1,95.23809524
2013020579,17,3583,0.0,33,30,7,1,3,90.90909091
2013020579,13,3531,0.0,31,27,5,0,4,87.09677419
2013020580,1,3600,0.0,31,30,4,0,1,96.77419355
2013020580,2,3534,0.0,25,23,1,0,2,92.0
2013020581,16,3900,0.0,25,20,2,0,5,80.0
2013020581,19,1200,0.0,13,10,0,3,3,76.92307692
2013020581,19,2700,0.0,19,17,0,1,2,89.47368421
2013020582,26,3545,0.0,31,28,9,0,3,90.32258065
2013020582,18,3597,0.0,28,26,2,1,2,92.85714286
2013020583,27,3620,0.0,41,38,8,0,3,92.68292683
2013020583,24,3643,0.0,25,23,1,0,2,92.0
2013020584,4,3898,0.0,16,13,2,0,3,81.25
2013020584,22,3900,0.0,38,35,5,1,3,92.10526316
2013020585,15,3900,0.0,17,16,0,0,1,94.11764706
2013020585,7,3900,0.0,50,49,8,0,1,98.0
2013020586,8,3504,0.0,24,21,1,0,3,87.5
2013020586,13,3600,0.0,22,21,2,1,1,95.45454545
2013020587,5,3574,0.0,28,25,1,2,3,89.28571429
2013020587,29,3507,0.0,30,25,6,0,5,83.33333333
2013020588,19,3889,0.0,30,28,8,0,2,93.33333333
2013020588,25,3889,0.0,22,19,1,0,3,86.36363636
2013020589,23,3600,0.0,18,18,0,0,0,100.0
2013020589,20,3471,0.0,30,28,3,0,2,93.33333333
2013020590,12,3551,0.0,26,22,3,0,4,84.61538462
2013020590,10,3600,0.0,43,41,2,2,2,95.34883721
2013020591,3,3600,0.0,40,37,2,0,3,92.5
2013020591,14,3503,0.0,29,25,1,0,4,86.20689655
2013020592,2,3600,0.0,37,33,5,1,4,89.18918919
2013020592,30,3571,0.0,31,26,5,0,5,83.87096774
2013020593,52,3898,0.0,34,33,1,0,1,97.05882353
2013020593,21,3898,0.0,37,35,4,1,2,94.59459459
2013020594,24,3545,0.0,23,20,0,0,3,86.95652174
2013020594,28,3600,0.0,31,30,1,0,1,96.77419355
2013020595,15,3536,0.0,37,35,6,0,2,94.59459459
2013020595,9,3597,0.0,35,34,4,1,1,97.14285714
2013020596,26,3564,0.0,30,29,7,1,1,96.66666667
2013020596,16,3600,0.0,26,26,1,0,0,100.0
2013020597,17,3562,0.0,28,23,3,0,5,82.14285714
2013020597,18,3600,0.0,25,21,1,2,4,84.0
2013020598,4,3857,0.0,44,41,10,1,3,93.18181818
2013020598,23,3900,0.0,27,24,1,1,3,88.88888889
2013020599,5,3580,0.0,30,28,4,0,2,93.33333333
2013020599,1,3594,0.0,20,19,1,0,1,95.0
2013020600,3,3900,0.0,22,21,4,0,1,95.45454545
2013020600,13,3897,0.0,31,30,7,2,1,96.77419355
2013020601,19,3600,0.0,25,24,2,0,1,96.0
2013020601,30,3520,0.0,23,21,1,1,2,91.30434783
2013020602,2,3600,0.0,38,35,4,4,3,92.10526316
2013020602,6,3599,2.0,31,26,6,1,5,83.87096774
2013020603,8,3807,0.0,42,37,17,1,5,88.0952381
2013020603,12,3792,0.0,25,21,3,2,4,84.0
2013020604,7,3570,0.0,25,23,5,0,2,92.0
2013020604,52,3600,0.0,27,27,6,0,0,100.0
2013020605,26,3539,0.0,32,29,6,0,3,90.625
2013020605,25,3598,0.0,25,23,6,0,2,92.0
2013020606,29,3567,0.0,23,18,0,1,5,78.26086957
2013020606,21,3600,0.0,38,35,4,1,3,92.10526316
2013020607,28,1126,0.0,4,3,0,1,1,75.0
2013020607,28,2466,0.0,34,29,2,0,5,85.29411765
2013020607,24,3600,0.0,36,33,8,1,3,91.66666667
2013020608,4,3600,0.0,24,23,4,0,1,95.83333333
2013020608,20,3421,0.0,20,17,1,0,3,85.0
2013020609,22,3893,0.0,45,41,1,0,4,91.11111111
2013020609,27,2258,0.0,15,15,2,0,0,100.0
2013020609,27,1604,0.0,10,7,0,0,3,70.0
2013020610,10,3896,0.0,43,41,13,0,2,95.34883721
2013020610,17,3883,0.0,26,24,5,0,2,92.30769231
2013020611,14,3600,0.0,30,28,4,0,2,93.33333333
2013020611,23,3444,0.0,33,29,2,0,4,87.87878788
2013020612,18,3654,0.0,25,22,4,1,3,88.0
2013020612,6,3650,0.0,35,33,2,1,2,94.28571429
2013020613,16,3658,0.0,34,31,3,0,3,91.17647059
2013020613,2,3658,0.0,39,37,0,0,2,94.87179487
2013020614,12,3680,0.0,41,38,2,0,3,92.68292683
2013020614,15,3680,0.0,33,29,6,0,4,87.87878788
2013020615,52,3511,0.0,29,25,0,0,4,86.20689655
2013020615,9,3600,0.0,35,32,0,2,3,91.42857143
2013020616,26,1901,0.0,14,12,3,0,2,85.71428571
2013020616,26,1699,0.0,12,9,1,1,3,75.0
2013020616,19,3600,0.0,30,30,10,1,0,100.0
2013020617,7,3551,0.0,31,28,8,0,3,90.32258065
2013020617,30,3600,0.0,20,19,6,0,1,95.0
2013020618,8,3592,0.0,32,28,7,0,4,87.5
2013020618,25,3583,0.0,27,22,2,0,5,81.48148148
2013020619,4,3513,0.0,31,29,2,0,2,93.5483871
2013020619,21,3599,0.0,30,29,9,2,1,96.66666667
2013020620,29,3599,0.0,34,34,5,3,0,100.0
2013020620,27,3538,2.0,31,29,5,0,2,93.5483871
2013020621,22,3600,0.0,36,31,3,0,5,86.11111111
2013020621,28,3588,0.0,24,23,5,2,1,95.83333333
2013020622,16,3600,0.0,27,24,5,0,3,88.88888889
2013020622,1,3600,0.0,24,19,2,0,5,79.16666667
2013020623,3,3600,0.0,28,23,2,0,5,82.14285714
2013020623,5,3582,0.0,35,33,12,0,2,94.28571429
2013020624,14,3600,0.0,19,19,4,0,0,100.0
2013020624,20,3574,0.0,29,27,8,2,2,93.10344828
2013020625,22,3502,0.0,37,32,15,0,5,86.48648649
2013020625,24,3593,0.0,18,16,1,2,2,88.88888889
2013020626,52,3600,0.0,29,25,0,1,4,86.20689655
2013020626,6,3600,0.0,37,36,3,0,1,97.2972973
2013020627,28,1955,0.0,7,6,0,0,1,85.71428571
2013020627,28,1545,0.0,14,11,3,0,3,78.57142857
2013020627,21,3600,0.0,33,30,6,1,3,90.90909091
2013020628,1,3535,0.0,22,20,10,0,2,90.90909091
2013020628,7,3584,0.0,22,21,4,3,1,95.45454545
2013020629,3,3600,0.0,26,25,1,0,1,96.15384615
2013020629,10,1394,0.0,18,16,4,1,2,88.88888889
2013020629,10,2195,0.0,32,27,3,0,5,84.375
2013020630,9,3658,0.0,29,26,5,1,3,89.65517241
2013020630,8,3656,0.0,34,30,4,0,4,88.23529412
2013020631,18,3887,0.0,29,25,4,0,4,86.20689655
2013020631,13,3900,0.0,42,38,2,0,4,90.47619048
2013020632,12,3600,0.0,40,38,6,2,2,95.0
2013020632,2,3416,0.0,30,27,2,0,3,90.0
2013020633,29,3600,0.0,37,31,1,0,6,83.78378378
2013020633,19,3600,0.0,24,22,0,0,2,91.66666667
2013020634,17,3600,0.0,45,44,10,1,1,97.77777778
2013020634,25,1200,0.0,13,10,1,0,3,76.92307692
2013020634,25,2391,0.0,14,12,2,2,2,85.71428571
2013020635,15,3499,0.0,11,6,0,0,5,54.54545455
2013020635,30,3600,0.0,30,27,5,0,3,90.0
2013020636,4,3584,0.0,29,26,2,0,3,89.65517241
2013020636,27,3541,0.0,27,23,4,2,4,85.18518519
2013020637,23,3575,0.0,48,46,3,1,2,95.83333333
2013020637,26,3599,0.0,28,27,5,1,1,96.42857143
2013020638,52,3505,0.0,39,33,1,1,6,84.61538462
2013020638,5,3600,0.0,34,29,3,0,5,85.29411765
2013020639,18,3522,0.0,25,23,0,1,2,92.0
2013020639,12,3600,0.0,32,31,2,1,1,96.875
2013020640,28,3900,0.0,35,33,0,0,2,94.28571429
2013020640,16,3900,0.0,42,40,4,0,2,95.23809524
2013020641,14,258,0.0,1,0,0,0,1,0.0
2013020641,14,3191,0.0,25,21,5,0,4,84.0
2013020641,22,3600,0.0,27,24,1,0,3,88.88888889
2013020642,23,3898,0.0,49,45,4,0,4,91.83673469
2013020642,24,3898,0.0,20,17,4,0,3,85.0
2013020643,25,3600,0.0,43,36,7,2,7,83.72093023
2013020643,2,2826,0.0,15,13,3,0,2,86.66666667
2013020643,2,774,0.0,8,7,2,0,1,87.5
2013020644,29,3900,0.0,43,40,8,0,3,93.02325581
2013020644,3,3870,0.0,39,36,5,3,3,92.30769231
2013020645,13,3545,0.0,35,33,2,2,2,94.28571429
2013020645,8,3597,0.0,27,26,1,0,1,96.2962963
2013020646,20,3600,0.0,25,22,4,3,3,88.0
2013020646,21,3499,0.0,19,15,2,0,4,78.94736842
2013020647,12,3571,0.0,18,15,1,0,3,83.33333333
2013020647,7,3600,0.0,38,36,6,0,2,94.73684211
2013020648,2,3600,0.0,26,23,5,0,3,88.46153846
2013020648,10,3531,0.0,24,20,0,0,4,83.33333333
2013020649,4,3710,0.0,33,31,2,1,2,93.93939394
2013020649,1,3661,0.0,28,25,6,1,3,89.28571429
2013020650,28,3481,0.0,28,25,1,1,3,89.28571429
2013020650,18,3600,0.0,28,26,3,0,2,92.85714286
2013020651,14,3600,2.0,14,12,0,0,2,85.71428571
2013020651,52,3579,0.0,32,29,5,1,3,90.625
2013020652,20,3600,0.0,30,24,4,0,6,80.0
2013020652,27,3594,0.0,27,27,6,0,0,100.0
2013020653,19,3600,0.0,18,16,0,1,2,88.88888889
2013020653,22,3493,0.0,29,25,4,0,4,86.20689655
2013020654,5,3856,0.0,26,22,1,0,4,84.61538462
2013020654,23,3900,0.0,35,31,3,1,4,88.57142857
2013020655,6,3600,0.0,20,15,2,0,5,75.0
2013020655,24,3596,0.0,32,30,3,0,2,93.75
2013020656,30,3886,0.0,40,39,7,0,1,97.5
2013020656,26,3900,0.0,17,16,4,0,1,94.11764706
2013020657,8,3600,0.0,27,24,2,0,3,88.88888889
2013020657,4,3575,0.0,20,19,5,1,1,95.0
2013020658,3,3600,0.0,37,35,4,0,2,94.59459459
2013020658,16,3510,0.0,32,29,4,1,3,90.625
2013020659,9,3633,0.0,31,27,1,0,4,87.09677419
2013020659,21,3633,0.0,32,29,4,1,3,90.625
2013020660,13,3900,0.0,24,23,2,0,1,95.83333333
2013020660,7,3900,0.0,35,34,8,0,1,97.14285714
2013020661,25,3565,0.0,34,33,2,1,1,97.05882353
2013020661,1,3600,0.0,26,26,3,1,0,100.0
2013020662,10,3600,0.0,36,30,6,0,6,83.33333333
2013020662,12,3600,0.0,26,25,0,1,1,96.15384615
2013020663,15,3595,0.0,36,33,2,2,3,91.66666667
2013020663,14,3575,0.0,20,16,3,0,4,80.0
2013020664,24,3545,0.0,26,23,8,0,3,88.46153846
2013020664,18,3520,0.0,28,24,3,1,4,85.71428571
2013020665,19,3600,0.0,33,33,10,2,0,100.0
2013020665,20,3580,0.0,29,24,6,1,5,82.75862069
2013020666,30,3600,0.0,40,39,7,1,1,97.5
2013020666,27,3575,0.0,28,25,6,1,3,89.28571429
2013020667,6,2227,0.0,17,16,2,0,1,94.11764706
2013020667,6,1305,0.0,18,15,3,0,3,83.33333333
2013020667,26,3597,0.0,22,20,3,1,2,90.90909091
2013020668,17,2397,0.0,23,19,4,0,4,82.60869565
2013020668,17,1200,0.0,3,3,0,1,0,100.0
2013020668,28,3586,0.0,25,24,3,0,1,96.0
2013020669,25,3522,0.0,34,31,3,0,3,91.17647059
2013020669,3,3600,0.0,26,24,0,0,2,92.30769231
2013020670,10,3526,0.0,35,32,7,1,3,91.42857143
2013020670,15,3598,0.0,34,32,6,2,2,94.11764706
2013020671,12,3600,0.0,24,21,2,0,3,87.5
2013020671,29,3600,0.0,36,36,4,0,0,100.0
2013020672,2,3692,0.0,31,30,2,0,1,96.77419355
2013020672,21,3706,0.0,24,22,3,1,2,91.66666667
2013020673,5,3661,0.0,31,27,5,0,4,87.09677419
2013020673,22,3661,2.0,28,25,6,1,3,89.28571429
2013020674,19,3533,0.0,22,20,2,0,2,90.90909091
2013020674,23,3600,0.0,31,30,0,1,1,96.77419355
2013020675,14,3600,0.0,38,35,7,1,3,92.10526316
2013020675,4,2390,0.0,17,12,2,0,5,70.58823529
2013020675,4,1174,0.0,7,7,0,1,0,100.0
2013020676,16,3688,0.0,38,36,2,4,2,94.73684211
2013020676,8,3688,0.0,20,19,0,1,1,95.0
2013020677,13,3897,0.0,36,34,2,2,2,94.44444444
2013020677,1,3894,0.0,30,29,3,1,1,96.66666667
2013020678,9,3900,0.0,33,32,4,0,1,96.96969697
2013020678,18,3897,0.0,21,20,0,0,1,95.23809524
2013020679,29,3600,0.0,31,28,7,3,3,90.32258065
2013020679,52,3600,0.0,26,20,2,0,6,76.92307692
2013020680,21,3600,0.0,27,25,1,1,2,92.59259259
2013020680,30,3590,0.0,17,14,4,1,3,82.35294118
2013020681,24,3600,0.0,31,28,8,0,3,90.32258065
2013020681,27,1855,0.0,23,19,0,0,4,82.60869565
2013020681,27,1632,0.0,7,6,1,0,1,85.71428571
2013020682,5,3600,0.0,28,27,3,2,1,96.42857143
2013020682,20,3518,0.0,26,24,4,0,2,92.30769231
2013020683,17,3586,0.0,45,44,3,0,1,97.77777778
2013020683,26,3455,0.0,26,23,8,0,3,88.46153846
2013020684,6,3588,0.0,26,26,1,0,0,100.0
2013020684,28,3527,0.0,22,21,3,1,1,95.45454545
2013020685,7,3900,0.0,29,28,1,2,1,96.55172414
2013020685,15,3900,0.0,31,30,3,2,1,96.77419355
2013020686,2,3549,0.0,31,29,1,0,2,93.5483871
2013020686,25,3559,0.0,30,27,0,1,3,90.0
2013020687,1,3865,0.0,25,23,7,0,2,92.0
2013020687,10,3900,0.0,38,36,6,2,2,94.73684211
2013020688,4,3586,0.0,35,31,8,0,4,88.57142857
2013020688,3,3599,0.0,38,37,7,2,1,97.36842105
2013020689,22,3476,4.0,41,36,8,1,5,87.80487805
2013020689,16,3587,0.0,20,18,0,2,2,90.0
2013020690,30,3600,0.0,23,23,0,1,0,100.0
2013020690,18,3600,0.0,23,19,2,0,4,82.60869565
2013020691,17,3517,0.0,23,22,4,3,1,95.65217391
2013020691,24,3600,0.0,22,22,6,0,0,100.0
2013020692,20,3597,0.0,23,23,1,1,0,100.0
2013020692,12,3553,0.0,29,27,2,0,2,93.10344828
2013020693,14,3523,0.0,28,25,3,2,3,89.28571429
2013020693,29,3600,0.0,28,26,3,2,2,92.85714286
2013020694,27,3600,0.0,38,33,14,1,5,86.84210526
2013020694,52,3596,0.0,19,18,4,0,1,94.73684211
2013020695,23,3494,0.0,20,19,8,0,1,95.0
2013020695,26,3595,0.0,28,28,7,3,0,100.0
2013020696,10,3600,0.0,41,38,6,4,3,92.68292683
2013020696,6,3514,0.0,26,22,6,1,4,84.61538462
2013020697,14,3586,0.0,34,33,4,1,1,97.05882353
2013020697,3,3556,0.0,25,23,1,1,2,92.0
2013020698,28,3900,0.0,36,35,2,1,1,97.22222222
2013020698,15,3900,0.0,29,28,2,0,1,96.55172414
2013020699,4,3564,0.0,19,16,5,1,3,84.21052632
2013020699,7,3592,0.0,33,29,8,2,4,87.87878788
2013020700,1,3600,0.0,30,29,7,2,1,96.66666667
2013020700,8,3520,0.0,18,15,0,1,3,83.33333333
2013020701,2,3462,0.0,26,22,7,0,4,84.61538462
2013020701,13,3600,0.0,33,31,3,1,2,93.93939394
2013020702,21,3849,0.0,48,46,13,0,2,95.83333333
2013020702,16,3849,0.0,26,23,2,2,3,88.46153846
2013020703,27,3524,0.0,18,16,4,0,2,88.88888889
2013020703,19,3600,0.0,21,20,4,0,1,95.23809524
2013020704,20,3471,0.0,34,30,8,0,4,88.23529412
2013020704,18,3600,0.0,24,22,4,0,2,91.66666667
2013020705,9,3588,0.0,27,27,1,0,0,100.0
2013020705,30,3600,0.0,32,29,5,0,3,90.625
2013020706,22,3459,0.0,29,25,0,1,4,86.20689655
2013020706,25,3600,0.0,33,31,3,0,2,93.93939394
2013020707,7,3874,0.0,39,36,4,0,3,92.30769231
2013020707,10,3859,0.0,30,27,2,0,3,90.0
2013020708,15,3529,0.0,37,33,7,1,4,89.18918919
2013020708,5,3597,0.0,28,25,3,0,3,89.28571429
2013020709,23,2162,0.0,31,25,13,1,6,80.64516129
2013020709,23,1438,0.0,13,10,2,1,3,76.92307692
2013020709,24,3598,0.0,32,31,1,0,1,96.875
2013020710,17,3519,0.0,48,47,4,1,1,97.91666667
2013020710,3,3600,0.0,38,38,5,2,0,100.0
2013020711,18,3893,0.0,30,27,4,1,3,90.0
2013020711,4,3881,0.0,37,34,4,1,3,91.89189189
2013020712,8,3623,0.0,44,40,1,1,4,90.90909091
2013020712,9,3623,0.0,23,18,0,0,5,78.26086957
2013020713,2,3875,0.0,30,29,2,0,1,96.66666667
2013020713,14,3897,0.0,30,29,5,1,1,96.66666667
2013020714,28,3590,0.0,24,24,0,3,0,100.0
2013020714,13,3600,0.0,39,36,5,3,3,92.30769231
2013020715,26,3600,0.0,29,28,7,0,1,96.55172414
2013020715,19,3507,0.0,30,27,7,0,3,90.0
2013020716,22,3596,0.0,33,29,5,1,4,87.87878788
2013020716,30,3600,0.0,21,20,1,1,1,95.23809524
2013020717,6,3600,0.0,34,32,8,2,2,94.11764706
2013020717,25,3547,0.0,40,37,4,5,3,92.5
2013020718,1,3900,0.0,38,37,5,0,1,97.36842105
2013020718,21,3888,0.0,34,33,5,1,1,97.05882353
2013020719,52,3600,0.0,22,20,4,0,2,90.90909091
2013020719,20,3600,0.0,23,18,1,0,5,78.26086957
2013020720,23,3536,0.0,23,22,3,3,1,95.65217391
2013020720,27,3600,0.0,29,29,10,2,0,100.0
2013020721,15,1301,0.0,14,11,1,0,3,78.57142857
2013020721,15,2271,0.0,22,20,5,0,2,90.90909091
2013020721,29,3598,0.0,27,26,8,0,1,96.2962963
2013020722,24,3558,0.0,34,31,4,0,3,91.17647059
2013020722,16,3587,0.0,21,19,2,3,2,90.47619048
2013020723,3,3580,0.0,30,29,0,2,1,96.66666667
2013020723,9,3600,0.0,31,27,6,2,4,87.09677419
2013020724,28,3579,0.0,29,25,0,1,4,86.20689655
2013020724,14,3504,2.0,32,27,1,0,5,84.375
2013020725,22,3670,0.0,39,36,9,2,3,92.30769231
2013020725,52,3670,0.0,22,20,4,0,2,90.90909091
2013020726,29,3900,0.0,29,26,6,0,3,89.65517241
2013020726,7,3826,0.0,35,32,4,0,3,91.42857143
2013020727,8,3523,0.0,29,25,5,0,4,86.20689655
2013020727,10,3600,0.0,33,30,6,0,3,90.90909091
2013020728,26,3900,0.0,35,33,2,0,2,94.28571429
2013020728,17,3866,2.0,32,30,5,0,2,93.75
2013020729,2,3547,0.0,31,26,3,1,5,83.87096774
2013020729,4,2040,0.0,24,20,3,1,4,83.33333333
2013020729,4,1560,0.0,5,5,0,0,0,100.0
2013020730,13,3543,0.0,39,36,9,2,3,92.30769231
2013020730,12,3600,0.0,39,37,8,0,2,94.87179487
2013020731,24,3589,0.0,36,34,4,0,2,94.44444444
2013020731,19,3527,0.0,21,18,0,0,3,85.71428571
2013020732,21,3600,0.0,31,27,3,0,4,87.09677419
2013020732,18,3537,0.0,29,24,0,1,5,82.75862069
2013020733,1,3455,0.0,27,24,2,0,3,88.88888889
2013020733,27,3600,0.0,35,33,4,1,2,94.28571429
2013020734,25,3738,0.0,19,16,3,0,3,84.21052632
2013020734,30,3762,0.0,35,33,3,1,2,94.28571429
2013020735,20,3900,0.0,33,31,6,0,2,93.93939394
2013020735,23,3881,0.0,33,31,2,0,2,93.93939394
2013020736,6,3900,0.0,37,35,4,0,2,94.59459459
2013020736,16,3897,0.0,36,34,4,0,2,94.44444444
2013020737,14,3600,0.0,51,48,6,1,3,94.11764706
2013020737,12,2542,0.0,17,15,0,0,2,88.23529412
2013020737,12,907,0.0,7,4,1,0,3,57.14285714
2013020738,15,1069,0.0,8,5,1,0,3,62.5
2013020738,15,2531,0.0,18,17,4,1,1,94.44444444
2013020738,3,3600,0.0,25,24,5,2,1,96.0
2013020739,26,3565,0.0,23,20,2,0,3,86.95652174
2013020739,6,3600,0.0,23,21,4,1,2,91.30434783
2013020740,4,3900,0.0,43,40,9,1,3,93.02325581
2013020740,2,3874,0.0,29,26,7,3,3,89.65517241
2013020741,13,3600,0.0,36,35,4,2,1,97.22222222
2013020741,5,3600,0.0,28,23,3,2,5,82.14285714
2013020742,19,3588,0.0,23,22,5,2,1,95.65217391
2013020742,17,1844,0.0,25,22,10,2,3,88.0
2013020742,17,1756,0.0,14,13,1,0,1,92.85714286
2013020743,25,3600,0.0,23,19,4,0,4,82.60869565
2013020743,18,3600,0.0,36,35,2,0,1,97.22222222
2013020744,10,3600,0.0,41,39,4,6,2,95.12195122
2013020744,27,3508,0.0,29,25,3,0,4,86.20689655
2013020745,20,3510,0.0,27,24,0,0,3,88.88888889
2013020745,28,3600,0.0,23,21,0,0,2,91.30434783
2013020746,13,3596,0.0,35,32,9,0,3,91.42857143
2013020746,7,3518,0.0,22,18,1,1,4,81.81818182
2013020747,19,2863,0.0,14,10,2,0,4,71.42857143
2013020747,19,737,0.0,9,6,0,0,3,66.66666667
2013020747,1,3600,0.0,27,26,4,2,1,96.2962963
2013020748,2,3600,0.0,33,30,4,0,3,90.90909091
2013020748,3,3516,0.0,36,32,2,0,4,88.88888889
2013020749,12,3600,0.0,24,22,2,0,2,91.66666667
2013020749,4,3500,0.0,32,29,2,1,3,90.625
2013020750,9,3600,0.0,34,34,5,2,0,100.0
2013020750,15,3523,0.0,26,24,4,1,2,92.30769231
2013020751,26,3483,0.0,34,29,9,2,5,85.29411765
2013020751,29,3600,0.0,29,26,4,0,3,89.65517241
2013020752,30,3596,0.0,36,32,10,1,4,88.88888889
2013020752,25,3598,0.0,18,18,1,2,0,100.0
2013020753,10,3593,0.0,37,35,4,1,2,94.59459459
2013020753,21,2182,0.0,20,19,3,0,1,95.0
2013020753,21,1375,0.0,10,7,1,0,3,70.0
2013020754,23,3597,0.0,29,28,7,0,1,96.55172414
2013020754,22,3530,0.0,27,25,6,1,2,92.59259259
2013020755,52,3600,0.0,42,40,6,0,2,95.23809524
2013020755,24,2143,0.0,11,8,1,0,3,72.72727273
2013020755,24,1409,0.0,10,10,0,0,0,100.0
2013020756,8,2103,0.0,21,16,4,0,5,76.19047619
2013020756,8,1493,2.0,10,10,0,1,0,100.0
2013020756,5,3596,2.0,24,23,7,0,1,95.83333333
2013020757,16,3900,0.0,31,27,5,0,4,87.09677419
2013020757,17,3900,0.0,35,31,3,2,4,88.57142857
2013020758,27,3511,0.0,26,23,3,0,3,88.46153846
2013020758,20,3600,0.0,32,30,3,0,2,93.75
2013020759,12,3583,0.0,29,26,1,0,3,89.65517241
2013020759,7,3529,0.0,32,28,4,0,4,87.5
2013020760,19,3598,0.0,35,34,1,1,1,97.14285714
2013020760,3,3543,0.0,25,23,2,1,2,92.0
2013020761,4,3565,0.0,39,34,11,3,5,87.17948718
2013020761,29,3591,0.0,28,26,8,0,2,92.85714286
2013020762,9,3897,0.0,38,35,4,0,3,92.10526316
2013020762,14,3900,0.0,36,33,4,1,3,91.66666667
2013020763,5,3600,0.0,34,30,5,0,4,88.23529412
2013020763,2,3544,0.0,28,23,4,0,5,82.14285714
2013020764,16,3461,0.0,19,17,4,0,2,89.47368421
2013020764,30,3600,0.0,34,33,2,1,1,97.05882353
2013020765,10,2004,0.0,15,11,0,1,4,73.33333333
2013020765,10,1595,0.0,13,10,1,0,3,76.92307692
2013020765,25,3600,0.0,25,24,1,0,1,96.0
2013020766,18,3588,0.0,34,33,9,0,1,97.05882353
2013020766,23,3500,0.0,26,24,4,2,2,92.30769231
2013020767,26,3529,0.0,21,19,3,2,2,90.47619048
2013020767,24,3600,0.0,31,30,7,1,1,96.77419355
2013020768,52,3554,0.0,32,31,2,2,1,96.875
2013020768,28,3600,0.0,20,20,4,0,0,100.0
2013020769,15,3525,0.0,30,28,10,0,2,93.33333333
2013020769,1,3600,0.0,31,30,9,3,1,96.77419355
2013020770,9,1190,0.0,9,9,2,0,0,100.0
2013020770,9,2400,0.0,22,17,3,0,5,77.27272727
2013020770,12,3600,0.0,26,23,3,1,3,88.46153846
2013020771,8,3600,0.0,26,22,3,0,4,84.61538462
2013020771,17,3600,0.0,31,30,3,1,1,96.77419355
2013020772,21,3600,0.0,36,34,1,0,2,94.44444444
2013020772,13,3500,0.0,25,22,1,1,3,88.0
2013020773,18,3900,0.0,31,27,1,0,4,87.09677419
2013020773,20,2339,0.0,13,12,1,0,1,92.30769231
2013020773,20,1560,0.0,12,9,1,0,3,75.0
2013020774,27,3600,2.0,39,36,6,0,3,92.30769231
2013020774,22,3525,0.0,29,25,5,0,4,86.20689655
2013020775,19,3834,0.0,36,33,10,0,3,91.66666667
2013020775,2,3898,0.0,35,32,2,1,3,91.42857143
2013020776,6,3600,0.0,26,25,3,1,1,96.15384615
2013020776,4,1990,0.0,19,15,3,0,4,78.94736842
2013020776,4,1606,0.0,14,12,2,2,2,85.71428571
2013020777,15,3573,0.0,21,21,2,3,0,100.0
2013020777,8,1818,0.0,26,22,4,0,4,84.61538462
2013020777,8,1761,0.0,8,7,3,0,1,87.5
2013020778,21,2400,0.0,18,15,4,1,3,83.33333333
2013020778,21,1200,0.0,11,9,1,0,2,81.81818182
2013020778,14,3595,0.0,27,25,2,0,2,92.59259259
2013020779,7,3600,0.0,38,36,1,0,2,94.73684211
2013020779,29,2145,0.0,11,10,1,0,1,90.90909091
2013020779,29,1408,0.0,10,7,0,0,3,70.0
2013020780,10,1691,0.0,19,15,2,1,4,78.94736842
2013020780,10,2071,0.0,13,12,0,0,1,92.30769231
2013020780,52,3764,0.0,28,24,3,0,4,85.71428571
2013020781,5,3600,0.0,28,25,5,3,3,89.28571429
2013020781,25,3600,0.0,24,24,7,0,0,100.0
2013020782,24,3600,0.0,36,36,6,0,0,100.0
2013020782,26,3550,0.0,20,18,2,1,2,90.0
2013020783,30,3810,0.0,32,29,0,0,3,90.625
2013020783,28,3806,0.0,22,20,3,0,2,90.90909091
2013020784,3,3600,0.0,22,19,0,1,3,86.36363636
2013020784,1,1200,0.0,5,4,0,0,1,80.0
2013020784,1,2400,0.0,21,15,1,0,6,71.42857143
2013020785,13,3891,0.0,30,26,5,0,4,86.66666667
2013020785,17,3896,0.0,37,33,8,0,4,89.18918919
2013020786,52,3600,0.0,35,34,4,1,1,97.14285714
2013020786,16,3567,0.0,20,18,1,1,2,90.0
2013020787,18,3597,0.0,27,22,4,0,5,81.48148148
2013020787,22,3599,0.0,35,34,5,0,1,97.14285714
2013020788,27,3735,0.0,25,20,1,0,5,80.0
2013020788,23,3722,0.0,33,29,6,2,4,87.87878788
2013020789,6,3595,0.0,37,34,10,2,3,91.89189189
2013020789,2,2886,0.0,36,30,0,0,6,83.33333333
2013020789,2,704,0.0,1,1,0,0,0,100.0
2013020790,29,3550,0.0,35,32,8,0,3,91.42857143
2013020790,12,3600,0.0,24,22,0,0,2,91.66666667
2013020791,7,3494,0.0,33,31,4,1,2,93.93939394
2013020791,5,3600,0.0,24,24,3,0,0,100.0
2013020792,21,3600,0.0,44,41,6,4,3,93.18181818
2013020792,25,3538,0.0,21,17,1,0,4,80.95238095
2013020793,22,3600,0.0,27,25,1,2,2,92.59259259
2013020793,23,3548,0.0,19,16,1,0,3,84.21052632
2013020794,26,3600,0.0,23,23,1,2,0,100.0
2013020794,28,3517,0.0,21,20,3,1,1,95.23809524
2013020795,13,3587,2.0,41,35,6,0,6,85.36585366
2013020795,6,3600,0.0,30,28,1,0,2,93.33333333
2013020796,14,3502,0.0,26,23,3,2,3,88.46153846
2013020796,10,3597,0.0,42,40,6,5,2,95.23809524
2013020797,17,3600,0.0,28,23,2,2,5,82.14285714
2013020797,4,3600,0.0,33,33,3,2,0,100.0
2013020798,9,3600,0.0,36,34,5,3,2,94.44444444
2013020798,29,3507,0.0,28,25,5,0,3,89.28571429
2013020799,15,3660,0.0,27,23,1,0,4,85.18518519
2013020799,7,3660,0.0,35,30,2,0,5,85.71428571
2013020800,12,3600,0.0,30,27,5,2,3,90.0
2013020800,8,3599,0.0,36,36,6,2,0,100.0
2013020801,1,3568,0.0,24,22,3,1,2,91.66666667
2013020801,19,3600,0.0,23,23,5,0,0,100.0
2013020802,18,3591,0.0,27,24,2,0,3,88.88888889
2013020802,52,3519,0.0,25,21,5,0,4,84.0
2013020803,16,1921,0.0,14,13,1,0,1,92.85714286
2013020803,16,1825,0.0,15,11,0,1,4,73.33333333
2013020803,20,2396,0.0,24,20,2,1,4,83.33333333
2013020803,20,1346,0.0,9,9,0,0,0,100.0
2013020804,26,3600,0.0,29,26,3,1,3,89.65517241
2013020804,27,3600,0.0,30,30,1,0,0,100.0
2013020805,30,3600,0.0,33,31,2,0,2,93.93939394
2013020805,24,3511,0.0,33,29,7,0,4,87.87878788
2013020806,3,3600,0.0,31,30,3,0,1,96.77419355
2013020806,2,3528,0.0,34,32,4,0,2,94.11764706
2013020807,28,3587,0.0,27,24,1,2,3,88.88888889
2013020807,22,3600,0.0,59,59,8,1,0,100.0
2013020808,16,3587,0.0,31,29,6,2,2,93.5483871
2013020808,23,3550,0.0,39,35,0,0,4,89.74358974
2013020809,8,3600,0.0,35,34,6,1,1,97.14285714
2013020809,6,1686,0.0,15,14,2,0,1,93.33333333
2013020809,6,1914,0.0,18,15,2,0,3,83.33333333
2013020810,13,3595,0.0,32,26,2,3,6,81.25
2013020810,10,3600,0.0,38,35,8,1,3,92.10526316
2013020811,15,3593,0.0,29,24,9,1,5,82.75862069
2013020811,29,3563,0.0,32,30,16,1,2,93.75
2013020812,14,109,0.0,1,0,0,0,1,0.0
2013020812,14,3268,0.0,27,23,5,1,4,85.18518519
2013020812,9,3596,0.0,38,35,2,0,3,92.10526316
2013020813,1,3640,0.0,16,14,1,1,2,87.5
2013020813,25,3593,0.0,24,21,1,3,3,87.5
2013020814,30,1345,0.0,9,8,2,0,1,88.88888889
2013020814,30,2184,0.0,23,19,3,0,4,82.60869565
2013020814,21,3600,0.0,35,31,2,2,4,88.57142857
2013020815,28,3545,0.0,29,26,1,0,3,89.65517241
2013020815,20,3600,0.0,28,27,3,0,1,96.42857143
2013020816,7,3600,0.0,40,38,6,0,2,95.0
2013020816,27,3505,0.0,28,25,2,2,3,89.28571429
2013020817,4,3464,0.0,27,23,1,0,4,85.18518519
2013020817,24,3600,0.0,30,27,5,0,3,90.0
2013020818,5,3599,0.0,31,30,3,0,1,96.77419355
2013020818,26,2400,0.0,15,14,0,1,1,93.33333333
2013020818,26,1198,0.0,7,4,1,0,3,57.14285714
2013020819,2,3527,0.0,36,33,5,0,3,91.66666667
2013020819,3,3593,0.0,39,38,10,1,1,97.43589744
2013020820,19,3571,0.0,30,28,5,2,2,93.33333333
2013020820,12,3591,0.0,28,27,4,0,1,96.42857143
2013020821,15,3879,0.0,45,42,14,0,3,93.33333333
2013020821,17,3879,0.0,29,26,5,0,3,89.65517241
2013020822,1,3687,0.0,33,30,4,0,3,90.90909091
2013020822,18,3631,0.0,26,24,2,0,2,92.30769231
2013020823,23,3565,0.0,34,30,6,0,4,88.23529412
2013020823,52,3597,0.0,26,23,1,1,3,88.46153846
2013020824,22,3581,2.0,41,37,7,2,4,90.24390244
2013020824,6,3598,0.0,22,22,2,0,0,100.0
2013020825,14,3876,2.0,29,28,5,1,1,96.55172414
2013020825,8,3874,2.0,36,34,3,3,2,94.44444444
2013020826,7,1200,0.0,12,10,1,0,2,83.33333333
2013020826,7,2400,0.0,27,22,3,2,5,81.48148148
2013020826,21,3587,0.0,28,27,9,0,1,96.42857143
2013020827,4,3600,0.0,35,35,4,0,0,100.0
2013020827,26,3494,0.0,13,11,1,0,2,84.61538462
2013020828,9,3589,0.0,35,30,5,1,5,85.71428571
2013020828,10,3587,0.0,26,23,4,0,3,88.46153846
2013020829,13,3599,0.0,30,26,1,0,4,86.66666667
2013020829,29,3600,0.0,36,35,8,0,1,97.22222222
2013020830,18,3900,0.0,34,31,3,0,3,91.17647059
2013020830,19,3883,0.0,31,28,1,2,3,90.32258065
2013020831,5,3533,0.0,30,27,7,1,3,90.0
2013020831,27,3600,0.0,24,23,3,0,1,95.83333333
2013020832,30,3733,0.0,32,28,6,0,4,87.5
2013020832,20,2693,0.0,17,14,2,0,3,82.35294118
2013020832,20,1052,0.0,6,6,1,0,0,100.0
2013020833,25,3600,0.0,26,26,2,2,0,100.0
2013020833,24,3560,0.0,26,25,3,1,1,96.15384615
2013020834,16,3900,0.0,39,38,12,2,1,97.43589744
2013020834,28,3896,0.0,30,29,3,1,1,96.66666667
2013020835,17,3753,0.0,28,22,6,0,6,78.57142857
2013020835,15,3757,0.0,30,25,2,2,5,83.33333333
2013020836,52,3600,2.0,31,30,6,0,1,96.77419355
2013020836,8,3540,0.0,35,33,5,0,2,94.28571429
2013020837,22,3599,0.0,44,42,6,1,2,95.45454545
2013020837,7,3522,0.0,28,25,5,2,3,89.28571429
2013020838,9,3715,0.0,48,46,8,1,2,95.83333333
2013020838,5,3696,0.0,25,24,1,1,1,96.0
2013020839,23,3536,0.0,29,28,4,4,1,96.55172414
2013020839,17,2400,0.0,16,16,2,0,0,100.0
2013020839,17,1200,0.0,8,8,6,0,0,100.0
2013020840,21,3578,0.0,28,27,3,2,1,96.42857143
2013020840,1,3628,0.0,25,23,6,1,2,92.0
2013020841,29,3600,0.0,36,34,2,0,2,94.44444444
2013020841,24,3510,0.0,33,29,7,0,4,87.87878788
2013020842,16,3599,0.0,34,31,7,0,3,91.17647059
2013020842,26,3519,0.0,30,25,7,0,5,83.33333333
2013020843,4,3600,0.0,22,20,7,0,2,90.90909091
2013020843,28,964,0.0,5,4,0,0,1,80.0
2013020843,28,2616,0.0,23,19,0,1,4,82.60869565
2013020844,23,3487,0.0,32,29,2,0,3,90.625
2013020844,6,3600,0.0,28,27,2,4,1,96.42857143
2013020845,21,3599,0.0,43,38,6,0,5,88.37209302
2013020845,3,3600,0.0,28,27,6,0,1,96.42857143
2013020846,52,3600,0.0,29,28,0,0,1,96.55172414
2013020846,12,3580,0.0,27,25,0,1,2,92.59259259
2013020847,20,3491,0.0,26,25,0,0,1,96.15384615
2013020847,8,3600,0.0,27,27,3,1,0,100.0
2013020848,10,3588,0.0,47,44,0,0,3,93.61702128
2013020848,13,3600,0.0,21,20,0,1,1,95.23809524
2013020849,2,3589,0.0,22,22,7,0,0,100.0
2013020849,15,3551,0.0,28,27,7,6,1,96.42857143
2013020850,9,3900,0.0,50,46,14,0,4,92.0
2013020850,19,3894,0.0,31,27,0,1,4,87.09677419
2013020851,14,3513,0.0,26,24,4,3,2,92.30769231
2013020851,30,3600,0.0,35,34,1,0,1,97.14285714
2013020852,25,3597,0.0,28,27,2,1,1,96.42857143
2013020852,27,3541,0.0,39,37,5,1,2,94.87179487
2013020853,5,3600,0.0,25,24,0,1,1,96.0
2013020853,7,3600,0.0,34,29,8,1,5,85.29411765
2013020854,16,3600,0.0,29,29,11,0,0,100.0
2013020854,24,3519,0.0,25,23,2,0,2,92.0
2013020855,25,3712,0.0,21,19,1,0,2,90.47619048
2013020855,28,3708,0.0,20,19,0,2,1,95.0
2013020856,20,3598,0.0,30,28,6,1,2,93.33333333
2013020856,2,3523,0.0,21,18,1,1,3,85.71428571
2013020857,22,3594,0.0,36,35,0,1,1,97.22222222
2013020857,3,3528,0.0,31,29,3,0,2,93.5483871
2013020858,21,3432,0.0,34,32,9,0,2,94.11764706
2013020858,4,3584,0.0,39,38,5,2,1,97.43589744
2013020859,52,3496,0.0,30,26,8,0,4,86.66666667
2013020859,15,3600,0.0,36,34,3,2,2,94.44444444
2013020860,23,3522,0.0,28,24,1,2,4,85.71428571
2013020860,8,3596,0.0,44,42,4,0,2,95.45454545
2013020861,7,3582,0.0,36,33,1,1,3,91.66666667
2013020861,9,3588,0.0,32,30,6,0,2,93.75
2013020862,10,3600,2.0,34,33,2,0,1,97.05882353
2013020862,14,1082,2.0,13,11,0,0,2,84.61538462
2013020862,14,2400,0.0,22,21,4,0,1,95.45454545
2013020863,17,3596,0.0,24,23,3,0,1,95.83333333
2013020863,13,3511,0.0,32,30,11,0,2,93.75
2013020864,6,3809,0.0,27,24,3,3,3,88.88888889
2013020864,19,3809,0.0,38,36,6,0,2,94.73684211
2013020865,18,3729,0.0,36,33,10,1,3,91.66666667
2013020865,30,3710,0.0,18,16,2,0,2,88.88888889
2013020866,29,3749,0.0,20,18,5,1,2,90.0
2013020866,26,3753,0.0,25,24,2,5,1,96.0
2013020867,22,3754,0.0,24,22,1,0,2,91.66666667
2013020867,1,3754,0.0,20,19,4,0,1,95.0
2013020868,3,3895,0.0,29,26,6,1,3,89.65517241
2013020868,5,3900,0.0,41,38,4,0,3,92.68292683
2013020869,13,1476,0.0,14,10,0,0,4,71.42857143
2013020869,13,2124,0.0,18,17,3,0,1,94.44444444
2013020869,12,3600,0.0,35,34,5,1,1,97.14285714
2013020870,16,3462,0.0,26,24,5,0,2,92.30769231
2013020870,27,3600,0.0,30,30,3,0,0,100.0
2013020871,29,3488,0.0,47,44,9,0,3,93.61702128
2013020871,28,3600,0.0,21,19,7,2,2,90.47619048
2013020872,20,3555,0.0,23,21,3,0,2,91.30434783
2013020872,4,3600,0.0,33,32,1,2,1,96.96969697
2013020873,52,3897,0.0,26,23,10,1,3,88.46153846
2013020873,19,3899,0.0,31,28,6,0,3,90.32258065
2013020874,9,2613,0.0,33,28,4,1,5,84.84848485
2013020874,9,985,0.0,9,7,0,0,2,77.77777778
2013020874,6,3599,0.0,28,26,6,2,2,92.85714286
2013020875,23,3484,0.0,24,21,3,0,3,87.5
2013020875,10,3591,0.0,33,32,5,1,1,96.96969697
2013020876,8,3600,0.0,32,31,1,0,1,96.875
2013020876,12,3590,0.0,23,20,0,0,3,86.95652174
2013020877,17,3585,0.0,27,24,4,1,3,88.88888889
2013020877,14,3600,0.0,33,31,5,0,2,93.93939394
2013020878,21,3600,0.0,33,31,10,0,2,93.93939394
2013020878,2,3485,0.0,24,21,2,0,3,87.5
2013020879,1,3557,0.0,24,23,5,0,1,95.83333333
2013020879,15,3600,0.0,25,25,4,2,0,100.0
2013020880,24,3600,0.0,38,36,4,1,2,94.73684211
2013020880,18,3401,0.0,23,19,1,0,4,82.60869565
2013020881,27,3478,0.0,33,31,10,1,2,93.93939394
2013020881,25,3581,0.0,27,26,6,1,1,96.2962963
2013020882,6,3614,0.0,26,21,8,0,5,80.76923077
2013020882,7,3602,0.0,33,29,9,3,4,87.87878788
2013020883,17,3872,0.0,20,19,2,0,1,95.0
2013020883,8,3827,0.0,30,28,0,0,2,93.33333333
2013020884,26,3579,0.0,29,25,6,1,4,86.20689655
2013020884,21,3476,0.0,27,22,4,2,5,81.48148148
2013020885,19,3502,0.0,35,34,6,0,1,97.14285714
2013020885,23,3600,0.0,20,20,3,2,0,100.0
2013020886,29,3423,0.0,34,30,2,1,4,88.23529412
2013020886,1,3600,0.0,19,17,2,0,2,89.47368421
2013020887,10,3714,0.0,35,30,3,0,5,85.71428571
2013020887,2,3715,0.0,22,18,2,1,4,81.81818182
2013020888,16,3435,0.0,24,22,1,0,2,91.66666667
2013020888,3,3590,0.0,32,31,5,0,1,96.875
2013020889,28,3599,0.0,30,27,3,1,3,90.0
2013020889,4,2398,0.0,16,12,3,1,4,75.0
2013020889,4,1202,0.0,13,10,0,2,3,76.92307692
2013020890,8,3900,0.0,32,27,11,0,5,84.375
2013020890,5,3895,0.0,29,24,2,1,5,82.75862069
2013020891,17,3597,0.0,38,37,7,2,1,97.36842105
2013020891,9,1504,0.0,15,9,1,0,6,60.0
2013020891,9,2071,0.0,11,11,2,0,0,100.0
2013020892,15,3577,2.0,34,30,10,0,4,88.23529412
2013020892,13,3542,0.0,32,27,6,1,5,84.375
2013020893,14,3524,0.0,29,26,2,1,3,89.65517241
2013020893,18,3600,0.0,16,14,0,0,2,87.5
2013020894,27,3900,0.0,29,27,5,2,2,93.10344828
2013020894,52,3900,0.0,36,34,11,0,2,94.44444444
2013020895,12,3565,0.0,33,30,14,1,3,90.90909091
2013020895,25,3559,0.0,30,29,6,1,1,96.66666667
2013020896,26,3600,0.0,25,25,6,0,0,100.0
2013020896,20,3487,0.0,24,22,0,1,2,91.66666667
2013020897,30,3600,0.0,21,21,2,0,0,100.0
2013020897,22,3598,0.0,21,18,2,1,3,85.71428571
2013020898,28,3487,0.0,19,16,3,1,3,84.21052632
2013020898,7,3598,0.0,38,36,4,0,2,94.73684211
2013020899,27,3491,0.0,33,29,3,1,4,87.87878788
2013020899,21,3600,0.0,42,40,11,1,2,95.23809524
2013020900,30,3893,0.0,31,30,2,0,1,96.77419355
2013020900,23,3900,0.0,23,22,3,0,1,95.65217391
2013020901,19,3546,0.0,19,18,1,0,1,94.73684211
2013020901,24,3600,0.0,18,18,1,2,0,100.0
2013020902,15,3593,0.0,38,36,4,4,2,94.73684211
2013020902,6,3499,0.0,31,27,12,1,4,87.09677419
2013020903,1,3595,0.0,19,18,4,3,1,94.73684211
2013020903,2,1200,0.0,16,15,6,0,1,93.75
2013020903,2,2400,0.0,19,14,2,1,5,73.68421053
2013020904,3,3441,0.0,31,27,9,0,4,87.09677419
2013020904,4,3600,0.0,35,33,6,0,2,94.28571429
2013020905,13,3568,0.0,35,31,4,1,4,88.57142857
2013020905,29,3595,0.0,20,17,4,1,3,85.0
2013020906,52,3600,0.0,40,39,12,0,1,97.5
2013020906,18,3455,0.0,20,17,5,2,3,85.0
2013020907,14,3600,0.0,41,39,6,0,2,95.12195122
2013020907,25,3467,0.0,21,17,2,0,4,80.95238095
2013020908,12,3569,0.0,30,28,5,1,2,93.33333333
2013020908,26,3600,0.0,25,24,3,0,1,96.0
2013020909,10,3808,2.0,30,26,2,0,4,86.66666667
2013020909,8,3808,2.0,25,22,4,0,3,88.0
2013020910,5,3600,0.0,40,35,9,1,5,87.5
2013020910,16,3593,0.0,32,31,10,0,1,96.875
2013020911,20,3707,0.0,22,21,2,1,1,95.45454545
2013020911,22,3709,0.0,30,28,4,0,2,93.33333333
2013020912,4,3739,0.0,29,25,8,0,4,86.20689655
2013020912,15,3765,0.0,36,31,9,1,5,86.11111111
2013020913,28,3595,0.0,23,21,1,1,2,91.30434783
2013020913,1,3487,0.0,22,18,1,0,4,81.81818182
2013020914,13,3600,0.0,38,35,12,2,3,92.10526316
2013020914,2,3521,0.0,34,29,7,0,5,85.29411765
2013020915,9,3600,0.0,31,29,5,1,2,93.5483871
2013020915,23,3528,0.0,27,24,1,0,3,88.88888889
2013020916,6,3600,0.0,42,39,6,0,3,92.85714286
2013020916,3,3592,0.0,33,27,0,1,6,81.81818182
2013020917,14,3524,0.0,33,29,5,1,4,87.87878788
2013020917,21,3587,0.0,34,31,0,1,3,91.17647059
2013020918,19,3600,0.0,25,23,4,0,2,92.0
2013020918,27,3531,0.0,30,26,5,0,4,86.66666667
2013020919,12,3594,0.0,34,29,5,2,5,85.29411765
2013020919,24,3600,0.0,52,49,8,2,3,94.23076923
2013020920,29,3600,0.0,29,28,4,0,1,96.55172414
2013020920,10,3512,0.0,33,31,0,2,2,93.93939394
2013020921,7,3585,0.0,39,36,13,0,3,92.30769231
2013020921,25,3597,0.0,23,21,2,2,2,91.30434783
2013020922,20,3502,0.0,27,24,5,0,3,88.88888889
2013020922,30,3600,0.0,23,21,1,0,2,91.30434783
2013020923,8,3542,0.0,22,20,4,0,2,90.90909091
2013020923,26,3600,0.0,18,17,2,1,1,94.44444444
2013020924,13,3553,0.0,38,35,5,4,3,92.10526316
2013020924,6,3600,0.0,24,23,1,1,1,95.83333333
2013020925,17,3563,0.0,29,25,3,0,4,86.20689655
2013020925,1,3600,0.0,23,20,6,0,3,86.95652174
2013020926,25,3484,0.0,20,16,1,0,4,80.0
2013020926,29,3600,0.0,33,31,5,0,2,93.93939394
2013020927,21,3600,0.0,38,36,3,1,2,94.73684211
2013020927,16,3526,0.0,20,17,3,0,3,85.0
2013020928,14,3536,0.0,28,25,5,0,3,89.28571429
2013020928,19,3589,0.0,17,15,3,0,2,88.23529412
2013020929,5,3596,0.0,19,18,3,0,1,94.73684211
2013020929,18,3561,0.0,19,16,5,0,3,84.21052632
2013020930,2,3833,2.0,38,36,8,1,2,94.73684211
2013020930,52,3823,0.0,27,24,2,0,3,88.88888889
2013020931,23,3535,0.0,32,31,6,0,1,96.875
2013020931,27,3598,0.0,23,23,0,1,0,100.0
2013020932,9,3565,0.0,30,27,2,0,3,90.0
2013020932,22,3600,0.0,36,34,1,0,2,94.44444444
2013020933,12,3858,0.0,37,35,0,0,2,94.59459459
2013020933,28,3858,0.0,35,32,2,0,3,91.42857143
2013020934,10,3711,0.0,37,35,2,0,2,94.59459459
2013020934,3,3711,0.0,29,26,1,0,3,89.65517241
2013020935,15,1652,0.0,11,10,3,1,1,90.90909091
2013020935,15,1912,0.0,18,14,0,0,4,77.77777778
2013020935,4,3600,0.0,25,21,3,0,4,84.0
2013020936,9,3600,0.0,28,24,7,1,4,85.71428571
2013020936,20,3585,0.0,31,30,6,1,1,96.77419355
2013020937,8,3900,0.0,42,39,12,4,3,92.85714286
2013020937,24,3893,0.0,31,28,5,1,3,90.32258065
2013020938,15,3572,0.0,42,40,0,0,2,95.23809524
2013020938,6,3597,0.0,16,16,0,0,0,100.0
2013020939,26,3599,0.0,18,17,1,1,1,94.44444444
2013020939,52,3500,0.0,41,38,9,0,3,92.68292683
2013020940,21,3868,0.0,37,35,1,0,2,94.59459459
2013020940,17,3868,0.0,25,22,1,0,3,88.0
2013020941,7,3600,0.0,44,43,3,1,1,97.72727273
2013020941,14,3515,0.0,21,18,1,1,3,85.71428571
2013020942,29,1651,0.0,15,13,4,1,2,86.66666667
2013020942,29,1949,0.0,18,14,0,0,4,77.77777778
2013020942,16,3595,0.0,23,22,3,0,1,95.65217391
2013020943,19,3600,0.0,21,20,2,0,1,95.23809524
2013020943,18,3523,0.0,22,20,2,1,2,90.90909091
2013020944,23,2400,0.0,17,12,2,0,5,70.58823529
2013020944,23,1188,0.0,5,4,0,0,1,80.0
2013020944,25,3588,0.0,33,32,8,2,1,96.96969697
2013020945,8,3600,0.0,23,18,4,0,5,78.26086957
2013020945,27,3598,0.0,26,24,5,0,2,92.30769231
2013020946,2,3743,0.0,29,26,0,2,3,89.65517241
2013020946,22,3720,0.0,34,32,3,1,2,94.11764706
2013020947,5,3516,0.0,46,42,17,0,4,91.30434783
2013020947,28,3600,0.0,22,19,1,1,3,86.36363636
2013020948,3,3577,0.0,24,22,7,0,2,91.66666667
2013020948,12,3565,0.0,43,40,6,2,3,93.02325581
2013020949,1,3600,0.0,33,26,1,2,7,78.78787879
2013020949,17,3600,0.0,25,21,4,0,4,84.0
2013020950,7,3505,0.0,44,42,15,1,2,95.45454545
2013020950,13,3580,0.0,25,25,1,5,0,100.0
2013020951,2,3595,0.0,23,19,3,1,4,82.60869565
2013020951,20,3600,0.0,26,23,3,0,3,88.46153846
2013020952,5,3900,0.0,31,29,3,0,2,93.5483871
2013020952,24,3889,0.0,17,15,5,0,2,88.23529412
2013020953,9,3600,0.0,49,46,15,1,3,93.87755102
2013020953,52,1772,0.0,20,15,3,1,5,75.0
2013020953,52,1712,0.0,12,12,0,0,0,100.0
2013020954,19,3600,0.0,27,26,1,0,1,96.2962963
2013020954,21,3460,0.0,25,23,0,2,2,92.0
2013020955,4,3741,0.0,36,32,3,0,4,88.88888889
2013020955,10,3741,0.0,31,28,3,2,3,90.32258065
2013020956,6,3900,0.0,20,17,0,3,3,85.0
2013020956,14,3900,0.0,32,29,6,0,3,90.625
2013020957,12,1971,0.0,22,18,1,0,4,81.81818182
2013020957,12,1577,0.0,9,8,0,1,1,88.88888889
2013020957,1,3600,2.0,33,29,1,3,4,87.87878788
2013020958,27,3514,0.0,33,30,5,0,3,90.90909091
2013020958,15,3600,0.0,33,31,7,0,2,93.93939394
2013020959,29,3576,0.0,28,28,3,0,0,100.0
2013020959,18,3510,0.0,36,35,10,0,1,97.22222222
2013020960,30,3514,0.0,38,34,9,3,4,89.47368421
2013020960,25,803,0.0,6,6,0,1,0,100.0
2013020960,25,2797,0.0,29,26,7,0,3,89.65517241
2013020961,20,3494,0.0,14,12,0,2,2,85.71428571
2013020961,23,3600,0.0,23,22,6,0,1,95.65217391
2013020962,8,2286,0.0,22,20,2,0,2,90.90909091
2013020962,8,1314,0.0,11,9,1,1,2,81.81818182
2013020962,28,3600,0.0,27,27,4,4,0,100.0
2013020963,6,3600,0.0,22,20,3,1,2,90.90909091
2013020963,13,3571,0.0,41,37,11,2,4,90.24390244
2013020964,16,3600,0.0,21,20,5,0,1,95.23809524
2013020964,7,3504,0.0,31,29,4,0,2,93.5483871
2013020965,17,3600,2.0,31,28,4,1,3,90.32258065
2013020965,3,3590,0.0,30,30,3,0,0,100.0
2013020966,19,3900,0.0,19,17,1,0,2,89.47368421
2013020966,30,3895,0.0,22,20,2,0,2,90.90909091
2013020967,26,3600,0.0,27,25,2,0,2,92.59259259
2013020967,22,3502,0.0,50,46,4,3,4,92.0
2013020968,5,3598,0.0,33,31,9,0,2,93.93939394
2013020968,15,3519,0.0,20,17,3,0,3,85.0
2013020969,18,3823,0.0,37,34,0,1,3,91.89189189
2013020969,9,2650,0.0,29,26,4,0,3,89.65517241
2013020969,9,1179,0.0,13,12,0,0,1,92.30769231
2013020970,27,3900,0.0,31,28,6,0,3,90.32258065
2013020970,14,3874,0.0,20,17,1,0,3,85.0
2013020971,29,3600,0.0,34,33,6,0,1,97.05882353
2013020971,25,3336,0.0,25,23,6,0,2,92.0
2013020972,52,3738,0.0,34,31,6,0,3,91.17647059
2013020972,21,3741,0.0,35,33,2,1,2,94.28571429
2013020973,26,3600,0.0,26,24,1,1,2,92.30769231
2013020973,20,3512,0.0,23,20,0,1,3,86.95652174
2013020974,2,3600,0.0,24,20,7,0,4,83.33333333
2013020974,23,3514,0.0,27,21,5,0,6,77.77777778
2013020975,10,3600,0.0,44,43,9,0,1,97.72727273
2013020975,24,3464,0.0,23,20,2,1,3,86.95652174
2013020976,18,3600,0.0,25,24,7,0,1,96.0
2013020976,7,3567,0.0,23,20,1,0,3,86.95652174
2013020977,1,3600,0.0,31,30,9,1,1,96.77419355
2013020977,4,3515,0.0,26,24,5,1,2,92.30769231
2013020978,3,3517,0.0,35,32,9,2,3,91.42857143
2013020978,12,3600,0.0,25,24,3,0,1,96.0
2013020979,17,3596,0.0,37,33,6,0,4,89.18918919
2013020979,29,3600,0.0,40,39,10,0,1,97.5
2013020980,27,3584,0.0,32,31,4,0,1,96.875
2013020980,13,3505,0.0,26,23,2,0,3,88.46153846
2013020981,15,3506,0.0,34,32,7,0,2,94.11764706
2013020981,5,3600,0.0,32,32,6,0,0,100.0
2013020982,25,3821,0.0,30,28,6,0,2,93.33333333
2013020982,19,3822,0.0,30,27,2,0,3,90.0
2013020983,22,3900,0.0,31,28,7,3,3,90.32258065
2013020983,30,3871,0.0,26,23,5,0,3,88.46153846
2013020984,10,3600,0.0,48,42,6,0,6,87.5
2013020984,28,3600,0.0,21,19,2,2,2,90.47619048
2013020985,6,3600,0.0,36,35,9,0,1,97.22222222
2013020985,8,3600,0.0,32,28,4,1,4,87.5
2013020986,23,3900,0.0,34,32,3,1,2,94.11764706
2013020986,52,3900,0.0,33,31,5,1,2,93.93939394
2013020987,16,3488,0.0,29,26,7,1,3,89.65517241
2013020987,21,3600,0.0,39,37,7,2,2,94.87179487
2013020988,24,688,0.0,5,2,1,1,3,40.0
2013020988,24,2884,0.0,20,16,2,0,4,80.0
2013020988,20,3565,0.0,22,20,1,2,2,90.90909091
2013020989,27,3555,0.0,20,18,0,1,2,90.0
2013020989,6,3600,0.0,22,21,4,0,1,95.45454545
2013020990,7,3518,0.0,54,51,13,0,3,94.44444444
2013020990,12,3600,0.0,23,21,4,0,2,91.30434783
2013020991,28,3895,0.0,38,35,3,1,3,92.10526316
2013020991,29,3900,0.0,27,24,3,0,3,88.88888889
2013020992,13,3555,0.0,28,23,5,0,5,82.14285714
2013020992,14,3600,0.0,27,23,3,0,4,85.18518519
2013020993,22,3600,0.0,37,31,7,3,6,83.78378378
2013020993,19,3592,0.0,25,23,7,2,2,92.0
2013020994,3,3500,0.0,26,24,2,1,2,92.30769231
2013020994,30,3600,0.0,30,29,4,0,1,96.66666667
2013020995,10,2400,0.0,31,31,4,0,0,100.0
2013020995,10,1178,0.0,10,8,0,0,2,80.0
2013020995,26,3523,0.0,29,26,5,1,3,89.65517241
2013020996,28,3600,0.0,38,35,0,0,3,92.10526316
2013020996,2,3498,0.0,26,22,3,0,4,84.61538462
2013020997,23,3514,0.0,21,17,4,0,4,80.95238095
2013020997,15,3600,0.0,41,38,8,0,3,92.68292683
2013020998,22,3900,0.0,23,22,4,0,1,95.65217391
2013020998,17,3894,0.0,22,21,1,0,1,95.45454545
2013020999,1,3550,0.0,21,17,2,0,4,80.95238095
2013020999,13,3600,0.0,31,28,1,0,3,90.32258065
2013021000,18,3600,0.0,33,31,1,0,2,93.93939394
2013021000,16,3523,0.0,29,26,2,0,3,89.65517241
2013021001,3,3590,0.0,32,30,5,0,2,93.75
2013021001,52,1200,0.0,8,6,0,0,2,75.0
2013021001,52,2274,0.0,15,13,4,4,2,86.66666667
2013021002,20,3900,0.0,25,22,0,0,3,88.0
2013021002,25,3900,0.0,30,27,0,0,3,90.0
2013021003,24,3600,0.0,38,34,11,0,4,89.47368421
2013021003,21,1454,0.0,9,8,2,0,1,88.88888889
2013021003,21,1909,0.0,24,19,1,0,5,79.16666667
2013021004,12,3598,0.0,41,36,6,0,5,87.80487805
2013021004,6,3600,0.0,30,29,3,0,1,96.66666667
2013021005,5,3600,0.0,40,36,4,0,4,90.0
2013021005,4,3600,0.0,25,25,5,0,0,100.0
2013021006,9,3668,0.0,48,43,13,0,5,89.58333333
2013021006,8,3578,0.0,34,30,3,4,4,88.23529412
2013021007,1,3557,0.0,32,29,0,2,3,90.625
2013021007,14,3600,0.0,23,23,1,0,0,100.0
2013021008,7,3492,0.0,37,34,4,3,3,91.89189189
2013021008,2,3600,0.0,34,33,10,1,1,97.05882353
2013021009,19,3600,0.0,31,30,3,0,1,96.77419355
2013021009,18,3600,0.0,26,22,3,1,4,84.61538462
2013021010,29,3900,0.0,33,32,2,0,1,96.96969697
2013021010,30,3900,0.0,29,28,0,0,1,96.55172414
2013021011,20,3526,0.0,26,23,7,0,3,88.46153846
2013021011,27,3583,0.0,31,29,4,3,2,93.5483871
2013021012,24,3600,0.0,38,37,4,0,1,97.36842105
2013021012,26,3526,0.0,20,18,1,0,2,90.0
2013021013,23,3900,0.0,29,26,6,1,3,89.65517241
2013021013,13,3900,0.0,32,29,8,0,3,90.625
2013021014,10,3574,0.0,32,29,3,0,3,90.625
2013021014,15,3600,0.0,29,27,8,0,2,93.10344828
2013021015,22,3600,2.0,30,29,4,0,1,96.66666667
2013021015,12,3524,0.0,33,31,2,2,2,93.93939394
2013021016,28,3584,0.0,41,41,4,0,0,100.0
2013021016,3,3574,0.0,29,28,0,4,1,96.55172414
2013021017,21,3600,0.0,39,38,5,1,1,97.43589744
2013021017,9,3512,0.0,22,19,0,0,3,86.36363636
2013021018,8,3600,0.0,29,29,3,0,0,100.0
2013021018,7,2169,0.0,22,20,2,1,2,90.90909091
2013021018,7,1305,0.0,10,10,0,0,0,100.0
2013021019,4,3600,0.0,23,20,3,1,3,86.95652174
2013021019,5,821,0.0,15,12,8,0,3,80.0
2013021019,5,2695,0.0,20,19,0,0,1,95.0
2013021020,17,3600,0.0,30,26,3,0,4,86.66666667
2013021020,16,3596,0.0,20,19,2,0,1,95.0
2013021021,25,2369,0.0,17,14,4,0,3,82.35294118
2013021021,25,1229,0.0,17,13,1,0,4,76.47058824
2013021021,52,3596,0.0,27,25,2,2,2,92.59259259
2013021022,30,3544,0.0,28,25,0,0,3,89.28571429
2013021022,6,3600,0.0,34,33,2,0,1,97.05882353
2013021023,23,3537,0.0,30,26,2,0,4,86.66666667
2013021023,14,3600,0.0,28,25,3,1,3,89.28571429
2013021024,52,3521,0.0,25,23,0,0,2,92.0
2013021024,19,3600,0.0,17,16,0,0,1,94.11764706
2013021025,27,3600,0.0,39,36,8,1,3,92.30769231
2013021025,26,3535,0.0,27,23,8,0,4,85.18518519
2013021026,6,3600,0.0,24,22,6,0,2,91.66666667
2013021026,1,3455,0.0,31,27,5,0,4,87.09677419
2013021027,30,3600,0.0,36,36,10,2,0,100.0
2013021027,2,3600,0.0,22,16,3,0,6,72.72727273
2013021028,25,3600,0.0,32,27,6,0,5,84.375
2013021028,5,3600,0.0,33,32,7,2,1,96.96969697
2013021029,12,3600,0.0,47,46,1,1,1,97.87234043
2013021029,29,1012,0.0,0,0,0,0,0,
2013021029,29,2400,0.0,20,17,8,1,3,85.0
2013021030,21,3517,2.0,35,30,4,1,5,85.71428571
2013021030,8,3569,0.0,28,25,4,1,3,89.28571429
2013021031,3,3600,0.0,39,35,1,0,4,89.74358974
2013021031,9,712,0.0,10,8,2,0,2,80.0
2013021031,9,2828,0.0,28,23,2,0,5,82.14285714
2013021032,10,3465,0.0,31,28,6,1,3,90.32258065
2013021032,17,3600,0.0,33,31,4,0,2,93.93939394
2013021033,16,3895,0.0,37,34,5,0,3,91.89189189
2013021033,4,3869,0.0,25,23,4,2,2,92.0
2013021034,7,3580,0.0,26,23,1,0,3,88.46153846
2013021034,20,3600,0.0,14,13,2,0,1,92.85714286
2013021035,18,2996,0.0,26,21,4,2,5,80.76923077
2013021035,18,599,0.0,4,4,0,0,0,100.0
2013021035,22,3569,0.0,29,28,5,3,1,96.55172414
2013021036,15,3598,0.0,45,43,12,0,2,95.55555556
2013021036,24,3518,0.0,30,27,3,0,3,90.0
2013021037,13,3600,0.0,54,52,15,0,2,96.2962963
2013021037,28,3498,0.0,24,21,1,0,3,87.5
2013021038,14,3600,0.0,39,36,6,1,3,92.30769231
2013021038,10,3498,0.0,30,25,4,0,5,83.33333333
2013021039,19,722,0.0,3,3,0,0,0,100.0
2013021039,19,2878,0.0,27,23,0,0,4,85.18518519
2013021039,16,3599,0.0,23,23,3,1,0,100.0
2013021040,21,3700,0.0,27,22,1,0,5,81.48148148
2013021040,52,3700,0.0,27,23,2,0,4,85.18518519
2013021041,18,3554,0.0,22,20,0,1,2,90.90909091
2013021041,23,3600,0.0,30,30,4,0,0,100.0
2013021042,30,3720,0.0,29,25,9,0,4,86.20689655
2013021042,1,3720,0.0,23,20,8,1,3,86.95652174
2013021043,25,3467,0.0,29,25,4,1,4,86.20689655
2013021043,4,3600,0.0,35,33,6,1,2,94.28571429
2013021044,29,3600,0.0,27,25,5,2,2,92.59259259
2013021044,8,3521,0.0,40,37,13,1,3,92.5
2013021045,14,3593,0.0,31,27,4,1,4,87.09677419
2013021045,9,3489,0.0,28,23,7,2,5,82.14285714
2013021046,5,3877,0.0,30,25,6,2,5,83.33333333
2013021046,17,3899,0.0,43,39,15,2,4,90.69767442
2013021047,7,3600,0.0,36,35,14,0,1,97.22222222
2013021047,22,3455,2.0,36,33,6,6,3,91.66666667
2013021048,13,3528,0.0,22,20,2,0,2,90.90909091
2013021048,27,3600,0.0,23,22,3,1,1,95.65217391
2013021049,15,3881,0.0,28,27,6,0,1,96.42857143
2013021049,26,3881,0.0,22,21,6,0,1,95.45454545
2013021050,24,3525,0.0,28,25,2,0,3,89.28571429
2013021050,28,3600,0.0,18,16,3,0,2,88.88888889
2013021051,3,3595,0.0,26,25,1,1,1,96.15384615
2013021051,29,3580,0.0,31,29,10,0,2,93.5483871
2013021052,12,3572,0.0,25,22,6,1,3,88.0
2013021052,16,3581,0.0,28,26,12,1,2,92.85714286
2013021053,6,3600,0.0,31,31,6,0,0,100.0
2013021053,21,3295,0.0,28,26,0,0,2,92.85714286
2013021054,18,2011,0.0,18,14,1,0,4,77.77777778
2013021054,18,1589,0.0,11,10,0,0,1,90.90909091
2013021054,20,1686,0.0,13,9,1,0,4,69.23076923
2013021054,20,1826,0.0,9,7,0,1,2,77.77777778
2013021055,19,3579,0.0,18,15,2,0,3,83.33333333
2013021055,4,3600,0.0,33,32,7,1,1,96.96969697
2013021056,14,3687,0.0,29,25,10,0,4,86.20689655
2013021056,5,3634,0.0,24,21,4,0,3,87.5
2013021057,17,3600,0.0,30,28,4,0,2,93.33333333
2013021057,30,3485,0.0,30,27,3,1,3,90.0
2013021058,9,3559,0.0,44,41,6,2,3,93.18181818
2013021058,25,3600,0.0,27,26,3,2,1,96.2962963
2013021059,13,3600,0.0,29,25,4,0,4,86.20689655
2013021059,26,3600,0.0,24,24,7,1,0,100.0
2013021060,8,3600,0.0,36,33,4,1,3,91.66666667
2013021060,10,3520,0.0,36,32,4,0,4,88.88888889
2013021061,3,3600,0.0,21,21,0,3,0,100.0
2013021061,1,3521,0.0,26,25,4,0,1,96.15384615
2013021062,12,3600,0.0,36,34,5,0,2,94.44444444
2013021062,52,3520,0.0,32,29,1,0,3,90.625
2013021063,6,3598,0.0,33,31,4,0,2,93.93939394
2013021063,27,3500,0.0,27,24,4,0,3,88.88888889
2013021064,20,3599,0.0,25,24,2,0,1,96.0
2013021064,22,1962,0.0,15,12,1,0,3,80.0
2013021064,22,1638,0.0,16,11,1,0,5,68.75
2013021065,15,3900,0.0,36,34,11,0,2,94.44444444
2013021065,28,3900,0.0,25,23,3,1,2,92.0
2013021066,29,3445,0.0,32,30,4,2,2,93.75
2013021066,2,3600,0.0,41,41,11,1,0,100.0
2013021067,19,3600,0.0,33,33,10,0,0,100.0
2013021067,5,3520,0.0,27,26,3,2,1,96.2962963
2013021068,10,1310,0.0,10,7,0,0,3,70.0
2013021068,10,2164,0.0,14,14,2,0,0,100.0
2013021068,1,3600,0.0,23,21,3,0,2,91.30434783
2013021069,18,3600,0.0,29,29,7,0,0,100.0
2013021069,16,3466,0.0,17,15,3,1,2,88.23529412
2013021070,30,3735,0.0,16,13,2,0,3,81.25
2013021070,17,3703,0.0,25,21,1,0,4,84.0
2013021071,7,3507,0.0,36,32,3,0,4,88.88888889
2013021071,23,3600,0.0,18,16,1,0,2,88.88888889
2013021072,13,3600,0.0,40,34,4,0,6,85.0
2013021072,24,3593,0.0,30,28,1,0,2,93.33333333
2013021073,27,570,0.0,9,7,0,0,2,77.77777778
2013021073,27,3121,0.0,27,25,1,1,2,92.59259259
2013021073,3,3716,0.0,21,18,3,1,3,85.71428571
2013021074,26,3600,0.0,32,30,4,1,2,93.75
2013021074,4,3529,0.0,41,38,3,1,3,92.68292683
2013021075,8,3882,0.0,29,28,6,0,1,96.55172414
2013021075,6,3900,0.0,22,21,9,3,1,95.45454545
2013021076,9,3884,0.0,38,35,9,1,3,92.10526316
2013021076,14,3875,0.0,32,29,6,2,3,90.625
2013021077,52,3487,0.0,27,25,4,1,2,92.59259259
2013021077,25,3600,0.0,33,32,2,1,1,96.96969697
2013021078,28,3893,0.0,27,26,2,1,1,96.2962963
2013021078,20,3900,0.0,34,33,6,0,1,97.05882353
2013021079,19,3600,0.0,25,22,2,0,3,88.0
2013021079,10,3523,0.0,48,44,2,1,4,91.66666667
2013021080,27,3600,0.0,25,23,2,2,2,92.0
2013021080,5,3510,0.0,29,26,6,0,3,89.65517241
2013021081,26,3900,0.0,27,23,4,2,4,85.18518519
2013021081,15,3879,0.0,36,32,7,0,4,88.88888889
2013021082,2,3600,0.0,28,24,5,0,4,85.71428571
2013021082,12,3152,0.0,23,21,5,0,2,91.30434783
2013021082,12,372,0.0,9,6,0,0,3,66.66666667
2013021083,7,3539,0.0,35,33,5,0,2,94.28571429
2013021083,8,3576,0.0,24,24,6,3,0,100.0
2013021084,9,3900,0.0,41,39,2,1,2,95.12195122
2013021084,13,3897,0.0,39,37,3,1,2,94.87179487
2013021085,17,3502,0.0,27,24,1,0,3,88.88888889
2013021085,29,2400,0.0,23,22,1,2,1,95.65217391
2013021085,29,1200,0.0,10,9,2,0,1,90.0
2013021086,25,3586,0.0,41,38,4,0,3,92.68292683
2013021086,16,3600,0.0,27,25,2,0,2,92.59259259
2013021087,21,3900,0.0,33,29,1,0,4,87.87878788
2013021087,18,3900,0.0,28,24,0,0,4,85.71428571
2013021088,28,3600,0.0,30,28,2,0,2,93.33333333
2013021088,22,3600,0.0,34,29,2,0,5,85.29411765
2013021089,23,3600,0.0,31,29,4,1,2,93.5483871
2013021089,30,1200,0.0,7,5,0,2,2,71.42857143
2013021089,30,2400,0.0,12,9,0,0,3,75.0
2013021090,4,3526,0.0,29,26,1,0,3,89.65517241
2013021090,3,3600,0.0,31,30,6,0,1,96.77419355
2013021091,24,3600,0.0,34,32,2,0,2,94.11764706
2013021091,20,3519,0.0,34,31,4,0,3,91.17647059
2013021092,16,3597,0.0,23,20,3,1,3,86.95652174
2013021092,6,3600,0.0,28,28,3,0,0,100.0
2013021093,27,3900,0.0,28,26,7,0,2,92.85714286
2013021093,1,3896,0.0,27,25,5,1,2,92.59259259
2013021094,26,3600,0.0,37,35,11,0,2,94.59459459
2013021094,5,3514,0.0,32,29,5,1,3,90.625
2013021095,8,3595,0.0,30,26,3,1,4,86.66666667
2013021095,17,3565,0.0,29,24,7,0,5,82.75862069
2013021096,2,3900,0.0,31,29,5,0,2,93.5483871
2013021096,14,3898,0.0,27,25,3,0,2,92.59259259
2013021097,12,3599,0.0,35,35,3,0,0,100.0
2013021097,13,2351,0.0,20,18,0,1,2,90.0
2013021097,13,1200,0.0,12,11,3,0,1,91.66666667
2013021098,30,3600,0.0,24,19,4,1,5,79.16666667
2013021098,19,3565,0.0,28,27,7,0,1,96.42857143
2013021099,7,2400,0.0,19,17,0,0,2,89.47368421
2013021099,7,1200,0.0,15,11,6,0,4,73.33333333
2013021099,18,3600,0.0,33,32,3,0,1,96.96969697
2013021100,23,3655,0.0,28,25,1,0,3,89.28571429
2013021100,21,3655,0.0,31,29,7,0,2,93.5483871
2013021101,52,3600,0.0,30,27,4,2,3,90.0
2013021101,28,3531,0.0,31,27,2,2,4,87.09677419
2013021102,10,3525,0.0,29,25,3,2,4,86.20689655
2013021102,4,3596,2.0,34,32,4,0,2,94.11764706
2013021103,5,3600,0.0,36,35,10,0,1,97.22222222
2013021103,29,3538,0.0,31,29,4,1,2,93.5483871
2013021104,16,3582,0.0,29,24,1,0,5,82.75862069
2013021104,9,3600,0.0,49,46,10,1,3,93.87755102
2013021105,18,3600,0.0,29,22,0,0,7,75.86206897
2013021105,25,3600,0.0,28,25,1,0,3,89.28571429
2013021106,3,3534,0.0,28,24,5,0,4,85.71428571
2013021106,20,3600,0.0,41,38,0,0,3,92.68292683
2013021107,24,3831,0.0,23,19,1,1,4,82.60869565
2013021107,22,3830,0.0,51,48,7,0,3,94.11764706
2013021108,6,3600,0.0,33,31,8,0,2,93.93939394
2013021108,15,3550,0.0,36,32,8,0,4,88.88888889
2013021109,28,3537,0.0,22,19,3,0,3,86.36363636
2013021109,21,3600,0.0,49,47,7,0,2,95.91836735
2013021110,14,3663,0.0,28,26,2,1,2,92.85714286
2013021110,7,3713,0.0,33,29,6,0,4,87.87878788
2013021111,17,3600,0.0,27,25,3,1,2,92.59259259
2013021111,10,3493,0.0,28,24,3,1,4,85.71428571
2013021112,8,3567,0.0,37,36,5,5,1,97.2972973
2013021112,13,3530,0.0,18,15,5,0,3,83.33333333
2013021113,1,3900,0.0,20,19,2,3,1,95.0
2013021113,2,3900,0.0,24,23,3,0,1,95.83333333
2013021114,29,3760,0.0,27,25,2,0,2,92.59259259
2013021114,12,3760,0.0,32,29,1,2,3,90.625
2013021115,25,3600,0.0,35,33,5,0,2,94.28571429
2013021115,19,3524,0.0,27,23,6,0,4,85.18518519
2013021116,30,3600,0.0,24,23,4,0,1,95.83333333
2013021116,27,3538,0.0,29,27,0,1,2,93.10344828
2013021117,24,3592,0.0,32,31,5,2,1,96.875
2013021117,23,3597,0.0,21,16,2,0,5,76.19047619
2013021118,52,1200,0.0,16,13,3,0,3,81.25
2013021118,52,2312,0.0,13,12,1,0,1,92.30769231
2013021118,26,3600,0.0,26,24,1,0,2,92.30769231
2013021119,20,3585,0.0,36,31,1,0,5,86.11111111
2013021119,9,3598,0.0,40,37,7,0,3,92.5
2013021120,14,3535,0.0,30,27,2,0,3,90.0
2013021120,17,3600,0.0,28,26,7,1,2,92.85714286
2013021121,6,3900,0.0,52,49,2,0,3,94.23076923
2013021121,4,3837,0.0,30,27,0,1,3,90.0
2013021122,16,3566,0.0,26,23,6,0,3,88.46153846
2013021122,5,3600,0.0,26,25,0,0,1,96.15384615
2013021123,15,3897,0.0,29,26,0,0,3,89.65517241
2013021123,18,3900,0.0,26,23,4,0,3,88.46153846
2013021124,3,3571,0.0,26,26,8,1,0,100.0
2013021124,22,3597,0.0,32,27,13,0,5,84.375
2013021125,12,3900,2.0,29,28,1,1,1,96.55172414
2013021125,9,3900,0.0,31,30,1,1,1,96.77419355
2013021126,13,3600,0.0,32,26,5,0,6,81.25
2013021126,1,2001,0.0,13,13,6,0,0,100.0
2013021126,1,1592,0.0,9,6,1,0,3,66.66666667
2013021127,52,3616,0.0,36,31,0,0,5,86.11111111
2013021127,24,3554,0.0,37,33,3,0,4,89.18918919
2013021128,30,3600,0.0,20,18,1,0,2,90.0
2013021128,26,3518,0.0,20,17,0,0,3,85.0
2013021129,1,3885,0.0,27,25,2,0,2,92.59259259
2013021129,7,3897,0.0,35,33,4,0,2,94.28571429
2013021130,20,3542,0.0,22,19,0,1,3,86.36363636
2013021130,10,3596,0.0,24,22,0,0,2,91.66666667
2013021131,13,3590,0.0,40,36,7,2,4,90.0
2013021131,2,3600,0.0,22,20,3,1,2,90.90909091
2013021132,12,3589,0.0,31,30,2,0,1,96.77419355
2013021132,5,3600,0.0,28,24,0,1,4,85.71428571
2013021133,25,3600,0.0,35,35,10,0,0,100.0
2013021133,15,1790,0.0,23,20,1,0,3,86.95652174
2013021133,15,1810,0.0,13,11,2,0,2,84.61538462
2013021134,21,3867,0.0,26,24,4,0,2,92.30769231
2013021134,29,3867,0.0,28,25,2,0,3,89.28571429
2013021135,8,3575,0.0,32,30,8,1,2,93.75
2013021135,14,3600,0.0,26,25,3,0,1,96.15384615
2013021136,4,3900,0.0,28,28,2,0,0,100.0
2013021136,19,3895,0.0,31,31,2,0,0,100.0
2013021137,3,3598,0.0,35,34,4,0,1,97.14285714
2013021137,23,3501,0.0,31,28,4,1,3,90.32258065
2013021138,52,3900,0.0,29,28,0,0,1,96.55172414
2013021138,27,3894,0.0,22,21,1,0,1,95.45454545
2013021139,22,3478,0.0,33,28,11,0,5,84.84848485
2013021139,28,3582,0.0,29,25,4,3,4,86.20689655
2013021140,2,3600,0.0,36,35,8,0,1,97.22222222
2013021140,9,3548,0.0,27,25,3,2,2,92.59259259
2013021141,6,3514,0.0,20,17,0,2,3,85.0
2013021141,17,3600,0.0,35,33,10,0,2,94.28571429
2013021142,22,3557,0.0,26,23,5,0,3,88.46153846
2013021142,24,3600,0.0,32,30,4,0,2,93.75
2013021143,27,3600,0.0,32,28,4,0,4,87.5
2013021143,26,3600,0.0,17,17,1,1,0,100.0
2013021144,6,3771,0.0,31,27,7,2,4,87.09677419
2013021144,10,869,0.0,11,10,4,1,1,90.90909091
2013021144,10,2902,0.0,27,25,0,1,2,92.59259259
2013021145,29,3583,0.0,37,37,3,4,0,100.0
2013021145,4,3455,0.0,27,25,4,1,2,92.59259259
2013021146,25,1731,0.0,16,15,3,0,1,93.75
2013021146,25,1693,0.0,16,13,1,0,3,81.25
2013021146,12,3600,0.0,34,33,5,0,1,97.05882353
2013021147,20,3600,0.0,32,31,4,0,1,96.875
2013021147,14,3514,0.0,24,21,2,1,3,87.5
2013021148,30,3900,0.0,26,24,0,0,2,92.30769231
2013021148,16,3900,0.0,27,25,2,0,2,92.59259259
2013021149,7,3541,0.0,28,26,0,1,2,92.85714286
2013021149,19,3600,0.0,25,24,2,1,1,96.0
2013021150,5,3600,0.0,15,13,0,1,2,86.66666667
2013021150,52,3490,0.0,21,17,1,0,4,80.95238095
2013021151,3,3900,0.0,37,35,8,1,2,94.59459459
2013021151,21,3822,0.0,31,29,5,3,2,93.5483871
2013021152,26,3562,0.0,21,19,1,0,2,90.47619048
2013021152,28,3600,0.0,27,26,6,0,1,96.2962963
2013021153,8,3600,0.0,43,39,7,4,4,90.69767442
2013021153,9,3600,0.0,23,16,2,1,7,69.56521739
2013021154,16,3591,0.0,27,24,5,1,3,88.88888889
2013021154,29,3593,0.0,38,34,4,1,4,89.47368421
2013021155,7,3541,0.0,31,28,2,0,3,90.32258065
2013021155,17,3600,0.0,23,21,0,0,2,91.30434783
2013021156,20,3591,0.0,35,34,5,2,1,97.14285714
2013021156,13,3525,0.0,17,15,5,0,2,88.23529412
2013021157,15,3562,0.0,31,29,10,0,2,93.5483871
2013021157,1,3600,0.0,25,24,5,0,1,96.0
2013021158,22,3851,0.0,26,24,1,2,2,92.30769231
2013021158,27,3900,0.0,26,24,1,0,2,92.30769231
2013021159,18,3598,0.0,29,27,6,1,2,93.10344828
2013021159,24,2225,0.0,17,13,1,0,4,76.47058824
2013021159,24,1375,0.0,7,6,1,0,1,85.71428571
2013021160,4,3572,0.0,41,37,1,2,4,90.24390244
2013021160,6,3600,0.0,26,24,2,0,2,92.30769231
2013021161,21,3600,0.0,31,31,5,3,0,100.0
2013021161,19,3600,0.0,29,25,7,1,4,86.20689655
2013021162,15,3898,0.0,38,35,4,2,3,92.10526316
2013021162,2,3900,0.0,29,26,4,0,3,89.65517241
2013021163,52,3600,0.0,25,23,6,1,2,92.0
2013021163,10,3435,0.0,41,37,0,1,4,90.24390244
2013021164,17,3492,0.0,26,21,3,0,5,80.76923077
2013021164,8,3600,0.0,37,34,9,3,3,91.89189189
2013021165,25,3600,0.0,29,27,2,3,2,93.10344828
2013021165,14,3369,0.0,28,23,10,0,5,82.14285714
2013021166,9,3600,0.0,43,41,2,1,2,95.34883721
2013021166,3,3600,0.0,34,31,1,0,3,91.17647059
2013021167,1,3600,0.0,27,26,6,1,1,96.2962963
2013021167,12,3527,0.0,22,20,0,1,2,90.90909091
2013021168,5,3591,0.0,20,16,2,0,4,80.0
2013021168,30,3600,0.0,20,20,4,1,0,100.0
2013021169,26,3566,2.0,40,38,6,0,2,95.0
2013021169,23,3596,0.0,26,25,0,1,1,96.15384615
2013021170,18,3600,0.0,35,35,2,1,0,100.0
2013021170,28,3597,0.0,24,21,1,0,3,87.5
2013021171,25,3543,0.0,24,21,0,2,3,87.5
2013021171,13,3600,2.0,37,35,9,1,2,94.59459459
2013021172,2,3600,0.0,33,29,8,0,4,87.87878788
2013021172,29,3600,0.0,31,31,2,2,0,100.0
2013021173,7,3572,0.0,37,32,8,2,5,86.48648649
2013021173,4,3600,0.0,19,17,4,1,2,89.47368421
2013021174,19,3516,0.0,34,31,5,1,3,91.17647059
2013021174,16,3600,0.0,23,21,1,1,2,91.30434783
2013021175,5,3900,0.0,41,39,12,0,2,95.12195122
2013021175,21,3899,0.0,32,30,1,2,2,93.75
2013021176,24,3465,0.0,27,24,2,1,3,88.88888889
2013021176,22,3600,0.0,36,34,7,0,2,94.44444444
2013021177,20,3600,2.0,31,31,2,1,0,100.0
2013021177,1,3524,0.0,22,21,4,0,1,95.45454545
2013021178,30,3600,0.0,24,24,4,1,0,100.0
2013021178,52,3488,0.0,17,16,4,1,1,94.11764706
2013021179,24,3591,0.0,18,18,3,0,0,100.0
2013021179,23,3600,0.0,23,20,1,1,3,86.95652174
2013021180,17,3595,0.0,27,25,5,1,2,92.59259259
2013021180,7,3540,0.0,36,33,10,0,3,91.66666667
2013021181,9,3600,0.0,46,45,5,5,1,97.82608696
2013021181,2,3512,0.0,31,28,4,3,3,90.32258065
2013021182,12,3600,0.0,36,32,2,0,4,88.88888889
2013021182,3,3600,0.0,28,27,0,0,1,96.42857143
2013021183,27,3752,0.0,30,26,3,0,4,86.66666667
2013021183,29,3813,0.0,32,29,4,0,3,90.625
2013021184,10,3547,0.0,33,31,0,0,2,93.93939394
2013021184,14,343,0.0,3,3,1,0,0,100.0
2013021184,14,3257,0.0,25,25,4,0,0,100.0
2013021185,4,3600,0.0,40,38,3,0,2,95.0
2013021185,13,3600,0.0,27,22,7,0,5,81.48148148
2013021186,15,3598,0.0,29,28,3,3,1,96.55172414
2013021186,19,3559,0.0,22,18,3,3,4,81.81818182
2013021187,6,3896,0.0,24,21,0,0,3,87.5
2013021187,30,3877,0.0,24,21,2,0,3,87.5
2013021188,18,3900,0.0,30,28,5,0,2,93.33333333
2013021188,25,3900,0.0,29,27,0,0,2,93.10344828
2013021189,21,3600,0.0,23,22,6,0,1,95.65217391
2013021189,22,3600,0.0,33,29,1,2,4,87.87878788
2013021190,8,3641,0.0,28,25,3,0,3,89.28571429
2013021190,16,3632,0.0,30,28,0,0,2,93.33333333
2013021191,17,3900,0.0,24,21,1,0,3,87.5
2013021191,5,3900,0.0,37,34,5,0,3,91.89189189
2013021192,26,3900,0.0,18,15,0,0,3,83.33333333
2013021192,20,3900,0.0,44,41,0,0,3,93.18181818
2013021193,28,1810,2.0,10,9,1,1,1,90.0
2013021193,28,1775,0.0,19,16,5,0,3,84.21052632
2013021193,24,3600,0.0,38,36,14,0,2,94.73684211
2013021194,7,3528,0.0,30,28,8,0,2,93.33333333
2013021194,3,3600,0.0,24,23,4,0,1,95.83333333
2013021195,15,3600,0.0,38,36,4,0,2,94.73684211
2013021195,12,3599,0.0,21,16,0,1,5,76.19047619
2013021196,2,3561,0.0,19,19,2,0,0,100.0
2013021196,8,3505,0.0,30,28,0,0,2,93.33333333
2013021197,1,3876,0.0,32,31,1,1,1,96.875
2013021197,9,3900,0.0,39,38,4,2,1,97.43589744
2013021198,4,3424,0.0,30,26,7,0,4,86.66666667
2013021198,14,3596,0.0,36,34,3,1,2,94.44444444
2013021199,10,3511,0.0,37,33,3,0,4,89.18918919
2013021199,13,3600,0.0,29,27,4,0,2,93.10344828
2013021200,27,3529,0.0,23,21,2,0,2,91.30434783
2013021200,18,3596,0.0,29,29,5,0,0,100.0
2013021201,19,912,0.0,2,2,0,0,0,100.0
2013021201,19,2601,0.0,13,9,3,1,4,69.23076923
2013021201,30,3578,0.0,45,43,8,2,2,95.55555556
2013021202,6,3900,0.0,37,36,2,1,1,97.2972973
2013021202,52,3894,0.0,33,32,4,0,1,96.96969697
2013021203,26,3600,0.0,17,17,0,2,0,100.0
2013021203,22,3600,0.0,48,45,14,0,3,93.75
2013021204,21,3600,0.0,40,38,0,2,2,95.0
2013021204,23,3586,0.0,27,24,2,0,3,88.88888889
2013021205,16,2400,0.0,20,16,1,0,4,80.0
2013021205,16,1200,0.0,7,7,1,0,0,100.0
2013021205,15,3600,0.0,34,34,3,1,0,100.0
2013021206,12,3600,0.0,29,28,3,0,1,96.55172414
2013021206,17,3527,0.0,19,17,1,1,2,89.47368421
2013021207,29,3491,0.0,22,19,1,0,3,86.36363636
2013021207,14,3587,0.0,38,36,7,5,2,94.73684211
2013021208,2,3898,0.0,27,25,2,0,2,92.59259259
2013021208,1,3889,0.0,30,28,4,0,2,93.33333333
2013021209,19,3600,0.0,40,37,7,1,3,92.5
2013021209,25,3600,0.0,22,22,4,3,0,100.0
2013021210,52,3600,0.0,38,35,5,0,3,92.10526316
2013021210,20,3527,0.0,26,22,0,0,4,84.61538462
2013021211,21,2934,0.0,24,22,4,0,2,91.66666667
2013021211,21,611,0.0,5,3,0,0,2,60.0
2013021211,28,3600,0.0,33,32,1,0,1,96.96969697
2013021212,7,695,0.0,7,6,2,1,1,85.71428571
2013021212,7,2905,0.0,23,20,0,0,3,86.95652174
2013021212,6,3600,0.0,25,24,3,1,1,96.0
2013021213,4,2400,2.0,22,21,5,0,1,95.45454545
2013021213,4,1330,0.0,14,12,2,0,2,85.71428571
2013021213,5,3702,0.0,21,17,1,0,4,80.95238095
2013021214,3,3719,0.0,27,26,5,1,1,96.2962963
2013021214,8,3724,0.0,41,41,7,1,0,100.0
2013021215,10,3560,0.0,37,36,7,4,1,97.2972973
2013021215,9,3600,0.0,28,28,5,0,0,100.0
2013021216,29,3600,0.0,35,33,8,2,2,94.28571429
2013021216,13,3552,0.0,38,35,10,2,3,92.10526316
2013021217,16,3559,0.0,32,26,9,1,6,81.25
2013021217,18,3600,0.0,25,20,1,0,5,80.0
2013021218,28,3600,0.0,32,30,1,1,2,93.75
2013021218,27,3529,0.0,32,29,5,0,3,90.625
2013021219,23,3600,0.0,22,17,4,1,5,77.27272727
2013021219,22,3600,0.0,42,40,6,1,2,95.23809524
2013021220,24,3888,0.0,30,27,5,2,3,90.0
2013021220,26,3866,0.0,24,21,5,0,3,87.5
2013021221,6,3588,0.0,31,28,1,0,3,90.32258065
2013021221,1,3596,0.0,18,16,1,1,2,88.88888889
2013021222,12,3900,0.0,44,39,3,2,5,88.63636364
2013021222,4,3839,0.0,38,33,7,0,5,86.84210526
2013021223,14,3888,0.0,18,18,4,0,0,100.0
2013021223,15,3900,0.0,32,32,1,0,0,100.0
2013021224,17,3600,0.0,23,23,1,1,0,100.0
2013021224,19,3586,0.0,21,18,4,0,3,85.71428571
2013021225,2,3900,0.0,39,36,0,0,3,92.30769231
2013021225,7,3896,0.0,25,22,4,0,3,88.0
2013021226,9,3900,0.0,28,26,5,0,2,92.85714286
2013021226,5,3900,0.0,33,31,13,0,2,93.93939394
2013021227,18,3600,0.0,29,26,2,1,3,89.65517241
2013021227,30,2400,0.0,21,16,1,0,5,76.19047619
2013021227,30,1200,0.0,12,10,4,0,2,83.33333333
2013021228,20,2029,0.0,20,16,3,0,4,80.0
2013021228,20,1571,0.0,3,2,0,0,1,66.66666667
2013021228,23,3600,0.0,22,21,4,2,1,95.45454545
2013021229,21,3693,0.0,36,33,2,3,3,91.66666667
2013021229,24,3676,0.0,31,29,1,1,2,93.5483871
2013021230,25,3529,0.0,31,29,5,0,2,93.5483871
2013021230,27,3600,0.0,17,16,1,3,1,94.11764706
2013030111,17,3600,0.0,25,25,2,1,0,100.0
2013030111,6,3528,0.0,24,23,1,1,1,95.83333333
2013030112,17,3542,0.0,29,25,8,1,4,86.20689655
2013030112,6,3553,0.0,35,34,1,0,1,97.14285714
2013030113,6,3600,0.0,23,23,5,1,0,100.0
2013030113,17,3543,0.0,33,31,7,1,2,93.93939394
2013030114,6,4405,0.0,37,35,6,1,2,94.59459459
2013030114,17,4412,0.0,40,37,2,0,3,92.5
2013030115,17,3541,0.0,32,29,6,3,3,90.625
2013030115,6,3600,0.0,33,31,8,1,2,93.93939394
2013030121,8,4688,0.0,25,21,2,0,4,84.0
2013030121,14,4688,0.0,44,39,2,1,5,88.63636364
2013030122,8,3578,0.0,27,26,0,0,1,96.2962963
2013030122,14,3106,0.0,23,20,1,0,3,86.95652174
2013030122,14,348,0.0,3,2,0,0,1,66.66666667
2013030123,14,3535,0.0,31,28,2,0,3,90.32258065
2013030123,8,3600,0.0,29,27,1,1,2,93.10344828
2013030124,14,1542,0.0,20,17,2,0,3,85.0
2013030124,14,2034,0.0,17,16,1,0,1,94.11764706
2013030124,8,3600,0.0,23,20,1,1,3,86.95652174
2013030131,29,3523,0.0,32,28,0,1,4,87.5
2013030131,5,3600,0.0,34,31,5,0,3,91.17647059
2013030132,29,4870,0.0,42,39,10,1,3,92.85714286
2013030132,5,4870,0.0,45,41,12,2,4,91.11111111
2013030133,5,3600,0.0,20,17,4,0,3,85.0
2013030133,29,3540,0.0,41,37,11,0,4,90.24390244
2013030134,5,3766,0.0,46,42,10,2,4,91.30434783
2013030134,29,3733,0.0,25,22,3,2,3,88.0
2013030135,29,3507,0.0,50,48,9,2,2,96.0
2013030135,5,3600,0.0,24,23,3,0,1,95.83333333
2013030136,5,3600,0.0,27,24,8,0,3,88.88888889
2013030136,29,3483,0.0,28,24,2,0,4,85.71428571
2013030141,4,3591,0.0,36,32,5,0,4,88.88888889
2013030141,3,3600,0.0,15,14,0,0,1,93.33333333
2013030142,4,3597,0.0,33,31,8,0,2,93.93939394
2013030142,3,3566,0.0,24,21,3,1,3,87.5
2013030143,3,3600,0.0,32,31,3,1,1,96.875
2013030143,4,435,0.0,3,3,2,0,0,100.0
2013030143,4,3141,0.0,20,16,4,0,4,80.0
2013030144,3,3528,0.0,25,23,1,0,2,92.0
2013030144,4,3600,0.0,38,37,5,1,1,97.36842105
2013030145,4,3466,0.0,21,18,2,0,3,85.71428571
2013030145,3,3600,0.0,26,24,4,0,2,92.30769231
2013030146,3,2397,0.0,23,19,3,0,4,82.60869565
2013030146,3,1172,0.0,5,5,0,2,0,100.0
2013030146,4,3598,0.0,36,34,4,3,2,94.44444444
2013030147,4,3523,0.0,33,31,0,2,2,93.93939394
2013030147,3,3600,0.0,27,26,2,0,1,96.2962963
2013030151,30,4047,0.0,31,26,1,0,5,83.87096774
2013030151,21,3897,0.0,33,29,3,2,4,87.87878788
2013030152,30,1919,0.0,14,11,0,0,3,78.57142857
2013030152,30,1562,0.0,14,14,2,1,0,100.0
2013030152,21,3600,0.0,32,30,7,0,2,93.75
2013030153,21,3875,0.0,46,45,6,1,1,97.82608696
2013030153,30,3884,0.0,22,22,4,2,0,100.0
2013030154,21,3446,0.0,32,30,3,0,2,93.75
2013030154,30,3572,0.0,12,11,3,1,1,91.66666667
2013030155,30,3794,0.0,35,31,5,0,4,88.57142857
2013030155,21,3739,0.0,32,29,4,1,3,90.625
2013030156,21,3492,0.0,21,18,2,1,3,85.71428571
2013030156,30,3600,0.0,23,21,5,0,2,91.30434783
2013030157,30,795,0.0,1,1,0,0,0,100.0
2013030157,30,3107,0.0,21,17,3,1,4,80.95238095
2013030157,21,3899,0.0,35,30,1,1,5,85.71428571
2013030161,16,6026,0.0,52,48,9,3,4,92.30769231
2013030161,19,6007,0.0,42,39,4,0,3,92.85714286
2013030162,16,3950,0.0,31,27,9,1,4,87.09677419
2013030162,19,3846,0.0,28,25,3,0,3,89.28571429
2013030163,19,3562,0.0,24,23,4,0,1,95.83333333
2013030163,16,3600,0.0,34,34,7,0,0,100.0
2013030164,19,4277,0.0,34,30,1,0,4,88.23529412
2013030164,16,4277,0.0,33,30,6,1,3,90.90909091
2013030165,16,4056,0.0,29,27,1,2,2,93.10344828
2013030165,19,4056,0.0,30,27,6,0,3,90.0
2013030166,19,3600,0.0,27,22,5,0,5,81.48148148
2013030166,16,3600,0.0,36,35,11,0,1,97.22222222
2013030171,25,3546,0.0,35,31,2,0,4,88.57142857
2013030171,24,3591,0.0,35,32,5,0,3,91.42857143
2013030172,25,3506,0.0,19,16,4,1,3,84.21052632
2013030172,24,3600,0.0,36,34,8,1,2,94.44444444
2013030173,24,3600,0.0,22,19,2,0,3,86.36363636
2013030173,25,3597,0.0,37,37,8,1,0,100.0
2013030174,24,634,0.0,1,1,0,0,0,100.0
2013030174,24,2858,0.0,25,21,3,0,4,84.0
2013030174,25,3600,0.0,23,21,5,1,2,91.30434783
2013030175,25,878,0.0,2,1,0,0,1,50.0
2013030175,25,2722,0.0,21,16,5,1,5,76.19047619
2013030175,24,3600,0.0,36,34,16,0,2,94.44444444
2013030176,24,1848,0.0,12,12,4,0,0,100.0
2013030176,24,1833,0.0,12,8,2,1,4,66.66666667
2013030176,25,3763,0.0,30,25,10,0,5,83.33333333
2013030181,26,1106,0.0,4,4,0,0,0,100.0
2013030181,26,2400,0.0,28,23,6,1,5,82.14285714
2013030181,28,3600,0.0,34,31,3,2,3,91.17647059
2013030182,26,3584,0.0,40,33,7,0,7,82.5
2013030182,28,3583,0.0,26,24,1,2,2,92.30769231
2013030183,28,3980,0.0,31,28,4,1,3,90.32258065
2013030183,26,3973,0.0,40,36,9,1,4,90.0
2013030184,28,1066,0.0,4,4,0,0,0,100.0
2013030184,28,2403,0.0,26,21,4,1,5,80.76923077
2013030184,26,3597,0.0,39,36,9,0,3,92.30769231
2013030185,26,3596,0.0,30,30,8,1,0,100.0
2013030185,28,2356,0.0,22,22,4,1,0,100.0
2013030185,28,1222,0.0,19,16,0,0,3,84.21052632
2013030186,28,3600,0.0,30,26,4,0,4,86.66666667
2013030186,26,3600,2.0,26,25,2,1,1,96.15384615
2013030187,26,3600,0.0,40,39,14,0,1,97.5
2013030187,28,3496,0.0,28,25,5,2,3,89.28571429
2013030211,8,5055,0.0,51,48,3,0,3,94.11764706
2013030211,6,5057,0.0,33,29,5,1,4,87.87878788
2013030212,8,3556,0.0,34,30,8,1,4,88.23529412
2013030212,6,3594,0.0,28,25,6,0,3,89.28571429
2013030213,6,3481,0.0,25,22,1,0,3,88.0
2013030213,8,3600,0.0,28,26,0,0,2,92.85714286
2013030214,6,3679,0.0,33,33,1,2,0,100.0
2013030214,8,3679,0.0,35,34,4,0,1,97.14285714
2013030215,8,3370,0.0,30,26,6,2,4,86.66666667
2013030215,6,3600,2.0,31,29,7,0,2,93.5483871
2013030216,6,3600,0.0,28,24,4,1,4,85.71428571
2013030216,8,3600,0.0,26,26,2,0,0,100.0
2013030217,8,3600,0.0,30,29,6,1,1,96.66666667
2013030217,6,3466,0.0,18,15,2,0,3,83.33333333
2013030221,3,3786,0.0,36,34,7,0,2,94.44444444
2013030221,5,3786,0.0,27,24,4,2,3,88.88888889
2013030222,3,3561,0.0,34,32,4,0,2,94.11764706
2013030222,5,3600,0.0,22,22,6,0,0,100.0
2013030223,5,3596,0.0,35,35,10,0,0,100.0
2013030223,3,3433,0.0,15,13,1,2,2,86.66666667
2013030224,5,3597,0.0,15,13,3,0,2,86.66666667
2013030224,3,3445,0.0,27,23,4,1,4,85.18518519
2013030225,3,3600,0.0,32,31,6,0,1,96.875
2013030225,5,3386,0.0,34,30,8,0,4,88.23529412
2013030226,5,3455,0.0,29,26,7,3,3,89.65517241
2013030226,3,3600,0.0,37,36,6,2,1,97.2972973
2013030227,3,3600,0.0,36,35,0,0,1,97.22222222
2013030227,5,3524,0.0,20,18,2,0,2,90.0
2013030231,30,3590,0.0,21,17,3,0,4,80.95238095
2013030231,16,3600,0.0,32,30,4,1,2,93.75
2013030232,30,3536,0.0,21,18,1,0,3,85.71428571
2013030232,16,3600,0.0,19,18,4,0,1,94.73684211
2013030233,16,3547,0.0,17,14,1,0,3,82.35294118
2013030233,30,3600,0.0,19,19,2,0,0,100.0
2013030234,16,3472,0.0,31,27,5,0,4,87.09677419
2013030234,30,3600,0.0,20,18,0,1,2,90.0
2013030235,30,3493,0.0,28,26,0,0,2,92.85714286
2013030235,16,3567,0.0,28,27,1,0,1,96.42857143
2013030236,16,4182,0.0,35,34,3,0,1,97.14285714
2013030236,30,4182,0.0,27,25,1,1,2,92.59259259
2013030241,26,4252,0.0,35,33,6,1,2,94.28571429
2013030241,24,4312,0.0,36,33,5,2,3,91.66666667
2013030242,26,3600,2.0,37,36,7,1,1,97.2972973
2013030242,24,3492,0.0,16,14,3,1,2,87.5
2013030243,24,598,0.0,8,7,0,0,1,87.5
2013030243,24,2990,0.0,23,22,0,0,1,95.65217391
2013030243,26,3488,0.0,22,19,1,0,3,86.36363636
2013030244,24,3600,0.0,28,28,3,1,0,100.0
2013030244,26,2279,0.0,3,3,3,0,0,100.0
2013030244,26,1200,0.0,11,9,1,2,2,81.81818182
2013030245,26,3533,0.0,24,20,2,0,4,83.33333333
2013030245,24,3600,0.0,42,39,6,1,3,92.85714286
2013030246,24,3506,0.0,23,21,1,0,2,91.30434783
2013030246,26,3600,0.0,22,21,6,0,1,95.45454545
2013030247,26,3600,0.0,27,25,3,2,2,92.59259259
2013030247,24,2278,0.0,12,10,3,1,2,83.33333333
2013030247,24,1322,0.0,18,14,5,0,4,77.77777778
2013030311,3,3592,0.0,22,20,4,1,2,90.90909091
2013030311,8,2400,0.0,20,16,4,0,4,80.0
2013030311,8,1200,0.0,8,5,4,0,3,62.5
2013030312,3,3594,0.0,41,40,10,1,1,97.56097561
2013030312,8,3326,0.0,30,27,1,1,3,90.0
2013030313,8,3672,0.0,37,35,1,2,2,94.59459459
2013030313,3,3609,0.0,25,22,1,1,3,88.0
2013030314,8,3954,0.0,29,26,2,3,3,89.65517241
2013030314,3,3962,0.0,29,27,7,0,2,93.10344828
2013030315,3,1738,0.0,19,15,4,1,4,78.94736842
2013030315,3,1607,0.0,8,6,2,0,2,75.0
2013030315,8,3600,0.0,27,23,5,3,4,85.18518519
2013030316,8,3476,0.0,32,31,5,1,1,96.875
2013030316,3,3600,0.0,18,18,2,1,0,100.0
2013030321,26,3401,0.0,20,17,1,1,3,85.0
2013030321,16,3600,0.0,26,25,1,0,1,96.15384615
2013030322,26,3600,0.0,25,23,5,1,2,92.0
2013030322,16,3546,0.0,30,25,4,0,5,83.33333333
2013030323,16,3460,0.0,32,28,7,1,4,87.5
2013030323,26,3600,0.0,27,24,3,0,3,88.88888889
2013030324,16,3481,0.0,20,16,2,0,4,80.0
2013030324,26,3600,0.0,24,22,3,0,2,91.66666667
2013030325,26,4916,0.0,45,40,6,0,5,88.88888889
2013030325,16,4921,0.0,44,40,6,1,4,90.90909091
2013030326,16,3600,0.0,29,26,2,0,3,89.65517241
2013030326,26,3526,0.0,25,21,3,0,4,84.0
2013030327,26,3945,0.0,41,37,6,0,4,90.24390244
2013030327,16,3945,0.0,32,27,0,1,5,84.375
2013030411,3,3876,0.0,43,40,2,0,3,93.02325581
2013030411,26,3864,0.0,27,25,3,4,2,92.59259259
2013030412,3,5426,0.0,44,39,7,2,5,88.63636364
2013030412,26,5425,0.0,38,34,4,1,4,89.47368421
2013030413,26,3600,0.0,32,32,10,3,0,100.0
2013030413,3,3339,0.0,15,12,5,0,3,80.0
2013030414,26,3533,0.0,19,17,7,0,2,89.47368421
2013030414,3,3600,0.0,41,40,2,0,1,97.56097561
2013030415,3,5683,0.0,51,48,5,0,3,94.11764706
2013030415,26,5683,0.0,30,28,5,0,2,93.33333333
2014020001,8,3560,0.0,27,24,3,1,3,88.88888889
2014020001,10,3569,0.0,32,28,2,1,4,87.5
2014020002,4,3523,0.0,33,31,3,1,2,93.93939394
2014020002,6,3597,0.0,20,19,4,2,1,95.0
2014020003,23,3600,0.0,25,23,3,0,2,92.0
2014020003,20,3519,0.0,32,29,0,4,3,90.625
2014020004,28,3600,0.0,34,34,6,3,0,100.0
2014020004,26,1194,0.0,3,3,0,0,0,100.0
2014020004,26,2400,0.0,27,23,6,0,4,85.18518519
2014020005,29,3583,0.0,22,21,2,1,1,95.45454545
2014020005,7,3600,0.0,40,37,5,0,3,92.5
2014020006,1,3600,0.0,39,35,4,1,4,89.74358974
2014020006,4,3523,0.0,25,20,3,0,5,80.0
2014020007,24,3600,0.0,39,33,2,2,6,84.61538462
2014020007,5,3600,0.0,29,25,3,2,4,86.20689655
2014020008,8,3900,0.0,30,29,4,1,1,96.66666667
2014020008,15,3900,0.0,24,23,6,0,1,95.83333333
2014020009,6,3486,0.0,24,22,2,0,2,91.66666667
2014020009,17,3600,0.0,17,16,4,2,1,94.11764706
2014020010,13,3656,0.0,32,29,8,0,3,90.625
2014020010,14,3671,0.0,21,19,2,0,2,90.47619048
2014020011,3,3600,0.0,25,23,4,0,2,92.0
2014020011,19,3550,0.0,25,22,1,1,3,88.0
2014020012,9,3559,0.0,37,34,2,2,3,91.89189189
2014020012,18,3600,0.0,20,18,2,0,2,90.0
2014020013,16,3900,0.0,34,32,7,3,2,94.11764706
2014020013,25,3900,0.0,26,24,7,0,2,92.30769231
2014020014,21,1200,0.0,10,10,0,0,0,100.0
2014020014,21,2400,0.0,38,33,2,1,5,86.84210526
2014020014,30,3592,0.0,16,16,0,0,0,100.0
2014020015,20,3600,0.0,40,38,3,0,2,95.0
2014020015,22,3545,0.0,26,21,2,1,5,80.76923077
2014020016,52,3600,0.0,28,26,4,1,2,92.85714286
2014020016,53,3598,0.0,27,21,11,1,6,77.77777778
2014020017,2,3599,0.0,24,21,7,0,3,87.5
2014020017,12,3516,0.0,26,21,2,1,5,80.76923077
2014020018,15,3600,0.0,29,29,5,1,0,100.0
2014020018,6,3600,0.0,21,17,4,0,4,80.95238095
2014020019,5,3590,0.0,25,23,7,0,2,92.0
2014020019,10,3600,0.0,41,36,6,2,5,87.80487805
2014020020,24,3600,0.0,29,27,3,3,2,93.10344828
2014020020,17,3580,0.0,26,23,3,0,3,88.46153846
2014020021,9,3900,0.0,40,38,4,2,2,95.0
2014020021,14,3886,0.0,34,32,8,0,2,94.11764706
2014020022,1,3600,0.0,29,28,7,1,1,96.55172414
2014020022,13,2221,0.0,10,10,5,0,0,100.0
2014020022,13,1367,0.0,14,9,3,0,5,64.28571429
2014020023,12,3506,0.0,31,27,4,1,4,87.09677419
2014020023,2,3591,0.0,24,21,6,0,3,87.5
2014020024,8,3870,0.0,32,29,7,4,3,90.625
2014020024,4,3900,0.0,38,35,3,0,3,92.10526316
2014020025,3,3502,0.0,23,19,2,0,4,82.60869565
2014020025,29,3600,0.0,26,24,5,0,2,92.30769231
2014020026,20,3600,0.0,39,35,5,2,4,89.74358974
2014020026,19,3574,0.0,24,23,2,0,1,95.83333333
2014020027,25,3562,0.0,32,29,5,1,3,90.625
2014020027,18,3600,0.0,18,17,1,1,1,94.44444444
2014020028,7,3599,0.0,47,41,4,2,6,87.23404255
2014020028,16,3580,0.0,23,21,2,1,2,91.30434783
2014020029,30,3592,0.0,30,30,3,2,0,100.0
2014020029,21,3428,0.0,33,31,13,1,2,93.93939394
2014020030,26,3886,0.0,40,37,5,1,3,92.5
2014020030,53,3886,0.0,26,24,3,0,2,92.30769231
2014020031,22,3900,0.0,43,39,10,0,4,90.69767442
2014020031,23,3876,0.0,29,25,4,0,4,86.20689655
2014020032,52,3600,0.0,26,23,7,0,3,88.46153846
2014020032,28,3595,0.0,30,30,6,4,0,100.0
2014020033,10,2803,0.0,26,24,0,1,2,92.30769231
2014020033,10,797,0.0,12,11,4,0,1,91.66666667
2014020033,3,2113,0.0,24,18,3,0,6,75.0
2014020033,3,1487,0.0,12,12,2,1,0,100.0
2014020034,52,2275,0.0,18,17,1,0,1,94.44444444
2014020034,52,1323,0.0,13,10,2,0,3,76.92307692
2014020034,26,3600,0.0,30,29,3,2,1,96.66666667
2014020035,21,3585,0.0,28,27,2,0,1,96.42857143
2014020035,6,3598,0.0,30,28,4,0,2,93.33333333
2014020036,24,3587,0.0,12,11,3,0,1,91.66666667
2014020036,7,3586,0.0,44,39,8,1,5,88.63636364
2014020037,9,3584,0.0,30,30,4,1,0,100.0
2014020037,13,3542,0.0,23,22,4,0,1,95.65217391
2014020038,2,3591,0.0,43,40,8,1,3,93.02325581
2014020038,3,3600,0.0,27,21,3,0,6,77.77777778
2014020039,24,3900,0.0,42,39,12,1,3,92.85714286
2014020039,4,3892,0.0,28,25,4,0,3,89.28571429
2014020040,28,3900,0.0,34,29,5,1,5,85.29411765
2014020040,15,574,0.0,7,4,1,0,3,57.14285714
2014020040,15,3326,0.0,16,14,3,2,2,87.5
2014020041,7,3900,0.0,25,22,2,2,3,88.0
2014020041,12,3900,0.0,26,23,8,1,3,88.46153846
2014020042,25,3600,2.0,35,33,6,0,2,94.28571429
2014020042,29,3554,0.0,34,31,0,0,3,91.17647059
2014020043,21,3634,0.0,40,37,11,0,3,92.5
2014020043,10,3618,2.0,24,22,1,1,2,91.66666667
2014020044,1,3600,0.0,27,26,5,1,1,96.2962963
2014020044,14,3552,0.0,25,23,6,0,2,92.0
2014020045,20,3900,0.0,21,19,1,1,2,90.47619048
2014020045,18,3900,0.0,28,26,2,1,2,92.85714286
2014020046,22,934,0.0,11,8,2,0,3,72.72727273
2014020046,22,2666,0.0,15,12,2,0,3,80.0
2014020046,26,3600,0.0,32,31,4,0,1,96.875
2014020047,6,3900,0.0,20,18,4,0,2,90.0
2014020047,17,3900,0.0,39,37,6,0,2,94.87179487
2014020048,20,3875,0.0,50,49,7,0,1,98.0
2014020048,16,3870,0.0,18,16,0,2,2,88.88888889
2014020049,22,3463,0.0,29,23,5,0,6,79.31034483
2014020049,53,3600,0.0,27,23,4,3,4,85.18518519
2014020050,28,3900,0.0,45,42,4,0,3,93.33333333
2014020050,2,3900,0.0,23,20,0,0,3,86.95652174
2014020051,25,3600,0.0,29,27,7,0,2,93.10344828
2014020051,5,3597,0.0,28,25,2,0,3,89.28571429
2014020052,1,2590,0.0,26,21,7,1,5,80.76923077
2014020052,1,995,0.0,7,6,2,0,1,85.71428571
2014020052,15,3599,0.0,28,26,5,1,2,92.85714286
2014020053,6,2835,0.0,23,18,4,0,5,78.26086957
2014020053,6,740,0.0,2,2,0,0,0,100.0
2014020053,8,3600,2.0,29,25,7,1,4,86.20689655
2014020054,21,3396,0.0,27,23,7,0,4,85.18518519
2014020054,21,166,0.0,0,0,0,0,0,
2014020054,9,3600,0.0,31,28,5,2,3,90.32258065
2014020055,19,3900,0.0,18,18,5,0,0,100.0
2014020055,26,3900,2.0,43,43,9,1,0,100.0
2014020056,13,3579,0.0,26,26,8,0,0,100.0
2014020056,7,3581,0.0,35,34,4,0,1,97.14285714
2014020057,12,3895,0.0,34,33,5,0,1,97.05882353
2014020057,3,3894,0.0,30,29,6,2,1,96.66666667
2014020058,20,3502,0.0,26,23,6,0,3,88.46153846
2014020058,29,3588,0.0,31,29,8,4,2,93.5483871
2014020059,17,3586,0.0,24,23,4,2,1,95.83333333
2014020059,10,3600,0.0,35,31,5,0,4,88.57142857
2014020060,18,3593,0.0,31,31,5,4,0,100.0
2014020060,52,3475,0.0,27,25,6,0,2,92.59259259
2014020061,23,3600,0.0,28,28,6,1,0,100.0
2014020061,22,3495,0.0,29,28,4,1,1,96.55172414
2014020062,30,3517,0.0,26,24,5,1,2,92.30769231
2014020062,24,3598,0.0,28,27,7,1,1,96.42857143
2014020063,6,3600,0.0,32,32,11,0,0,100.0
2014020063,7,3600,0.0,36,32,4,2,4,88.88888889
2014020064,21,3480,0.0,36,33,7,1,3,91.66666667
2014020064,8,3595,0.0,34,32,4,0,2,94.11764706
2014020065,29,1622,0.0,17,15,4,0,2,88.23529412
2014020065,29,1864,0.0,18,17,0,0,1,94.44444444
2014020065,9,3600,0.0,40,38,2,0,2,95.0
2014020066,10,3890,0.0,32,31,6,2,1,96.875
2014020066,17,3889,0.0,30,30,4,2,0,100.0
2014020067,28,3600,0.0,37,35,3,2,2,94.59459459
2014020067,1,3573,0.0,31,28,6,2,3,90.32258065
2014020068,2,3522,0.0,37,35,7,1,2,94.59459459
2014020068,5,3600,0.0,35,34,10,1,1,97.14285714
2014020069,13,3893,0.0,28,27,0,1,1,96.42857143
2014020069,15,3900,0.0,21,20,2,0,1,95.23809524
2014020070,4,2400,0.0,18,14,0,2,4,77.77777778
2014020070,4,1369,0.0,5,4,0,0,1,80.0
2014020070,25,3769,0.0,37,31,8,0,6,83.78378378
2014020071,18,3806,0.0,37,35,7,3,2,94.59459459
2014020071,16,3806,0.0,20,19,3,1,1,95.0
2014020072,19,3600,0.0,25,24,7,0,1,96.0
2014020072,53,3595,0.0,36,30,3,0,6,83.33333333
2014020073,14,3593,0.0,32,30,12,2,2,93.75
2014020073,23,3430,0.0,24,20,2,2,4,83.33333333
2014020074,30,3535,0.0,16,14,2,0,2,87.5
2014020074,26,3598,0.0,41,40,14,0,1,97.56097561
2014020075,28,3594,0.0,29,25,0,1,4,86.20689655
2014020075,3,3600,0.0,33,33,6,0,0,100.0
2014020076,20,3600,0.0,35,34,2,3,1,97.14285714
2014020076,52,3597,0.0,29,25,3,0,4,86.20689655
2014020077,19,3568,0.0,25,22,1,0,3,88.0
2014020077,24,3600,0.0,28,28,1,1,0,100.0
2014020078,14,3527,0.0,23,20,2,0,3,86.95652174
2014020078,22,3600,0.0,24,22,0,0,2,91.66666667
2014020079,28,3558,0.0,32,28,1,1,4,87.5
2014020079,6,3600,0.0,34,31,7,1,3,91.17647059
2014020080,3,3762,0.0,31,28,4,1,3,90.32258065
2014020080,1,3761,0.0,25,21,1,1,4,84.0
2014020081,10,3600,0.0,36,34,8,2,2,94.44444444
2014020081,2,2400,0.0,23,18,4,2,5,78.26086957
2014020081,2,1188,0.0,5,5,1,0,0,100.0
2014020082,17,3625,0.0,36,34,3,0,2,94.44444444
2014020082,8,3656,0.0,28,27,6,0,1,96.42857143
2014020083,53,3900,0.0,26,23,7,0,3,88.46153846
2014020083,18,3900,0.0,36,33,8,0,3,91.66666667
2014020084,12,3494,0.0,26,23,8,1,3,88.46153846
2014020084,52,3600,0.0,22,21,2,0,1,95.45454545
2014020085,4,3600,0.0,43,39,6,0,4,90.69767442
2014020085,16,3600,0.0,32,32,4,0,0,100.0
2014020086,23,1277,0.0,13,8,3,1,5,61.53846154
2014020086,23,2319,0.0,15,14,3,1,1,93.33333333
2014020086,25,3600,0.0,46,43,4,6,3,93.47826087
2014020087,13,3743,0.0,33,30,9,0,3,90.90909091
2014020087,21,3742,0.0,36,32,1,1,4,88.88888889
2014020088,14,3780,0.0,22,21,4,0,1,95.45454545
2014020088,20,3763,0.0,22,20,0,1,2,90.90909091
2014020089,10,3600,0.0,41,38,8,0,3,92.68292683
2014020089,9,3497,0.0,30,25,5,1,5,83.33333333
2014020090,4,3600,0.0,25,22,1,0,3,88.0
2014020090,5,3545,0.0,32,28,4,1,4,87.5
2014020091,15,3519,0.0,20,17,3,0,3,85.0
2014020091,22,3600,0.0,34,32,3,0,2,94.11764706
2014020092,7,3584,0.0,33,30,5,0,3,90.90909091
2014020092,24,3599,0.0,23,22,2,1,1,95.65217391
2014020093,2,3600,0.0,32,30,3,1,2,93.75
2014020093,6,3530,0.0,38,35,2,0,3,92.10526316
2014020094,5,3851,0.0,31,27,6,1,4,87.09677419
2014020094,17,3807,0.0,26,23,8,0,3,88.46153846
2014020095,23,3600,0.0,32,31,4,0,1,96.875
2014020095,19,3567,0.0,22,19,1,1,3,86.36363636
2014020096,16,3515,0.0,27,24,1,0,3,88.88888889
2014020096,18,3600,0.0,32,30,3,0,2,93.75
2014020097,53,3492,0.0,29,27,3,2,2,93.10344828
2014020097,30,3600,0.0,26,26,1,4,0,100.0
2014020098,12,3600,0.0,24,19,2,1,5,79.16666667
2014020098,20,3600,0.0,16,16,0,0,0,100.0
2014020099,7,3576,0.0,39,37,1,1,2,94.87179487
2014020099,26,3598,0.0,29,29,3,0,0,100.0
2014020100,29,3560,0.0,37,33,9,1,4,89.18918919
2014020100,28,3554,0.0,28,23,8,1,5,82.14285714
2014020101,25,3898,0.0,27,25,0,1,2,92.59259259
2014020101,1,3900,0.0,37,35,2,0,2,94.59459459
2014020102,14,3596,0.0,42,40,11,2,2,95.23809524
2014020102,52,2400,0.0,18,14,0,0,4,77.77777778
2014020102,52,1089,0.0,9,9,0,0,0,100.0
2014020103,23,3600,0.0,48,41,8,1,7,85.41666667
2014020103,21,3600,2.0,29,26,6,0,3,89.65517241
2014020104,12,3543,0.0,28,23,5,0,5,82.14285714
2014020104,22,3584,0.0,30,27,0,0,3,90.0
2014020105,29,3566,0.0,33,30,8,2,3,90.90909091
2014020105,24,3600,0.0,17,16,4,0,1,94.11764706
2014020106,7,3590,0.0,30,29,1,3,1,96.66666667
2014020106,28,3502,0.0,15,13,1,0,2,86.66666667
2014020107,6,3590,0.0,33,32,6,5,1,96.96969697
2014020107,10,935,0.0,8,8,1,0,0,100.0
2014020107,10,2649,0.0,25,21,4,0,4,84.0
2014020108,3,3484,0.0,30,27,1,0,3,90.0
2014020108,8,3600,0.0,35,34,2,0,1,97.14285714
2014020109,1,3786,0.0,35,33,4,0,2,94.28571429
2014020109,9,3759,0.0,29,26,5,0,3,89.65517241
2014020110,25,3540,0.0,28,22,1,1,6,78.57142857
2014020110,2,3600,0.0,31,26,3,1,5,83.87096774
2014020111,17,3542,0.0,16,13,6,0,3,81.25
2014020111,4,3593,0.0,37,35,1,2,2,94.59459459
2014020112,16,3527,0.0,31,28,7,0,3,90.32258065
2014020112,19,3600,0.0,24,22,3,1,2,91.66666667
2014020113,5,3600,0.0,25,25,5,0,0,100.0
2014020113,18,3600,0.0,26,23,2,1,3,88.46153846
2014020114,14,2565,0.0,14,11,1,0,3,78.57142857
2014020114,14,1035,0.0,8,4,0,0,4,50.0
2014020114,30,3600,0.0,19,17,0,0,2,89.47368421
2014020115,13,3740,0.0,41,39,15,0,2,95.12195122
2014020115,53,3735,0.0,24,23,1,2,1,95.83333333
2014020116,15,3600,0.0,21,20,2,2,1,95.23809524
2014020116,20,3431,0.0,30,27,0,1,3,90.0
2014020117,21,3868,0.0,28,26,4,0,2,92.85714286
2014020117,52,3872,0.0,23,22,2,2,1,95.65217391
2014020118,29,3585,0.0,27,22,2,0,5,81.48148148
2014020118,26,3600,0.0,24,22,1,1,2,91.66666667
2014020119,9,3568,0.0,45,43,5,1,2,95.55555556
2014020119,16,3589,0.0,33,32,9,3,1,96.96969697
2014020120,28,3600,0.0,34,33,10,1,1,97.05882353
2014020120,24,3599,0.0,37,33,6,2,4,89.18918919
2014020121,15,3530,0.0,33,30,2,0,3,90.90909091
2014020121,23,3600,0.0,22,20,3,0,2,90.90909091
2014020122,30,3547,0.0,20,15,1,1,5,75.0
2014020122,3,3600,0.0,30,26,10,0,4,86.66666667
2014020123,8,3532,0.0,18,16,6,0,2,88.88888889
2014020123,22,3600,0.0,29,29,3,1,0,100.0
2014020124,30,3600,2.0,28,25,3,0,3,89.28571429
2014020124,6,3513,0.0,42,38,4,0,4,90.47619048
2014020125,52,3600,0.0,21,18,3,1,3,85.71428571
2014020125,2,3535,0.0,30,26,4,0,4,86.66666667
2014020126,26,3756,10.0,43,40,1,2,3,93.02325581
2014020126,4,3756,0.0,40,38,6,1,2,95.0
2014020127,1,2400,0.0,23,18,6,0,5,78.26086957
2014020127,1,1200,0.0,10,7,5,0,3,70.0
2014020127,5,3600,0.0,19,16,1,0,3,84.21052632
2014020128,9,3600,0.0,38,36,10,0,2,94.73684211
2014020128,29,3600,0.0,34,29,3,0,5,85.29411765
2014020129,7,3600,0.0,37,33,8,0,4,89.18918919
2014020129,10,3565,0.0,10,10,1,1,0,100.0
2014020130,53,2966,0.0,33,27,3,0,6,81.81818182
2014020130,53,634,0.0,2,1,0,0,1,50.0
2014020130,14,3600,0.0,25,22,0,0,3,88.0
2014020131,24,3600,0.0,38,38,5,0,0,100.0
2014020131,16,3445,0.0,25,24,3,1,1,96.0
2014020132,19,3667,0.0,28,25,3,1,3,89.28571429
2014020132,25,3688,0.0,27,23,7,1,4,85.18518519
2014020133,28,3900,0.0,33,31,6,1,2,93.93939394
2014020133,21,3885,0.0,51,49,10,1,2,96.07843137
2014020134,8,3900,0.0,38,37,13,0,1,97.36842105
2014020134,20,3898,0.0,19,18,5,0,1,94.73684211
2014020135,12,3552,0.0,24,21,3,1,3,87.5
2014020135,23,3600,0.0,30,29,1,0,1,96.66666667
2014020136,17,3600,0.0,27,25,8,0,2,92.59259259
2014020136,15,3558,0.0,22,18,4,2,4,81.81818182
2014020137,18,3600,0.0,27,26,4,0,1,96.2962963
2014020137,22,3591,0.0,35,31,3,0,4,88.57142857
2014020138,6,3680,0.0,15,13,2,2,2,86.66666667
2014020138,7,3671,0.0,37,34,3,0,3,91.89189189
2014020139,52,3882,0.0,28,27,3,0,1,96.42857143
2014020139,1,3898,0.0,25,24,3,0,1,96.0
2014020140,26,3572,0.0,23,20,5,0,3,86.95652174
2014020140,5,3600,0.0,36,36,6,6,0,100.0
2014020141,16,3896,0.0,32,28,7,2,4,87.5
2014020141,9,3870,2.0,39,35,10,3,4,89.74358974
2014020142,4,3466,0.0,32,28,8,1,4,87.5
2014020142,14,3568,0.0,27,24,3,1,3,88.88888889
2014020143,53,3544,0.0,26,24,6,0,2,92.30769231
2014020143,13,3600,0.0,33,32,9,2,1,96.96969697
2014020144,24,3432,0.0,29,27,3,0,2,93.10344828
2014020144,19,3600,0.0,24,24,3,0,0,100.0
2014020145,28,3900,0.0,46,43,2,0,3,93.47826087
2014020145,30,3900,0.0,28,25,2,3,3,89.28571429
2014020146,2,3600,0.0,23,18,4,0,5,78.26086957
2014020146,21,3600,0.0,40,40,10,0,0,100.0
2014020147,8,3765,0.0,30,27,3,0,3,90.0
2014020147,23,3765,0.0,25,23,3,2,2,92.0
2014020148,10,3585,0.0,29,28,4,0,1,96.55172414
2014020148,29,3600,0.0,27,23,1,0,4,85.18518519
2014020149,26,3545,0.0,34,30,4,2,4,88.23529412
2014020149,17,3600,0.0,30,28,6,3,2,93.33333333
2014020150,24,3708,0.0,22,21,2,1,1,95.45454545
2014020150,25,3750,0.0,24,22,2,3,2,91.66666667
2014020151,18,3493,0.0,30,26,1,0,4,86.66666667
2014020151,20,3600,0.0,31,28,5,0,3,90.32258065
2014020152,2,3507,0.0,31,28,2,0,3,90.32258065
2014020152,28,3600,0.0,20,19,4,0,1,95.0
2014020153,9,3556,0.0,30,26,3,0,4,86.66666667
2014020153,6,3600,0.0,29,27,1,1,2,93.10344828
2014020154,16,3512,0.0,27,24,2,0,3,88.88888889
2014020154,10,3600,0.0,47,45,6,3,2,95.74468085
2014020155,15,3494,0.0,28,24,6,0,4,85.71428571
2014020155,14,3600,0.0,38,35,4,1,3,92.10526316
2014020156,4,3368,0.0,30,28,5,4,2,93.33333333
2014020156,13,3598,0.0,37,36,15,0,1,97.2972973
2014020157,29,3553,0.0,29,26,6,0,3,89.65517241
2014020157,1,3586,0.0,34,32,7,0,2,94.11764706
2014020158,52,3893,0.0,38,38,11,3,0,100.0
2014020158,3,3887,0.0,25,25,4,0,0,100.0
2014020159,7,3600,0.0,34,29,2,4,5,85.29411765
2014020159,5,3600,0.0,18,18,6,0,0,100.0
2014020160,53,3600,0.0,35,32,2,2,3,91.42857143
2014020160,12,3588,0.0,25,25,4,0,0,100.0
2014020161,21,3896,0.0,29,27,7,0,2,93.10344828
2014020161,19,3900,0.0,29,27,11,0,2,93.10344828
2014020162,25,3574,0.0,30,26,3,3,4,86.66666667
2014020162,30,3600,0.0,20,19,5,0,1,95.0
2014020163,23,3600,0.0,27,25,3,0,2,92.59259259
2014020163,22,3520,0.0,30,27,1,1,3,90.0
2014020164,17,3891,0.0,21,19,1,0,2,90.47619048
2014020164,7,3897,0.0,38,36,7,0,2,94.73684211
2014020165,26,3565,0.0,32,29,4,2,3,90.625
2014020165,12,3600,0.0,32,30,5,0,2,93.75
2014020166,20,3600,0.0,20,18,1,3,2,90.0
2014020166,8,3597,0.0,35,30,10,0,5,85.71428571
2014020167,53,3597,0.0,37,32,4,1,5,86.48648649
2014020167,15,3461,0.0,30,24,4,0,6,80.0
2014020168,24,3600,0.0,18,16,0,0,2,88.88888889
2014020168,21,3438,0.0,33,30,9,1,3,90.90909091
2014020169,52,3600,0.0,33,33,2,0,0,100.0
2014020169,16,3527,0.0,27,26,3,0,1,96.2962963
2014020170,18,3600,0.0,27,26,4,1,1,96.2962963
2014020170,23,3533,0.0,33,30,4,0,3,90.90909091
2014020171,19,3900,0.0,39,36,6,1,3,92.30769231
2014020171,3,3900,0.0,34,31,3,1,3,91.17647059
2014020172,13,3807,0.0,25,23,0,0,2,92.0
2014020172,6,3807,0.0,19,18,0,0,1,94.73684211
2014020173,19,3594,2.0,26,26,3,0,0,100.0
2014020173,1,3506,0.0,23,22,2,1,1,95.65217391
2014020174,22,3600,0.0,25,21,0,0,4,84.0
2014020174,4,3600,0.0,36,35,7,0,1,97.22222222
2014020175,20,3857,0.0,34,31,4,0,3,91.17647059
2014020175,15,3857,0.0,23,19,0,1,4,82.60869565
2014020176,12,3565,0.0,19,17,2,1,2,89.47368421
2014020176,29,3531,0.0,36,33,14,0,3,91.66666667
2014020177,16,3600,0.0,28,28,2,0,0,100.0
2014020177,8,3589,0.0,32,27,4,0,5,84.375
2014020178,17,3580,0.0,31,29,6,2,2,93.5483871
2014020178,9,3600,0.0,32,31,4,0,1,96.875
2014020179,5,3600,0.0,34,33,9,1,1,97.05882353
2014020179,30,3550,0.0,21,18,2,1,3,85.71428571
2014020180,18,3549,0.0,25,23,4,1,2,92.0
2014020180,52,3585,0.0,24,23,2,0,1,95.83333333
2014020181,26,3600,0.0,34,33,4,3,1,97.05882353
2014020181,25,3490,0.0,30,27,4,0,3,90.0
2014020182,23,3594,0.0,22,20,4,1,2,90.90909091
2014020182,21,3600,0.0,37,32,6,1,5,86.48648649
2014020183,10,3541,0.0,33,30,5,1,3,90.90909091
2014020183,53,3588,0.0,30,28,5,1,2,93.33333333
2014020184,8,3900,0.0,32,31,2,1,1,96.875
2014020184,7,3900,0.0,32,31,1,1,1,96.875
2014020185,17,3563,0.0,30,26,4,1,4,86.66666667
2014020185,3,3710,0.0,28,25,5,0,3,89.28571429
2014020186,2,3735,0.0,34,32,4,1,2,94.11764706
2014020186,24,3738,0.0,36,33,8,0,3,91.66666667
2014020187,22,3510,0.0,31,27,5,4,4,87.09677419
2014020187,6,3600,0.0,26,24,2,0,2,92.30769231
2014020188,13,3600,0.0,30,26,0,1,4,86.66666667
2014020188,4,3600,2.0,35,34,3,0,1,97.14285714
2014020189,30,3582,0.0,17,14,1,0,3,82.35294118
2014020189,9,3600,0.0,35,35,7,0,0,100.0
2014020190,20,3534,0.0,32,28,1,3,4,87.5
2014020190,14,3600,0.0,31,29,8,0,2,93.5483871
2014020191,1,2870,0.0,25,22,3,0,3,88.0
2014020191,1,617,0.0,4,3,1,0,1,75.0
2014020191,19,3600,0.0,27,24,5,0,3,88.88888889
2014020192,5,3900,2.0,37,34,10,1,3,91.89189189
2014020192,52,3900,0.0,35,32,9,1,3,91.42857143
2014020193,18,3600,0.0,35,33,2,1,2,94.28571429
2014020193,25,3523,0.0,33,30,6,0,3,90.90909091
2014020194,10,3889,0.0,34,31,3,0,3,91.17647059
2014020194,21,3900,0.0,38,35,1,3,3,92.10526316
2014020195,2,3899,0.0,29,28,3,0,1,96.55172414
2014020195,26,3883,0.0,26,25,4,1,1,96.15384615
2014020196,23,3600,0.0,36,34,3,0,2,94.44444444
2014020196,28,3506,0.0,19,16,0,1,3,84.21052632
2014020197,22,3600,0.0,31,29,2,1,2,93.5483871
2014020197,7,3527,0.0,52,49,6,0,3,94.23076923
2014020198,29,3845,0.0,35,32,10,0,3,91.42857143
2014020198,12,3862,0.0,31,29,8,1,2,93.5483871
2014020199,1,2400,0.0,24,20,4,1,4,83.33333333
2014020199,1,1010,0.0,7,7,1,0,0,100.0
2014020199,17,3600,0.0,17,15,2,0,2,88.23529412
2014020200,15,3600,0.0,40,38,1,0,2,95.0
2014020200,16,3507,0.0,24,21,1,2,3,87.5
2014020201,53,3900,0.0,39,37,3,1,2,94.87179487
2014020201,24,3868,2.0,25,23,2,0,2,92.0
2014020202,20,1589,0.0,9,9,0,0,0,100.0
2014020202,20,2011,0.0,22,18,2,0,4,81.81818182
2014020202,13,3571,0.0,24,19,2,2,5,79.16666667
2014020203,5,3600,0.0,21,20,5,1,1,95.23809524
2014020203,7,3600,0.0,39,33,7,0,6,84.61538462
2014020204,3,3508,0.0,31,26,0,0,5,83.87096774
2014020204,10,3600,0.0,35,31,1,1,4,88.57142857
2014020205,30,3600,0.0,31,27,1,0,4,87.09677419
2014020205,8,3593,0.0,31,30,3,0,1,96.77419355
2014020206,52,3900,0.0,38,37,3,1,1,97.36842105
2014020206,9,3897,0.0,37,36,2,1,1,97.2972973
2014020207,21,3431,0.0,27,23,6,2,4,85.18518519
2014020207,4,3600,0.0,39,36,7,1,3,92.30769231
2014020208,14,3600,0.0,32,28,5,0,4,87.5
2014020208,29,2295,0.0,22,20,0,0,2,90.90909091
2014020208,29,1200,0.0,15,11,2,0,4,73.33333333
2014020209,12,3886,0.0,39,35,3,1,4,89.74358974
2014020209,15,3886,0.0,27,24,2,0,3,88.88888889
2014020210,18,3600,0.0,29,28,1,0,1,96.55172414
2014020210,19,3530,0.0,35,33,5,0,2,94.28571429
2014020211,28,3594,2.0,40,37,6,0,3,92.5
2014020211,25,3516,0.0,28,24,1,1,4,85.71428571
2014020212,2,3600,0.0,19,19,10,2,0,100.0
2014020212,53,3499,0.0,33,32,8,2,1,96.96969697
2014020213,23,2400,0.0,22,18,1,0,4,81.81818182
2014020213,23,1191,0.0,14,13,3,0,1,92.85714286
2014020213,26,3600,0.0,19,18,4,1,1,94.73684211
2014020214,14,3898,2.0,20,17,6,0,3,85.0
2014020214,17,3900,0.0,30,27,5,0,3,90.0
2014020215,22,3598,0.0,21,20,1,0,1,95.23809524
2014020215,3,3528,0.0,32,30,4,1,2,93.75
2014020216,28,3542,0.0,36,32,4,0,4,88.88888889
2014020216,16,3600,0.0,34,32,7,0,2,94.11764706
2014020217,23,3899,0.0,29,28,0,1,1,96.55172414
2014020217,24,3899,0.0,35,34,4,0,1,97.14285714
2014020218,1,3433,0.0,23,19,0,0,4,82.60869565
2014020218,6,3600,0.0,28,26,0,0,2,92.85714286
2014020219,20,3600,0.0,31,27,2,0,4,87.09677419
2014020219,12,3600,0.0,23,22,0,0,1,95.65217391
2014020220,30,3594,0.0,22,20,2,1,2,90.90909091
2014020220,1,3600,0.0,24,23,6,0,1,95.83333333
2014020221,21,3600,0.0,46,40,8,3,6,86.95652174
2014020221,2,3600,0.0,20,20,6,0,0,100.0
2014020222,5,3593,0.0,35,30,11,0,5,85.71428571
2014020222,3,3600,0.0,33,33,4,0,0,100.0
2014020223,29,3512,0.0,32,28,12,1,4,87.5
2014020223,15,3600,0.0,26,24,4,1,2,92.30769231
2014020224,52,3429,0.0,26,24,5,0,2,92.30769231
2014020224,8,3600,0.0,29,29,3,0,0,100.0
2014020225,28,3600,0.0,30,26,3,1,4,86.66666667
2014020225,13,3600,0.0,26,25,1,0,1,96.15384615
2014020226,7,3600,0.0,29,23,6,0,6,79.31034483
2014020226,19,3593,0.0,29,28,2,3,1,96.55172414
2014020227,22,1200,0.0,17,14,0,0,3,82.35294118
2014020227,22,2319,0.0,18,18,3,1,0,100.0
2014020227,18,3600,0.0,23,21,4,1,2,91.30434783
2014020228,14,3900,0.0,39,37,12,0,2,94.87179487
2014020228,16,3900,0.0,27,25,0,1,2,92.59259259
2014020229,25,3600,0.0,37,34,11,0,3,91.89189189
2014020229,53,3530,0.0,32,28,2,3,4,87.5
2014020230,9,3845,0.0,37,33,5,1,4,89.18918919
2014020230,23,3845,0.0,24,21,1,0,3,87.5
2014020231,6,1412,0.0,16,12,0,0,4,75.0
2014020231,6,2188,0.0,17,15,1,0,2,88.23529412
2014020231,10,3600,0.0,26,25,5,0,1,96.15384615
2014020232,26,3897,0.0,49,44,2,5,5,89.79591837
2014020232,24,2140,0.0,16,14,1,0,2,87.5
2014020232,24,1760,0.0,10,7,1,0,3,70.0
2014020233,21,3900,0.0,33,30,3,0,3,90.90909091
2014020233,3,3861,0.0,29,26,1,0,3,89.65517241
2014020234,52,3597,0.0,23,22,1,0,1,95.65217391
2014020234,12,3519,0.0,36,34,5,0,2,94.44444444
2014020235,6,3600,0.0,34,29,6,0,5,85.29411765
2014020235,8,3600,0.0,22,21,2,0,1,95.45454545
2014020236,28,3600,0.0,33,32,7,0,1,96.96969697
2014020236,14,3543,0.0,39,37,12,0,2,94.87179487
2014020237,18,3510,0.0,27,23,4,1,4,85.18518519
2014020237,19,3587,0.0,25,22,2,0,3,88.0
2014020238,7,3579,0.0,38,33,9,0,5,86.84210526
2014020238,30,3196,0.0,26,25,7,2,1,96.15384615
2014020238,30,384,0.0,2,0,0,0,2,0.0
2014020239,53,3521,0.0,25,20,5,2,5,80.0
2014020239,20,3600,0.0,23,20,0,1,3,86.95652174
2014020240,9,3752,0.0,37,34,8,0,3,91.89189189
2014020240,22,3759,0.0,30,26,7,1,4,86.66666667
2014020241,25,3600,0.0,27,27,1,2,0,100.0
2014020241,26,3439,0.0,27,25,2,0,2,92.59259259
2014020242,29,3585,0.0,27,24,1,0,3,88.88888889
2014020242,4,3506,0.0,38,34,5,0,4,89.47368421
2014020243,1,3600,0.0,30,30,8,1,0,100.0
2014020243,15,3499,0.0,28,27,4,1,1,96.42857143
2014020244,5,3600,0.0,31,30,12,1,1,96.77419355
2014020244,10,3440,0.0,40,38,5,1,2,95.0
2014020245,16,3559,0.0,36,33,3,0,3,91.66666667
2014020245,17,3600,2.0,26,25,0,0,1,96.15384615
2014020246,2,3900,2.0,38,35,7,1,3,92.10526316
2014020246,13,3900,0.0,34,31,3,3,3,91.17647059
2014020247,53,3600,0.0,35,35,7,1,0,100.0
2014020247,23,3599,0.0,23,18,3,0,5,78.26086957
2014020248,12,3484,0.0,25,23,0,2,2,92.0
2014020248,6,3600,0.0,34,33,3,0,1,97.05882353
2014020249,30,3575,0.0,28,27,2,1,1,96.42857143
2014020249,25,3510,0.0,22,20,0,0,2,90.90909091
2014020250,24,3739,0.0,37,34,6,0,3,91.89189189
2014020250,26,3734,0.0,29,27,3,1,2,93.10344828
2014020251,10,3581,0.0,35,29,5,0,6,82.85714286
2014020251,7,3600,0.0,34,32,7,1,2,94.11764706
2014020252,4,3592,0.0,28,22,5,1,6,78.57142857
2014020252,8,3580,0.0,29,26,5,0,3,89.65517241
2014020253,2,3600,0.0,28,23,0,0,5,82.14285714
2014020253,14,3597,0.0,27,25,7,0,2,92.59259259
2014020254,21,3596,0.0,25,23,5,0,2,92.0
2014020254,1,3504,0.0,29,26,4,0,3,89.65517241
2014020255,3,3900,0.0,38,36,3,3,2,94.73684211
2014020255,5,3900,0.0,31,29,8,1,2,93.5483871
2014020256,28,3510,0.0,28,26,4,1,2,92.85714286
2014020256,29,3586,0.0,37,36,5,0,1,97.2972973
2014020257,52,3496,0.0,29,27,0,0,2,93.10344828
2014020257,18,3600,0.0,22,21,0,0,1,95.45454545
2014020258,15,3600,0.0,34,30,1,0,4,88.23529412
2014020258,19,3596,0.0,25,24,0,0,1,96.0
2014020259,9,3505,0.0,25,21,0,1,4,84.0
2014020259,20,3559,0.0,25,23,9,0,2,92.0
2014020260,28,3596,0.0,45,45,2,0,0,100.0
2014020260,12,3536,0.0,18,17,2,3,1,94.44444444
2014020261,52,1193,0.0,11,8,3,0,3,72.72727273
2014020261,52,2459,0.0,16,15,2,3,1,93.75
2014020261,30,3034,0.0,22,19,10,0,3,86.36363636
2014020261,30,614,0.0,3,3,2,0,0,100.0
2014020262,8,3592,0.0,29,28,5,0,1,96.55172414
2014020262,17,3351,0.0,19,15,0,0,4,78.94736842
2014020263,25,3600,0.0,47,41,7,0,6,87.23404255
2014020263,16,3598,0.0,24,22,2,0,2,91.66666667
2014020264,13,3600,0.0,35,33,3,1,2,94.28571429
2014020264,24,949,0.0,14,12,1,0,2,85.71428571
2014020264,24,2651,0.0,15,11,0,0,4,73.33333333
2014020265,53,3600,0.0,34,33,7,2,1,97.05882353
2014020265,22,3508,2.0,28,26,4,0,2,92.85714286
2014020266,14,3589,0.0,16,15,2,1,1,93.75
2014020266,3,3587,0.0,30,25,2,1,5,83.33333333
2014020267,19,3451,0.0,17,15,1,2,2,88.23529412
2014020267,6,3600,0.0,33,33,1,1,0,100.0
2014020268,28,3506,0.0,13,10,1,0,3,76.92307692
2014020268,7,1176,0.0,10,10,4,2,0,100.0
2014020268,7,2400,0.0,20,19,3,0,1,95.0
2014020269,14,3600,2.0,36,31,8,0,5,86.11111111
2014020269,2,3600,0.0,28,26,3,1,2,92.85714286
2014020270,17,3600,0.0,28,28,5,1,0,100.0
2014020270,29,3600,0.0,40,35,11,1,5,87.5
2014020271,18,3600,0.0,31,29,2,2,2,93.5483871
2014020271,10,2400,0.0,25,19,8,1,6,76.0
2014020271,10,1200,0.0,12,9,3,0,3,75.0
2014020272,5,3600,0.0,27,27,6,0,0,100.0
2014020272,8,3598,0.0,22,18,1,0,4,81.81818182
2014020273,1,3531,0.0,34,31,3,0,3,91.17647059
2014020273,52,3578,0.0,22,21,2,3,1,95.45454545
2014020274,12,3584,0.0,27,23,0,1,4,85.18518519
2014020274,25,1292,0.0,9,7,4,0,2,77.77777778
2014020274,25,2154,0.0,16,12,1,0,4,75.0
2014020275,24,3882,0.0,19,16,6,0,3,84.21052632
2014020275,20,3889,0.0,27,24,5,1,3,88.88888889
2014020276,15,3796,0.0,24,23,7,0,1,95.83333333
2014020276,53,3795,0.0,24,22,6,0,2,91.66666667
2014020277,13,1200,0.0,2,1,1,0,1,50.0
2014020277,13,2400,0.0,25,21,5,0,4,84.0
2014020277,26,3600,0.0,32,30,8,3,2,93.75
2014020278,4,3388,0.0,34,32,8,1,2,94.11764706
2014020278,3,3600,0.0,31,31,6,0,0,100.0
2014020279,23,3600,0.0,32,28,2,2,4,87.5
2014020279,22,3491,0.0,31,26,3,1,5,83.87096774
2014020280,30,3581,0.0,39,37,6,2,2,94.87179487
2014020280,4,3563,0.0,29,26,3,0,3,89.65517241
2014020281,14,3325,0.0,20,16,6,0,4,80.0
2014020281,10,3600,0.0,28,26,2,0,2,92.85714286
2014020282,19,3600,0.0,30,26,0,0,4,86.66666667
2014020282,8,3600,0.0,32,31,0,2,1,96.875
2014020283,18,3521,0.0,19,16,3,0,3,84.21052632
2014020283,9,3600,0.0,35,33,2,2,2,94.28571429
2014020284,17,3600,0.0,31,28,1,2,3,90.32258065
2014020284,52,3490,0.0,27,23,4,2,4,85.18518519
2014020285,53,3490,0.0,27,24,2,0,3,88.88888889
2014020285,25,3600,0.0,27,26,6,0,1,96.2962963
2014020286,15,3600,0.0,29,27,0,0,2,93.10344828
2014020286,21,3515,0.0,23,20,1,0,3,86.95652174
2014020287,16,3600,0.0,27,24,12,1,3,88.88888889
2014020287,20,3500,0.0,22,18,0,0,4,81.81818182
2014020288,24,3883,0.0,28,25,0,1,3,89.28571429
2014020288,23,3879,0.0,26,23,1,0,3,88.46153846
2014020289,12,3484,0.0,39,36,4,1,3,92.30769231
2014020289,26,3600,0.0,27,25,2,0,2,92.59259259
2014020290,13,3900,0.0,30,28,2,3,2,93.33333333
2014020290,28,3831,0.0,28,26,10,0,2,92.85714286
2014020291,3,3597,0.0,25,24,5,0,1,96.0
2014020291,7,3544,0.0,43,40,6,0,3,93.02325581
2014020292,2,3900,0.0,30,26,0,0,4,86.66666667
2014020292,5,3898,0.0,35,31,2,0,4,88.57142857
2014020293,6,3900,0.0,28,25,3,1,3,89.28571429
2014020293,29,3900,0.0,41,38,1,0,3,92.68292683
2014020294,1,3600,0.0,29,29,2,1,0,100.0
2014020294,22,3379,0.0,26,24,4,0,2,92.30769231
2014020295,19,3575,0.0,26,24,5,0,2,92.30769231
2014020295,9,3600,0.0,33,30,9,0,3,90.90909091
2014020296,8,3582,0.0,33,33,1,2,0,100.0
2014020296,6,3483,0.0,23,21,3,0,2,91.30434783
2014020297,17,3562,0.0,27,24,3,1,3,88.88888889
2014020297,10,3600,0.0,27,26,4,2,1,96.2962963
2014020298,30,3492,0.0,28,26,1,0,2,92.85714286
2014020298,14,3600,0.0,31,30,4,1,1,96.77419355
2014020299,5,3600,0.0,35,31,2,0,4,88.57142857
2014020299,2,3600,0.0,28,27,2,1,1,96.42857143
2014020300,29,3545,0.0,37,33,6,0,4,89.18918919
2014020300,4,3594,0.0,22,20,5,0,2,90.90909091
2014020301,7,3600,0.0,44,43,1,1,1,97.72727273
2014020301,15,3517,0.0,26,24,5,0,2,92.30769231
2014020302,13,3820,0.0,50,48,4,2,2,96.0
2014020302,18,3890,0.0,30,28,4,0,2,93.33333333
2014020303,26,3544,0.0,23,18,2,3,5,78.26086957
2014020303,25,3600,0.0,41,37,9,2,4,90.24390244
2014020304,12,3519,0.0,35,31,8,0,4,88.57142857
2014020304,21,2590,0.0,17,17,0,1,0,100.0
2014020304,21,1010,0.0,10,7,0,0,3,70.0
2014020305,1,3900,0.0,37,33,4,0,4,89.18918919
2014020305,20,3764,0.0,29,25,0,0,4,86.20689655
2014020306,16,3600,0.0,25,24,4,1,1,96.0
2014020306,22,2235,0.0,17,15,6,1,2,88.23529412
2014020306,22,1365,0.0,13,8,6,0,5,61.53846154
2014020307,53,3900,0.0,43,40,9,0,3,93.02325581
2014020307,28,3895,0.0,25,22,2,0,3,88.0
2014020308,19,3600,0.0,30,28,1,2,2,93.33333333
2014020308,52,3517,0.0,28,25,5,0,3,89.28571429
2014020309,8,3600,0.0,34,29,4,2,5,85.29411765
2014020309,3,3600,0.0,21,21,2,1,0,100.0
2014020310,53,3544,0.0,30,28,3,0,2,93.33333333
2014020310,24,3600,0.0,27,26,3,0,1,96.2962963
2014020311,16,3502,0.0,29,26,2,0,3,89.65517241
2014020311,23,3600,0.0,25,24,2,2,1,96.0
2014020312,5,3632,0.0,29,27,5,0,2,93.10344828
2014020312,6,3632,0.0,33,30,2,0,3,90.90909091
2014020313,4,3900,0.0,46,46,2,1,0,100.0
2014020313,2,3900,0.0,21,21,1,3,0,100.0
2014020314,9,3537,2.0,43,39,13,1,4,90.69767442
2014020314,17,3584,0.0,26,23,5,1,3,88.46153846
2014020315,30,3574,0.0,30,29,5,2,1,96.66666667
2014020315,13,3576,0.0,38,35,7,0,3,92.10526316
2014020316,52,3600,0.0,34,32,10,1,2,94.11764706
2014020316,29,3577,0.0,31,28,3,3,3,90.32258065
2014020317,9,3834,0.0,29,27,7,1,2,93.10344828
2014020317,19,2038,0.0,16,16,0,3,0,100.0
2014020317,19,1862,0.0,17,15,5,1,2,88.23529412
2014020318,26,3900,0.0,33,30,6,0,3,90.90909091
2014020318,18,3900,0.0,21,18,4,0,3,85.71428571
2014020319,22,3577,0.0,34,31,2,0,3,91.17647059
2014020319,25,3600,0.0,37,35,1,1,2,94.59459459
2014020320,21,3143,0.0,25,25,0,0,0,100.0
2014020320,21,653,0.0,8,5,0,0,3,62.5
2014020320,53,3796,0.0,35,31,2,1,4,88.57142857
2014020321,1,3445,0.0,36,34,3,0,2,94.44444444
2014020321,23,3600,0.0,20,20,0,2,0,100.0
2014020322,20,3441,0.0,29,26,0,1,3,89.65517241
2014020322,24,3600,0.0,34,32,7,0,2,94.11764706
2014020323,52,3587,0.0,20,19,2,1,1,95.0
2014020323,7,3497,0.0,26,24,4,3,2,92.30769231
2014020324,15,3876,0.0,35,32,2,0,3,91.42857143
2014020324,2,3875,0.0,27,25,1,0,2,92.59259259
2014020325,4,1907,0.0,14,11,5,0,3,78.57142857
2014020325,4,1603,0.0,10,9,0,0,1,90.0
2014020325,17,3600,0.0,24,22,0,0,2,91.66666667
2014020326,3,3543,0.0,29,25,1,0,4,86.20689655
2014020326,14,3577,0.0,19,16,2,1,3,84.21052632
2014020327,12,3500,0.0,28,27,1,0,1,96.42857143
2014020327,13,1778,0.0,22,22,3,0,0,100.0
2014020327,13,1822,0.0,11,11,1,0,0,100.0
2014020328,10,3773,0.0,26,22,3,1,4,84.61538462
2014020328,5,3773,0.0,27,24,8,0,3,88.88888889
2014020329,26,3600,0.0,28,28,4,1,0,100.0
2014020329,30,2397,0.0,12,12,0,0,0,100.0
2014020329,30,1200,0.0,10,6,0,0,4,60.0
2014020330,16,3600,0.0,29,27,0,1,2,93.10344828
2014020330,21,3450,0.0,45,42,10,2,3,93.33333333
2014020331,20,3600,0.0,32,32,3,0,0,100.0
2014020331,28,3596,0.0,18,17,2,0,1,94.44444444
2014020332,22,3832,0.0,25,24,7,0,1,96.0
2014020332,18,3829,0.0,37,37,4,3,0,100.0
2014020333,3,3575,0.0,26,26,5,3,0,100.0
2014020333,4,3570,0.0,24,21,3,6,3,87.5
2014020334,16,3600,0.0,24,23,1,2,1,95.83333333
2014020334,24,3551,0.0,37,34,10,1,3,91.89189189
2014020335,2,3562,0.0,26,22,1,2,4,84.61538462
2014020335,15,3600,0.0,28,26,1,1,2,92.85714286
2014020336,52,3819,0.0,38,36,4,3,2,94.73684211
2014020336,6,3819,0.0,36,35,9,2,1,97.22222222
2014020337,8,3542,0.0,25,23,2,0,2,92.0
2014020337,7,3600,0.0,31,30,3,3,1,96.77419355
2014020338,17,3900,0.0,25,21,1,0,4,84.0
2014020338,1,3887,0.0,32,28,7,0,4,87.5
2014020339,12,3600,0.0,22,20,0,1,2,90.90909091
2014020339,5,3561,0.0,34,31,1,0,3,91.17647059
2014020340,23,3600,0.0,31,31,3,1,0,100.0
2014020340,29,3593,0.0,29,25,0,1,4,86.20689655
2014020341,9,3518,0.0,46,43,4,0,3,93.47826087
2014020341,13,3600,0.0,24,22,1,1,2,91.66666667
2014020342,22,3860,0.0,41,37,7,0,4,90.24390244
2014020342,19,3858,0.0,16,13,0,0,3,81.25
2014020343,30,3715,0.0,45,41,5,0,4,91.11111111
2014020343,25,3720,0.0,34,29,1,2,5,85.29411765
2014020344,15,1200,0.0,12,9,2,0,3,75.0
2014020344,15,2400,0.0,11,8,0,0,3,72.72727273
2014020344,10,3572,0.0,37,35,7,0,2,94.59459459
2014020345,7,3900,0.0,44,41,2,0,3,93.18181818
2014020345,8,3877,0.0,26,23,3,0,3,88.46153846
2014020346,9,3600,0.0,32,28,4,0,4,87.5
2014020346,14,3600,0.0,27,26,2,2,1,96.2962963
2014020347,1,3528,0.0,27,25,5,0,2,92.59259259
2014020347,2,3600,0.0,35,34,10,1,1,97.14285714
2014020348,4,3443,0.0,34,30,5,0,4,88.23529412
2014020348,3,3595,0.0,23,21,0,1,2,91.30434783
2014020349,5,3593,0.0,34,32,14,0,2,94.11764706
2014020349,12,3511,0.0,33,30,5,1,3,90.90909091
2014020350,29,3522,0.0,42,40,7,0,2,95.23809524
2014020350,18,3554,0.0,22,21,4,0,1,95.45454545
2014020351,19,3900,0.0,38,36,7,0,2,94.73684211
2014020351,30,3895,0.0,26,24,3,2,2,92.30769231
2014020352,25,3600,0.0,47,42,15,1,5,89.36170213
2014020352,21,3593,0.0,24,22,1,0,2,91.66666667
2014020353,20,3600,0.0,26,26,2,1,0,100.0
2014020353,53,3600,0.0,29,26,5,0,3,89.65517241
2014020354,16,3577,2.0,20,19,6,0,1,95.0
2014020354,26,3533,0.0,24,21,3,0,3,87.5
2014020355,24,2021,0.0,15,15,3,5,0,100.0
2014020355,24,1569,0.0,19,14,0,0,5,73.68421053
2014020355,28,3600,0.0,34,30,6,3,4,88.23529412
2014020356,23,3471,0.0,29,25,3,0,4,86.20689655
2014020356,17,3600,0.0,33,30,2,0,3,90.90909091
2014020357,14,3600,0.0,35,32,8,1,3,91.42857143
2014020357,3,3499,0.0,20,15,1,0,5,75.0
2014020358,13,3532,0.0,23,21,4,0,2,91.30434783
2014020358,29,3598,0.0,25,24,3,0,1,96.0
2014020359,8,3600,0.0,29,26,0,0,3,89.65517241
2014020359,21,3473,0.0,30,26,1,1,4,86.66666667
2014020360,53,3600,0.0,27,25,6,1,2,92.59259259
2014020360,22,3594,0.0,24,19,3,0,5,79.16666667
2014020361,6,3522,0.0,28,25,1,0,3,89.28571429
2014020361,24,3600,0.0,34,32,11,5,2,94.11764706
2014020362,14,3900,0.0,22,21,2,0,1,95.45454545
2014020362,7,3900,0.0,27,26,2,0,1,96.2962963
2014020363,9,3786,0.0,28,25,1,0,3,89.28571429
2014020363,2,3786,0.0,18,16,1,0,2,88.88888889
2014020364,1,3530,0.0,23,22,3,3,1,95.65217391
2014020364,5,3600,0.0,29,29,4,0,0,100.0
2014020365,23,3600,0.0,25,22,2,0,3,88.0
2014020365,15,3483,0.0,32,28,3,0,4,87.5
2014020366,18,3520,0.0,25,23,2,0,2,92.0
2014020366,12,3600,0.0,33,32,3,1,1,96.96969697
2014020367,25,3439,0.0,40,35,10,0,5,87.5
2014020367,10,3598,0.0,38,35,4,4,3,92.10526316
2014020368,13,3600,0.0,41,38,5,1,3,92.68292683
2014020368,17,3406,0.0,31,27,1,1,4,87.09677419
2014020369,53,3572,0.0,23,19,3,0,4,82.60869565
2014020369,20,3600,0.0,29,27,2,1,2,93.10344828
2014020370,4,3593,0.0,27,25,3,2,2,92.59259259
2014020370,28,3600,0.0,29,28,0,0,1,96.55172414
2014020371,6,3571,0.0,34,33,9,0,1,97.05882353
2014020371,26,3600,0.0,31,31,0,1,0,100.0
2014020372,8,3485,0.0,35,33,5,0,2,94.28571429
2014020372,30,3600,0.0,19,18,0,0,1,94.73684211
2014020373,19,3590,0.0,33,29,5,1,4,87.87878788
2014020373,16,3600,0.0,41,40,12,1,1,97.56097561
2014020374,22,3617,0.0,26,23,0,0,3,88.46153846
2014020374,52,3617,0.0,24,22,2,0,2,91.66666667
2014020375,4,3785,0.0,33,29,8,1,4,87.87878788
2014020375,24,3900,0.0,35,31,0,0,4,88.57142857
2014020376,23,3600,0.0,22,22,1,1,0,100.0
2014020376,5,3600,0.0,31,28,4,0,3,90.32258065
2014020377,15,3600,0.0,30,29,0,1,1,96.66666667
2014020377,12,3423,0.0,28,26,2,0,2,92.85714286
2014020378,1,3588,0.0,32,29,5,2,3,90.625
2014020378,10,3451,0.0,26,21,2,0,5,80.76923077
2014020379,2,3587,0.0,21,20,3,1,1,95.23809524
2014020379,9,3527,0.0,25,23,4,0,2,92.0
2014020380,25,3599,0.0,29,24,0,2,5,82.75862069
2014020380,17,3597,0.0,24,22,4,1,2,91.66666667
2014020381,7,3600,0.0,35,30,7,1,5,85.71428571
2014020381,14,3600,0.0,13,13,3,0,0,100.0
2014020382,29,3900,0.0,55,52,9,0,3,94.54545455
2014020382,13,3900,0.0,20,17,3,1,3,85.0
2014020383,19,3554,0.0,24,20,1,0,4,83.33333333
2014020383,18,3600,0.0,32,29,5,1,3,90.625
2014020384,21,3707,0.0,25,21,1,0,4,84.0
2014020384,20,3676,0.0,29,26,3,0,3,89.65517241
2014020385,26,3569,0.0,26,26,1,2,0,100.0
2014020385,53,2141,0.0,20,17,0,1,3,85.0
2014020385,53,1459,0.0,23,22,2,0,1,95.65217391
2014020386,6,3600,0.0,44,37,11,0,7,84.09090909
2014020386,28,3600,0.0,24,20,6,0,4,83.33333333
2014020387,24,3600,0.0,25,21,4,0,4,84.0
2014020387,30,638,0.0,3,3,1,0,0,100.0
2014020387,30,2908,0.0,18,13,2,0,5,72.22222222
2014020388,21,1002,0.0,7,6,0,0,1,85.71428571
2014020388,21,2477,0.0,30,25,7,0,5,83.33333333
2014020388,52,3600,0.0,22,20,4,0,2,90.90909091
2014020389,8,3578,0.0,36,32,7,1,4,88.88888889
2014020389,16,3600,0.0,41,38,2,0,3,92.68292683
2014020390,9,3546,0.0,33,30,7,0,3,90.90909091
2014020390,5,3594,2.0,29,27,2,3,2,93.10344828
2014020391,4,3599,0.0,38,37,8,3,1,97.36842105
2014020391,26,3526,0.0,16,14,3,0,2,87.5
2014020392,23,1539,0.0,14,10,2,0,4,71.42857143
2014020392,23,2042,0.0,13,13,1,1,0,100.0
2014020392,10,3600,0.0,46,44,10,3,2,95.65217391
2014020393,3,3524,0.0,34,31,2,1,3,91.17647059
2014020393,17,3600,0.0,29,27,8,2,2,93.10344828
2014020394,29,3600,0.0,34,33,1,0,1,97.05882353
2014020394,14,3389,0.0,20,17,1,0,3,85.0
2014020395,7,3544,0.0,37,34,1,1,3,91.89189189
2014020395,13,3600,0.0,28,26,3,0,2,92.85714286
2014020396,15,3600,0.0,34,33,4,1,1,97.05882353
2014020396,1,3518,0.0,28,25,2,0,3,89.28571429
2014020397,19,2400,0.0,15,14,1,0,1,93.33333333
2014020397,19,1200,0.0,12,9,1,0,3,75.0
2014020397,2,3582,0.0,40,34,9,0,6,85.0
2014020398,16,3597,0.0,33,32,1,0,1,96.96969697
2014020398,18,3514,0.0,30,28,2,0,2,93.33333333
2014020399,8,3508,0.0,28,25,5,1,3,89.28571429
2014020399,25,3599,0.0,17,16,4,1,1,94.11764706
2014020400,6,3600,0.0,26,24,3,0,2,92.30769231
2014020400,53,1513,0.0,9,8,3,1,1,88.88888889
2014020400,53,2087,0.0,24,20,5,1,4,83.33333333
2014020401,28,3600,0.0,35,33,6,1,2,94.28571429
2014020401,20,3481,0.0,30,27,3,0,3,90.0
2014020402,24,3647,0.0,30,27,6,1,3,90.0
2014020402,52,3646,0.0,25,21,5,2,4,84.0
2014020403,17,3600,0.0,35,34,11,1,1,97.14285714
2014020403,12,3470,0.0,22,19,7,1,3,86.36363636
2014020404,23,3681,0.0,45,41,15,3,4,91.11111111
2014020404,9,3657,0.0,33,30,3,2,3,90.90909091
2014020405,28,3516,0.0,24,22,4,0,2,91.66666667
2014020405,22,3583,0.0,21,20,4,0,1,95.23809524
2014020406,5,3825,0.0,29,25,8,0,4,86.20689655
2014020406,3,3825,0.0,35,32,5,2,3,91.42857143
2014020407,1,3600,0.0,40,39,8,1,1,97.5
2014020407,12,3472,0.0,16,14,0,0,2,87.5
2014020408,13,3560,0.0,27,24,7,1,3,88.88888889
2014020408,19,3600,0.0,34,32,5,1,2,94.11764706
2014020409,26,3525,0.0,16,15,2,0,1,93.75
2014020409,7,3600,0.0,34,34,4,3,0,100.0
2014020410,16,3900,0.0,24,22,2,0,2,91.66666667
2014020410,1,3900,0.0,39,37,6,0,2,94.87179487
2014020411,4,3644,0.0,24,21,5,0,3,87.5
2014020411,29,3718,0.0,21,19,2,2,2,90.47619048
2014020412,20,3541,0.0,27,25,2,1,2,92.59259259
2014020412,10,3600,0.0,33,32,3,1,1,96.96969697
2014020413,23,3551,0.0,24,22,6,0,2,91.66666667
2014020413,8,3598,0.0,16,15,2,1,1,93.75
2014020414,15,3600,0.0,36,33,3,0,3,91.66666667
2014020414,14,3518,0.0,34,30,3,1,4,88.23529412
2014020415,2,3539,0.0,30,25,4,0,5,83.33333333
2014020415,30,3600,0.0,19,15,1,0,4,78.94736842
2014020416,52,3600,0.0,28,26,6,0,2,92.85714286
2014020416,25,1946,0.0,15,13,3,1,2,86.66666667
2014020416,25,1654,0.0,17,14,0,0,3,82.35294118
2014020417,18,3600,0.0,26,26,0,1,0,100.0
2014020417,21,3543,0.0,34,33,9,1,1,97.05882353
2014020418,22,3600,0.0,24,19,0,1,5,79.16666667
2014020418,28,3600,0.0,27,25,5,0,2,92.59259259
2014020419,10,3900,0.0,42,41,4,0,1,97.61904762
2014020419,17,3900,0.0,19,18,3,2,1,94.73684211
2014020420,22,3581,0.0,34,32,6,1,2,94.11764706
2014020420,24,3598,0.0,22,21,2,0,1,95.45454545
2014020421,16,3600,0.0,34,32,1,1,2,94.11764706
2014020421,6,3522,0.0,21,18,2,0,3,85.71428571
2014020422,20,3514,0.0,19,15,0,0,4,78.94736842
2014020422,7,3600,0.0,45,42,7,0,3,93.33333333
2014020423,1,3579,0.0,35,32,12,0,3,91.42857143
2014020423,4,3599,0.0,18,17,0,1,1,94.44444444
2014020424,29,3880,0.0,41,39,17,2,2,95.12195122
2014020424,15,3877,0.0,23,20,2,0,3,86.95652174
2014020425,26,3600,0.0,35,32,4,1,3,91.42857143
2014020425,9,3534,0.0,35,31,5,0,4,88.57142857
2014020426,12,3584,0.0,27,25,1,0,2,92.59259259
2014020426,14,3585,0.0,30,29,8,0,1,96.66666667
2014020427,2,3577,0.0,32,27,0,1,5,84.375
2014020427,19,3600,0.0,28,25,7,0,3,89.28571429
2014020428,52,3900,2.0,26,23,3,0,3,88.46153846
2014020428,21,3900,0.0,33,30,6,2,3,90.90909091
2014020429,18,3600,0.0,32,31,4,0,1,96.875
2014020429,53,3590,0.0,38,33,10,0,5,86.84210526
2014020430,30,3452,0.0,30,28,3,0,2,93.33333333
2014020430,28,3600,0.0,19,18,0,0,1,94.73684211
2014020431,20,3444,0.0,22,19,4,0,3,86.36363636
2014020431,5,3600,0.0,27,26,5,1,1,96.2962963
2014020432,26,3600,0.0,20,14,0,1,6,70.0
2014020432,8,3600,0.0,46,44,16,1,2,95.65217391
2014020433,13,3900,0.0,31,29,8,2,2,93.5483871
2014020433,17,3900,0.0,26,24,6,1,2,92.30769231
2014020434,24,3600,0.0,23,21,2,1,2,91.30434783
2014020434,22,1248,0.0,12,9,2,0,3,75.0
2014020434,22,2331,0.0,7,7,2,0,0,100.0
2014020435,9,3900,0.0,31,29,4,0,2,93.5483871
2014020435,6,3898,0.0,31,29,2,0,2,93.5483871
2014020436,12,3600,0.0,23,18,0,0,5,78.26086957
2014020436,4,3600,0.0,26,25,3,0,1,96.15384615
2014020437,13,3629,0.0,32,28,1,0,4,87.5
2014020437,7,3629,0.0,28,25,0,1,3,89.28571429
2014020438,17,3541,0.0,40,37,9,1,3,92.5
2014020438,10,3579,0.0,28,27,1,1,1,96.42857143
2014020439,16,3518,0.0,41,38,10,0,3,92.68292683
2014020439,2,3600,0.0,25,23,2,1,2,92.0
2014020440,14,3553,0.0,27,24,9,0,3,88.88888889
2014020440,15,3580,0.0,28,26,6,0,2,92.85714286
2014020441,5,3817,0.0,27,24,8,1,3,88.88888889
2014020441,29,3885,2.0,36,33,8,0,3,91.66666667
2014020442,24,3600,0.0,28,27,1,2,1,96.42857143
2014020442,52,3515,0.0,30,27,11,2,3,90.0
2014020443,1,2400,0.0,33,29,5,0,4,87.87878788
2014020443,1,1053,0.0,3,3,0,0,0,100.0
2014020443,25,3592,0.0,31,28,1,0,3,90.32258065
2014020444,30,3900,0.0,30,27,2,0,3,90.0
2014020444,53,3889,0.0,35,32,3,0,3,91.42857143
2014020445,19,3663,0.0,25,23,7,0,2,92.0
2014020445,21,3663,0.0,42,39,6,3,3,92.85714286
2014020446,3,3600,0.0,30,29,1,0,1,96.66666667
2014020446,23,3596,0.0,23,18,0,0,5,78.26086957
2014020447,18,3522,0.0,33,32,4,0,1,96.96969697
2014020447,28,3600,0.0,29,29,3,0,0,100.0
2014020448,26,3897,0.0,31,28,8,1,3,90.32258065
2014020448,10,3900,0.0,36,33,4,0,3,91.66666667
2014020449,20,3508,0.0,28,26,0,1,2,92.85714286
2014020449,16,3599,0.0,24,23,5,0,1,95.83333333
2014020450,3,3592,0.0,16,16,2,0,0,100.0
2014020450,22,3512,0.0,21,20,1,0,1,95.23809524
2014020451,1,3900,0.0,33,31,3,0,2,93.93939394
2014020451,2,3893,0.0,28,26,1,0,2,92.85714286
2014020452,14,1200,0.0,5,4,1,0,1,80.0
2014020452,14,2238,0.0,21,18,3,0,3,85.71428571
2014020452,5,3579,0.0,30,28,5,1,2,93.33333333
2014020453,14,3600,0.0,24,23,4,1,1,95.83333333
2014020453,4,3483,0.0,22,20,2,0,2,90.90909091
2014020454,24,872,0.0,7,5,0,0,2,71.42857143
2014020454,24,2728,0.0,20,16,3,0,4,80.0
2014020454,10,3600,0.0,42,40,6,2,2,95.23809524
2014020455,12,3600,0.0,29,25,9,1,4,86.20689655
2014020455,8,3600,0.0,26,25,4,3,1,96.15384615
2014020456,29,3900,0.0,30,30,4,0,0,100.0
2014020456,17,3900,0.0,29,29,4,0,0,100.0
2014020457,15,3900,0.0,29,28,3,0,1,96.55172414
2014020457,13,3900,0.0,24,23,2,0,1,95.83333333
2014020458,26,3550,0.0,22,18,3,2,4,81.81818182
2014020458,19,3600,0.0,23,21,3,0,2,91.30434783
2014020459,6,3885,0.0,40,38,4,1,2,95.0
2014020459,18,3884,0.0,35,33,4,3,2,94.28571429
2014020460,7,3600,0.0,36,31,5,0,5,86.11111111
2014020460,52,3595,0.0,28,27,9,0,1,96.42857143
2014020461,30,3514,0.0,38,34,4,0,4,89.47368421
2014020461,16,3579,0.0,29,26,7,0,3,89.65517241
2014020462,3,3600,0.0,31,29,5,3,2,93.5483871
2014020462,20,1690,0.0,9,9,2,0,0,100.0
2014020462,20,1836,0.0,13,9,2,0,4,69.23076923
2014020463,22,3894,0.0,44,42,6,0,2,95.45454545
2014020463,53,3899,0.0,32,31,5,1,1,96.875
2014020464,9,3600,0.0,34,34,11,0,0,100.0
2014020464,1,3520,0.0,15,14,4,0,1,93.33333333
2014020465,6,3690,0.0,37,35,5,0,2,94.59459459
2014020465,30,3690,0.0,25,22,4,0,3,88.0
2014020466,25,3589,0.0,27,27,5,1,0,100.0
2014020466,23,3537,0.0,28,27,3,2,1,96.42857143
2014020467,13,3900,0.0,26,25,0,0,1,96.15384615
2014020467,4,3900,0.0,32,31,1,0,1,96.875
2014020468,21,3744,0.0,48,47,3,0,1,97.91666667
2014020468,5,3744,0.0,29,29,2,0,0,100.0
2014020469,10,3522,0.0,36,33,1,0,3,91.66666667
2014020469,12,3600,0.0,26,25,4,0,1,96.15384615
2014020470,15,3642,0.0,26,22,3,0,4,84.61538462
2014020470,29,3642,0.0,36,31,8,0,5,86.11111111
2014020471,24,3600,0.0,24,23,1,1,1,95.83333333
2014020471,8,3504,0.0,23,21,0,1,2,91.30434783
2014020472,19,3460,0.0,37,31,4,0,6,83.78378378
2014020472,26,3597,0.0,28,24,5,1,4,85.71428571
2014020473,22,3516,0.0,30,26,7,0,4,86.66666667
2014020473,28,3597,0.0,28,25,1,1,3,89.28571429
2014020474,14,3850,0.0,18,16,4,0,2,88.88888889
2014020474,1,3899,0.0,28,26,4,0,2,92.85714286
2014020475,24,3600,0.0,31,25,2,0,6,80.64516129
2014020475,9,3593,0.0,34,32,5,0,2,94.11764706
2014020476,2,3600,0.0,18,17,0,1,1,94.44444444
2014020476,17,1200,0.0,9,8,0,1,1,88.88888889
2014020476,17,2332,0.0,23,22,7,0,1,95.65217391
2014020477,6,3498,0.0,27,25,7,1,2,92.59259259
2014020477,52,3600,0.0,31,30,4,3,1,96.77419355
2014020478,25,3600,0.0,22,21,4,1,1,95.45454545
2014020478,20,3496,0.0,21,19,0,0,2,90.47619048
2014020479,53,3527,0.0,35,31,7,1,4,88.57142857
2014020479,26,3600,0.0,17,15,2,1,2,88.23529412
2014020480,21,3600,0.0,29,28,7,0,1,96.55172414
2014020480,7,3376,0.0,22,18,1,0,4,81.81818182
2014020481,4,3600,0.0,25,21,4,1,4,84.0
2014020481,10,628,0.0,1,1,0,0,0,100.0
2014020481,10,2972,0.0,41,34,8,1,7,82.92682927
2014020482,9,3597,0.0,29,25,2,0,4,86.20689655
2014020482,8,3564,0.0,25,24,1,2,1,96.0
2014020483,15,3600,0.0,21,21,3,0,0,100.0
2014020483,1,3540,0.0,20,17,5,1,3,85.0
2014020484,14,3526,0.0,47,45,5,2,2,95.74468085
2014020484,2,3600,0.0,21,20,0,0,1,95.23809524
2014020485,13,3393,0.0,34,31,12,1,3,91.17647059
2014020485,5,3600,0.0,46,45,14,1,1,97.82608696
2014020486,3,3895,0.0,20,18,2,0,2,90.0
2014020486,12,3900,0.0,34,32,0,3,2,94.11764706
2014020487,16,3886,0.0,19,17,2,0,2,89.47368421
2014020487,29,3900,0.0,41,39,6,0,2,95.12195122
2014020488,18,3699,0.0,27,22,6,0,5,81.48148148
2014020488,30,2462,0.0,30,27,3,1,3,90.0
2014020488,30,1200,0.0,14,11,1,0,3,78.57142857
2014020489,20,3613,0.0,32,30,3,1,2,93.75
2014020489,23,3618,0.0,28,26,1,2,2,92.85714286
2014020490,19,3862,0.0,30,27,6,0,3,90.0
2014020490,28,3790,0.0,20,18,0,1,2,90.0
2014020491,21,3900,0.0,35,34,9,1,1,97.14285714
2014020491,17,3900,0.0,23,22,0,0,1,95.65217391
2014020492,25,2139,0.0,10,9,0,1,1,90.0
2014020492,25,1759,0.0,19,15,1,0,4,78.94736842
2014020492,22,3899,0.0,45,40,2,0,5,88.88888889
2014020493,7,3734,0.0,37,33,0,1,4,89.18918919
2014020493,6,3710,0.0,28,25,5,0,3,89.28571429
2014020494,12,3508,0.0,31,30,6,0,1,96.77419355
2014020494,3,3588,0.0,18,18,2,0,0,100.0
2014020495,10,3600,0.0,34,30,4,1,4,88.23529412
2014020495,16,3600,0.0,31,31,5,1,0,100.0
2014020496,4,3610,0.0,28,25,4,0,3,89.28571429
2014020496,52,3610,0.0,23,19,3,0,4,82.60869565
2014020497,9,3482,0.0,23,21,3,1,2,91.30434783
2014020497,15,3576,0.0,39,38,13,1,1,97.43589744
2014020498,18,3596,0.0,31,30,2,0,1,96.77419355
2014020498,29,767,0.0,5,4,3,0,1,80.0
2014020498,29,2833,0.0,30,26,1,1,4,86.66666667
2014020499,5,3900,0.0,37,34,7,0,3,91.89189189
2014020499,13,3897,0.0,27,24,4,0,3,88.88888889
2014020500,53,1299,0.0,11,7,0,0,4,63.63636364
2014020500,53,2299,0.0,29,26,17,0,3,89.65517241
2014020500,23,3591,0.0,39,38,4,0,1,97.43589744
2014020501,28,3658,0.0,32,29,6,1,3,90.625
2014020501,24,3658,0.0,32,30,0,1,2,93.75
2014020502,20,3776,0.0,34,31,5,1,3,91.17647059
2014020502,26,3847,0.0,28,24,0,0,4,85.71428571
2014020503,18,3563,0.0,24,20,6,0,4,83.33333333
2014020503,6,3600,0.0,25,22,2,2,3,88.0
2014020504,12,3898,0.0,19,18,1,0,1,94.73684211
2014020504,1,3897,0.0,33,32,5,1,1,96.96969697
2014020505,8,3600,0.0,38,37,4,1,1,97.36842105
2014020505,2,3571,0.0,21,18,0,0,3,85.71428571
2014020506,15,3511,0.0,27,23,10,1,4,85.18518519
2014020506,3,3600,0.0,32,30,4,3,2,93.75
2014020507,4,3583,0.0,24,22,5,0,2,91.66666667
2014020507,30,3470,0.0,29,25,2,0,4,86.20689655
2014020508,7,3600,0.0,39,33,5,0,6,84.61538462
2014020508,17,3600,0.0,16,13,0,1,3,81.25
2014020509,5,1252,0.0,10,7,2,0,3,70.0
2014020509,5,2205,0.0,17,16,1,0,1,94.11764706
2014020509,14,3600,0.0,29,26,0,0,3,89.65517241
2014020510,53,3600,0.0,27,26,11,0,1,96.2962963
2014020510,22,3295,0.0,19,16,2,1,3,84.21052632
2014020510,22,300,0.0,3,1,0,0,2,33.33333333
2014020511,52,3600,0.0,39,38,4,1,1,97.43589744
2014020511,16,930,0.0,13,10,0,0,3,76.92307692
2014020511,16,2646,0.0,12,11,0,1,1,91.66666667
2014020512,10,3600,0.0,43,43,4,5,0,100.0
2014020512,25,3546,0.0,25,22,4,0,3,88.0
2014020513,19,1200,0.0,10,10,0,1,0,100.0
2014020513,19,2398,0.0,31,26,7,0,5,83.87096774
2014020513,21,3600,0.0,26,26,5,1,0,100.0
2014020514,2,3900,0.0,26,23,3,0,3,88.46153846
2014020514,7,3900,0.0,36,33,4,1,3,91.66666667
2014020515,17,3852,0.0,33,31,10,0,2,93.93939394
2014020515,9,3832,0.0,27,24,2,2,3,88.88888889
2014020516,12,3488,2.0,38,36,10,0,2,94.73684211
2014020516,14,3580,0.0,26,25,2,0,1,96.15384615
2014020517,1,3575,0.0,27,25,3,2,2,92.59259259
2014020517,3,3600,0.0,20,19,3,0,1,95.0
2014020518,15,3580,0.0,31,31,9,3,0,100.0
2014020518,5,3503,0.0,34,31,9,0,3,91.17647059
2014020519,6,2004,0.0,15,12,0,1,3,80.0
2014020519,6,1592,0.0,15,12,1,0,3,80.0
2014020519,29,3600,0.0,28,26,3,0,2,92.85714286
2014020520,52,3767,0.0,25,22,4,1,3,88.0
2014020520,30,3767,0.0,23,19,3,0,4,82.60869565
2014020521,25,3600,0.0,33,30,2,1,3,90.90909091
2014020521,19,3538,0.0,24,20,3,1,4,83.33333333
2014020522,4,3560,0.0,37,34,12,1,3,91.89189189
2014020522,18,3595,0.0,27,26,7,0,1,96.2962963
2014020523,24,3900,0.0,29,28,3,0,1,96.55172414
2014020523,53,3889,0.0,36,35,0,1,1,97.22222222
2014020524,16,3600,0.0,25,23,5,0,2,92.0
2014020524,21,3476,0.0,32,28,1,0,4,87.5
2014020525,22,528,0.0,6,3,0,0,3,50.0
2014020525,22,3010,0.0,21,20,7,1,1,95.23809524
2014020525,20,3600,0.0,27,26,4,2,1,96.2962963
2014020526,28,3439,0.0,29,26,6,0,3,89.65517241
2014020526,26,3580,0.0,22,21,2,2,1,95.45454545
2014020527,10,3501,0.0,33,28,4,0,5,84.84848485
2014020527,13,3595,0.0,22,18,2,0,4,81.81818182
2014020528,23,3762,0.0,31,29,1,0,2,93.5483871
2014020528,24,3759,0.0,14,13,0,0,1,92.85714286
2014020529,17,3544,0.0,44,40,2,3,4,90.90909091
2014020529,6,3584,0.0,30,28,6,0,2,93.33333333
2014020530,5,3540,0.0,27,24,3,0,3,88.88888889
2014020530,1,3598,0.0,28,27,4,1,1,96.42857143
2014020531,15,3766,0.0,39,35,13,2,4,89.74358974
2014020531,2,3773,0.0,26,23,6,0,3,88.46153846
2014020532,8,3600,0.0,29,28,5,0,1,96.55172414
2014020532,12,3518,0.0,18,16,0,0,2,88.88888889
2014020533,7,3423,0.0,35,31,3,2,4,88.57142857
2014020533,9,3600,0.0,21,19,3,0,2,90.47619048
2014020534,10,3517,0.0,41,38,2,0,3,92.68292683
2014020534,14,3571,0.0,23,21,4,2,2,91.30434783
2014020535,21,3600,0.0,25,22,1,0,3,88.0
2014020535,19,3600,0.0,16,16,0,0,0,100.0
2014020536,30,3600,0.0,30,28,2,1,2,93.33333333
2014020536,52,3499,0.0,31,28,5,0,3,90.32258065
2014020537,18,3900,0.0,42,38,6,2,4,90.47619048
2014020537,16,3893,0.0,40,36,9,1,4,90.0
2014020538,3,3511,0.0,27,24,7,0,3,88.88888889
2014020538,25,3600,0.0,30,28,4,2,2,93.33333333
2014020539,26,3515,0.0,15,13,0,0,2,86.66666667
2014020539,20,3600,0.0,27,26,2,0,1,96.2962963
2014020540,4,3520,0.0,24,21,3,0,3,87.5
2014020540,53,3600,0.0,32,30,3,0,2,93.75
2014020541,8,3900,0.0,37,36,5,1,1,97.2972973
2014020541,13,3900,0.0,34,33,10,1,1,97.05882353
2014020542,19,3500,0.0,47,44,9,0,3,93.61702128
2014020542,18,3600,0.0,28,26,5,1,2,92.85714286
2014020543,26,3900,0.0,21,19,4,0,2,90.47619048
2014020543,22,3900,0.0,39,37,2,0,2,94.87179487
2014020544,23,3600,0.0,32,31,8,0,1,96.875
2014020544,28,3463,0.0,21,18,0,0,3,85.71428571
2014020545,2,3600,0.0,23,21,6,1,2,91.30434783
2014020545,52,3594,0.0,32,28,4,0,4,87.5
2014020546,14,3600,0.0,11,10,2,0,1,90.90909091
2014020546,7,3600,0.0,25,20,1,0,5,80.0
2014020547,10,3900,0.0,28,25,4,0,3,89.28571429
2014020547,6,3900,0.0,21,18,2,0,3,85.71428571
2014020548,12,3539,0.0,39,37,4,0,2,94.87179487
2014020548,5,3580,0.0,25,24,1,2,1,96.0
2014020549,30,3546,0.0,25,23,0,0,2,92.0
2014020549,29,3585,0.0,29,28,9,0,1,96.55172414
2014020550,1,3600,0.0,28,25,3,1,3,89.28571429
2014020550,17,3600,0.0,13,12,3,0,1,92.30769231
2014020551,3,3592,0.0,20,18,0,1,2,90.0
2014020551,13,3600,0.0,34,29,1,1,5,85.29411765
2014020552,28,3600,0.0,28,28,3,2,0,100.0
2014020552,24,3572,0.0,26,24,11,0,2,92.30769231
2014020553,53,3600,0.0,31,25,2,0,6,80.64516129
2014020553,25,3600,0.0,32,32,7,0,0,100.0
2014020554,4,3861,0.0,33,29,3,1,4,87.87878788
2014020554,21,3876,0.0,29,26,4,1,3,89.65517241
2014020555,22,3668,0.0,28,24,11,0,4,85.71428571
2014020555,20,3649,0.0,20,17,3,2,3,85.0
2014020556,16,3579,0.0,35,32,3,0,3,91.42857143
2014020556,15,3600,0.0,35,33,3,2,2,94.28571429
2014020557,26,3600,0.0,16,14,0,0,2,87.5
2014020557,23,3538,0.0,40,37,2,0,3,92.5
2014020558,13,3600,0.0,30,30,3,0,0,100.0
2014020558,7,3422,0.0,33,31,1,0,2,93.93939394
2014020559,8,3600,0.0,24,22,3,0,2,91.66666667
2014020559,1,3497,0.0,25,22,3,2,3,88.0
2014020560,14,819,0.0,10,7,1,0,3,70.0
2014020560,14,2710,0.0,18,16,2,1,2,88.88888889
2014020560,5,3586,0.0,35,32,4,1,3,91.42857143
2014020561,4,3488,0.0,26,24,2,1,2,92.30769231
2014020561,12,3600,0.0,24,23,3,0,1,95.83333333
2014020562,10,3525,0.0,29,26,2,0,3,89.65517241
2014020562,30,3599,0.0,35,34,7,0,1,97.14285714
2014020563,22,3900,0.0,28,27,2,0,1,96.42857143
2014020563,21,3900,0.0,28,27,7,0,1,96.42857143
2014020564,2,3600,0.0,23,22,3,0,1,95.65217391
2014020564,20,3490,0.0,24,22,0,3,2,91.66666667
2014020565,19,3529,0.0,33,29,7,3,4,87.87878788
2014020565,24,3581,0.0,42,39,12,2,3,92.85714286
2014020566,9,3642,0.0,28,26,3,0,2,92.85714286
2014020566,6,3639,0.0,26,23,5,0,3,88.46153846
2014020567,18,3618,0.0,30,24,2,0,6,80.0
2014020567,26,2958,0.0,16,12,1,1,4,75.0
2014020567,26,583,0.0,9,6,0,0,3,66.66666667
2014020568,4,2393,0.0,8,6,0,0,2,75.0
2014020568,4,1200,0.0,10,7,2,0,3,70.0
2014020568,1,3600,0.0,20,18,0,0,2,90.0
2014020569,7,754,0.0,9,5,1,0,4,55.55555556
2014020569,7,2846,0.0,30,28,8,0,2,93.33333333
2014020569,3,3585,0.0,25,24,8,0,1,96.0
2014020570,8,3600,0.0,31,30,1,0,1,96.77419355
2014020570,5,3600,0.0,33,29,10,0,4,87.87878788
2014020571,10,3600,0.0,40,35,4,0,5,87.5
2014020571,52,3581,0.0,21,20,8,0,1,95.23809524
2014020572,30,1864,0.0,14,11,3,0,3,78.57142857
2014020572,30,1736,0.0,21,17,0,0,4,80.95238095
2014020572,25,3600,0.0,22,21,3,0,1,95.45454545
2014020573,29,897,0.0,3,3,0,0,0,100.0
2014020573,29,2698,0.0,31,25,9,0,6,80.64516129
2014020573,53,3599,0.0,26,23,4,1,3,88.46153846
2014020574,17,3488,0.0,22,20,3,2,2,90.90909091
2014020574,23,3591,0.0,30,29,6,1,1,96.66666667
2014020575,19,3600,0.0,20,18,5,0,2,90.0
2014020575,28,884,0.0,6,5,0,1,1,83.33333333
2014020575,28,2698,0.0,27,21,0,2,6,77.77777778
2014020576,6,3900,2.0,36,35,1,0,1,97.22222222
2014020576,12,3900,0.0,20,19,3,0,1,95.0
2014020577,13,1087,0.0,5,4,0,0,1,80.0
2014020577,13,2400,0.0,21,18,4,0,3,85.71428571
2014020577,15,3600,0.0,32,29,7,0,3,90.625
2014020578,14,3600,0.0,22,20,5,5,2,90.90909091
2014020578,9,3594,0.0,30,26,4,2,4,86.66666667
2014020579,25,3677,0.0,38,33,6,0,5,86.84210526
2014020579,16,3665,0.0,34,30,0,0,4,88.23529412
2014020580,29,3600,0.0,29,26,6,0,3,89.65517241
2014020580,21,3532,0.0,27,23,3,1,4,85.18518519
2014020581,18,3900,0.0,33,30,6,0,3,90.90909091
2014020581,24,3880,2.0,30,27,6,0,3,90.0
2014020582,2,3553,0.0,22,18,5,0,4,81.81818182
2014020582,22,3598,0.0,33,31,3,0,2,93.93939394
2014020583,28,3574,0.0,19,17,3,2,2,89.47368421
2014020583,52,3595,0.0,37,34,13,0,3,91.89189189
2014020584,7,3593,0.0,27,24,4,0,3,88.88888889
2014020584,1,3600,0.0,21,20,1,0,1,95.23809524
2014020585,9,3900,0.0,34,33,1,3,1,97.05882353
2014020585,4,3900,0.0,42,41,4,1,1,97.61904762
2014020586,14,3598,0.0,22,20,1,0,2,90.90909091
2014020586,8,3461,0.0,36,32,9,1,4,88.88888889
2014020587,12,3504,0.0,26,23,2,0,3,88.46153846
2014020587,18,3595,0.0,25,23,1,0,2,92.0
2014020588,28,3749,0.0,31,28,2,1,3,90.32258065
2014020588,30,3789,0.0,26,22,0,1,4,84.61538462
2014020589,21,3600,0.0,54,54,9,0,0,100.0
2014020589,16,3439,0.0,24,22,3,1,2,91.66666667
2014020590,29,3571,0.0,26,24,9,1,2,92.30769231
2014020590,25,3471,0.0,20,16,5,0,4,80.0
2014020591,19,3569,0.0,23,23,0,0,0,100.0
2014020591,53,3582,0.0,39,33,6,1,6,84.61538462
2014020592,17,3600,0.0,23,21,3,1,2,91.30434783
2014020592,22,3576,0.0,40,37,7,2,3,92.5
2014020593,2,3535,0.0,20,17,1,2,3,85.0
2014020593,23,3600,0.0,23,21,5,1,2,91.30434783
2014020594,15,3581,0.0,33,31,0,0,2,93.93939394
2014020594,10,3537,0.0,25,20,2,1,5,80.0
2014020595,6,3752,0.0,39,37,5,0,2,94.87179487
2014020595,5,3760,0.0,24,21,2,0,3,87.5
2014020596,17,3600,0.0,30,28,6,1,2,93.33333333
2014020596,20,1682,0.0,9,7,2,0,2,77.77777778
2014020596,20,1811,0.0,13,12,0,0,1,92.30769231
2014020597,3,3596,0.0,25,24,0,0,1,96.0
2014020597,24,3591,0.0,29,26,0,0,3,89.65517241
2014020598,1,3502,0.0,42,40,4,0,2,95.23809524
2014020598,6,3600,0.0,14,14,0,0,0,100.0
2014020599,15,3625,0.0,33,30,9,1,3,90.90909091
2014020599,4,3673,0.0,28,26,3,3,2,92.85714286
2014020600,7,3600,0.0,31,26,1,0,5,83.87096774
2014020600,12,3600,0.0,20,18,3,0,2,90.0
2014020601,28,1600,0.0,7,5,2,0,2,71.42857143
2014020601,28,2000,0.0,21,16,3,0,5,76.19047619
2014020601,19,3600,0.0,26,24,2,1,2,92.30769231
2014020602,25,3617,0.0,24,21,1,0,3,87.5
2014020602,18,3615,0.0,20,18,3,0,2,90.0
2014020603,16,3593,0.0,44,42,9,0,2,95.45454545
2014020603,30,3569,0.0,19,16,6,0,3,84.21052632
2014020604,9,1609,0.0,9,6,0,0,3,66.66666667
2014020604,9,1990,0.0,12,10,2,0,2,83.33333333
2014020604,21,3599,0.0,38,36,5,3,2,94.73684211
2014020605,52,3555,0.0,30,26,7,2,4,86.66666667
2014020605,53,3600,0.0,35,34,8,0,1,97.14285714
2014020606,13,3600,0.0,33,32,3,2,1,96.96969697
2014020606,23,3503,0.0,30,27,1,1,3,90.0
2014020607,3,3596,0.0,31,28,4,1,3,90.32258065
2014020607,26,3515,0.0,26,22,3,0,4,84.61538462
2014020608,2,3785,0.0,23,21,2,2,2,91.30434783
2014020608,1,3785,0.0,31,28,5,2,3,90.32258065
2014020609,29,3524,0.0,31,27,8,0,4,87.09677419
2014020609,10,3600,0.0,20,18,1,1,2,90.0
2014020610,7,3565,0.0,47,45,5,1,2,95.74468085
2014020610,14,3592,0.0,21,20,6,1,1,95.23809524
2014020611,13,3599,2.0,30,25,7,0,5,83.33333333
2014020611,20,3481,0.0,35,29,1,0,6,82.85714286
2014020612,16,3575,0.0,21,17,4,0,4,80.95238095
2014020612,22,3600,0.0,21,19,1,0,2,90.47619048
2014020613,6,3598,0.0,25,24,3,0,1,96.0
2014020613,4,427,0.0,5,5,0,0,0,100.0
2014020613,4,3039,0.0,13,10,1,1,3,76.92307692
2014020614,18,3600,2.0,37,36,6,2,1,97.2972973
2014020614,30,3595,0.0,27,24,1,1,3,88.88888889
2014020615,25,3522,0.0,30,26,1,1,4,86.66666667
2014020615,21,3600,0.0,40,37,9,0,3,92.5
2014020616,5,3819,0.0,28,27,8,0,1,96.42857143
2014020616,8,3808,0.0,37,35,7,4,2,94.59459459
2014020617,17,113,0.0,3,2,1,0,1,66.66666667
2014020617,17,3337,0.0,14,12,2,1,2,85.71428571
2014020617,15,3600,0.0,27,26,0,0,1,96.2962963
2014020618,2,3600,0.0,18,16,2,1,2,88.88888889
2014020618,29,3596,0.0,40,35,8,3,5,87.5
2014020619,9,3598,0.0,32,31,9,0,1,96.875
2014020619,53,3600,0.0,33,28,7,0,5,84.84848485
2014020620,12,3900,0.0,35,31,2,0,4,88.57142857
2014020620,19,762,0.0,10,7,0,0,3,70.0
2014020620,19,3118,0.0,20,19,3,0,1,95.0
2014020621,20,3593,0.0,36,36,0,0,0,100.0
2014020621,23,3550,0.0,23,22,4,0,1,95.65217391
2014020622,52,3900,0.0,29,25,4,0,4,86.20689655
2014020622,26,3900,0.0,25,21,3,1,4,84.0
2014020623,3,3599,0.0,31,30,6,2,1,96.77419355
2014020623,28,3571,0.0,31,29,0,1,2,93.5483871
2014020624,13,3600,0.0,33,31,3,0,2,93.93939394
2014020624,22,3532,0.0,27,23,3,0,4,85.18518519
2014020625,30,3600,0.0,35,31,3,1,4,88.57142857
2014020625,16,3600,0.0,37,36,5,0,1,97.2972973
2014020626,52,3895,0.0,43,39,11,4,4,90.69767442
2014020626,24,3900,0.0,32,28,9,2,4,87.5
2014020627,14,2244,0.0,12,9,2,0,3,75.0
2014020627,14,1356,0.0,13,9,0,0,4,69.23076923
2014020627,4,3584,0.0,24,21,1,0,3,87.5
2014020628,21,3466,2.0,38,36,5,2,2,94.73684211
2014020628,15,3600,0.0,32,31,7,1,1,96.875
2014020629,10,3536,0.0,19,18,1,1,1,94.73684211
2014020629,26,3600,0.0,19,19,3,0,0,100.0
2014020630,14,3537,0.0,34,30,2,2,4,88.23529412
2014020630,6,3592,0.0,19,16,3,0,3,84.21052632
2014020631,17,3584,0.0,26,25,1,0,1,96.15384615
2014020631,7,3494,0.0,30,27,4,2,3,90.0
2014020632,2,3600,0.0,27,27,1,0,0,100.0
2014020632,3,2400,0.0,32,29,2,0,3,90.625
2014020632,3,1200,0.0,12,12,0,0,0,100.0
2014020633,30,544,0.0,2,1,0,0,1,50.0
2014020633,30,3048,0.0,35,29,3,0,6,82.85714286
2014020633,5,3575,0.0,32,30,2,0,2,93.75
2014020634,21,3900,0.0,46,44,0,0,2,95.65217391
2014020634,12,3900,0.0,30,28,2,0,2,93.33333333
2014020635,22,3475,0.0,29,25,3,0,4,86.20689655
2014020635,19,3600,0.0,15,13,1,0,2,86.66666667
2014020636,23,3598,0.0,30,25,8,0,5,83.33333333
2014020636,18,2573,0.0,21,20,0,0,1,95.23809524
2014020636,18,1025,0.0,10,10,0,2,0,100.0
2014020637,13,2003,0.0,15,11,2,0,4,73.33333333
2014020637,13,1597,0.0,20,16,1,0,4,80.0
2014020637,52,3600,0.0,27,25,1,1,2,92.59259259
2014020638,9,3478,0.0,29,24,2,1,5,82.75862069
2014020638,25,2970,0.0,36,34,3,0,2,94.44444444
2014020638,25,630,0.0,5,3,1,0,2,60.0
2014020639,28,3597,0.0,29,27,3,0,2,93.10344828
2014020639,53,3530,0.0,25,22,1,0,3,88.0
2014020640,8,3600,0.0,16,14,0,2,2,87.5
2014020640,29,3541,0.0,31,28,3,0,3,90.32258065
2014020641,4,3517,0.0,26,25,2,1,1,96.15384615
2014020641,15,3600,0.0,21,21,4,0,0,100.0
2014020642,10,3429,0.0,24,21,3,1,3,87.5
2014020642,24,3597,0.0,28,28,3,0,0,100.0
2014020643,1,3600,0.0,26,23,1,2,3,88.46153846
2014020643,26,2901,0.0,13,10,2,1,3,76.92307692
2014020643,26,640,0.0,7,5,0,0,2,71.42857143
2014020644,3,3600,0.0,32,29,4,2,3,90.625
2014020644,6,3600,0.0,30,30,9,3,0,100.0
2014020645,30,3597,0.0,18,18,4,1,0,100.0
2014020645,7,3600,0.0,37,30,5,1,7,81.08108108
2014020646,23,3600,0.0,30,30,4,0,0,100.0
2014020646,4,2319,0.0,10,9,2,1,1,90.0
2014020646,4,1281,0.0,12,9,0,1,3,75.0
2014020647,8,3452,0.0,34,31,6,1,3,91.17647059
2014020647,9,3600,0.0,26,25,7,1,1,96.15384615
2014020648,22,3500,0.0,19,16,0,0,3,84.21052632
2014020648,14,3600,0.0,32,30,6,1,2,93.75
2014020649,21,3584,0.0,32,30,5,0,2,93.75
2014020649,13,3533,0.0,28,25,4,0,3,89.28571429
2014020650,17,3897,0.0,27,25,2,2,2,92.59259259
2014020650,19,3869,0.0,24,21,1,0,3,87.5
2014020651,52,3600,0.0,47,46,13,0,1,97.87234043
2014020651,25,3453,0.0,22,20,1,0,2,90.90909091
2014020652,20,3584,0.0,28,27,0,1,1,96.42857143
2014020652,53,3580,0.0,24,21,1,0,3,87.5
2014020653,10,3531,0.0,41,39,5,0,2,95.12195122
2014020653,28,3600,0.0,25,24,0,0,1,96.0
2014020654,5,3545,0.0,34,29,5,0,5,85.29411765
2014020654,2,3600,0.0,24,21,4,0,3,87.5
2014020655,23,3588,0.0,28,28,4,1,0,100.0
2014020655,12,1200,0.0,4,4,0,0,0,100.0
2014020655,12,2400,0.0,13,10,0,0,3,76.92307692
2014020656,3,3600,0.0,36,35,5,0,1,97.22222222
2014020656,29,3535,0.0,26,24,7,1,2,92.30769231
2014020657,15,3508,0.0,30,26,7,1,4,86.66666667
2014020657,18,3600,0.0,34,31,4,0,3,91.17647059
2014020658,52,3600,0.0,33,31,5,1,2,93.93939394
2014020658,16,3560,0.0,34,31,3,1,3,91.17647059
2014020659,1,1200,0.0,15,14,4,0,1,93.33333333
2014020659,1,2400,0.0,25,21,3,1,4,84.0
2014020659,24,3600,0.0,15,14,0,0,1,93.33333333
2014020660,29,3600,0.0,35,34,2,0,1,97.14285714
2014020660,6,3566,0.0,30,28,7,0,2,93.33333333
2014020661,4,3600,0.0,27,24,1,2,3,88.88888889
2014020661,7,3495,0.0,32,28,3,1,4,87.5
2014020662,2,3223,0.0,33,27,3,1,6,81.81818182
2014020662,2,291,0.0,2,2,1,0,0,100.0
2014020662,8,3600,0.0,31,27,8,0,4,87.09677419
2014020663,12,3600,0.0,32,30,1,1,2,93.75
2014020663,9,3521,0.0,28,25,2,3,3,89.28571429
2014020664,18,752,0.0,4,1,0,0,3,25.0
2014020664,18,2820,0.0,20,18,1,0,2,90.0
2014020664,17,3594,0.0,36,34,8,0,2,94.44444444
2014020665,21,3777,0.0,31,29,5,1,2,93.5483871
2014020665,14,3900,0.0,42,40,4,0,2,95.23809524
2014020666,22,3900,0.0,37,35,2,0,2,94.59459459
2014020666,13,3900,0.0,34,32,5,0,2,94.11764706
2014020667,10,3600,0.0,33,30,5,0,3,90.90909091
2014020667,19,3600,0.0,27,27,0,1,0,100.0
2014020668,15,3531,0.0,26,21,5,1,5,80.76923077
2014020668,25,3600,0.0,32,28,4,1,4,87.5
2014020669,53,3579,0.0,32,30,8,0,2,93.75
2014020669,30,3579,0.0,26,25,1,2,1,96.15384615
2014020670,24,3885,0.0,28,26,1,0,2,92.85714286
2014020670,26,3893,0.0,31,29,0,1,2,93.5483871
2014020671,20,3624,0.0,22,19,3,0,3,86.36363636
2014020671,28,3624,0.0,23,19,3,0,4,82.60869565
2014020672,3,3592,0.0,34,32,3,1,2,94.11764706
2014020672,5,2066,0.0,14,13,4,0,1,92.85714286
2014020672,5,1519,0.0,17,13,5,1,4,76.47058824
2014020673,25,3600,0.0,41,38,4,0,3,92.68292683
2014020673,16,3493,0.0,33,28,1,1,5,84.84848485
2014020674,53,3900,0.0,30,27,3,2,3,90.0
2014020674,52,3900,0.0,31,28,6,0,3,90.32258065
2014020675,7,3600,0.0,26,20,0,0,6,76.92307692
2014020675,17,817,0.0,7,4,0,0,3,57.14285714
2014020675,17,2754,0.0,8,7,0,0,1,87.5
2014020676,4,1879,0.0,20,16,5,2,4,80.0
2014020676,4,1618,0.0,20,18,1,0,2,90.0
2014020676,2,3592,0.0,29,25,3,1,4,86.20689655
2014020677,12,3579,0.0,35,34,8,0,1,97.14285714
2014020677,10,2283,0.0,18,18,4,0,0,100.0
2014020677,10,1242,0.0,13,10,2,0,3,76.92307692
2014020678,23,3600,0.0,24,23,5,1,1,95.83333333
2014020678,13,3505,0.0,23,21,3,4,2,91.30434783
2014020679,21,3417,0.0,30,27,3,0,3,90.0
2014020679,19,3597,0.0,18,17,1,1,1,94.44444444
2014020680,29,3600,0.0,26,25,5,0,1,96.15384615
2014020680,30,3489,0.0,23,20,2,0,3,86.95652174
2014020681,20,3830,0.0,34,33,10,0,1,97.05882353
2014020681,26,3846,0.0,23,21,8,0,2,91.30434783
2014020682,1,3600,0.0,36,34,10,2,2,94.44444444
2014020682,28,3587,0.0,34,29,2,0,5,85.29411765
2014020683,9,3769,0.0,35,32,4,1,3,91.42857143
2014020683,3,3766,0.0,35,33,2,0,2,94.28571429
2014020684,5,3837,0.0,40,37,16,0,3,92.5
2014020684,4,3837,2.0,35,33,11,1,2,94.28571429
2014020685,22,3857,0.0,24,20,1,3,4,83.33333333
2014020685,15,3896,0.0,31,27,4,3,4,87.09677419
2014020686,18,3846,0.0,27,25,2,0,2,92.59259259
2014020686,8,3846,0.0,37,36,0,1,1,97.2972973
2014020687,30,1645,0.0,10,6,1,0,4,60.0
2014020687,30,2255,0.0,14,14,1,0,0,100.0
2014020687,17,3900,0.0,38,34,8,0,4,89.47368421
2014020688,23,3476,0.0,25,22,2,0,3,88.0
2014020688,14,3600,0.0,28,27,7,1,1,96.42857143
2014020689,53,3600,0.0,51,45,9,0,6,88.23529412
2014020689,16,3581,0.0,36,35,5,0,1,97.22222222
2014020690,6,3600,0.0,37,36,16,0,1,97.2972973
2014020690,25,3509,0.0,27,24,4,1,3,88.88888889
2014020691,10,3501,0.0,26,22,0,0,4,84.61538462
2014020691,9,3588,0.0,40,37,8,1,3,92.5
2014020692,16,3891,2.0,35,33,4,0,2,94.28571429
2014020692,5,3897,0.0,26,24,2,1,2,92.30769231
2014020693,29,1932,0.0,17,16,1,0,1,94.11764706
2014020693,29,1664,0.0,12,9,0,1,3,75.0
2014020693,52,3588,0.0,29,29,3,0,0,100.0
2014020694,6,3900,2.0,36,34,7,0,2,94.44444444
2014020694,21,3863,0.0,24,22,2,2,2,91.66666667
2014020695,20,1728,0.0,15,14,2,0,1,93.33333333
2014020695,20,1766,0.0,11,7,0,1,4,63.63636364
2014020695,24,3600,0.0,33,30,5,0,3,90.90909091
2014020696,26,3405,0.0,24,21,1,1,3,87.5
2014020696,28,3600,0.0,28,26,8,1,2,92.85714286
2014020697,3,3600,0.0,38,34,3,2,4,89.47368421
2014020697,2,3598,0.0,41,40,4,1,1,97.56097561
2014020698,53,3900,0.0,42,39,5,0,3,92.85714286
2014020698,4,3542,0.0,23,22,1,0,1,95.65217391
2014020698,4,350,0.0,4,2,0,0,2,50.0
2014020699,52,3555,0.0,29,25,3,0,4,86.20689655
2014020699,5,3600,0.0,22,19,0,0,3,86.36363636
2014020700,14,3454,0.0,22,18,5,0,4,81.81818182
2014020700,12,3600,0.0,30,28,2,0,2,93.33333333
2014020701,15,3563,0.0,30,26,7,2,4,86.66666667
2014020701,29,3600,0.0,28,25,4,2,3,89.28571429
2014020702,25,3504,0.0,26,23,9,1,3,88.46153846
2014020702,8,3587,0.0,42,40,6,1,2,95.23809524
2014020703,17,3600,0.0,41,37,12,0,4,90.24390244
2014020703,13,1559,0.0,10,10,0,0,0,100.0
2014020703,13,1943,0.0,17,12,1,0,5,70.58823529
2014020704,21,3674,0.0,39,35,0,0,4,89.74358974
2014020704,18,3766,0.0,24,21,2,0,3,87.5
2014020705,7,3585,0.0,31,27,6,1,4,87.09677419
2014020705,20,3573,0.0,18,17,2,0,1,94.44444444
2014020706,30,3597,2.0,24,23,6,0,1,95.83333333
2014020706,22,3500,0.0,29,27,4,0,2,93.10344828
2014020707,24,3600,0.0,17,17,2,2,0,100.0
2014020707,23,3439,0.0,23,20,5,2,3,86.95652174
2014020708,10,3883,0.0,23,22,5,2,1,95.65217391
2014020708,1,3892,0.0,30,29,13,1,1,96.66666667
2014020709,5,3581,0.0,36,32,8,4,4,88.88888889
2014020709,15,3579,0.0,27,27,2,0,0,100.0
2014020710,16,3504,0.0,27,23,2,2,4,85.18518519
2014020710,26,3600,0.0,29,26,4,0,3,89.65517241
2014020711,6,3593,0.0,45,43,2,0,2,95.55555556
2014020711,2,3496,0.0,32,28,1,1,4,87.5
2014020712,8,3600,0.0,24,24,2,0,0,100.0
2014020712,3,3524,0.0,26,25,2,1,1,96.15384615
2014020713,52,3551,0.0,31,27,7,0,4,87.09677419
2014020713,4,3600,0.0,38,36,7,1,2,94.73684211
2014020714,53,3600,0.0,25,24,7,2,1,96.0
2014020714,10,3428,0.0,45,42,11,3,3,93.33333333
2014020715,25,3600,0.0,28,25,3,2,3,89.28571429
2014020715,9,3556,0.0,39,35,6,1,4,89.74358974
2014020716,17,2400,0.0,15,10,1,0,5,66.66666667
2014020716,17,1200,0.0,17,17,0,0,0,100.0
2014020716,14,3600,0.0,28,27,3,0,1,96.42857143
2014020717,29,3515,0.0,31,28,5,0,3,90.32258065
2014020717,13,3600,0.0,33,31,1,1,2,93.93939394
2014020718,18,3900,0.0,35,31,10,1,4,88.57142857
2014020718,19,3895,0.0,37,33,6,2,4,89.18918919
2014020719,30,3600,0.0,30,30,1,0,0,100.0
2014020719,20,3498,0.0,32,31,0,0,1,96.875
2014020720,7,3563,0.0,34,31,4,1,3,91.17647059
2014020720,22,3600,0.0,20,18,1,0,2,90.0
2014020721,24,2167,0.0,25,19,8,1,6,76.0
2014020721,24,1433,0.0,8,8,2,0,0,100.0
2014020721,28,3599,0.0,28,25,4,1,3,89.28571429
2014020722,5,3717,0.0,14,13,2,0,1,92.85714286
2014020722,1,3741,0.0,43,41,6,0,2,95.34883721
2014020723,19,3900,0.0,28,26,1,1,2,92.85714286
2014020723,12,205,0.0,3,1,0,0,2,33.33333333
2014020723,12,3695,0.0,29,29,1,0,0,100.0
2014020724,18,3524,0.0,27,25,6,0,2,92.59259259
2014020724,21,3600,0.0,23,23,1,1,0,100.0
2014020725,7,3515,0.0,37,33,5,1,4,89.18918919
2014020725,23,3600,0.0,22,20,8,0,2,90.90909091
2014020726,16,3582,0.0,22,21,3,1,1,95.45454545
2014020726,24,3600,0.0,33,29,3,0,4,87.87878788
2014020727,15,3788,0.0,30,29,4,6,1,96.66666667
2014020727,8,3779,0.0,36,36,11,0,0,100.0
2014020728,2,3600,0.0,19,15,3,1,4,78.94736842
2014020728,17,3595,0.0,23,22,5,1,1,95.65217391
2014020729,53,2535,2.0,20,15,5,0,5,75.0
2014020729,53,1063,0.0,11,9,0,1,2,81.81818182
2014020729,9,3597,0.0,37,35,11,0,2,94.59459459
2014020730,26,3566,0.0,32,30,2,1,2,93.75
2014020730,6,3600,0.0,31,30,2,0,1,96.77419355
2014020731,13,3509,0.0,13,11,2,0,2,84.61538462
2014020731,1,3600,0.0,27,26,2,0,1,96.2962963
2014020732,12,3600,0.0,37,33,1,0,4,89.18918919
2014020732,3,3600,0.0,32,31,6,0,1,96.875
2014020733,10,3546,0.0,18,17,3,0,1,94.44444444
2014020733,4,3600,0.0,30,30,1,1,0,100.0
2014020734,25,3600,0.0,40,38,2,0,2,95.0
2014020734,52,3455,0.0,32,27,5,1,5,84.375
2014020735,29,3333,0.0,34,31,4,0,3,91.17647059
2014020735,14,3600,0.0,35,34,7,2,1,97.14285714
2014020736,22,3474,0.0,33,29,4,0,4,87.87878788
2014020736,20,3600,0.0,19,17,0,0,2,89.47368421
2014020737,16,3564,0.0,19,18,4,0,1,94.73684211
2014020737,28,3600,0.0,31,31,2,3,0,100.0
2014020738,53,3587,0.0,20,18,3,0,2,90.0
2014020738,8,3514,0.0,32,29,5,1,3,90.625
2014020739,19,3600,0.0,36,33,3,2,3,91.66666667
2014020739,15,3539,0.0,40,36,6,1,4,90.0
2014020740,18,3585,0.0,21,21,5,0,0,100.0
2014020740,5,3587,0.0,24,20,2,0,4,83.33333333
2014020741,30,3600,0.0,37,35,9,1,2,94.59459459
2014020741,23,3439,0.0,19,16,1,1,3,84.21052632
2014020742,13,3568,0.0,37,32,4,0,5,86.48648649
2014020742,3,3600,0.0,36,33,1,1,3,91.66666667
2014020743,52,740,0.0,4,4,0,1,0,100.0
2014020743,52,2843,0.0,23,19,4,0,4,82.60869565
2014020743,20,3567,0.0,19,17,1,2,2,89.47368421
2014020744,22,3900,0.0,37,33,0,1,4,89.18918919
2014020744,28,3900,0.0,40,36,4,0,4,90.0
2014020745,9,3536,0.0,19,17,1,1,2,89.47368421
2014020745,1,3600,0.0,20,19,2,1,1,95.0
2014020746,13,3600,0.0,34,32,5,0,2,94.11764706
2014020746,2,3528,0.0,29,26,1,2,3,89.65517241
2014020747,26,3600,0.0,27,23,5,3,4,85.18518519
2014020747,15,3600,0.0,27,27,0,0,0,100.0
2014020748,53,3600,0.0,31,30,0,1,1,96.77419355
2014020748,29,3548,0.0,28,25,3,0,3,89.28571429
2014020749,7,3600,0.0,34,32,2,1,2,94.11764706
2014020749,8,3538,0.0,18,15,0,0,3,83.33333333
2014020750,14,3676,0.0,18,16,1,0,2,88.88888889
2014020750,19,3676,0.0,31,30,3,0,1,96.77419355
2014020751,10,324,0.0,4,4,2,0,0,100.0
2014020751,10,3209,0.0,28,24,2,0,4,85.71428571
2014020751,18,3578,0.0,28,25,3,1,3,89.28571429
2014020752,16,3600,0.0,43,40,7,3,3,93.02325581
2014020752,30,3592,0.0,24,24,1,0,0,100.0
2014020753,21,3813,0.0,32,30,5,1,2,93.75
2014020753,25,3900,0.0,24,22,1,0,2,91.66666667
2014020754,52,3636,0.0,33,30,13,0,3,90.90909091
2014020754,23,3634,0.0,28,26,3,0,2,92.85714286
2014020755,12,3645,0.0,31,26,8,0,5,83.87096774
2014020755,24,3645,0.0,32,28,6,2,4,87.5
2014020756,6,3513,0.0,25,22,4,1,3,88.0
2014020756,3,3600,0.0,20,18,1,1,2,90.0
2014020757,5,3600,0.0,22,22,3,0,0,100.0
2014020757,22,3427,0.0,26,24,0,0,2,92.30769231
2014020758,28,3463,0.0,23,20,2,1,3,86.95652174
2014020758,20,3600,0.0,29,28,2,0,1,96.55172414
2014020759,19,3600,0.0,23,23,2,2,0,100.0
2014020759,7,3597,0.0,29,27,2,0,2,93.10344828
2014020760,2,3900,0.0,18,16,1,0,2,88.88888889
2014020760,4,3900,0.0,30,28,2,0,2,93.33333333
2014020761,15,3600,0.0,26,25,7,2,1,96.15384615
2014020761,9,3562,0.0,29,27,1,2,2,93.10344828
2014020762,26,3534,0.0,20,17,2,0,3,85.0
2014020762,13,3600,0.0,31,29,3,1,2,93.5483871
2014020763,24,3600,0.0,46,44,4,0,2,95.65217391
2014020763,18,3480,2.0,25,21,6,1,4,84.0
2014020764,14,3600,0.0,36,33,6,1,3,91.66666667
2014020764,25,3487,0.0,28,24,3,2,4,85.71428571
2014020765,17,3600,0.0,28,28,4,0,0,100.0
2014020765,21,3425,0.0,27,26,2,1,1,96.2962963
2014020766,12,3900,0.0,29,28,0,2,1,96.55172414
2014020766,53,3900,2.0,41,40,4,0,1,97.56097561
2014020767,28,3585,0.0,34,33,2,3,1,97.05882353
2014020767,23,3600,0.0,38,33,3,1,5,86.84210526
2014020768,10,3600,0.0,17,13,0,0,4,76.47058824
2014020768,1,3595,0.0,34,33,3,0,1,97.05882353
2014020769,24,3900,0.0,34,32,2,0,2,94.11764706
2014020769,15,3900,0.0,25,23,4,0,2,92.0
2014020770,19,1706,0.0,14,10,0,2,4,71.42857143
2014020770,19,1894,0.0,19,16,0,0,3,84.21052632
2014020770,29,3600,0.0,33,32,5,0,1,96.96969697
2014020771,16,3781,0.0,21,20,1,0,1,95.23809524
2014020771,52,3781,0.0,22,20,2,0,2,90.90909091
2014020772,5,3600,0.0,21,21,7,0,0,100.0
2014020772,20,2719,0.0,24,20,1,0,4,83.33333333
2014020772,20,881,0.0,6,6,0,0,0,100.0
2014020773,3,3473,0.0,23,20,1,0,3,86.95652174
2014020773,18,3600,0.0,32,30,2,2,2,93.75
2014020774,26,3600,0.0,28,26,3,0,2,92.85714286
2014020774,14,1200,0.0,9,6,0,0,3,66.66666667
2014020774,14,2290,0.0,20,19,4,0,1,95.0
2014020775,2,3512,0.0,36,34,3,0,2,94.44444444
2014020775,6,3600,0.0,40,39,6,0,1,97.5
2014020776,25,3476,0.0,24,21,3,0,3,87.5
2014020776,7,3600,0.0,40,38,3,1,2,95.0
2014020777,22,3600,0.0,28,23,2,1,5,82.14285714
2014020777,10,3600,0.0,32,31,4,0,1,96.875
2014020778,1,3599,0.0,44,38,3,0,6,86.36363636
2014020778,8,3598,0.0,23,21,0,1,2,91.30434783
2014020779,29,3600,0.0,35,34,9,0,1,97.14285714
2014020779,9,3593,0.0,32,29,0,1,3,90.625
2014020780,21,3480,0.0,29,28,7,0,1,96.55172414
2014020780,30,3600,0.0,18,18,6,0,0,100.0
2014020781,17,3600,0.0,23,22,8,3,1,95.65217391
2014020781,53,3538,0.0,25,23,8,3,2,92.0
2014020782,5,3597,0.0,27,22,3,1,5,81.48148148
2014020782,23,3600,0.0,31,31,7,1,0,100.0
2014020783,12,3600,0.0,27,23,2,1,4,85.18518519
2014020783,28,3558,0.0,29,25,4,0,4,86.20689655
2014020784,16,3591,0.0,27,25,0,1,2,92.59259259
2014020784,19,3572,0.0,27,24,4,0,3,88.88888889
2014020785,18,3897,0.0,36,34,6,1,2,94.44444444
2014020785,13,3886,0.0,25,23,1,0,2,92.0
2014020786,4,1878,0.0,8,8,1,0,0,100.0
2014020786,4,1722,0.0,6,5,1,0,1,83.33333333
2014020786,15,3508,0.0,24,22,0,2,2,91.66666667
2014020787,2,3600,0.0,10,8,0,0,2,80.0
2014020787,7,3551,0.0,31,28,2,1,3,90.32258065
2014020788,24,482,0.0,1,1,0,0,0,100.0
2014020788,24,3002,0.0,22,17,4,0,5,77.27272727
2014020788,14,3600,0.0,28,25,3,2,3,89.28571429
2014020789,25,3662,0.0,36,34,3,0,2,94.44444444
2014020789,3,3658,0.0,25,22,2,2,3,88.0
2014020790,21,3310,0.0,29,24,2,2,5,82.75862069
2014020790,52,3597,0.0,28,25,4,2,3,89.28571429
2014020791,8,3598,0.0,35,34,0,0,1,97.14285714
2014020791,6,3539,0.0,33,31,1,0,2,93.93939394
2014020792,22,3600,0.0,14,13,0,0,1,92.85714286
2014020792,1,3498,0.0,24,22,6,0,2,91.66666667
2014020793,26,3600,0.0,26,23,0,0,3,88.46153846
2014020793,29,3495,0.0,44,40,0,0,4,90.90909091
2014020794,23,1679,0.0,18,13,4,0,5,72.22222222
2014020794,23,1870,0.0,14,14,0,0,0,100.0
2014020794,30,3600,0.0,25,22,0,0,3,88.0
2014020795,53,3900,0.0,38,36,2,0,2,94.73684211
2014020795,16,3884,0.0,29,27,1,2,2,93.10344828
2014020796,20,3522,0.0,34,33,6,0,1,97.05882353
2014020796,28,3553,0.0,26,23,3,2,3,88.46153846
2014020797,25,3600,0.0,44,41,9,0,3,93.18181818
2014020797,6,2306,0.0,21,20,2,1,1,95.23809524
2014020797,6,1200,0.0,10,7,0,0,3,70.0
2014020798,9,3600,0.0,36,35,3,0,1,97.22222222
2014020798,7,3524,0.0,26,24,4,0,2,92.30769231
2014020799,22,3543,0.0,28,25,4,0,3,89.28571429
2014020799,2,3600,0.0,36,34,4,0,2,94.44444444
2014020800,3,3600,0.0,34,30,0,2,4,88.23529412
2014020800,10,3537,0.0,39,34,3,0,5,87.17948718
2014020801,4,3799,0.0,41,39,4,0,2,95.12195122
2014020801,8,3765,0.0,24,23,2,0,1,95.83333333
2014020802,24,1557,0.0,8,5,2,0,3,62.5
2014020802,24,2043,0.0,18,15,6,0,3,83.33333333
2014020802,13,3600,0.0,33,31,5,1,2,93.93939394
2014020803,53,3477,0.0,36,34,5,0,2,94.44444444
2014020803,19,3600,0.0,26,25,4,0,1,96.15384615
2014020804,14,3867,0.0,29,26,0,1,3,89.65517241
2014020804,18,3862,0.0,32,30,0,1,2,93.75
2014020805,30,3840,0.0,34,32,5,1,2,94.11764706
2014020805,52,3840,0.0,30,29,9,0,1,96.66666667
2014020806,17,1200,0.0,4,4,0,0,0,100.0
2014020806,17,2400,0.0,17,13,2,0,4,76.47058824
2014020806,5,3576,0.0,24,23,1,0,1,95.83333333
2014020807,23,3680,0.0,41,37,6,0,4,90.24390244
2014020807,16,3577,0.0,36,31,4,0,5,86.11111111
2014020808,15,3741,0.0,30,26,0,0,4,86.66666667
2014020808,28,3762,0.0,33,28,4,0,5,84.84848485
2014020809,10,3537,0.0,41,38,4,0,3,92.68292683
2014020809,2,3598,0.0,34,32,1,2,2,94.11764706
2014020810,24,3600,0.0,36,35,5,0,1,97.22222222
2014020810,12,3504,0.0,17,15,0,1,2,88.23529412
2014020811,22,3644,0.0,26,23,5,0,3,88.46153846
2014020811,8,3707,0.0,38,34,2,2,4,89.47368421
2014020812,5,3885,0.0,33,29,8,0,4,87.87878788
2014020812,9,3885,0.0,29,25,1,0,4,86.20689655
2014020813,19,3600,0.0,29,26,1,0,3,89.65517241
2014020813,14,2398,0.0,34,29,4,0,5,85.29411765
2014020813,14,1178,0.0,9,9,0,0,0,100.0
2014020814,52,3476,0.0,26,23,9,0,3,88.46153846
2014020814,18,3575,0.0,33,32,7,0,1,96.96969697
2014020815,13,3501,0.0,23,21,3,1,2,91.30434783
2014020815,30,3600,0.0,27,26,8,0,1,96.2962963
2014020816,3,3600,0.0,29,26,4,1,3,89.65517241
2014020816,21,3480,0.0,30,25,5,1,5,83.33333333
2014020817,20,2898,0.0,40,35,2,3,5,87.5
2014020817,20,534,0.0,5,5,3,0,0,100.0
2014020817,26,3600,2.0,18,15,1,0,3,83.33333333
2014020818,4,3724,0.0,33,29,2,1,4,87.87878788
2014020818,29,3737,0.0,25,22,4,0,3,88.0
2014020819,1,3588,0.0,34,32,5,1,2,94.11764706
2014020819,16,3600,0.0,26,25,2,1,1,96.15384615
2014020820,13,3498,0.0,28,26,9,0,2,92.85714286
2014020820,25,3600,0.0,37,37,4,4,0,100.0
2014020821,28,3578,0.0,36,34,2,0,2,94.44444444
2014020821,53,3518,0.0,25,22,2,1,3,88.0
2014020822,6,3584,0.0,24,20,3,0,4,83.33333333
2014020822,23,3600,0.0,23,21,5,0,2,91.30434783
2014020823,22,1241,0.0,15,12,0,1,3,80.0
2014020823,22,2341,0.0,27,23,2,0,4,85.18518519
2014020823,9,3600,0.0,27,25,4,1,2,92.59259259
2014020824,10,3900,0.0,32,31,4,1,1,96.875
2014020824,8,3900,0.0,29,28,3,2,1,96.55172414
2014020825,52,3897,0.0,29,25,3,1,4,86.20689655
2014020825,17,3895,0.0,38,34,6,3,4,89.47368421
2014020826,29,3600,0.0,46,40,7,3,6,86.95652174
2014020826,2,3600,0.0,37,34,9,2,3,91.89189189
2014020827,1,3519,0.0,38,35,6,0,3,92.10526316
2014020827,18,3595,0.0,22,21,2,0,1,95.45454545
2014020828,12,3524,0.0,23,18,3,1,5,78.26086957
2014020828,30,3593,0.0,27,24,4,0,3,88.88888889
2014020829,3,3600,0.0,35,34,2,0,1,97.14285714
2014020829,53,3600,0.0,32,27,0,2,5,84.375
2014020830,25,3397,0.0,30,26,2,0,4,86.66666667
2014020830,21,3600,0.0,25,24,2,0,1,96.0
2014020831,23,3499,0.0,34,31,6,0,3,91.17647059
2014020831,20,3600,0.0,30,28,1,0,2,93.33333333
2014020832,15,3447,0.0,30,27,2,1,3,90.0
2014020832,26,3600,0.0,28,27,3,2,1,96.42857143
2014020833,5,3852,0.0,32,31,2,0,1,96.875
2014020833,16,3852,0.0,37,36,4,1,1,97.2972973
2014020834,19,3900,0.0,41,40,11,0,1,97.56097561
2014020834,13,3884,0.0,33,32,0,0,1,96.96969697
2014020835,4,3598,0.0,22,21,3,1,1,95.45454545
2014020835,7,3557,0.0,30,28,2,1,2,93.33333333
2014020836,15,3600,0.0,33,30,11,0,3,90.90909091
2014020836,24,3483,0.0,28,23,4,0,5,82.14285714
2014020837,14,3595,0.0,35,33,6,0,2,94.28571429
2014020837,28,3538,0.0,32,28,0,1,4,87.5
2014020838,3,3598,0.0,43,38,4,1,5,88.37209302
2014020838,2,3554,0.0,42,36,10,0,6,85.71428571
2014020839,12,3596,0.0,32,29,3,1,3,90.625
2014020839,9,2346,0.0,31,27,3,0,4,87.09677419
2014020839,9,1246,0.0,5,3,0,0,2,60.0
2014020840,8,3600,0.0,25,25,1,0,0,100.0
2014020840,17,3514,0.0,28,27,5,0,1,96.42857143
2014020841,22,3900,0.0,46,42,5,0,4,91.30434783
2014020841,22,0,0.0,0,0,0,0,0,
2014020841,52,3900,0.0,22,18,1,0,4,81.81818182
2014020842,53,3600,0.0,34,29,4,0,5,85.29411765
2014020842,21,1200,0.0,12,11,0,2,1,91.66666667
2014020842,21,2400,0.0,5,4,1,0,1,80.0
2014020843,6,3898,0.0,27,23,0,1,4,85.18518519
2014020843,20,2648,0.0,16,16,0,0,0,100.0
2014020843,20,1249,0.0,11,8,0,0,3,72.72727273
2014020844,30,3523,0.0,29,26,3,0,3,89.65517241
2014020844,23,3600,0.0,22,20,2,0,2,90.90909091
2014020845,14,3483,0.0,28,25,2,1,3,89.28571429
2014020845,26,3590,0.0,23,21,2,0,2,91.30434783
2014020846,7,3900,0.0,35,34,4,1,1,97.14285714
2014020846,1,3891,0.0,25,24,4,1,1,96.0
2014020847,29,3600,0.0,44,42,8,0,2,95.45454545
2014020847,4,3488,0.0,24,20,0,1,4,83.33333333
2014020848,15,3600,0.0,33,32,7,2,1,96.96969697
2014020848,5,3532,0.0,32,30,7,0,2,93.75
2014020849,2,3600,0.0,38,37,2,0,1,97.36842105
2014020849,12,3568,0.0,29,26,1,1,3,89.65517241
2014020850,13,3597,0.0,29,27,1,1,2,93.10344828
2014020850,10,3401,0.0,17,14,2,0,3,82.35294118
2014020851,25,3596,0.0,28,27,6,2,1,96.42857143
2014020851,19,518,0.0,6,3,0,0,3,50.0
2014020851,19,3082,0.0,16,15,5,1,1,93.75
2014020852,28,3582,0.0,37,32,3,1,5,86.48648649
2014020852,18,3600,0.0,43,42,9,0,1,97.6744186
2014020853,8,3546,0.0,38,35,5,0,3,92.10526316
2014020853,9,3598,0.0,44,42,3,2,2,95.45454545
2014020854,17,3900,0.0,34,32,9,1,2,94.11764706
2014020854,16,3892,0.0,28,26,1,1,2,92.85714286
2014020855,30,3710,0.0,37,35,7,0,2,94.59459459
2014020855,20,3710,0.0,29,26,3,2,3,89.65517241
2014020856,26,3600,0.0,43,42,8,3,1,97.6744186
2014020856,21,3496,0.0,25,22,3,0,3,88.0
2014020857,6,3900,0.0,30,27,6,0,3,90.0
2014020857,22,3894,0.0,41,38,5,0,3,92.68292683
2014020858,14,3600,0.0,25,24,3,1,1,96.0
2014020858,24,3600,0.0,32,28,3,0,4,87.5
2014020859,18,3588,0.0,40,35,2,1,5,87.5
2014020859,2,3591,0.0,32,30,6,0,2,93.75
2014020860,23,3848,0.0,34,30,5,0,4,88.23529412
2014020860,3,3900,0.0,28,24,2,0,4,85.71428571
2014020861,7,3898,0.0,38,36,11,0,2,94.73684211
2014020861,4,3892,0.0,32,30,4,0,2,93.75
2014020862,29,3600,0.0,30,29,3,0,1,96.66666667
2014020862,5,3498,0.0,30,28,9,1,2,93.33333333
2014020863,52,3514,0.0,32,28,7,1,4,87.5
2014020863,15,3600,0.0,20,19,6,1,1,95.0
2014020864,13,3900,0.0,39,37,1,0,2,94.87179487
2014020864,8,3900,0.0,21,19,1,0,2,90.47619048
2014020865,28,3600,0.0,39,37,6,0,2,94.87179487
2014020865,25,1985,0.0,9,9,1,1,0,100.0
2014020865,25,1574,0.0,17,14,2,0,3,82.35294118
2014020866,9,3900,0.0,33,29,1,0,4,87.87878788
2014020866,7,3869,0.0,33,29,7,0,4,87.87878788
2014020867,23,3461,0.0,26,23,2,0,3,88.46153846
2014020867,1,3600,0.0,23,21,6,0,2,91.30434783
2014020868,10,3547,0.0,26,24,1,2,2,92.30769231
2014020868,12,3600,2.0,24,23,0,1,1,95.83333333
2014020869,6,1725,0.0,9,7,1,0,2,77.77777778
2014020869,6,1875,0.0,6,3,0,0,3,50.0
2014020869,19,3600,0.0,27,26,5,2,1,96.2962963
2014020870,21,3600,0.0,28,27,0,0,1,96.42857143
2014020870,16,3574,0.0,30,26,2,0,4,86.66666667
2014020871,24,3600,0.0,28,25,9,0,3,89.28571429
2014020871,20,3531,0.0,37,32,2,0,5,86.48648649
2014020872,30,3600,0.0,15,15,0,0,0,100.0
2014020872,22,3596,0.0,29,25,0,0,4,86.20689655
2014020873,2,3861,0.0,27,25,0,0,2,92.59259259
2014020873,15,3900,0.0,32,30,3,0,2,93.75
2014020874,18,3900,0.0,33,31,1,0,2,93.93939394
2014020874,4,3900,0.0,22,20,1,0,2,90.90909091
2014020875,52,3827,0.0,33,29,5,2,4,87.87878788
2014020875,10,3827,0.0,34,31,4,6,3,91.17647059
2014020876,29,3538,0.0,23,21,3,0,2,91.30434783
2014020876,8,3598,0.0,32,31,6,0,1,96.875
2014020877,13,3600,0.0,39,35,8,1,4,89.74358974
2014020877,9,3598,0.0,22,21,2,2,1,95.45454545
2014020878,12,3305,0.0,19,16,3,0,3,84.21052632
2014020878,1,1561,0.0,15,14,1,0,1,93.33333333
2014020878,1,2039,0.0,17,17,2,2,0,100.0
2014020879,24,3600,0.0,27,26,3,0,1,96.2962963
2014020879,22,3514,0.0,21,19,0,2,2,90.47619048
2014020880,5,3582,0.0,23,21,0,1,2,91.30434783
2014020880,19,3533,0.0,29,25,6,0,4,86.20689655
2014020881,17,3037,0.0,32,26,0,1,6,81.25
2014020881,17,573,0.0,2,2,2,0,0,100.0
2014020881,25,3636,0.0,36,29,2,1,7,80.55555556
2014020882,14,3600,0.0,24,22,0,1,2,91.66666667
2014020882,53,3547,0.0,26,23,7,0,3,88.46153846
2014020883,26,3600,0.0,32,31,6,0,1,96.875
2014020883,28,3525,0.0,29,27,2,0,2,93.10344828
2014020884,15,3452,0.0,28,25,3,1,3,89.28571429
2014020884,4,3599,0.0,23,21,2,2,2,91.30434783
2014020885,6,3600,4.0,28,26,5,1,2,92.85714286
2014020885,16,1939,0.0,14,10,2,1,4,71.42857143
2014020885,16,1661,0.0,16,14,0,0,2,87.5
2014020886,18,3886,0.0,17,16,1,0,1,94.11764706
2014020886,7,3899,0.0,38,37,6,1,1,97.36842105
2014020887,23,1258,0.0,10,10,2,0,0,100.0
2014020887,23,2327,0.0,27,27,7,0,0,100.0
2014020887,2,3367,0.0,23,20,3,1,3,86.95652174
2014020888,13,3600,0.0,26,21,6,1,5,80.76923077
2014020888,5,3600,0.0,35,34,5,0,1,97.14285714
2014020889,14,3490,0.0,18,13,2,2,5,72.22222222
2014020889,21,3600,0.0,32,28,5,0,4,87.5
2014020890,29,3894,0.0,37,34,8,4,3,91.89189189
2014020890,3,3900,0.0,30,27,2,2,3,90.0
2014020891,25,3598,0.0,35,29,7,1,6,82.85714286
2014020891,30,3600,0.0,20,18,4,1,2,90.0
2014020892,53,3579,0.0,27,25,0,1,2,92.59259259
2014020892,1,3600,0.0,38,38,7,0,0,100.0
2014020893,17,3900,0.0,25,22,5,1,3,88.0
2014020893,24,3884,0.0,38,35,5,1,3,92.10526316
2014020894,23,3600,2.0,41,40,13,0,1,97.56097561
2014020894,6,3474,0.0,28,26,2,2,2,92.85714286
2014020895,53,3600,0.0,39,34,5,2,5,87.17948718
2014020895,2,3600,0.0,28,27,2,1,1,96.42857143
2014020896,20,3508,0.0,29,28,4,0,1,96.55172414
2014020896,3,3600,0.0,21,21,0,0,0,100.0
2014020897,4,3600,0.0,35,31,9,0,4,88.57142857
2014020897,12,3600,0.0,24,23,4,0,1,95.83333333
2014020898,7,3599,0.0,47,45,7,0,2,95.74468085
2014020898,29,3442,0.0,31,27,9,0,4,87.09677419
2014020899,8,3600,0.0,29,27,2,1,2,93.10344828
2014020899,19,3582,0.0,23,18,2,0,5,78.26086957
2014020900,21,1019,0.0,11,11,0,0,0,100.0
2014020900,21,2531,0.0,29,25,2,3,4,86.20689655
2014020900,18,3600,0.0,20,18,4,0,2,90.0
2014020901,22,3600,0.0,34,33,6,0,1,97.05882353
2014020901,30,3521,0.0,19,17,3,0,2,89.47368421
2014020902,25,3524,0.0,24,21,1,0,3,87.5
2014020902,52,3600,0.0,28,26,4,0,2,92.85714286
2014020903,13,3900,0.0,38,36,7,0,2,94.73684211
2014020903,16,3891,0.0,36,34,6,1,2,94.44444444
2014020904,17,3526,2.0,27,26,8,0,1,96.2962963
2014020904,26,3600,0.0,20,20,5,0,0,100.0
2014020905,20,3600,0.0,27,26,7,0,1,96.2962963
2014020905,1,3496,0.0,25,23,1,0,2,92.0
2014020906,5,3600,2.0,24,21,5,2,3,87.5
2014020906,15,3455,0.0,26,22,9,0,4,84.61538462
2014020907,9,3564,0.0,25,25,3,0,0,100.0
2014020907,24,3498,0.0,33,31,5,1,2,93.93939394
2014020908,23,3525,0.0,23,18,3,0,5,78.26086957
2014020908,7,3600,0.0,31,28,0,0,3,90.32258065
2014020909,53,3519,2.0,38,34,4,1,4,89.47368421
2014020909,3,3576,0.0,40,37,5,1,3,92.5
2014020910,8,3600,0.0,27,25,3,0,2,92.59259259
2014020910,29,3475,0.0,26,22,2,0,4,84.61538462
2014020911,4,1533,0.0,8,6,3,0,2,75.0
2014020911,4,1944,0.0,9,8,0,1,1,88.88888889
2014020911,10,3600,0.0,49,47,14,5,2,95.91836735
2014020912,16,3566,0.0,20,20,1,0,0,100.0
2014020912,13,3476,0.0,28,26,5,0,2,92.85714286
2014020913,30,3600,0.0,29,27,2,0,2,93.10344828
2014020913,18,3432,0.0,29,26,3,1,3,89.65517241
2014020914,19,3900,0.0,31,30,3,0,1,96.77419355
2014020914,52,3893,0.0,29,28,9,1,1,96.55172414
2014020915,9,3600,0.0,35,35,8,0,0,100.0
2014020915,26,3516,0.0,28,27,5,0,1,96.42857143
2014020916,17,3597,0.0,22,20,5,1,2,90.90909091
2014020916,28,3530,0.0,35,32,7,0,3,91.42857143
2014020917,6,3766,0.0,31,29,4,0,2,93.5483871
2014020917,1,3755,0.0,34,31,2,0,3,91.17647059
2014020918,20,3504,0.0,38,37,2,1,1,97.36842105
2014020918,2,3600,0.0,27,26,5,0,1,96.2962963
2014020919,15,3415,0.0,37,35,4,0,2,94.59459459
2014020919,12,3600,0.0,28,28,2,0,0,100.0
2014020920,16,3599,0.0,29,25,4,0,4,86.20689655
2014020920,14,3582,0.0,28,28,9,2,0,100.0
2014020921,21,3884,0.0,36,32,6,0,4,88.88888889
2014020921,25,3887,0.0,23,19,2,0,4,82.60869565
2014020922,26,3564,0.0,31,28,3,0,3,90.32258065
2014020922,24,3600,0.0,22,20,0,1,2,90.90909091
2014020923,7,3546,0.0,46,42,13,0,4,91.30434783
2014020923,13,3600,0.0,14,11,4,0,3,78.57142857
2014020924,17,3600,0.0,40,37,11,1,3,92.5
2014020924,18,3459,2.0,25,21,2,0,4,84.0
2014020925,12,3600,0.0,24,21,0,0,3,87.5
2014020925,2,3455,0.0,41,36,4,0,5,87.80487805
2014020926,1,3599,0.0,33,33,8,1,0,100.0
2014020926,29,3552,0.0,18,17,3,0,1,94.44444444
2014020927,53,1910,0.0,20,16,6,0,4,80.0
2014020927,53,1690,0.0,14,14,3,0,0,100.0
2014020927,6,3600,0.0,32,31,0,2,1,96.875
2014020928,10,3474,0.0,22,19,7,2,3,86.36363636
2014020928,8,3587,0.0,30,30,1,0,0,100.0
2014020929,3,3572,0.0,33,30,3,0,3,90.90909091
2014020929,4,3600,0.0,36,34,2,2,2,94.44444444
2014020930,30,3600,0.0,34,33,12,1,1,97.05882353
2014020930,21,3372,0.0,32,29,6,0,3,90.625
2014020931,19,3600,0.0,22,21,1,0,1,95.45454545
2014020931,22,3517,0.0,27,25,6,0,2,92.59259259
2014020932,9,3595,0.0,30,28,1,0,2,93.33333333
2014020932,28,3525,0.0,30,27,3,1,3,90.0
2014020933,26,1137,0.0,7,7,0,0,0,100.0
2014020933,26,2400,0.0,21,17,1,0,4,80.95238095
2014020933,52,3600,0.0,20,18,3,0,2,90.0
2014020934,14,3509,0.0,26,22,5,0,4,84.61538462
2014020934,13,3594,0.0,23,20,0,0,3,86.95652174
2014020935,29,3575,0.0,41,36,11,0,5,87.80487805
2014020935,5,3600,0.0,25,22,3,2,3,88.0
2014020936,10,3560,0.0,31,28,5,1,3,90.32258065
2014020936,15,3600,0.0,32,32,5,1,0,100.0
2014020937,24,3600,0.0,40,39,3,0,1,97.5
2014020937,25,3480,0.0,22,19,0,2,3,86.36363636
2014020938,19,374,0.0,6,5,0,0,1,83.33333333
2014020938,19,3523,0.0,25,21,4,0,4,84.0
2014020938,23,3900,0.0,39,34,5,1,5,87.17948718
2014020939,18,3397,0.0,39,36,1,3,3,92.30769231
2014020939,3,3600,0.0,26,25,2,0,1,96.15384615
2014020940,12,1200,0.0,8,7,0,0,1,87.5
2014020940,12,2400,0.0,18,14,0,0,4,77.77777778
2014020940,16,3600,0.0,29,27,4,0,2,93.10344828
2014020941,8,3600,0.0,37,33,1,0,4,89.18918919
2014020941,28,3600,0.0,20,20,0,0,0,100.0
2014020942,18,3451,0.0,23,21,1,0,2,91.30434783
2014020942,1,3580,0.0,34,33,5,0,1,97.05882353
2014020943,20,3683,0.0,37,35,4,1,2,94.59459459
2014020943,4,3683,0.0,26,23,1,0,3,88.46153846
2014020944,15,3600,0.0,30,27,5,1,3,90.0
2014020944,29,3523,0.0,32,28,6,0,4,87.5
2014020945,7,3555,0.0,35,32,3,1,3,91.42857143
2014020945,14,3600,0.0,28,28,6,0,0,100.0
2014020946,10,3600,0.0,42,40,9,0,2,95.23809524
2014020946,13,1852,0.0,15,12,1,1,3,80.0
2014020946,13,1684,0.0,19,19,2,0,0,100.0
2014020947,9,3896,0.0,38,36,6,1,2,94.73684211
2014020947,30,3900,0.0,33,31,7,1,2,93.93939394
2014020948,2,3654,0.0,35,32,6,0,3,91.42857143
2014020948,25,3738,0.0,37,35,3,4,2,94.59459459
2014020949,24,3600,0.0,30,29,1,0,1,96.66666667
2014020949,53,3566,0.0,34,31,0,0,3,91.17647059
2014020950,26,3600,2.0,23,21,2,1,2,91.30434783
2014020950,22,3598,0.0,29,24,4,1,5,82.75862069
2014020951,28,3600,0.0,28,26,5,0,2,92.85714286
2014020951,23,3067,0.0,24,23,3,1,1,95.83333333
2014020951,23,465,0.0,4,1,0,0,3,25.0
2014020952,9,3600,0.0,36,35,7,0,1,97.22222222
2014020952,52,1543,0.0,3,3,0,1,0,100.0
2014020952,52,1914,0.0,17,14,1,1,3,82.35294118
2014020953,3,3669,0.0,31,29,5,0,2,93.5483871
2014020953,17,3664,0.0,40,39,4,0,1,97.5
2014020954,5,3430,0.0,22,19,3,2,3,86.36363636
2014020954,21,3600,0.0,29,28,1,1,1,96.55172414
2014020955,8,3492,0.0,32,30,1,1,2,93.75
2014020955,24,3600,0.0,38,37,3,2,1,97.36842105
2014020956,20,3900,0.0,37,34,4,2,3,91.89189189
2014020956,6,3890,0.0,32,29,5,1,3,90.625
2014020957,19,3507,0.0,30,28,1,0,2,93.33333333
2014020957,4,3600,0.0,29,28,1,1,1,96.55172414
2014020958,30,3600,0.0,25,24,0,1,1,96.0
2014020958,15,3506,0.0,30,28,1,0,2,93.33333333
2014020959,10,3478,0.0,31,27,1,0,4,87.09677419
2014020959,14,3600,0.0,27,25,4,0,2,92.59259259
2014020960,25,1952,0.0,10,10,4,0,0,100.0
2014020960,25,1948,0.0,14,11,0,0,3,78.57142857
2014020960,13,3900,0.0,32,29,4,1,3,90.625
2014020961,2,3600,0.0,31,28,0,0,3,90.32258065
2014020961,18,3445,0.0,26,22,2,0,4,84.61538462
2014020962,23,3869,0.0,35,33,0,2,2,94.28571429
2014020962,53,3900,0.0,34,32,7,0,2,94.11764706
2014020963,8,3881,0.0,29,26,4,1,3,89.65517241
2014020963,26,3863,0.0,18,15,3,0,3,83.33333333
2014020964,29,3561,0.0,23,21,3,0,2,91.30434783
2014020964,1,3548,0.0,24,21,2,2,3,87.5
2014020965,30,3600,0.0,38,37,5,0,1,97.36842105
2014020965,12,3584,0.0,19,16,0,1,3,84.21052632
2014020966,7,3527,0.0,37,34,2,0,3,91.89189189
2014020966,9,3600,0.0,26,24,0,0,2,92.30769231
2014020967,20,3600,0.0,35,33,1,1,2,94.28571429
2014020967,17,3436,0.0,23,19,2,1,4,82.60869565
2014020968,22,3900,0.0,39,38,1,0,1,97.43589744
2014020968,16,3893,0.0,47,46,0,2,1,97.87234043
2014020969,5,3593,0.0,29,27,4,2,2,93.10344828
2014020969,24,3521,0.0,20,16,2,3,4,80.0
2014020970,4,3832,0.0,37,34,7,1,3,91.89189189
2014020970,6,3715,0.0,31,29,0,0,2,93.5483871
2014020971,19,3598,0.0,24,23,6,1,1,95.83333333
2014020971,10,2400,0.0,27,24,7,1,3,88.88888889
2014020971,10,1200,0.0,17,14,3,0,3,82.35294118
2014020972,25,3521,0.0,27,23,2,0,4,85.18518519
2014020972,14,3600,0.0,35,31,3,3,4,88.57142857
2014020973,2,3898,0.0,18,15,2,0,3,83.33333333
2014020973,13,3895,0.0,28,25,2,0,3,89.28571429
2014020974,7,1567,0.0,22,20,3,0,2,90.90909091
2014020974,7,2033,0.0,23,19,2,0,4,82.60869565
2014020974,15,3600,0.0,17,16,1,1,1,94.11764706
2014020975,21,3591,0.0,44,44,4,1,0,100.0
2014020975,29,1200,0.0,12,9,3,0,3,75.0
2014020975,29,2400,0.0,21,20,9,0,1,95.23809524
2014020976,52,3600,0.0,21,20,0,0,1,95.23809524
2014020976,18,3497,0.0,25,23,2,0,2,92.0
2014020977,8,3600,0.0,28,28,1,1,0,100.0
2014020977,53,3517,0.0,34,33,1,1,1,97.05882353
2014020978,5,3704,0.0,31,31,5,1,0,100.0
2014020978,26,3704,0.0,18,17,4,0,1,94.44444444
2014020979,23,3600,0.0,40,38,5,0,2,95.0
2014020979,28,3486,0.0,34,31,7,0,3,91.17647059
2014020980,22,3534,0.0,34,28,6,1,6,82.35294118
2014020980,12,3600,0.0,20,16,4,1,4,80.0
2014020981,4,3598,0.0,21,16,2,1,5,76.19047619
2014020981,1,3600,0.0,27,25,4,0,2,92.59259259
2014020982,21,344,0.0,4,3,0,0,1,75.0
2014020982,21,3256,0.0,30,29,7,0,1,96.66666667
2014020982,30,3428,0.0,21,18,5,2,3,85.71428571
2014020983,20,2263,0.0,19,19,1,0,0,100.0
2014020983,20,1616,0.0,23,19,3,1,4,82.60869565
2014020983,9,3900,0.0,46,42,9,2,4,91.30434783
2014020984,17,1074,0.0,7,6,3,0,1,85.71428571
2014020984,17,2379,0.0,23,19,6,0,4,82.60869565
2014020984,6,3600,0.0,39,36,8,1,3,92.30769231
2014020985,3,3632,0.0,29,29,3,0,0,100.0
2014020985,16,3632,0.0,36,35,3,0,1,97.22222222
2014020986,2,3860,0.0,25,22,5,0,3,88.0
2014020986,10,3878,0.0,43,39,5,0,4,90.69767442
2014020987,22,3499,0.0,24,21,2,1,3,87.5
2014020987,17,3598,0.0,38,36,9,0,2,94.73684211
2014020988,24,3510,0.0,16,14,1,0,2,87.5
2014020988,23,3588,0.0,30,29,4,0,1,96.66666667
2014020989,18,3743,0.0,28,27,3,0,1,96.42857143
2014020989,53,3765,0.0,40,38,7,1,2,95.0
2014020990,5,3900,0.0,30,29,2,3,1,96.66666667
2014020990,28,3900,0.0,40,39,4,1,1,97.5
2014020991,3,3600,0.0,30,29,2,0,1,96.66666667
2014020991,2,3523,0.0,22,20,1,3,2,90.90909091
2014020992,25,3589,0.0,26,25,4,2,1,96.15384615
2014020992,4,3477,0.0,39,37,6,1,2,94.87179487
2014020993,29,3888,0.0,32,29,2,3,3,90.625
2014020993,12,3900,0.0,32,29,6,1,3,90.625
2014020994,14,3663,0.0,19,19,1,0,0,100.0
2014020994,8,3663,0.0,36,35,5,0,1,97.22222222
2014020995,6,3600,0.0,40,39,6,1,1,97.5
2014020995,9,3484,0.0,22,19,2,2,3,86.36363636
2014020996,52,1677,0.0,20,19,10,0,1,95.0
2014020996,52,1869,0.0,7,3,1,0,4,42.85714286
2014020996,19,3600,0.0,16,12,5,0,4,75.0
2014020997,1,2490,0.0,30,25,3,0,5,83.33333333
2014020997,1,1110,0.0,8,7,0,0,1,87.5
2014020997,30,3592,0.0,32,30,0,1,2,93.75
2014020998,26,3600,0.0,23,21,1,0,2,91.30434783
2014020998,21,855,0.0,8,5,1,0,3,62.5
2014020998,21,2593,0.0,22,20,3,3,2,90.90909091
2014020999,7,3896,0.0,34,31,8,1,3,91.17647059
2014020999,10,3900,0.0,33,30,1,1,3,90.90909091
2014021000,3,3600,0.0,29,28,2,1,1,96.55172414
2014021000,15,3467,0.0,31,28,3,5,3,90.32258065
2014021001,24,3574,0.0,23,17,2,1,6,73.91304348
2014021001,20,3600,0.0,32,29,0,1,3,90.625
2014021002,14,3900,0.0,30,28,6,0,2,93.33333333
2014021002,6,3898,0.0,37,35,3,1,2,94.59459459
2014021003,22,2328,0.0,21,19,2,0,2,90.47619048
2014021003,22,1261,0.0,13,9,2,0,4,69.23076923
2014021003,5,3600,0.0,29,25,3,0,4,86.20689655
2014021004,25,3600,0.0,18,15,0,0,3,83.33333333
2014021004,12,3535,0.0,31,27,2,0,4,87.09677419
2014021005,9,3600,0.0,29,27,9,0,2,93.10344828
2014021005,8,3600,0.0,28,23,4,1,5,82.14285714
2014021006,29,3600,0.0,42,41,7,0,1,97.61904762
2014021006,17,3423,0.0,26,23,2,1,3,88.46153846
2014021007,52,3481,0.0,19,16,1,0,3,84.21052632
2014021007,13,3597,0.0,20,18,1,1,2,90.0
2014021008,4,3900,0.0,35,35,7,0,0,100.0
2014021008,19,3900,0.0,28,28,6,1,0,100.0
2014021009,1,3900,0.0,29,28,5,0,1,96.55172414
2014021009,21,3891,0.0,24,23,1,1,1,95.83333333
2014021010,26,3600,0.0,19,19,0,0,0,100.0
2014021010,23,3588,0.0,19,16,0,0,3,84.21052632
2014021011,16,3600,0.0,18,17,0,0,1,94.44444444
2014021011,53,3527,2.0,44,42,15,0,2,95.45454545
2014021012,18,3569,2.0,20,19,5,1,1,95.0
2014021012,28,3598,0.0,35,35,4,3,0,100.0
2014021013,9,3600,0.0,35,34,9,0,1,97.14285714
2014021013,2,3531,0.0,28,26,2,1,2,92.85714286
2014021014,25,3600,0.0,20,18,7,0,2,90.0
2014021014,15,2034,0.0,22,18,2,1,4,81.81818182
2014021014,15,1436,0.0,9,9,3,0,0,100.0
2014021015,22,3881,0.0,31,27,5,1,4,87.09677419
2014021015,29,3900,0.0,35,31,3,0,4,88.57142857
2014021016,24,3600,0.0,33,32,8,1,1,96.96969697
2014021016,30,3505,0.0,24,22,7,3,2,91.66666667
2014021017,10,3600,0.0,28,22,1,2,6,78.57142857
2014021017,20,3600,0.0,28,25,7,0,3,89.28571429
2014021018,17,3600,0.0,36,29,4,1,7,80.55555556
2014021018,4,3594,0.0,33,31,6,1,2,93.93939394
2014021019,6,3600,0.0,30,30,5,1,0,100.0
2014021019,5,3543,0.0,29,28,5,2,1,96.55172414
2014021020,16,3518,0.0,35,33,5,0,2,94.28571429
2014021020,28,3507,0.0,29,24,2,2,5,82.75862069
2014021021,3,3548,0.0,20,20,3,2,0,100.0
2014021021,7,3571,0.0,32,31,4,2,1,96.875
2014021022,52,3600,0.0,16,15,1,2,1,93.75
2014021022,14,3522,0.0,29,27,5,0,2,93.10344828
2014021023,8,3598,0.0,36,35,9,3,1,97.22222222
2014021023,2,3487,0.0,29,27,4,2,2,93.10344828
2014021024,13,3585,0.0,27,27,3,0,0,100.0
2014021024,12,3448,0.0,21,20,1,0,1,95.23809524
2014021025,10,3561,0.0,34,31,2,2,3,91.17647059
2014021025,23,3596,0.0,29,28,8,2,1,96.55172414
2014021026,30,3600,0.0,42,41,3,0,1,97.61904762
2014021026,19,3490,0.0,19,16,3,1,3,84.21052632
2014021027,1,3600,0.0,31,30,2,4,1,96.77419355
2014021027,53,3600,0.0,29,25,3,1,4,86.20689655
2014021028,20,3513,0.0,26,23,0,1,3,88.46153846
2014021028,21,3600,0.0,31,29,4,0,2,93.5483871
2014021029,18,3600,0.0,24,23,0,0,1,95.83333333
2014021029,26,3531,0.0,23,21,2,0,2,91.30434783
2014021030,13,3466,0.0,34,32,4,0,2,94.11764706
2014021030,3,3600,0.0,39,38,5,0,1,97.43589744
2014021031,12,3593,0.0,24,22,2,0,2,91.66666667
2014021031,29,3515,0.0,27,24,5,0,3,88.88888889
2014021032,19,3600,0.0,28,28,7,1,0,100.0
2014021032,25,3574,0.0,20,18,0,2,2,90.0
2014021033,4,3900,0.0,28,27,5,1,1,96.42857143
2014021033,9,3882,0.0,28,27,6,0,1,96.42857143
2014021034,17,3600,0.0,43,42,15,0,1,97.6744186
2014021034,5,1888,0.0,9,8,4,0,1,88.88888889
2014021034,5,1664,0.0,16,12,5,0,4,75.0
2014021035,6,3476,0.0,38,36,1,3,2,94.73684211
2014021035,15,3600,0.0,32,32,4,0,0,100.0
2014021036,18,3441,0.0,28,24,11,0,4,85.71428571
2014021036,24,3600,0.0,27,25,3,0,2,92.59259259
2014021037,15,3900,0.0,33,30,6,0,3,90.90909091
2014021037,7,3885,0.0,38,35,3,1,3,92.10526316
2014021038,8,3588,0.0,33,30,3,1,3,90.90909091
2014021038,14,3600,0.0,34,32,5,0,2,94.11764706
2014021039,10,3112,0.0,28,27,6,0,1,96.42857143
2014021039,10,488,0.0,4,1,1,0,3,25.0
2014021039,22,3596,0.0,29,28,7,0,1,96.55172414
2014021040,53,3519,0.0,35,34,7,1,1,97.14285714
2014021040,26,3594,0.0,25,25,5,0,0,100.0
2014021041,7,3854,0.0,45,44,4,0,1,97.77777778
2014021041,6,3878,0.0,24,23,4,0,1,95.83333333
2014021042,5,3545,0.0,18,17,1,0,1,94.44444444
2014021042,1,3600,0.0,35,35,0,1,0,100.0
2014021043,9,3886,0.0,36,35,4,0,1,97.22222222
2014021043,12,3886,0.0,33,31,4,0,2,93.93939394
2014021044,8,3600,0.0,43,41,7,1,2,95.34883721
2014021044,13,3548,0.0,25,22,1,1,3,88.0
2014021045,30,3622,0.0,27,25,9,0,2,92.59259259
2014021045,18,3622,0.0,21,18,0,0,3,85.71428571
2014021046,28,2819,0.0,14,12,1,0,2,85.71428571
2014021046,28,781,0.0,8,5,1,0,3,62.5
2014021046,52,3600,0.0,40,38,4,1,2,95.0
2014021047,2,3589,0.0,30,26,1,1,4,86.66666667
2014021047,16,3600,0.0,39,38,3,1,1,97.43589744
2014021048,19,3600,0.0,25,25,0,0,0,100.0
2014021048,20,3436,0.0,25,22,1,0,3,88.0
2014021049,4,3448,0.0,34,31,4,0,3,91.17647059
2014021049,23,3600,0.0,28,27,4,1,1,96.42857143
2014021050,16,3600,0.0,25,25,5,0,0,100.0
2014021050,3,3539,0.0,31,30,3,1,1,96.77419355
2014021051,29,3899,0.0,47,44,12,0,3,93.61702128
2014021051,22,3900,0.0,20,17,2,1,3,85.0
2014021052,26,3641,0.0,26,23,6,1,3,88.46153846
2014021052,24,3624,0.0,31,29,1,0,2,93.5483871
2014021053,28,3552,0.0,28,27,3,3,1,96.42857143
2014021053,10,3600,0.0,42,38,9,2,4,90.47619048
2014021054,12,3600,0.0,22,18,1,0,4,81.81818182
2014021054,8,3597,0.0,31,31,4,3,0,100.0
2014021055,6,3513,0.0,31,26,4,0,5,83.87096774
2014021055,9,3590,0.0,35,31,7,1,4,88.57142857
2014021056,17,3499,0.0,32,29,7,0,3,90.625
2014021056,13,3600,0.0,27,26,2,1,1,96.2962963
2014021057,15,3599,0.0,30,28,6,1,2,93.33333333
2014021057,30,3519,0.0,27,24,4,0,3,88.88888889
2014021058,19,3900,0.0,34,33,4,1,1,97.05882353
2014021058,52,3900,0.0,33,32,6,1,1,96.96969697
2014021059,5,3514,0.0,26,24,5,0,2,92.30769231
2014021059,25,3600,0.0,32,31,6,1,1,96.875
2014021060,4,2277,0.0,16,14,0,0,2,87.5
2014021060,4,1323,2.0,10,8,2,0,2,80.0
2014021060,20,3600,0.0,27,26,7,1,1,96.2962963
2014021061,29,3600,0.0,40,38,3,0,2,95.0
2014021061,23,2968,0.0,30,25,0,2,5,83.33333333
2014021061,23,593,0.0,2,2,0,0,0,100.0
2014021062,21,3600,0.0,30,28,1,0,2,93.33333333
2014021062,53,3498,0.0,28,24,3,0,4,85.71428571
2014021063,1,3600,0.0,29,28,4,0,1,96.55172414
2014021063,7,3600,0.0,27,24,5,0,3,88.88888889
2014021064,17,3494,0.0,31,29,5,1,2,93.5483871
2014021064,14,3598,0.0,31,30,8,0,1,96.77419355
2014021065,21,3685,0.0,40,37,3,0,3,92.5
2014021065,24,3660,0.0,24,22,0,3,2,91.66666667
2014021066,19,1445,0.0,16,12,1,0,4,75.0
2014021066,19,2155,0.0,12,10,3,1,2,83.33333333
2014021066,30,3600,0.0,29,26,3,0,3,89.65517241
2014021067,29,3841,0.0,40,38,8,0,2,95.0
2014021067,20,3841,0.0,26,23,0,1,3,88.46153846
2014021068,23,3600,0.0,26,25,3,3,1,96.15384615
2014021068,26,3528,2.0,40,38,6,1,2,95.0
2014021069,28,3478,0.0,28,27,0,2,1,96.42857143
2014021069,8,3600,0.0,29,29,5,0,0,100.0
2014021070,10,1389,0.0,18,15,6,0,3,83.33333333
2014021070,10,2185,0.0,22,21,7,0,1,95.45454545
2014021070,9,3598,0.0,25,22,3,0,3,88.0
2014021071,6,3900,0.0,25,24,2,0,1,96.0
2014021071,13,3898,0.0,27,26,4,0,1,96.2962963
2014021072,2,3600,0.0,26,26,0,0,0,100.0
2014021072,1,3466,0.0,29,27,4,0,2,93.10344828
2014021073,3,3900,0.0,30,28,2,0,2,93.33333333
2014021073,12,3900,0.0,29,27,3,0,2,93.10344828
2014021074,15,3573,0.0,23,21,6,0,2,91.30434783
2014021074,52,3593,0.0,28,28,3,3,0,100.0
2014021075,7,3593,0.0,43,40,0,2,3,93.02325581
2014021075,18,3600,0.0,24,24,2,0,0,100.0
2014021076,16,3597,0.0,29,25,6,0,4,86.20689655
2014021076,25,3600,0.0,33,33,3,0,0,100.0
2014021077,5,3508,0.0,31,30,4,2,1,96.77419355
2014021077,53,3552,0.0,36,34,2,0,2,94.44444444
2014021078,4,3766,0.0,34,29,4,2,5,85.29411765
2014021078,22,3766,2.0,31,27,2,1,4,87.09677419
2014021079,19,3600,0.0,25,23,8,0,2,92.0
2014021079,17,3618,0.0,24,23,3,1,1,95.83333333
2014021080,6,1670,0.0,12,8,0,0,4,66.66666667
2014021080,6,1889,0.0,7,6,1,0,1,85.71428571
2014021080,14,3600,0.0,28,25,2,0,3,89.28571429
2014021081,24,616,0.0,7,4,2,0,3,57.14285714
2014021081,24,2984,0.0,22,18,1,0,4,81.81818182
2014021081,3,3600,0.0,38,36,4,0,2,94.73684211
2014021082,23,3600,0.0,27,26,0,0,1,96.2962963
2014021082,53,3525,0.0,43,41,5,0,2,95.34883721
2014021083,26,3595,0.0,20,19,3,0,1,95.0
2014021083,1,3477,0.0,33,30,5,0,3,90.90909091
2014021084,16,3600,0.0,44,43,1,0,1,97.72727273
2014021084,12,3548,0.0,24,22,0,0,2,91.66666667
2014021085,30,3592,0.0,36,35,3,2,1,97.22222222
2014021085,10,3522,0.0,32,30,3,0,2,93.75
2014021086,28,3538,0.0,36,32,2,0,4,88.88888889
2014021086,9,3600,0.0,31,29,2,0,2,93.5483871
2014021087,7,3520,0.0,39,35,6,1,4,89.74358974
2014021087,25,3600,0.0,28,25,4,0,3,89.28571429
2014021088,21,3484,0.0,26,23,1,1,3,88.46153846
2014021088,20,3600,0.0,27,25,2,0,2,92.59259259
2014021089,52,3600,0.0,34,33,4,2,1,97.05882353
2014021089,22,3600,0.0,24,20,2,1,4,83.33333333
2014021090,30,3900,0.0,38,37,1,0,1,97.36842105
2014021090,2,3900,0.0,32,31,2,0,1,96.875
2014021091,26,3590,0.0,36,34,0,0,2,94.44444444
2014021091,3,3425,0.0,35,31,1,0,4,88.57142857
2014021092,19,3635,0.0,26,24,2,0,2,92.30769231
2014021092,5,3634,0.0,35,32,0,1,3,91.42857143
2014021093,24,3550,0.0,26,22,0,3,4,84.61538462
2014021093,29,3600,0.0,40,37,9,0,3,92.5
2014021094,53,3788,0.0,37,33,8,0,4,89.18918919
2014021094,17,3788,0.0,22,17,2,0,5,77.27272727
2014021095,13,3517,0.0,25,21,0,1,4,84.0
2014021095,14,3600,0.0,36,33,5,0,3,91.66666667
2014021096,8,3714,0.0,31,28,5,0,3,90.32258065
2014021096,18,3714,0.0,29,27,1,0,2,93.10344828
2014021097,52,3543,0.0,28,25,3,0,3,89.28571429
2014021097,23,3600,0.0,28,26,3,0,2,92.85714286
2014021098,16,3600,0.0,33,29,3,0,4,87.87878788
2014021098,4,3600,0.0,35,34,0,0,1,97.14285714
2014021099,21,2948,0.0,27,26,3,0,1,96.2962963
2014021099,21,576,0.0,7,4,0,0,3,57.14285714
2014021099,22,3600,0.0,44,41,8,0,3,93.18181818
2014021100,25,3898,0.0,34,31,10,2,3,91.17647059
2014021100,20,3866,0.0,30,27,10,1,3,90.0
2014021101,24,3758,0.0,29,27,5,1,2,93.10344828
2014021101,6,3785,0.0,32,29,0,2,3,90.625
2014021102,53,3654,0.0,35,32,6,2,3,91.42857143
2014021102,7,3607,0.0,42,38,12,0,4,90.47619048
2014021103,26,3600,0.0,27,25,2,2,2,92.59259259
2014021103,2,3520,0.0,37,34,2,1,3,91.89189189
2014021104,1,3625,0.0,24,21,4,0,3,87.5
2014021104,15,3673,0.0,31,29,3,3,2,93.5483871
2014021105,5,3599,0.0,28,23,9,1,5,82.14285714
2014021105,12,3600,0.0,29,27,5,0,2,93.10344828
2014021106,13,3600,0.0,25,24,2,1,1,96.0
2014021106,10,2074,0.0,16,13,0,1,3,81.25
2014021106,10,1515,0.0,11,11,1,0,0,100.0
2014021107,3,3600,0.0,24,23,5,0,1,95.83333333
2014021107,9,1372,0.0,10,10,0,2,0,100.0
2014021107,9,2225,0.0,22,17,0,1,5,77.27272727
2014021108,28,3600,0.0,34,30,5,0,4,88.23529412
2014021108,17,2339,0.0,19,17,2,1,2,89.47368421
2014021108,17,1200,0.0,10,7,0,1,3,70.0
2014021109,18,3600,0.0,30,28,3,2,2,93.33333333
2014021109,14,1614,0.0,11,8,0,0,3,72.72727273
2014021109,14,1901,0.0,8,8,4,0,0,100.0
2014021110,8,3600,0.0,22,17,0,0,5,77.27272727
2014021110,52,3594,0.0,41,39,7,2,2,95.12195122
2014021111,21,3600,0.0,34,33,8,3,1,97.05882353
2014021111,23,3530,0.0,37,34,8,1,3,91.89189189
2014021112,20,404,0.0,1,1,0,0,0,100.0
2014021112,20,3106,0.0,35,31,2,0,4,88.57142857
2014021112,30,3600,0.0,25,23,0,1,2,92.0
2014021113,29,3600,0.0,33,31,7,0,2,93.93939394
2014021113,16,946,0.0,13,9,0,0,4,69.23076923
2014021113,16,2559,0.0,13,13,2,1,0,100.0
2014021114,25,3600,0.0,28,24,0,0,4,85.71428571
2014021114,22,3600,0.0,29,29,5,0,0,100.0
2014021115,18,3600,0.0,28,25,4,0,3,89.28571429
2014021115,15,887,0.0,13,10,0,1,3,76.92307692
2014021115,15,2610,0.0,14,13,1,1,1,92.85714286
2014021116,3,3600,0.0,30,26,3,0,4,86.66666667
2014021116,6,1210,0.0,14,14,0,0,0,100.0
2014021116,6,2390,0.0,18,16,0,0,2,88.88888889
2014021117,24,3600,0.0,31,29,4,0,2,93.5483871
2014021117,2,3523,0.0,24,21,0,0,3,87.5
2014021118,28,3895,0.0,18,16,3,0,2,88.88888889
2014021118,4,3881,0.0,44,42,4,1,2,95.45454545
2014021119,53,3479,0.0,46,43,11,0,3,93.47826087
2014021119,5,3590,0.0,24,22,5,0,2,91.66666667
2014021120,14,3554,0.0,22,19,4,0,3,86.36363636
2014021120,17,3596,0.0,23,23,3,0,0,100.0
2014021121,9,3797,0.0,31,27,1,0,4,87.09677419
2014021121,10,3734,0.0,25,22,0,1,3,88.0
2014021122,13,3779,0.0,25,22,4,0,3,88.0
2014021122,8,3743,0.0,23,21,1,0,2,91.30434783
2014021123,1,3496,0.0,32,29,2,0,3,90.625
2014021123,12,3600,0.0,22,21,0,1,1,95.45454545
2014021124,29,3600,2.0,31,29,8,1,2,93.5483871
2014021124,19,3509,0.0,16,13,2,0,3,81.25
2014021125,26,2367,0.0,10,9,1,1,1,90.0
2014021125,26,1200,0.0,9,7,0,0,2,77.77777778
2014021125,30,3600,0.0,32,31,7,1,1,96.875
2014021126,7,1189,0.0,12,10,0,0,2,83.33333333
2014021126,7,2267,0.0,10,7,1,0,3,70.0
2014021126,21,3600,0.0,38,35,6,2,3,92.10526316
2014021127,25,3853,0.0,36,33,5,0,3,91.66666667
2014021127,23,3833,0.0,40,36,0,0,4,90.0
2014021128,15,3600,0.0,25,23,4,1,2,92.0
2014021128,3,3593,0.0,30,26,3,0,4,86.66666667
2014021129,13,3600,0.0,27,25,4,1,2,92.59259259
2014021129,9,3551,0.0,36,33,4,1,3,91.66666667
2014021130,17,1199,0.0,11,7,1,0,4,63.63636364
2014021130,17,2303,0.0,16,15,1,2,1,93.75
2014021130,2,3600,0.0,25,21,4,0,4,84.0
2014021131,6,3863,0.0,31,30,4,0,1,96.77419355
2014021131,12,3860,0.0,30,28,3,0,2,93.33333333
2014021132,20,3600,0.0,29,27,2,0,2,93.10344828
2014021132,18,3427,0.0,29,25,5,0,4,86.20689655
2014021133,24,3600,0.0,27,26,2,0,1,96.2962963
2014021133,1,3502,0.0,25,23,2,1,2,92.0
2014021134,28,3890,0.0,33,31,1,2,2,93.93939394
2014021134,5,3890,0.0,32,30,5,0,2,93.75
2014021135,16,3600,0.0,34,31,9,2,3,91.17647059
2014021135,52,3597,0.0,24,20,3,0,4,83.33333333
2014021136,14,3598,2.0,28,25,9,0,3,89.28571429
2014021136,8,3508,0.0,43,39,9,1,4,90.69767442
2014021137,23,3600,0.0,24,23,1,0,1,95.83333333
2014021137,19,3586,0.0,21,18,0,1,3,85.71428571
2014021138,26,3600,0.0,40,36,6,0,4,90.0
2014021138,16,3600,0.0,32,31,2,1,1,96.875
2014021139,20,3597,0.0,36,33,3,0,3,91.66666667
2014021139,25,1340,0.0,5,5,2,0,0,100.0
2014021139,25,2174,0.0,19,15,2,0,4,78.94736842
2014021140,22,3600,0.0,30,29,1,0,1,96.66666667
2014021140,21,3555,0.0,34,32,0,0,2,94.11764706
2014021141,7,3600,0.0,29,28,3,0,1,96.55172414
2014021141,53,3528,0.0,34,32,1,0,2,94.11764706
2014021142,13,3540,0.0,29,26,3,0,3,89.65517241
2014021142,6,3600,0.0,24,22,2,2,2,91.66666667
2014021143,12,3600,0.0,20,16,0,0,4,80.0
2014021143,15,3600,0.0,25,23,2,0,2,92.0
2014021144,1,3637,0.0,31,28,3,2,3,90.32258065
2014021144,29,3617,0.0,26,24,3,4,2,92.30769231
2014021145,14,3390,0.0,28,25,2,0,3,89.28571429
2014021145,10,3600,0.0,41,40,4,2,1,97.56097561
2014021146,9,3892,0.0,17,16,0,1,1,94.11764706
2014021146,17,3900,0.0,34,33,10,0,1,97.05882353
2014021147,23,3900,0.0,38,34,17,1,4,89.47368421
2014021147,18,3891,0.0,25,21,2,1,4,84.0
2014021148,3,3600,0.0,34,32,0,1,2,94.11764706
2014021148,52,3560,0.0,24,21,4,0,3,87.5
2014021149,10,3474,0.0,31,27,9,1,4,87.09677419
2014021149,7,3590,2.0,27,24,6,2,3,88.88888889
2014021150,4,3600,0.0,25,24,1,2,1,96.0
2014021150,5,3575,0.0,31,27,6,0,4,87.09677419
2014021151,22,3598,0.0,27,22,2,0,5,81.48148148
2014021151,24,3600,0.0,23,22,0,0,1,95.65217391
2014021152,21,3529,0.0,28,25,1,0,3,89.28571429
2014021152,28,3600,0.0,20,19,0,1,1,95.0
2014021153,2,3900,0.0,39,36,7,0,3,92.30769231
2014021153,29,3900,0.0,28,25,5,0,3,89.28571429
2014021154,15,3900,0.0,27,23,4,0,4,85.18518519
2014021154,8,3890,2.0,19,15,2,0,4,78.94736842
2014021155,14,3883,0.0,34,32,6,1,2,94.11764706
2014021155,9,3883,0.0,29,28,2,1,1,96.55172414
2014021156,6,3600,0.0,37,35,7,1,2,94.59459459
2014021156,17,3508,0.0,25,22,7,2,3,88.0
2014021157,12,3600,0.0,35,29,0,0,6,82.85714286
2014021157,13,3598,0.0,32,31,4,0,1,96.875
2014021158,20,3566,0.0,42,39,5,1,3,92.85714286
2014021158,19,3600,0.0,18,17,4,1,1,94.44444444
2014021159,3,3600,0.0,28,26,4,1,2,92.85714286
2014021159,30,3486,0.0,26,23,5,0,3,88.46153846
2014021160,23,3480,0.0,38,35,5,1,3,92.10526316
2014021160,16,3600,0.0,36,35,5,1,1,97.22222222
2014021161,22,2400,0.0,21,16,1,1,5,76.19047619
2014021161,22,1200,0.0,12,9,0,0,3,75.0
2014021161,26,3595,0.0,30,28,3,0,2,93.33333333
2014021162,16,3591,0.0,38,35,8,0,3,92.10526316
2014021162,7,3552,0.0,36,32,5,2,4,88.88888889
2014021163,8,3897,0.0,18,16,2,0,2,88.88888889
2014021163,1,3900,0.0,33,31,8,0,2,93.93939394
2014021164,19,3600,0.0,32,27,5,1,5,84.375
2014021164,25,335,0.0,1,1,0,1,0,100.0
2014021164,25,3132,0.0,19,13,2,1,6,68.42105263
2014021165,21,3570,0.0,37,35,7,2,2,94.59459459
2014021165,24,3523,0.0,22,19,3,0,3,86.36363636
2014021166,53,3492,0.0,37,34,6,0,3,91.89189189
2014021166,28,3600,0.0,21,20,0,0,1,95.23809524
2014021167,4,3900,0.0,26,24,4,0,2,92.30769231
2014021167,12,3882,0.0,23,21,5,0,2,91.30434783
2014021168,5,3542,0.0,34,30,6,0,4,88.23529412
2014021168,29,3600,0.0,36,33,7,1,3,91.66666667
2014021169,23,3464,0.0,36,31,4,0,5,86.11111111
2014021169,52,3600,0.0,30,26,4,1,4,86.66666667
2014021170,10,3900,0.0,50,49,7,1,1,98.0
2014021170,6,3900,0.0,28,27,1,3,1,96.42857143
2014021171,15,3794,2.0,28,24,4,0,4,85.71428571
2014021171,9,3785,0.0,32,29,1,0,3,90.625
2014021172,14,3600,0.0,34,34,4,0,0,100.0
2014021172,13,3581,0.0,22,18,0,1,4,81.81818182
2014021173,7,3600,0.0,36,33,1,1,3,91.66666667
2014021173,2,3600,0.0,21,21,5,0,0,100.0
2014021174,1,744,0.0,6,3,0,0,3,50.0
2014021174,1,2851,0.0,26,23,0,1,3,88.46153846
2014021174,3,3600,0.0,36,35,7,0,1,97.22222222
2014021175,17,3849,0.0,24,22,3,0,2,91.66666667
2014021175,30,3897,0.0,22,20,3,2,2,90.90909091
2014021176,25,3844,0.0,36,33,0,0,3,91.66666667
2014021176,18,3823,0.0,24,20,1,0,4,83.33333333
2014021177,28,3541,0.0,35,31,9,2,4,88.57142857
2014021177,53,3595,0.0,45,42,13,0,3,93.33333333
2014021178,20,3541,0.0,27,27,0,0,0,100.0
2014021178,20,58,0.0,0,0,0,0,0,
2014021178,22,3600,0.0,29,25,0,0,4,86.20689655
2014021179,21,3477,0.0,26,23,0,0,3,88.46153846
2014021179,26,3600,0.0,10,9,1,0,1,90.0
2014021180,15,3600,0.0,36,35,12,1,1,97.22222222
2014021180,17,3464,0.0,28,26,4,0,2,92.85714286
2014021181,8,3600,0.0,25,24,4,0,1,96.0
2014021181,13,3597,0.0,28,24,7,0,4,85.71428571
2014021182,9,3874,0.0,38,36,4,1,2,94.73684211
2014021182,10,3900,0.0,45,43,7,0,2,95.55555556
2014021183,5,3589,0.0,20,16,0,1,4,80.0
2014021183,4,3561,0.0,47,46,5,2,1,97.87234043
2014021184,19,3600,0.0,39,38,4,0,1,97.43589744
2014021184,16,3524,2.0,33,31,5,0,2,93.93939394
2014021185,12,3477,0.0,25,21,0,0,4,84.0
2014021185,7,3600,0.0,52,49,0,0,3,94.23076923
2014021186,29,3850,0.0,42,38,7,0,4,90.47619048
2014021186,3,3811,0.0,32,29,1,1,3,90.625
2014021187,52,3600,0.0,32,32,7,2,0,100.0
2014021187,30,3469,0.0,34,32,7,0,2,94.11764706
2014021188,26,3900,0.0,38,37,4,0,1,97.36842105
2014021188,23,3900,0.0,37,36,4,2,1,97.2972973
2014021189,25,3600,0.0,24,23,4,1,1,95.83333333
2014021189,28,3569,0.0,25,20,7,0,5,80.0
2014021190,3,3582,0.0,21,19,0,1,2,90.47619048
2014021190,1,3598,0.0,39,36,9,1,3,92.30769231
2014021191,2,3487,0.0,27,22,1,0,5,81.48148148
2014021191,4,3591,0.0,40,36,4,2,4,90.0
2014021192,5,3759,0.0,44,40,6,1,4,90.90909091
2014021192,9,3747,0.0,28,25,5,0,3,89.28571429
2014021193,12,3489,0.0,25,22,0,0,3,88.0
2014021193,17,3600,0.0,32,30,0,0,2,93.75
2014021194,8,2400,0.0,23,19,1,1,4,82.60869565
2014021194,8,1200,0.0,18,15,2,0,3,83.33333333
2014021194,14,3598,0.0,17,16,2,0,1,94.11764706
2014021195,52,3586,0.0,30,30,4,0,0,100.0
2014021195,19,3514,0.0,31,30,4,0,1,96.77419355
2014021196,30,3600,0.0,33,32,0,0,1,96.96969697
2014021196,16,3497,0.0,30,28,1,0,2,93.33333333
2014021197,18,3504,0.0,23,20,3,0,3,86.95652174
2014021197,21,3591,0.0,42,40,4,1,2,95.23809524
2014021198,53,3513,2.0,32,29,6,0,3,90.625
2014021198,20,3589,0.0,24,22,0,0,2,91.66666667
2014021199,26,3521,0.0,21,18,2,0,3,85.71428571
2014021199,22,3600,0.0,27,25,0,0,2,92.59259259
2014021200,10,1410,0.0,20,16,2,0,4,80.0
2014021200,10,2190,0.0,13,12,0,1,1,92.30769231
2014021200,29,3600,0.0,35,35,5,1,0,100.0
2014021201,6,3600,0.0,33,30,2,0,3,90.90909091
2014021201,15,3600,0.0,27,27,0,0,0,100.0
2014021202,25,3598,0.0,19,19,1,2,0,100.0
2014021202,24,3600,0.0,32,28,2,0,4,87.5
2014021203,9,3600,0.0,26,26,3,0,0,100.0
2014021203,3,3505,0.0,26,24,3,1,2,92.30769231
2014021204,12,3593,0.0,28,27,3,2,1,96.42857143
2014021204,4,3507,0.0,26,24,6,1,2,92.30769231
2014021205,17,3679,0.0,26,22,2,0,4,84.61538462
2014021205,8,3681,0.0,27,24,5,1,3,88.88888889
2014021206,1,3670,0.0,31,27,8,1,4,87.09677419
2014021206,14,3682,0.0,24,21,3,2,3,87.5
2014021207,6,3422,0.0,30,26,4,0,4,86.66666667
2014021207,13,3600,0.0,36,34,5,1,2,94.44444444
2014021208,16,3520,2.0,25,23,6,2,2,92.0
2014021208,19,3600,0.0,22,21,2,3,1,95.45454545
2014021209,30,3600,0.0,34,32,3,0,2,94.11764706
2014021209,18,3510,0.0,26,23,2,0,3,88.46153846
2014021210,52,3900,0.0,21,21,2,2,0,100.0
2014021210,21,3900,0.0,41,41,10,0,0,100.0
2014021211,26,3550,0.0,24,22,2,0,2,91.66666667
2014021211,20,3591,0.0,34,33,0,0,1,97.05882353
2014021212,28,3600,0.0,27,26,2,1,1,96.2962963
2014021212,22,3576,0.0,51,49,2,2,2,96.07843137
2014021213,53,2230,0.0,24,20,5,1,4,83.33333333
2014021213,53,1370,0.0,8,7,0,0,1,87.5
2014021213,23,3598,0.0,28,28,7,1,0,100.0
2014021214,2,3600,0.0,38,37,6,1,1,97.36842105
2014021214,5,3488,0.0,26,23,2,1,3,88.46153846
2014021215,7,3524,0.0,39,36,2,0,3,92.30769231
2014021215,29,3600,0.0,25,23,1,0,2,92.0
2014021216,9,3600,0.0,35,34,5,2,1,97.14285714
2014021216,4,3580,0.0,22,19,2,1,3,86.36363636
2014021217,3,3600,0.0,24,22,0,2,2,91.66666667
2014021217,15,3554,0.0,33,30,10,0,3,90.90909091
2014021218,20,3600,0.0,22,17,4,0,5,77.27272727
2014021218,52,3598,0.0,25,24,1,0,1,96.0
2014021219,28,3588,0.0,35,32,3,0,3,91.42857143
2014021219,26,3600,0.0,21,20,3,2,1,95.23809524
2014021220,5,3600,0.0,28,28,0,0,0,100.0
2014021220,7,3429,2.0,38,36,0,0,2,94.73684211
2014021221,8,3890,0.0,22,19,1,2,3,86.36363636
2014021221,10,3900,0.0,33,30,8,2,3,90.90909091
2014021222,1,3488,0.0,27,24,4,1,3,88.88888889
2014021222,13,3600,0.0,33,31,0,3,2,93.93939394
2014021223,29,3880,0.0,52,48,5,1,4,92.30769231
2014021223,2,3900,0.0,37,33,3,0,4,89.18918919
2014021224,17,3600,0.0,35,35,4,0,0,100.0
2014021224,12,3500,0.0,28,27,1,0,1,96.42857143
2014021225,6,3863,0.0,25,23,1,1,2,92.0
2014021225,14,3900,0.0,38,36,4,2,2,94.73684211
2014021226,30,2400,0.0,14,11,2,1,3,78.57142857
2014021226,30,1115,0.0,9,8,0,0,1,88.88888889
2014021226,19,3600,0.0,25,23,7,0,2,92.0
2014021227,18,3539,0.0,24,21,1,1,3,87.5
2014021227,25,3600,0.0,25,24,3,0,1,96.0
2014021228,16,3566,0.0,24,21,1,0,3,87.5
2014021228,21,3596,0.0,30,28,0,0,2,93.33333333
2014021229,24,3600,0.0,24,23,2,0,1,95.83333333
2014021229,53,3583,0.0,38,36,7,2,2,94.73684211
2014021230,22,3749,0.0,23,17,2,1,6,73.91304348
2014021230,23,3749,0.0,28,23,1,1,5,82.14285714
2014030111,9,3512,0.0,39,35,5,2,4,89.74358974
2014030111,8,3600,0.0,33,30,5,0,3,90.90909091
2014030112,9,3817,0.0,42,39,14,2,3,92.85714286
2014030112,8,3806,0.0,31,29,6,4,2,93.5483871
2014030113,8,4099,0.0,34,33,2,5,1,97.05882353
2014030113,9,4127,0.0,49,47,11,0,2,95.91836735
2014030114,8,3567,0.0,32,31,4,1,1,96.875
2014030114,9,3600,0.0,28,28,5,1,0,100.0
2014030115,9,3595,0.0,46,45,4,2,1,97.82608696
2014030115,8,3600,2.0,25,20,0,0,5,80.0
2014030116,8,3600,0.0,43,43,5,0,0,100.0
2014030116,9,3495,0.0,19,18,0,1,1,94.73684211
2014030121,17,3600,0.0,46,44,12,0,2,95.65217391
2014030121,14,3479,0.0,14,11,1,1,3,78.57142857
2014030122,17,2400,0.0,18,14,0,1,4,77.77777778
2014030122,17,1200,0.0,12,11,6,0,1,91.66666667
2014030122,14,3600,0.0,24,23,6,1,1,95.83333333
2014030123,14,3545,0.0,20,18,3,0,2,90.0
2014030123,17,3600,0.0,22,22,6,2,0,100.0
2014030124,14,3745,4.0,24,22,7,0,2,91.66666667
2014030124,17,3719,0.0,29,26,6,2,3,89.65517241
2014030125,17,3600,0.0,28,28,7,0,0,100.0
2014030125,14,3501,0.0,29,26,6,0,3,89.65517241
2014030126,14,3600,0.0,24,22,6,0,2,91.66666667
2014030126,17,3466,0.0,27,23,4,1,4,85.18518519
2014030127,17,3509,0.0,16,15,6,2,1,93.75
2014030127,14,3600,0.0,31,31,6,0,0,100.0
2014030131,5,3535,0.0,38,36,6,0,2,94.73684211
2014030131,3,3600,0.0,25,24,1,1,1,96.0
2014030132,5,3600,0.0,26,23,12,1,3,88.46153846
2014030132,3,3514,0.0,22,18,3,2,4,81.81818182
2014030133,3,3600,0.0,24,23,2,1,1,95.83333333
2014030133,5,3545,0.0,26,24,3,0,2,92.30769231
2014030134,3,3794,0.0,23,22,4,1,1,95.65217391
2014030134,5,3794,0.0,24,22,1,2,2,91.66666667
2014030135,5,4230,0.0,36,34,8,0,2,94.44444444
2014030135,3,4245,0.0,38,37,4,0,1,97.36842105
2014030141,2,3600,0.0,25,24,3,0,1,96.0
2014030141,15,3546,0.0,26,23,4,0,3,88.46153846
2014030142,2,3523,0.0,35,31,1,0,4,88.57142857
2014030142,15,3600,0.0,21,18,1,0,3,85.71428571
2014030143,15,3615,0.0,42,40,7,1,2,95.23809524
2014030143,2,3615,0.0,25,24,3,0,1,96.0
2014030144,15,4259,0.0,37,36,8,0,1,97.2972973
2014030144,2,4246,0.0,30,28,3,2,2,93.33333333
2014030145,2,2940,2.0,35,30,3,0,5,85.71428571
2014030145,2,660,0.0,6,6,3,0,0,100.0
2014030145,15,3595,0.0,23,22,2,1,1,95.65217391
2014030146,15,3502,0.0,37,35,0,0,2,94.59459459
2014030146,2,3600,0.0,39,38,7,0,1,97.43589744
2014030147,2,3540,0.0,26,24,0,0,2,92.30769231
2014030147,15,3600,0.0,11,10,0,0,1,90.90909091
2014030151,30,3600,0.0,21,19,3,0,2,90.47619048
2014030151,19,3559,0.0,27,25,5,1,2,92.59259259
2014030152,30,3554,0.0,26,23,4,0,3,88.46153846
2014030152,19,3600,0.0,25,24,1,1,1,96.0
2014030153,19,3535,0.0,23,21,3,0,2,91.30434783
2014030153,30,3598,0.0,17,17,0,2,0,100.0
2014030154,19,3600,0.0,18,17,0,0,1,94.44444444
2014030154,30,2210,0.0,17,11,0,0,6,64.70588235
2014030154,30,1390,0.0,9,9,1,0,0,100.0
2014030155,30,3600,0.0,37,36,6,0,1,97.2972973
2014030155,19,3491,0.0,19,15,0,0,4,78.94736842
2014030156,19,1571,0.0,7,6,0,0,1,85.71428571
2014030156,19,1879,0.0,13,11,1,0,2,84.61538462
2014030156,30,3600,0.0,31,30,3,0,1,96.77419355
2014030161,16,1200,0.0,12,9,3,0,3,75.0
2014030161,16,4064,0.0,42,42,7,1,0,100.0
2014030161,18,5269,0.0,42,38,4,0,4,90.47619048
2014030162,16,3600,0.0,35,29,4,0,6,82.85714286
2014030162,18,3600,0.0,26,24,2,0,2,92.30769231
2014030163,18,3488,0.0,30,26,0,1,4,86.66666667
2014030163,16,3600,0.0,37,35,3,1,2,94.59459459
2014030164,18,6037,0.0,48,45,2,1,3,93.75
2014030164,16,6059,0.0,52,50,1,0,2,96.15384615
2014030165,16,3467,0.0,28,24,2,2,4,85.71428571
2014030165,18,3600,0.0,30,28,6,3,2,93.33333333
2014030166,18,3485,0.0,32,28,0,0,4,87.5
2014030166,16,2924,0.0,13,13,3,0,0,100.0
2014030166,16,676,0.0,12,9,0,0,3,75.0
2014030171,52,3489,0.0,33,29,2,0,4,87.87878788
2014030171,24,3600,0.0,27,25,4,1,2,92.59259259
2014030172,52,3557,0.0,39,37,6,2,2,94.87179487
2014030172,24,3594,0.0,29,28,6,0,1,96.55172414
2014030173,24,3912,0.0,35,31,6,0,4,88.57142857
2014030173,52,3912,0.0,31,26,3,2,5,83.87096774
2014030174,24,3600,0.0,27,25,1,0,2,92.59259259
2014030174,52,3498,0.0,34,30,4,1,4,88.23529412
2014030181,20,3600,0.0,30,29,5,0,1,96.66666667
2014030181,23,3583,0.0,30,28,2,0,2,93.33333333
2014030182,20,3248,0.0,29,26,4,1,3,89.65517241
2014030182,20,298,0.0,2,2,1,0,0,100.0
2014030182,23,3561,0.0,23,22,2,1,1,95.65217391
2014030183,23,3552,0.0,28,24,5,0,4,85.71428571
2014030183,20,3600,0.0,25,23,5,1,2,92.0
2014030184,23,1200,0.0,7,4,1,0,3,57.14285714
2014030184,23,2271,0.0,15,15,1,1,0,100.0
2014030184,20,3599,0.0,29,28,0,1,1,96.55172414
2014030185,20,3507,0.0,43,41,5,1,2,95.34883721
2014030185,23,3592,0.0,21,20,1,0,1,95.23809524
2014030186,23,3507,0.0,31,26,4,1,5,83.87096774
2014030186,20,452,0.0,3,1,0,0,2,33.33333333
2014030186,20,3148,0.0,19,17,0,0,2,89.47368421
2014030211,14,4926,0.0,44,43,6,2,1,97.72727273
2014030211,8,4926,0.0,35,33,5,0,2,94.28571429
2014030212,14,3600,0.0,29,27,1,3,2,93.10344828
2014030212,8,3600,0.0,24,18,3,1,6,75.0
2014030213,8,3599,0.0,19,17,3,0,2,89.47368421
2014030213,14,3600,0.0,31,30,4,1,1,96.77419355
2014030214,8,3570,0.0,24,22,1,0,2,91.66666667
2014030214,14,1508,0.0,14,11,0,0,3,78.57142857
2014030214,14,2092,0.0,26,23,3,0,3,88.46153846
2014030215,14,3514,0.0,29,27,6,0,2,93.10344828
2014030215,8,3600,0.0,25,24,0,0,1,96.0
2014030216,8,3536,0.0,27,24,5,2,3,88.88888889
2014030216,14,3600,0.0,19,18,3,0,1,94.73684211
2014030221,15,3600,0.0,32,31,3,0,1,96.875
2014030221,3,3600,0.0,29,27,0,0,2,93.10344828
2014030222,15,3498,0.0,35,32,10,1,3,91.42857143
2014030222,3,3579,0.0,32,30,3,0,2,93.75
2014030223,3,3514,0.0,22,21,4,0,1,95.45454545
2014030223,15,3600,0.0,30,30,3,0,0,100.0
2014030224,3,3524,0.0,30,28,2,0,2,93.33333333
2014030224,15,3600,0.0,29,28,1,1,1,96.55172414
2014030225,15,4167,0.0,43,41,7,1,2,95.34883721
2014030225,3,4153,0.0,29,28,1,0,1,96.55172414
2014030226,3,3600,0.0,45,42,5,5,3,93.33333333
2014030226,15,3489,0.0,28,24,1,0,4,85.71428571
2014030227,15,4272,0.0,39,37,8,2,2,94.87179487
2014030227,3,4284,0.0,36,35,6,0,1,97.22222222
2014030231,30,3537,0.0,35,31,0,1,4,88.57142857
2014030231,16,3600,0.0,33,30,4,0,3,90.90909091
2014030232,30,3591,0.0,30,27,2,0,3,90.0
2014030232,16,3600,0.0,31,30,1,0,1,96.77419355
2014030233,16,3600,0.0,30,30,3,0,0,100.0
2014030233,30,3512,0.0,22,21,0,0,1,95.45454545
2014030234,16,3600,0.0,37,34,4,0,3,91.89189189
2014030234,30,3423,0.0,24,21,3,0,3,87.5
2014030241,20,1333,0.0,14,11,2,0,3,78.57142857
2014030241,20,2267,0.0,21,18,5,0,3,85.71428571
2014030241,24,3600,0.0,24,23,2,2,1,95.83333333
2014030242,20,3536,0.0,33,31,8,0,2,93.93939394
2014030242,24,3600,0.0,30,30,3,0,0,100.0
2014030243,24,3863,0.0,21,17,5,0,4,80.95238095
2014030243,20,3714,0.0,21,18,1,0,3,85.71428571
2014030244,24,3600,0.0,27,25,2,1,2,92.59259259
2014030244,20,3487,0.0,28,25,6,0,3,89.28571429
2014030245,20,3725,0.0,47,44,6,2,3,93.61702128
2014030245,24,3746,0.0,19,17,2,1,2,89.47368421
2014030311,14,3539,0.0,30,28,2,0,2,93.33333333
2014030311,3,3600,0.0,24,23,1,1,1,95.83333333
2014030312,14,3600,0.0,37,35,11,5,2,94.59459459
2014030312,3,3600,0.0,26,20,6,2,6,76.92307692
2014030313,3,3777,0.0,40,34,0,1,6,85.0
2014030313,14,3805,0.0,28,23,0,0,5,82.14285714
2014030314,3,3600,0.0,39,38,7,0,1,97.43589744
2014030314,14,3600,0.0,24,19,1,1,5,79.16666667
2014030315,14,3600,0.0,26,26,4,1,0,100.0
2014030315,3,3410,0.0,22,20,2,2,2,90.90909091
2014030316,3,3600,0.0,39,36,3,2,3,92.30769231
2014030316,14,2834,0.0,26,21,3,1,5,80.76923077
2014030316,14,607,0.0,7,6,2,1,1,85.71428571
2014030317,14,3600,0.0,22,22,2,0,0,100.0
2014030317,3,3376,0.0,25,23,0,0,2,92.0
2014030321,16,3534,0.0,26,23,2,1,3,88.46153846
2014030321,24,3600,0.0,33,32,5,1,1,96.96969697
2014030322,16,6972,0.0,62,60,6,1,2,96.77419355
2014030322,24,6972,0.0,56,53,4,0,3,94.64285714
2014030323,24,3600,0.0,28,27,1,0,1,96.42857143
2014030323,16,3480,0.0,27,25,0,0,2,92.59259259
2014030324,24,5137,0.0,40,35,6,0,5,87.5
2014030324,16,5130,0.0,51,47,6,0,4,92.15686275
2014030325,16,3568,0.0,28,23,4,0,5,82.14285714
2014030325,24,3644,0.0,28,24,2,0,4,85.71428571
2014030326,24,3507,0.0,22,18,3,0,4,81.81818182
2014030326,16,3600,0.0,32,30,5,1,2,93.75
2014030327,16,3600,0.0,38,35,2,0,3,92.10526316
2014030327,24,3405,0.0,26,21,3,0,5,80.76923077
2014030411,16,3600,0.0,23,22,2,0,1,95.65217391
2014030411,14,3518,0.0,21,19,2,0,2,90.47619048
2014030412,16,3476,0.0,24,20,0,1,4,83.33333333
2014030412,14,3033,0.0,24,21,1,1,3,87.5
2014030412,14,553,0.0,5,5,2,0,0,100.0
2014030413,14,3600,0.0,38,36,1,1,2,94.73684211
2014030413,16,3498,0.0,32,29,3,0,3,90.625
2014030414,14,3511,0.0,19,17,2,1,2,89.47368421
2014030414,16,3592,0.0,25,24,6,0,1,96.0
2014030415,16,3600,0.0,32,31,2,1,1,96.875
2014030415,14,3546,0.0,29,27,2,0,2,93.10344828
2014030416,14,3445,0.0,32,30,7,0,2,93.75
2014030416,16,3593,0.0,25,25,3,1,0,100.0
2015020001,8,3600,0.0,37,36,3,0,1,97.2972973
2015020001,10,3463,0.0,28,26,0,1,2,92.85714286
2015020002,3,3572,0.0,34,32,3,0,2,94.11764706
2015020002,16,3495,0.0,27,24,0,0,3,88.88888889
2015020003,23,3577,0.0,30,29,2,0,1,96.66666667
2015020003,20,3600,0.0,44,39,9,0,5,88.63636364
2015020004,28,3600,0.0,20,19,6,2,1,95.0
2015020004,26,3600,0.0,32,27,11,0,5,84.375
2015020005,52,3600,0.0,31,29,6,0,2,93.5483871
2015020005,6,3582,0.0,31,26,0,1,5,83.87096774
2015020006,9,3600,0.0,27,26,2,0,1,96.2962963
2015020006,7,1889,0.0,9,8,0,0,1,88.88888889
2015020006,7,1650,0.0,12,11,0,0,1,91.66666667
2015020007,4,3710,0.0,32,29,4,1,3,90.625
2015020007,14,3698,0.0,25,23,4,2,2,92.0
2015020008,22,3550,0.0,30,28,3,1,2,93.33333333
2015020008,19,3594,0.0,24,23,1,3,1,95.83333333
2015020009,12,3487,0.0,25,23,8,2,2,92.0
2015020009,18,3600,0.0,26,25,3,0,1,96.15384615
2015020010,5,3451,0.0,24,21,4,0,3,87.5
2015020010,25,3590,0.0,37,37,7,0,0,100.0
2015020011,30,3600,0.0,23,19,0,0,4,82.60869565
2015020011,21,3506,0.0,30,25,0,0,5,83.33333333
2015020012,52,3600,0.0,21,20,5,0,1,95.23809524
2015020012,1,3422,0.0,30,27,5,1,3,90.0
2015020013,3,3600,0.0,33,31,6,2,2,93.93939394
2015020013,29,3533,0.0,25,21,4,1,4,84.0
2015020014,10,2380,0.0,13,12,0,1,1,92.30769231
2015020014,10,1220,0.0,9,6,0,0,3,66.66666667
2015020014,17,3600,0.0,22,22,3,0,0,100.0
2015020015,16,3694,0.0,36,34,1,0,2,94.44444444
2015020015,2,3709,0.0,35,32,2,0,3,91.42857143
2015020016,53,3600,0.0,41,40,8,1,1,97.56097561
2015020016,26,3600,0.0,22,18,3,0,4,81.81818182
2015020017,14,3600,0.0,25,24,2,0,1,96.0
2015020017,7,3587,0.0,31,27,2,3,4,87.09677419
2015020018,8,3579,0.0,21,19,3,1,2,90.47619048
2015020018,6,3545,0.0,37,34,7,1,3,91.89189189
2015020019,9,3900,0.0,41,37,3,1,4,90.24390244
2015020019,10,3900,0.0,33,29,6,0,4,87.87878788
2015020020,4,3194,0.0,22,19,2,2,3,86.36363636
2015020020,4,406,0.0,8,4,0,0,4,50.0
2015020020,13,3600,0.0,39,38,7,4,1,97.43589744
2015020021,29,1200,0.0,7,6,1,0,1,85.71428571
2015020021,29,2356,0.0,22,18,0,3,4,81.81818182
2015020021,3,3600,0.0,39,37,7,0,2,94.87179487
2015020022,1,3450,0.0,26,22,11,0,4,84.61538462
2015020022,15,3548,0.0,24,21,2,1,3,87.5
2015020023,17,3600,0.0,47,44,11,0,3,93.61702128
2015020023,12,3505,0.0,19,15,0,0,4,78.94736842
2015020024,22,3475,0.0,26,24,2,2,2,92.30769231
2015020024,18,3600,0.0,31,31,5,0,0,100.0
2015020025,19,3522,0.0,19,16,1,0,3,84.21052632
2015020025,30,3595,0.0,32,30,6,0,2,93.75
2015020026,2,3590,0.0,34,30,10,0,4,88.23529412
2015020026,16,3578,0.0,29,28,1,3,1,96.55172414
2015020027,25,3600,2.0,28,22,3,3,6,78.57142857
2015020027,21,3600,0.0,33,30,6,1,3,90.90909091
2015020028,20,3783,0.0,30,28,5,0,2,93.33333333
2015020028,23,3783,0.0,38,35,4,1,3,92.10526316
2015020029,5,3540,0.0,39,37,11,4,2,94.87179487
2015020029,53,3600,0.0,28,27,6,0,1,96.42857143
2015020030,24,3547,0.0,44,42,2,1,2,95.45454545
2015020030,28,3600,0.0,27,27,3,0,0,100.0
2015020031,8,3600,0.0,21,20,6,1,1,95.23809524
2015020031,9,3482,0.0,34,31,3,1,3,91.17647059
2015020032,14,3600,0.0,30,27,2,0,3,90.0
2015020032,6,3549,0.0,23,17,2,0,6,73.91304348
2015020033,52,3527,0.0,43,40,12,2,3,93.02325581
2015020033,2,3592,0.0,24,22,5,1,2,91.66666667
2015020034,29,3385,0.0,33,29,9,0,4,87.87878788
2015020034,7,3597,0.0,24,22,5,0,2,91.66666667
2015020035,13,3531,0.0,33,32,7,2,1,96.96969697
2015020035,4,3600,0.0,31,31,5,0,0,100.0
2015020036,23,3900,0.0,29,28,3,2,1,96.55172414
2015020036,24,3900,0.0,25,24,2,1,1,96.0
2015020037,18,3600,0.0,23,22,3,0,1,95.65217391
2015020037,1,3479,0.0,18,17,3,0,1,94.44444444
2015020038,52,3598,0.0,41,40,8,1,1,97.56097561
2015020038,3,3567,0.0,28,25,3,0,3,89.28571429
2015020039,8,3600,0.0,33,31,1,0,2,93.93939394
2015020039,5,3550,0.0,30,27,0,1,3,90.0
2015020040,28,3594,0.0,31,31,4,5,0,100.0
2015020040,15,3347,0.0,30,27,7,1,3,90.0
2015020041,13,3600,0.0,23,22,6,1,1,95.65217391
2015020041,12,3505,0.0,29,26,2,0,3,89.65517241
2015020042,14,3492,0.0,23,21,3,0,2,91.30434783
2015020042,17,3595,0.0,21,20,2,1,1,95.23809524
2015020043,22,3568,0.0,51,48,11,0,3,94.11764706
2015020043,25,3556,0.0,28,26,3,1,2,92.85714286
2015020044,19,3600,0.0,18,15,2,0,3,83.33333333
2015020044,20,3485,0.0,28,24,0,1,4,85.71428571
2015020045,23,3600,0.0,15,15,2,1,0,100.0
2015020045,26,3505,0.0,25,23,5,2,2,92.0
2015020046,9,3589,0.0,41,38,14,0,3,92.68292683
2015020046,29,3545,0.0,26,20,4,0,6,76.92307692
2015020047,16,3600,0.0,29,26,4,1,3,89.65517241
2015020047,4,3600,0.0,30,30,8,2,0,100.0
2015020048,6,3600,0.0,22,20,2,3,2,90.90909091
2015020048,21,1342,0.0,5,5,1,0,0,100.0
2015020048,21,2132,0.0,19,14,0,0,5,73.68421053
2015020049,53,3600,0.0,37,37,6,2,0,100.0
2015020049,24,773,0.0,8,5,2,0,3,62.5
2015020049,24,2827,0.0,21,20,5,0,1,95.23809524
2015020050,18,3485,0.0,28,24,2,2,4,85.71428571
2015020050,2,3600,0.0,47,44,3,1,3,93.61702128
2015020051,9,3507,0.0,36,34,5,1,2,94.44444444
2015020051,5,3600,0.0,22,22,1,0,0,100.0
2015020052,16,3600,0.0,24,20,1,0,4,83.33333333
2015020052,15,3588,0.0,27,26,2,0,1,96.2962963
2015020053,3,3543,0.0,31,29,6,1,2,93.5483871
2015020053,8,3591,0.0,25,25,7,2,0,100.0
2015020054,25,3600,0.0,33,30,0,1,3,90.90909091
2015020054,14,3450,0.0,22,17,3,0,5,77.27272727
2015020055,7,3516,0.0,29,26,7,0,3,89.65517241
2015020055,13,3600,0.0,26,24,4,0,2,92.30769231
2015020056,19,3599,0.0,26,24,6,0,2,92.30769231
2015020056,22,3530,0.0,29,25,2,1,4,86.20689655
2015020057,30,3600,0.0,30,27,7,0,3,90.0
2015020057,53,1627,0.0,17,14,0,1,3,82.35294118
2015020057,53,1883,0.0,7,6,2,1,1,85.71428571
2015020058,28,3900,0.0,32,31,6,1,1,96.875
2015020058,1,3893,0.0,34,33,3,4,1,97.05882353
2015020059,10,3600,0.0,27,24,5,0,3,88.88888889
2015020059,29,3512,0.0,33,28,3,0,5,84.84848485
2015020060,12,3592,0.0,20,17,2,0,3,85.0
2015020060,17,3464,0.0,36,31,3,1,5,86.11111111
2015020061,20,3553,0.0,29,27,3,0,2,93.10344828
2015020061,52,3600,0.0,20,19,2,0,1,95.0
2015020062,19,3600,0.0,34,31,5,0,3,91.17647059
2015020062,23,3461,0.0,32,28,3,0,4,87.5
2015020063,21,3600,0.0,35,35,4,0,0,100.0
2015020063,24,3535,0.0,24,22,2,0,2,91.66666667
2015020064,30,3739,0.0,37,35,10,1,2,94.59459459
2015020064,26,3739,0.0,26,25,6,0,1,96.15384615
2015020065,17,3561,0.0,40,37,8,1,3,92.5
2015020065,8,3600,0.0,22,21,2,3,1,95.45454545
2015020066,18,3884,0.0,41,38,5,2,3,92.68292683
2015020066,9,3900,0.0,25,22,4,0,3,88.0
2015020067,7,3420,0.0,22,20,5,1,2,90.90909091
2015020067,14,3584,0.0,32,31,5,1,1,96.875
2015020068,25,3600,0.0,26,24,0,0,2,92.30769231
2015020068,13,3538,0.0,36,33,1,0,3,91.66666667
2015020069,10,3487,0.0,33,31,6,1,2,93.93939394
2015020069,5,3600,0.0,27,26,8,2,1,96.2962963
2015020070,12,3600,0.0,34,30,1,1,4,88.23529412
2015020070,15,3600,0.0,19,18,11,0,1,94.73684211
2015020071,28,3582,0.0,33,28,3,1,5,84.84848485
2015020071,2,3600,0.0,25,22,1,0,3,88.0
2015020072,29,3546,0.0,29,26,4,1,3,89.65517241
2015020072,16,3596,0.0,23,22,5,0,1,95.65217391
2015020073,22,3600,0.0,24,22,5,2,2,91.66666667
2015020073,20,3600,0.0,28,23,5,0,5,82.14285714
2015020074,6,3600,0.0,23,20,3,2,3,86.95652174
2015020074,53,3551,0.0,43,38,13,2,5,88.37209302
2015020075,1,3787,0.0,27,26,4,0,1,96.2962963
2015020075,3,3787,0.0,24,22,0,1,2,91.66666667
2015020076,19,3576,0.0,29,27,10,1,2,93.10344828
2015020076,52,3543,0.0,41,37,11,1,4,90.24390244
2015020077,30,3519,0.0,21,18,1,0,3,85.71428571
2015020077,24,3600,0.0,35,34,2,1,1,97.14285714
2015020078,22,3706,0.0,34,33,3,0,1,97.05882353
2015020078,23,3706,0.0,24,22,1,1,2,91.66666667
2015020079,21,3555,0.0,40,38,2,0,2,95.0
2015020079,26,3589,0.0,23,22,6,1,1,95.65217391
2015020080,28,3600,0.0,28,24,0,3,4,85.71428571
2015020080,3,3600,0.0,22,22,1,0,0,100.0
2015020081,53,3598,0.0,25,22,4,0,3,88.0
2015020081,1,3619,0.0,20,18,6,0,2,90.0
2015020082,25,3600,0.0,35,34,11,0,1,97.14285714
2015020082,4,3550,0.0,32,30,3,1,2,93.75
2015020083,13,3681,0.0,35,32,4,1,3,91.42857143
2015020083,5,3679,0.0,33,31,4,1,2,93.93939394
2015020084,2,3597,0.0,37,37,11,1,0,100.0
2015020084,29,3487,0.0,28,25,5,2,3,89.28571429
2015020085,19,3600,0.0,36,33,3,3,3,91.66666667
2015020085,8,3600,0.0,38,38,1,0,0,100.0
2015020086,14,3900,2.0,33,29,6,1,4,87.87878788
2015020086,18,3897,0.0,29,25,0,0,4,86.20689655
2015020087,15,3594,0.0,19,17,1,1,2,89.47368421
2015020087,20,1703,0.0,12,10,1,0,2,83.33333333
2015020087,20,1897,0.0,18,14,2,0,4,77.77777778
2015020088,10,3900,0.0,35,34,11,0,1,97.14285714
2015020088,7,3900,0.0,24,23,3,0,1,95.83333333
2015020089,4,1200,0.0,12,10,1,0,2,83.33333333
2015020089,4,2529,0.0,18,16,0,1,2,88.88888889
2015020089,6,3729,0.0,37,32,0,1,5,86.48648649
2015020090,17,3402,0.0,28,25,4,1,3,89.28571429
2015020090,22,3598,0.0,29,28,9,1,1,96.55172414
2015020091,12,3707,0.0,26,26,5,2,0,100.0
2015020091,21,3709,0.0,19,18,6,1,1,94.73684211
2015020092,53,3548,0.0,27,24,3,0,3,88.88888889
2015020092,3,3597,0.0,35,34,5,2,1,97.14285714
2015020093,25,3600,0.0,34,33,6,2,1,97.05882353
2015020093,5,3477,0.0,23,19,2,1,4,82.60869565
2015020094,1,3832,0.0,39,35,7,1,4,89.74358974
2015020094,9,3900,0.0,32,28,2,0,4,87.5
2015020095,24,3600,0.0,29,24,4,0,5,82.75862069
2015020095,18,3600,0.0,28,27,8,1,1,96.42857143
2015020096,29,3514,0.0,23,20,3,0,3,86.95652174
2015020096,30,3591,0.0,29,27,2,1,2,93.10344828
2015020097,13,3581,0.0,27,24,5,0,3,88.88888889
2015020097,16,3561,0.0,18,16,4,0,2,88.88888889
2015020098,15,3600,0.0,25,23,2,0,2,92.0
2015020098,23,3491,0.0,35,32,2,4,3,91.42857143
2015020099,26,3576,0.0,40,39,8,2,1,97.5
2015020099,28,3600,0.0,29,25,2,0,4,86.20689655
2015020100,8,3588,0.0,36,34,2,1,2,94.44444444
2015020100,7,3598,0.0,26,19,1,2,7,73.07692308
2015020101,6,3600,0.0,26,23,4,0,3,88.46153846
2015020101,2,3462,0.0,25,21,1,1,4,84.0
2015020102,14,3636,0.0,36,33,2,0,3,91.66666667
2015020102,52,3632,0.0,31,27,3,0,4,87.09677419
2015020103,17,3792,0.0,40,37,4,0,3,92.5
2015020103,20,3744,0.0,29,27,4,0,2,93.10344828
2015020104,15,3580,0.0,23,19,3,1,4,82.60869565
2015020104,22,1908,0.0,17,11,1,0,6,64.70588235
2015020104,22,1691,0.0,9,8,2,1,1,88.88888889
2015020105,12,3599,0.0,28,25,4,2,3,89.28571429
2015020105,26,3600,0.0,40,40,9,0,0,100.0
2015020106,24,3600,0.0,30,27,4,0,3,90.0
2015020106,30,3600,0.0,15,15,1,1,0,100.0
2015020107,1,3600,0.0,29,26,5,1,3,89.65517241
2015020107,7,3471,0.0,28,24,3,1,4,85.71428571
2015020108,10,3417,0.0,27,22,5,0,5,81.48148148
2015020108,8,3600,0.0,52,49,12,2,3,94.23076923
2015020109,53,3600,0.0,36,35,4,1,1,97.22222222
2015020109,9,3579,0.0,25,22,3,1,3,88.0
2015020110,3,3900,0.0,48,46,4,1,2,95.83333333
2015020110,4,3900,0.0,39,37,2,0,2,94.87179487
2015020111,2,3840,0.0,40,38,5,1,2,95.0
2015020111,19,3834,0.0,22,19,2,0,3,86.36363636
2015020112,5,3641,0.0,39,38,4,3,1,97.43589744
2015020112,18,3591,0.0,25,23,4,0,2,92.0
2015020113,13,3600,0.0,35,33,1,0,2,94.28571429
2015020113,25,2315,0.0,19,16,3,0,3,84.21052632
2015020113,25,1260,0.0,11,8,0,0,3,72.72727273
2015020114,14,3597,0.0,32,31,6,2,1,96.875
2015020114,16,3617,0.0,21,21,4,0,0,100.0
2015020115,29,3600,0.0,34,31,5,2,3,91.17647059
2015020115,21,3545,0.0,36,32,3,0,4,88.88888889
2015020116,17,3830,0.0,32,30,4,3,2,93.75
2015020116,23,3830,0.0,28,25,6,0,3,89.28571429
2015020117,12,1766,0.0,7,7,1,0,0,100.0
2015020117,12,1749,0.0,13,9,0,0,4,69.23076923
2015020117,28,3600,0.0,34,32,5,0,2,94.11764706
2015020118,30,2248,0.0,15,14,0,2,1,93.33333333
2015020118,30,1251,0.0,18,14,0,1,4,77.77777778
2015020118,52,3591,0.0,30,26,8,0,4,86.66666667
2015020119,20,3121,0.0,21,17,0,2,4,80.95238095
2015020119,20,479,0.0,5,5,0,0,0,100.0
2015020119,3,3600,0.0,23,22,4,3,1,95.65217391
2015020120,26,3600,0.0,28,26,3,0,2,92.85714286
2015020120,22,3539,0.0,34,31,8,0,3,91.17647059
2015020121,20,3600,0.0,35,31,3,1,4,88.57142857
2015020121,2,3600,0.0,29,29,1,0,0,100.0
2015020122,53,3600,0.0,27,24,4,3,3,88.88888889
2015020122,10,3417,0.0,24,20,3,0,4,83.33333333
2015020123,24,3651,2.0,24,23,3,0,1,95.83333333
2015020123,16,3651,0.0,39,39,6,0,0,100.0
2015020124,53,3600,0.0,27,21,4,0,6,77.77777778
2015020124,6,3600,0.0,24,24,1,1,0,100.0
2015020125,29,3600,0.0,24,23,4,0,1,95.83333333
2015020125,1,3471,0.0,14,11,1,0,3,78.57142857
2015020126,7,3744,0.0,33,30,8,0,3,90.90909091
2015020126,4,3733,0.0,40,36,3,0,4,90.0
2015020127,12,3579,0.0,26,25,0,2,1,96.15384615
2015020127,17,3550,0.0,20,18,1,0,2,90.0
2015020128,21,3572,0.0,28,24,5,0,4,85.71428571
2015020128,13,3600,0.0,32,31,11,0,1,96.875
2015020129,14,3524,0.0,23,22,1,0,1,95.65217391
2015020129,19,3600,0.0,26,26,0,0,0,100.0
2015020130,22,3523,0.0,28,24,4,0,4,85.71428571
2015020130,30,3592,0.0,25,22,1,1,3,88.0
2015020131,26,3598,0.0,25,24,2,2,1,96.0
2015020131,52,3530,0.0,30,28,1,0,2,93.33333333
2015020132,24,3484,0.0,34,30,4,4,4,88.23529412
2015020132,25,3576,0.0,20,17,4,0,3,85.0
2015020133,8,3571,0.0,28,23,2,0,5,82.14285714
2015020133,23,3594,0.0,26,25,1,0,1,96.15384615
2015020134,20,3140,0.0,18,14,3,1,4,77.77777778
2015020134,20,760,0.0,5,5,1,0,0,100.0
2015020134,9,3870,0.0,38,34,7,0,4,89.47368421
2015020135,5,3600,0.0,34,33,7,0,1,97.05882353
2015020135,15,3532,0.0,24,22,3,1,2,91.66666667
2015020136,18,3590,0.0,21,20,3,0,1,95.23809524
2015020136,28,3496,0.0,24,22,3,1,2,91.66666667
2015020137,12,3731,0.0,19,17,2,0,2,89.47368421
2015020137,2,3741,0.0,29,26,1,0,3,89.65517241
2015020138,1,3600,0.0,28,27,3,2,1,96.42857143
2015020138,4,3428,0.0,32,29,4,2,3,90.625
2015020139,7,3482,0.0,29,25,1,0,4,86.20689655
2015020139,5,3600,0.0,53,50,8,0,3,94.33962264
2015020140,21,3600,0.0,35,34,8,5,1,97.14285714
2015020140,14,3495,0.0,26,24,9,0,2,92.30769231
2015020141,24,3507,0.0,34,32,4,0,2,94.11764706
2015020141,19,3600,0.0,23,22,3,1,1,95.65217391
2015020142,16,3421,0.0,31,28,4,0,3,90.32258065
2015020142,52,3600,0.0,46,45,7,1,1,97.82608696
2015020143,23,3737,0.0,29,25,6,0,4,86.20689655
2015020143,25,3737,0.0,32,29,1,0,3,90.625
2015020144,8,3559,0.0,27,23,7,1,4,85.18518519
2015020144,22,3600,0.0,21,18,0,0,3,85.71428571
2015020145,4,3459,0.0,36,33,13,0,3,91.66666667
2015020145,7,3587,0.0,28,27,5,0,1,96.42857143
2015020146,10,3529,0.0,25,23,3,0,2,92.0
2015020146,3,3600,0.0,25,24,0,0,1,96.0
2015020147,29,3504,0.0,28,26,3,1,2,92.85714286
2015020147,15,3600,0.0,30,29,6,0,1,96.66666667
2015020148,21,3446,0.0,26,23,1,0,3,88.46153846
2015020148,12,3600,0.0,32,30,7,0,2,93.75
2015020149,9,3600,0.0,30,29,8,0,1,96.66666667
2015020149,17,3451,0.0,34,32,6,2,2,94.11764706
2015020150,6,3600,0.0,32,31,8,0,1,96.875
2015020150,13,3361,0.0,30,27,2,1,3,90.0
2015020151,16,3526,0.0,30,25,2,0,5,83.33333333
2015020151,30,3600,0.0,29,25,0,1,4,86.20689655
2015020152,8,3597,0.0,32,30,2,0,2,93.75
2015020152,20,3600,0.0,31,25,4,1,6,80.64516129
2015020153,23,3592,0.0,31,28,4,1,3,90.32258065
2015020153,53,266,0.0,3,1,0,0,2,33.33333333
2015020153,53,3232,0.0,19,17,5,0,2,89.47368421
2015020154,2,3900,0.0,17,15,2,0,2,88.23529412
2015020154,1,3900,0.0,26,24,4,0,2,92.30769231
2015020155,28,3562,0.0,24,20,3,0,4,83.33333333
2015020155,25,3600,0.0,29,26,3,3,3,89.65517241
2015020156,18,3882,0.0,29,25,5,0,4,86.20689655
2015020156,26,3882,0.0,34,31,3,1,3,91.17647059
2015020157,5,3600,2.0,21,21,4,1,0,100.0
2015020157,10,3600,0.0,32,28,7,2,4,87.5
2015020158,17,3600,0.0,36,33,8,1,3,91.66666667
2015020158,9,3551,0.0,28,23,4,1,5,82.14285714
2015020159,6,3600,0.0,22,21,4,0,1,95.45454545
2015020159,14,3564,0.0,33,31,3,1,2,93.93939394
2015020160,15,3824,0.0,27,26,8,0,1,96.2962963
2015020160,13,3823,0.0,27,25,2,0,2,92.59259259
2015020161,52,3600,0.0,21,19,4,0,2,90.47619048
2015020161,29,2249,0.0,16,16,2,1,0,100.0
2015020161,29,1200,0.0,11,8,0,0,3,72.72727273
2015020162,30,3866,0.0,26,23,1,0,3,88.46153846
2015020162,19,3866,0.0,31,29,5,0,2,93.5483871
2015020163,20,3600,0.0,23,19,5,0,4,82.60869565
2015020163,22,3591,0.0,32,27,3,2,5,84.375
2015020164,28,3600,0.0,26,23,4,0,3,88.46153846
2015020164,21,3533,2.0,31,28,2,1,3,90.32258065
2015020165,14,3600,0.0,35,32,1,0,3,91.42857143
2015020165,12,3443,0.0,31,27,6,1,4,87.09677419
2015020166,52,2218,0.0,17,16,5,0,1,94.11764706
2015020166,52,1382,0.0,9,5,0,0,4,55.55555556
2015020166,8,3580,0.0,19,18,1,2,1,94.73684211
2015020167,7,3600,0.0,30,29,0,0,1,96.66666667
2015020167,2,3530,0.0,22,20,0,0,2,90.90909091
2015020168,18,3436,0.0,28,24,0,2,4,85.71428571
2015020168,24,3600,0.0,42,40,6,0,2,95.23809524
2015020169,25,3544,0.0,26,22,4,0,4,84.61538462
2015020169,10,3600,0.0,44,43,2,2,1,97.72727273
2015020170,26,3541,0.0,26,22,1,0,4,84.61538462
2015020170,16,3600,0.0,35,33,6,0,2,94.28571429
2015020171,4,3530,0.0,33,30,1,0,3,90.90909091
2015020171,23,3600,0.0,28,27,4,0,1,96.42857143
2015020172,25,3600,0.0,39,36,5,1,3,92.30769231
2015020172,6,3472,0.0,19,14,2,1,5,73.68421053
2015020173,1,3536,0.0,34,32,0,3,2,94.11764706
2015020173,2,3600,0.0,24,23,5,0,1,95.83333333
2015020174,15,3600,0.0,22,17,0,1,5,77.27272727
2015020174,3,3600,0.0,34,32,4,0,2,94.11764706
2015020175,9,3634,0.0,37,36,6,0,1,97.2972973
2015020175,8,3630,0.0,27,25,5,0,2,92.59259259
2015020176,14,3536,0.0,29,27,6,0,2,93.10344828
2015020176,17,3581,0.0,30,29,5,0,1,96.66666667
2015020177,26,3584,0.0,24,24,4,0,0,100.0
2015020177,19,3446,0.0,33,31,11,2,2,93.93939394
2015020178,20,3592,0.0,41,36,6,1,5,87.80487805
2015020178,21,3600,0.0,25,22,1,0,3,88.0
2015020179,4,3551,2.0,48,45,12,2,3,93.75
2015020179,22,3590,0.0,22,20,0,0,2,90.90909091
2015020180,29,3600,0.0,43,41,9,1,2,95.34883721
2015020180,28,2400,0.0,21,17,5,0,4,80.95238095
2015020180,28,1095,0.0,2,2,0,0,0,100.0
2015020181,52,3599,0.0,26,24,1,0,2,92.30769231
2015020181,10,3533,0.0,33,30,3,2,3,90.90909091
2015020182,19,1023,0.0,15,11,0,0,4,73.33333333
2015020182,19,2811,0.0,28,27,1,0,1,96.42857143
2015020182,16,3833,0.0,29,23,0,0,6,79.31034483
2015020183,5,3597,0.0,20,18,3,1,2,90.0
2015020183,23,3449,0.0,23,20,2,0,3,86.95652174
2015020184,13,3900,2.0,39,37,8,1,2,94.87179487
2015020184,24,3830,0.0,25,23,2,0,2,92.0
2015020185,14,3600,0.0,31,30,7,2,1,96.77419355
2015020185,7,2348,0.0,10,10,2,0,0,100.0
2015020185,7,1200,0.0,11,8,0,0,3,72.72727273
2015020186,6,3528,0.0,30,27,6,0,3,90.0
2015020186,15,3600,0.0,29,28,1,1,1,96.55172414
2015020187,2,3490,0.0,23,20,0,1,3,86.95652174
2015020187,8,3600,0.0,18,17,4,0,1,94.44444444
2015020188,52,3900,0.0,31,29,4,0,2,93.5483871
2015020188,9,3900,0.0,40,38,0,0,2,95.0
2015020189,18,3600,0.0,29,27,6,0,2,93.10344828
2015020189,30,3455,0.0,24,21,1,0,3,87.5
2015020190,4,3633,0.0,30,28,0,1,2,93.33333333
2015020190,20,3635,0.0,27,26,4,0,1,96.2962963
2015020191,21,3541,0.0,27,24,9,1,3,88.88888889
2015020191,53,3600,0.0,28,26,3,2,2,92.85714286
2015020192,29,3589,0.0,33,31,6,1,2,93.93939394
2015020192,26,3472,2.0,25,22,3,1,3,88.0
2015020193,13,3546,0.0,31,27,3,0,4,87.09677419
2015020193,28,3594,0.0,33,31,5,1,2,93.93939394
2015020194,17,3727,0.0,33,32,7,2,1,96.96969697
2015020194,10,3693,0.0,24,22,7,0,2,91.66666667
2015020195,16,1200,0.0,13,10,1,0,3,76.92307692
2015020195,16,2037,0.0,13,12,0,1,1,92.30769231
2015020195,1,3596,0.0,29,27,0,0,2,93.10344828
2015020196,25,3600,0.0,31,30,0,0,1,96.77419355
2015020196,12,3487,0.0,28,25,2,0,3,89.28571429
2015020197,3,3600,0.0,30,29,5,0,1,96.66666667
2015020197,21,3498,0.0,33,31,6,1,2,93.93939394
2015020198,5,3600,0.0,28,27,3,1,1,96.42857143
2015020198,22,3514,2.0,33,31,4,0,2,93.93939394
2015020199,29,3495,0.0,33,30,4,1,3,90.90909091
2015020199,24,3587,0.0,36,34,7,0,2,94.44444444
2015020200,23,3583,0.0,22,19,3,0,3,86.36363636
2015020200,7,3600,0.0,37,35,3,2,2,94.59459459
2015020201,13,3600,0.0,35,31,1,1,4,88.57142857
2015020201,26,3600,0.0,19,18,2,0,1,94.73684211
2015020202,6,3586,0.0,32,29,3,2,3,90.625
2015020202,8,3600,0.0,31,29,4,0,2,93.5483871
2015020203,10,3900,0.0,31,29,4,0,2,93.5483871
2015020203,15,3803,0.0,25,23,3,1,2,92.0
2015020204,9,3771,0.0,46,43,6,0,3,93.47826087
2015020204,12,3630,0.0,21,19,1,2,2,90.47619048
2015020205,4,3600,0.0,28,28,8,1,0,100.0
2015020205,52,3526,0.0,22,20,8,2,2,90.90909091
2015020206,19,3600,0.0,45,45,9,0,0,100.0
2015020206,18,3597,0.0,28,24,2,1,4,85.71428571
2015020207,14,3540,0.0,25,24,4,0,1,96.0
2015020207,30,3600,0.0,31,31,6,1,0,100.0
2015020208,3,3600,0.0,40,39,12,1,1,97.5
2015020208,53,1536,0.0,17,14,4,0,3,82.35294118
2015020208,53,2059,0.0,13,12,5,0,1,92.30769231
2015020209,5,3574,0.0,30,26,4,0,4,86.66666667
2015020209,20,3600,0.0,25,23,2,0,2,92.0
2015020210,24,3595,0.0,31,31,7,0,0,100.0
2015020210,28,3504,0.0,17,16,1,0,1,94.11764706
2015020211,25,3600,0.0,22,21,5,1,1,95.45454545
2015020211,17,2826,0.0,22,20,0,1,2,90.90909091
2015020211,17,666,0.0,2,2,2,0,0,100.0
2015020212,23,3787,0.0,28,24,7,1,4,85.71428571
2015020212,1,3784,0.0,31,28,13,0,3,90.32258065
2015020213,6,3600,0.0,37,36,2,1,1,97.2972973
2015020213,2,3570,0.0,27,25,3,0,2,92.59259259
2015020214,22,3487,0.0,28,24,3,0,4,85.71428571
2015020214,16,3600,0.0,36,34,1,1,2,94.44444444
2015020215,53,3663,0.0,36,33,7,1,3,91.66666667
2015020215,24,3678,0.0,28,24,5,1,4,85.71428571
2015020216,19,3597,0.0,24,24,3,1,0,100.0
2015020216,1,3521,0.0,28,26,1,0,2,92.85714286
2015020217,12,3600,0.0,23,20,9,1,3,86.95652174
2015020217,3,3591,0.0,33,33,8,2,0,100.0
2015020218,21,3600,0.0,25,25,0,0,0,100.0
2015020218,4,3596,0.0,40,36,3,0,4,90.0
2015020219,23,3600,0.0,45,42,6,2,3,93.33333333
2015020219,29,3512,0.0,29,25,2,2,4,86.20689655
2015020220,15,3524,0.0,27,26,2,1,1,96.2962963
2015020220,17,3600,0.0,38,38,11,0,0,100.0
2015020221,7,3600,0.0,31,30,3,1,1,96.77419355
2015020221,14,3430,0.0,26,23,3,0,3,88.46153846
2015020222,20,3520,0.0,31,27,4,0,4,87.09677419
2015020222,13,3600,0.0,28,25,2,0,3,89.28571429
2015020223,9,3434,0.0,38,31,3,1,7,81.57894737
2015020223,18,3598,0.0,26,21,2,0,5,80.76923077
2015020224,52,1794,0.0,12,8,2,0,4,66.66666667
2015020224,52,1684,0.0,16,15,8,0,1,93.75
2015020224,30,3593,0.0,28,25,5,1,3,89.28571429
2015020225,10,3600,0.0,38,36,2,0,2,94.73684211
2015020225,25,3521,0.0,30,27,0,0,3,90.0
2015020226,53,3600,0.0,35,33,2,0,2,94.28571429
2015020226,26,3543,0.0,25,22,6,0,3,88.0
2015020227,2,3600,0.0,36,34,4,0,2,94.44444444
2015020227,28,210,0.0,3,1,0,0,2,33.33333333
2015020227,28,3307,0.0,21,20,2,2,1,95.23809524
2015020228,8,3900,0.0,34,31,7,0,3,91.17647059
2015020228,5,3765,0.0,35,32,6,0,3,91.42857143
2015020228,5,130,0.0,3,3,0,0,0,100.0
2015020229,22,3676,0.0,37,34,3,1,3,91.89189189
2015020229,24,3676,0.0,27,23,2,0,4,85.18518519
2015020230,21,3600,0.0,27,25,5,0,2,92.59259259
2015020230,6,3480,0.0,30,27,1,1,3,90.0
2015020231,19,2590,0.0,16,14,2,3,2,87.5
2015020231,19,878,0.0,5,2,0,0,3,40.0
2015020231,3,3600,0.0,34,31,5,0,3,91.17647059
2015020232,15,3594,0.0,20,18,1,1,2,90.0
2015020232,4,3600,0.0,32,27,3,1,5,84.375
2015020233,30,3830,0.0,39,37,4,0,2,94.87179487
2015020233,12,3809,0.0,21,18,0,0,3,85.71428571
2015020234,23,3496,0.0,25,22,5,1,3,88.0
2015020234,9,3594,0.0,35,33,4,1,2,94.28571429
2015020235,20,3550,0.0,29,26,1,0,3,89.65517241
2015020235,14,3600,0.0,31,30,3,0,1,96.77419355
2015020236,7,3597,0.0,38,36,6,0,2,94.73684211
2015020236,13,3484,0.0,19,16,0,0,3,84.21052632
2015020237,10,3900,0.0,22,21,0,0,1,95.45454545
2015020237,18,3899,0.0,23,22,6,0,1,95.65217391
2015020238,1,3600,0.0,29,27,3,1,2,93.10344828
2015020238,16,3505,0.0,22,19,2,1,3,86.36363636
2015020239,52,3525,0.0,32,28,5,1,4,87.5
2015020239,25,3598,0.0,38,35,9,0,3,92.10526316
2015020240,22,3600,0.0,21,17,3,3,4,80.95238095
2015020240,53,3594,0.0,28,27,5,0,1,96.42857143
2015020241,2,3490,0.0,22,20,1,0,2,90.90909091
2015020241,26,3586,0.0,32,31,5,0,1,96.875
2015020242,29,3600,0.0,29,28,5,1,1,96.55172414
2015020242,5,3457,0.0,28,26,2,4,2,92.85714286
2015020243,20,3700,0.0,36,34,2,0,2,94.44444444
2015020243,15,3700,0.0,29,26,1,1,3,89.65517241
2015020244,28,3600,0.0,28,26,2,1,2,92.85714286
2015020244,17,3444,0.0,14,11,1,0,3,78.57142857
2015020245,2,3600,0.0,25,24,5,2,1,96.0
2015020245,24,3600,0.0,29,25,11,0,4,86.20689655
2015020246,3,3900,0.0,23,22,1,0,1,95.65217391
2015020246,9,3900,0.0,34,33,0,1,1,97.05882353
2015020247,17,3458,0.0,31,28,1,0,3,90.32258065
2015020247,6,3600,0.0,23,22,3,0,1,95.65217391
2015020248,28,3779,0.0,31,30,4,0,1,96.77419355
2015020248,7,3779,0.0,32,30,6,1,2,93.75
2015020249,23,3397,0.0,40,36,8,2,4,90.0
2015020249,10,3600,0.0,45,43,5,1,2,95.55555556
2015020250,21,3600,0.0,40,39,8,0,1,97.5
2015020250,8,1200,0.0,13,11,4,0,2,84.61538462
2015020250,8,2400,0.0,11,7,1,0,4,63.63636364
2015020251,13,3846,0.0,28,24,4,0,4,85.71428571
2015020251,14,3899,0.0,23,19,3,0,4,82.60869565
2015020252,5,3600,0.0,37,33,10,1,4,89.18918919
2015020252,1,3559,0.0,21,21,4,1,0,100.0
2015020253,4,3624,0.0,21,19,1,0,2,90.47619048
2015020253,12,3634,0.0,19,16,2,0,3,84.21052632
2015020254,53,3600,0.0,21,16,3,3,5,76.19047619
2015020254,29,3600,0.0,29,27,5,0,2,93.10344828
2015020255,52,2875,0.0,27,23,6,0,4,85.18518519
2015020255,52,721,0.0,7,4,1,1,3,57.14285714
2015020255,18,3600,2.0,20,20,3,1,0,100.0
2015020256,16,3600,0.0,31,29,6,0,2,93.5483871
2015020256,19,3545,0.0,26,23,0,1,3,88.46153846
2015020257,30,3790,0.0,36,33,5,0,3,91.66666667
2015020257,25,3797,0.0,24,22,2,3,2,91.66666667
2015020258,22,3535,0.0,28,24,4,0,4,85.71428571
2015020258,26,3588,0.0,25,22,4,2,3,88.0
2015020259,10,3538,0.0,30,26,1,0,4,86.66666667
2015020259,3,3600,0.0,26,23,4,1,3,88.46153846
2015020260,20,3483,0.0,40,37,2,1,3,92.5
2015020260,16,3600,0.0,26,25,7,0,1,96.15384615
2015020261,53,3511,0.0,31,27,2,1,4,87.09677419
2015020261,2,3600,0.0,33,31,3,0,2,93.93939394
2015020262,24,3600,0.0,25,24,4,0,1,96.0
2015020262,12,3574,0.0,19,16,0,0,3,84.21052632
2015020263,23,3805,0.0,36,32,10,2,4,88.88888889
2015020263,8,3805,0.0,26,23,5,1,3,88.46153846
2015020264,17,3720,0.0,25,22,1,1,3,88.0
2015020264,9,3724,0.0,37,33,5,0,4,89.18918919
2015020265,14,3579,0.0,20,19,4,1,1,95.0
2015020265,13,3600,0.0,39,39,0,0,0,100.0
2015020266,52,3496,0.0,28,25,3,0,3,89.28571429
2015020266,19,3600,0.0,18,16,3,1,2,88.88888889
2015020267,28,3600,0.0,29,25,4,0,4,86.20689655
2015020267,6,3565,0.0,28,23,2,0,5,82.14285714
2015020268,25,3600,0.0,25,24,3,0,1,96.0
2015020268,7,3525,0.0,28,26,3,1,2,92.85714286
2015020269,26,3881,0.0,38,36,9,0,2,94.73684211
2015020269,4,3900,0.0,40,38,1,0,2,95.0
2015020270,30,3517,0.0,29,25,10,1,4,86.20689655
2015020270,5,3593,0.0,29,26,4,1,3,89.65517241
2015020271,19,3565,0.0,37,35,7,0,2,94.59459459
2015020271,29,3591,0.0,20,19,3,1,1,95.0
2015020272,21,411,0.0,4,3,0,0,1,75.0
2015020272,21,3102,0.0,26,22,3,1,4,84.61538462
2015020272,10,3571,0.0,35,34,3,0,1,97.14285714
2015020273,24,1902,0.0,11,11,4,1,0,100.0
2015020273,24,1573,0.0,10,7,2,1,3,70.0
2015020273,18,3600,0.0,40,38,8,5,2,95.0
2015020274,1,3537,0.0,30,27,6,0,3,90.0
2015020274,20,3600,0.0,20,18,3,0,2,90.0
2015020275,23,3582,2.0,33,30,7,1,3,90.90909091
2015020275,52,3590,0.0,30,29,9,1,1,96.66666667
2015020276,15,3645,0.0,26,25,3,2,1,96.15384615
2015020276,17,3645,0.0,27,25,9,0,2,92.59259259
2015020277,16,3668,0.0,37,34,7,0,3,91.89189189
2015020277,22,3668,0.0,27,23,0,1,4,85.18518519
2015020278,30,3473,0.0,38,34,8,0,4,89.47368421
2015020278,6,3590,0.0,26,24,2,1,2,92.30769231
2015020279,28,3825,0.0,34,34,5,1,0,100.0
2015020279,4,3825,0.0,21,20,2,0,1,95.23809524
2015020280,21,3409,0.0,30,26,6,1,4,86.66666667
2015020280,5,3561,0.0,31,28,7,0,3,90.32258065
2015020281,25,3600,0.0,35,33,0,1,2,94.28571429
2015020281,15,3521,0.0,31,28,1,0,3,90.32258065
2015020282,53,3600,0.0,33,31,4,1,2,93.93939394
2015020282,8,3472,0.0,20,17,1,0,3,85.0
2015020283,29,3596,0.0,28,26,6,0,2,92.85714286
2015020283,9,3595,0.0,25,25,6,0,0,100.0
2015020284,3,3550,0.0,28,26,1,0,2,92.85714286
2015020284,14,3590,0.0,21,20,4,0,1,95.23809524
2015020285,24,3594,0.0,25,24,2,0,1,96.0
2015020285,13,3539,0.0,40,38,4,1,2,95.0
2015020286,7,3900,0.0,29,27,2,0,2,93.10344828
2015020286,19,3900,0.0,34,32,10,2,2,94.11764706
2015020287,10,3900,0.0,34,33,0,0,1,97.05882353
2015020287,12,3900,0.0,25,24,5,0,1,96.0
2015020288,18,3422,0.0,17,14,4,1,3,82.35294118
2015020288,29,3600,0.0,39,39,4,0,0,100.0
2015020289,26,3542,0.0,29,26,3,0,3,89.65517241
2015020289,17,3600,0.0,37,35,3,0,2,94.59459459
2015020290,8,3600,0.0,36,33,2,0,3,91.66666667
2015020290,2,2315,0.0,16,15,0,0,1,93.75
2015020290,2,1200,0.0,11,8,0,0,3,72.72727273
2015020291,16,3698,0.0,37,35,0,0,2,94.59459459
2015020291,20,3698,0.0,19,18,2,2,1,94.73684211
2015020292,1,3497,0.0,26,22,5,1,4,84.61538462
2015020292,22,3585,0.0,20,19,5,0,1,95.0
2015020293,10,3483,0.0,36,35,1,0,1,97.22222222
2015020293,6,3600,0.0,22,22,0,2,0,100.0
2015020294,4,3568,0.0,31,27,2,0,4,87.09677419
2015020294,9,3600,0.0,36,36,10,1,0,100.0
2015020295,24,3600,0.0,24,19,6,0,5,79.16666667
2015020295,14,3600,0.0,30,30,0,2,0,100.0
2015020296,3,3721,0.0,43,39,14,0,4,90.69767442
2015020296,13,3649,0.0,31,26,4,1,5,83.87096774
2015020297,28,3600,0.0,39,38,8,0,1,97.43589744
2015020297,5,3426,0.0,29,26,7,0,3,89.65517241
2015020298,21,2400,0.0,21,18,5,0,3,85.71428571
2015020298,21,1200,0.0,11,7,2,0,4,63.63636364
2015020298,15,3600,0.0,27,24,1,1,3,88.88888889
2015020299,53,3510,0.0,23,20,5,2,3,86.95652174
2015020299,52,2400,0.0,22,20,3,1,2,90.90909091
2015020299,52,1200,0.0,7,7,1,0,0,100.0
2015020300,17,3881,0.0,33,30,3,0,3,90.90909091
2015020300,19,3876,0.0,32,28,7,0,4,87.5
2015020301,7,3600,0.0,32,29,7,1,3,90.625
2015020301,25,3596,0.0,22,22,2,0,0,100.0
2015020302,18,3558,0.0,27,23,8,0,4,85.18518519
2015020302,30,3541,0.0,23,23,3,0,0,100.0
2015020303,16,3501,0.0,19,14,3,0,5,73.68421053
2015020303,23,3600,0.0,29,26,1,1,3,89.65517241
2015020304,26,1109,0.0,8,8,2,0,0,100.0
2015020304,26,2400,0.0,21,17,0,0,4,80.95238095
2015020304,12,3600,0.0,29,26,0,0,3,89.65517241
2015020305,28,3600,0.0,31,28,3,1,3,90.32258065
2015020305,29,3589,0.0,28,24,5,0,4,85.71428571
2015020306,2,3522,0.0,26,23,3,1,3,88.46153846
2015020306,8,3600,0.0,23,21,5,2,2,91.30434783
2015020307,1,3600,0.0,38,36,14,1,2,94.73684211
2015020307,23,3440,2.0,22,19,6,0,3,86.36363636
2015020308,19,3600,0.0,25,24,4,0,1,96.0
2015020308,7,3532,0.0,26,24,0,1,2,92.30769231
2015020309,18,3598,0.0,19,16,7,1,3,84.21052632
2015020309,3,3600,0.0,31,31,11,1,0,100.0
2015020310,12,3598,0.0,36,33,2,5,3,91.66666667
2015020310,4,3619,0.0,33,31,4,0,2,93.93939394
2015020311,22,3512,0.0,30,29,6,0,1,96.66666667
2015020311,15,3600,0.0,33,33,3,2,0,100.0
2015020312,6,3900,0.0,42,39,12,2,3,92.85714286
2015020312,10,3856,0.0,29,26,5,1,3,89.65517241
2015020313,26,3591,0.0,34,33,3,0,1,97.05882353
2015020313,13,518,0.0,9,8,0,0,1,88.88888889
2015020313,13,2941,0.0,23,21,4,1,2,91.30434783
2015020314,21,3600,0.0,21,20,3,1,1,95.23809524
2015020314,52,3520,0.0,28,25,4,0,3,89.28571429
2015020315,9,3600,0.0,37,33,4,0,4,89.18918919
2015020315,25,3064,0.0,16,11,2,0,5,68.75
2015020315,25,512,0.0,3,2,0,0,1,66.66666667
2015020316,20,3480,0.0,31,27,0,1,4,87.09677419
2015020316,24,639,0.0,5,3,0,0,2,60.0
2015020316,24,2961,0.0,20,19,2,0,1,95.0
2015020317,18,3590,0.0,32,30,2,1,2,93.75
2015020317,7,1922,0.0,12,12,2,0,0,100.0
2015020317,7,1589,0.0,8,5,0,0,3,62.5
2015020318,29,3600,0.0,28,27,7,0,1,96.42857143
2015020318,1,3476,0.0,25,23,3,0,2,92.0
2015020319,4,3555,0.0,35,33,3,4,2,94.28571429
2015020319,2,3600,0.0,18,17,3,1,1,94.44444444
2015020320,8,2400,0.0,23,22,6,0,1,95.65217391
2015020320,8,1198,0.0,11,11,1,0,0,100.0
2015020320,3,2946,0.0,24,19,5,1,5,79.16666667
2015020320,3,654,0.0,1,1,0,0,0,100.0
2015020321,19,3663,0.0,34,30,5,0,4,88.23529412
2015020321,5,3663,0.0,32,29,3,0,3,90.625
2015020322,52,3462,0.0,34,29,5,0,5,85.29411765
2015020322,15,3600,0.0,26,23,2,0,3,88.46153846
2015020323,22,3580,0.0,26,23,0,0,3,88.46153846
2015020323,12,3600,0.0,31,30,5,0,1,96.77419355
2015020324,23,3600,0.0,33,31,9,1,2,93.93939394
2015020324,30,3514,0.0,28,25,0,0,3,89.28571429
2015020325,6,3812,0.0,34,32,3,0,2,94.11764706
2015020325,17,3812,0.0,22,19,4,1,3,86.36363636
2015020326,26,3900,0.0,30,29,2,0,1,96.66666667
2015020326,14,3900,0.0,38,37,0,1,1,97.36842105
2015020327,24,3587,0.0,33,30,6,0,3,90.90909091
2015020327,53,3600,0.0,31,29,5,2,2,93.5483871
2015020328,9,3600,0.0,43,40,7,1,3,93.02325581
2015020328,21,2118,0.0,13,12,0,0,1,92.30769231
2015020328,21,1302,0.0,15,12,0,2,3,80.0
2015020329,16,3600,0.0,29,27,14,0,2,93.10344828
2015020329,28,3538,0.0,25,21,4,0,4,84.0
2015020330,3,3525,0.0,34,30,3,0,4,88.23529412
2015020330,6,3600,0.0,27,24,5,1,3,88.88888889
2015020331,18,3777,0.0,36,33,3,0,3,91.66666667
2015020331,4,3848,0.0,35,33,1,3,2,94.28571429
2015020332,52,3600,0.0,15,14,0,0,1,93.33333333
2015020332,30,3519,0.0,29,26,3,0,3,89.65517241
2015020333,16,3577,0.0,25,23,4,0,2,92.0
2015020333,24,3693,0.0,32,29,4,0,3,90.625
2015020334,14,3476,0.0,37,33,8,0,4,89.18918919
2015020334,15,3598,0.0,34,32,1,1,2,94.11764706
2015020335,12,2391,0.0,14,11,2,0,3,78.57142857
2015020335,12,1200,0.0,7,6,0,0,1,85.71428571
2015020335,7,3600,0.0,28,27,1,0,1,96.42857143
2015020336,8,3900,0.0,27,25,5,1,2,92.59259259
2015020336,1,3889,0.0,27,25,4,0,2,92.59259259
2015020337,5,3749,0.0,43,41,5,1,2,95.34883721
2015020337,29,3761,0.0,25,24,2,1,1,96.0
2015020338,22,3626,0.0,32,28,4,0,4,87.5
2015020338,17,3626,0.0,24,21,1,0,3,87.5
2015020339,2,3900,0.0,27,25,1,0,2,92.59259259
2015020339,13,3900,0.0,25,23,1,0,2,92.0
2015020340,23,3900,0.0,25,23,4,2,2,92.0
2015020340,25,3880,0.0,36,34,6,0,2,94.44444444
2015020341,20,3860,0.0,21,19,4,0,2,90.47619048
2015020341,53,3860,0.0,26,25,6,0,1,96.15384615
2015020342,4,3600,0.0,24,24,3,0,0,100.0
2015020342,3,3419,0.0,33,31,5,0,2,93.93939394
2015020343,15,3600,0.0,34,32,2,0,2,94.11764706
2015020343,10,3502,0.0,23,19,2,0,4,82.60869565
2015020344,1,3728,0.0,32,30,5,0,2,93.75
2015020344,8,3751,0.0,31,28,0,0,3,90.32258065
2015020345,2,3600,0.0,31,29,3,1,2,93.5483871
2015020345,14,3517,0.0,22,19,3,2,3,86.36363636
2015020346,22,3895,0.0,41,39,7,1,2,95.12195122
2015020346,5,3900,0.0,36,34,3,1,2,94.44444444
2015020347,29,3531,0.0,31,29,2,0,2,93.5483871
2015020347,19,3600,0.0,24,23,3,0,1,95.83333333
2015020348,7,3600,0.0,29,28,2,1,1,96.55172414
2015020348,18,3481,0.0,23,20,4,1,3,86.95652174
2015020349,25,3826,0.0,26,23,0,0,3,88.46153846
2015020349,30,3837,0.0,44,40,5,2,4,90.90909091
2015020350,52,3553,0.0,24,20,4,0,4,83.33333333
2015020350,21,3600,0.0,28,25,0,0,3,89.28571429
2015020351,9,3506,0.0,19,15,2,0,4,78.94736842
2015020351,53,3600,0.0,38,35,1,1,3,92.10526316
2015020352,20,3600,0.0,29,24,1,2,5,82.75862069
2015020352,28,3600,0.0,27,25,4,1,2,92.59259259
2015020353,16,3712,0.0,36,33,1,0,3,91.66666667
2015020353,26,3724,0.0,22,20,0,0,2,90.90909091
2015020354,13,3680,0.0,29,28,7,0,1,96.55172414
2015020354,17,3680,0.0,32,30,8,2,2,93.75
2015020355,21,3392,0.0,27,23,3,3,4,85.18518519
2015020355,2,3600,0.0,28,25,7,0,3,89.28571429
2015020356,12,3512,0.0,22,18,1,1,4,81.81818182
2015020356,3,3600,0.0,36,33,3,0,3,91.66666667
2015020357,22,3555,0.0,25,23,4,2,2,92.0
2015020357,10,3577,0.0,24,24,1,1,0,100.0
2015020358,23,2919,0.0,29,25,5,0,4,86.20689655
2015020358,23,681,0.0,1,1,0,0,0,100.0
2015020358,24,3599,0.0,25,25,5,1,0,100.0
2015020359,21,3600,0.0,28,27,5,1,1,96.42857143
2015020359,1,3576,0.0,25,23,2,0,2,92.0
2015020360,29,3558,0.0,26,24,4,1,2,92.30769231
2015020360,8,3600,0.0,23,22,2,0,1,95.65217391
2015020361,4,3599,0.0,25,23,1,0,2,92.0
2015020361,9,3518,0.0,32,29,8,0,3,90.625
2015020362,7,3900,0.0,46,42,1,1,4,91.30434783
2015020362,17,3900,0.0,32,28,5,0,4,87.5
2015020363,13,3600,0.0,30,29,2,0,1,96.66666667
2015020363,19,1075,0.0,8,8,0,0,0,100.0
2015020363,19,2400,0.0,15,12,0,1,3,80.0
2015020364,53,3545,0.0,40,36,2,0,4,90.0
2015020364,18,3600,2.0,15,13,2,0,2,86.66666667
2015020365,30,3600,0.0,31,30,4,1,1,96.77419355
2015020365,16,3492,0.0,36,34,8,0,2,94.44444444
2015020366,25,3900,0.0,32,29,5,0,3,90.625
2015020366,20,3900,0.0,29,26,2,1,3,89.65517241
2015020367,23,3717,0.0,40,38,5,0,2,95.0
2015020367,26,3717,0.0,16,15,3,1,1,93.75
2015020368,5,3600,0.0,34,33,7,0,1,97.05882353
2015020368,28,3560,0.0,28,24,3,1,4,85.71428571
2015020369,10,3600,0.0,35,29,8,0,6,82.85714286
2015020369,52,3600,0.0,33,32,1,0,1,96.96969697
2015020370,3,3900,0.0,37,36,3,3,1,97.2972973
2015020370,2,3900,0.0,34,33,9,0,1,97.05882353
2015020371,6,3900,0.0,36,34,7,0,2,94.44444444
2015020371,22,3855,0.0,40,38,1,4,2,95.0
2015020372,14,3600,0.0,33,32,6,2,1,96.96969697
2015020372,24,3522,0.0,22,20,2,0,2,90.90909091
2015020373,21,3600,0.0,25,24,3,0,1,96.0
2015020373,3,3436,0.0,18,16,0,0,2,88.88888889
2015020374,1,3588,0.0,31,30,5,3,1,96.77419355
2015020374,12,3556,0.0,27,22,8,0,5,81.48148148
2015020375,15,3593,0.0,35,33,5,1,2,94.28571429
2015020375,8,3556,0.0,19,16,3,0,3,84.21052632
2015020376,16,3630,0.0,27,23,2,0,4,85.18518519
2015020376,9,3630,0.0,38,35,3,0,3,92.10526316
2015020377,53,1200,0.0,16,13,3,0,3,81.25
2015020377,53,2400,0.0,28,26,3,0,2,92.85714286
2015020377,17,3578,0.0,27,26,0,0,1,96.2962963
2015020378,13,3600,0.0,33,32,3,0,1,96.96969697
2015020378,18,3442,0.0,16,14,0,0,2,87.5
2015020379,10,3506,0.0,28,27,1,1,1,96.42857143
2015020379,30,3600,2.0,28,28,1,1,0,100.0
2015020380,25,3596,0.0,16,14,1,0,2,87.5
2015020380,23,3499,0.0,33,30,2,0,3,90.90909091
2015020381,53,3564,0.0,27,23,1,0,4,85.18518519
2015020381,7,3600,0.0,20,18,4,0,2,90.0
2015020382,4,3766,0.0,18,15,3,0,3,83.33333333
2015020382,1,3790,0.0,25,21,3,0,4,84.0
2015020383,13,3900,0.0,23,22,6,0,1,95.65217391
2015020383,29,3900,0.0,32,31,6,2,1,96.875
2015020384,19,3900,0.0,25,24,3,1,1,96.0
2015020384,2,3900,0.0,32,31,3,0,1,96.875
2015020385,6,2484,0.0,26,24,3,0,2,92.30769231
2015020385,6,1316,0.0,11,8,1,0,3,72.72727273
2015020385,20,3744,0.0,38,34,0,3,4,89.47368421
2015020386,25,3645,0.0,24,22,3,0,2,91.66666667
2015020386,22,3645,0.0,43,42,11,0,1,97.6744186
2015020387,28,3550,0.0,26,25,5,0,1,96.15384615
2015020387,24,3582,0.0,23,23,6,0,0,100.0
2015020388,15,3880,0.0,36,34,10,0,2,94.44444444
2015020388,52,3880,0.0,38,37,3,0,1,97.36842105
2015020389,5,3535,0.0,36,32,3,0,4,88.88888889
2015020389,26,3600,0.0,20,17,2,0,3,85.0
2015020390,2,3814,0.0,29,26,3,0,3,89.65517241
2015020390,9,3674,0.0,31,29,2,0,2,93.5483871
2015020391,18,3685,0.0,36,31,9,1,5,86.11111111
2015020391,17,3698,0.0,32,28,5,1,4,87.5
2015020392,8,3476,0.0,29,26,5,1,3,89.65517241
2015020392,12,3600,0.0,38,36,5,0,2,94.73684211
2015020393,10,3600,0.0,28,27,0,1,1,96.42857143
2015020393,19,138,0.0,0,0,0,0,0,
2015020393,19,3462,0.0,29,25,3,0,4,86.20689655
2015020394,29,3600,0.0,28,27,0,2,1,96.42857143
2015020394,4,3588,0.0,34,30,5,0,4,88.23529412
2015020395,21,3541,0.0,43,41,9,0,2,95.34883721
2015020395,30,1853,0.0,11,11,0,2,0,100.0
2015020395,30,1745,0.0,9,9,0,0,0,100.0
2015020396,6,3600,0.0,17,17,3,0,0,100.0
2015020396,23,3600,0.0,22,18,0,0,4,81.81818182
2015020397,14,2891,0.0,26,24,12,0,2,92.30769231
2015020397,14,670,0.0,8,7,1,0,1,87.5
2015020397,28,3495,0.0,20,16,2,2,4,80.0
2015020398,53,3597,0.0,18,13,4,2,5,72.22222222
2015020398,12,3600,0.0,23,19,4,0,4,82.60869565
2015020399,52,3495,0.0,31,29,5,0,2,93.5483871
2015020399,16,3600,0.0,31,30,3,0,1,96.77419355
2015020400,13,3411,0.0,18,14,1,0,4,77.77777778
2015020400,1,3600,0.0,36,34,3,0,2,94.44444444
2015020401,9,3560,0.0,30,27,1,0,3,90.0
2015020401,3,3600,0.0,24,23,3,0,1,95.83333333
2015020402,7,3480,0.0,28,24,0,2,4,85.71428571
2015020402,22,3597,0.0,34,32,8,0,2,94.11764706
2015020403,5,3492,0.0,25,23,1,0,2,92.0
2015020403,24,3600,0.0,24,23,5,0,1,95.83333333
2015020404,14,2266,0.0,18,17,2,1,1,94.44444444
2015020404,14,1215,0.0,10,8,1,2,2,80.0
2015020404,26,3600,0.0,25,24,4,1,1,96.0
2015020405,18,3551,0.0,17,15,3,0,2,88.23529412
2015020405,6,3517,0.0,33,30,1,0,3,90.90909091
2015020406,30,3815,0.0,20,18,0,1,2,90.0
2015020406,21,3815,0.0,20,19,3,0,1,95.0
2015020407,7,3600,0.0,31,26,8,0,5,83.87096774
2015020407,23,3598,0.0,34,32,2,0,2,94.11764706
2015020408,2,3900,0.0,46,43,4,0,3,93.47826087
2015020408,4,2626,0.0,16,16,0,0,0,100.0
2015020408,4,1270,0.0,10,7,1,0,3,70.0
2015020409,17,3891,0.0,40,38,11,0,2,95.0
2015020409,15,3895,0.0,23,21,2,0,2,91.30434783
2015020410,26,3852,0.0,23,21,0,0,2,91.30434783
2015020410,29,608,0.0,7,5,0,0,2,71.42857143
2015020410,29,3252,0.0,34,33,7,1,1,97.05882353
2015020411,1,3900,0.0,37,35,12,3,2,94.59459459
2015020411,10,3900,0.0,27,25,10,0,2,92.59259259
2015020412,9,3600,0.0,27,25,9,0,2,92.59259259
2015020412,13,3570,0.0,22,19,8,0,3,86.36363636
2015020413,53,3536,0.0,21,18,3,0,3,85.71428571
2015020413,19,3584,0.0,23,22,10,1,1,95.65217391
2015020414,18,3536,0.0,23,20,3,1,3,86.95652174
2015020414,16,3600,0.0,37,36,4,2,1,97.2972973
2015020415,12,1200,0.0,8,4,0,0,4,50.0
2015020415,12,2386,0.0,12,10,1,0,2,83.33333333
2015020415,25,403,0.0,0,0,0,0,0,
2015020415,25,3189,0.0,30,25,3,0,5,83.33333333
2015020416,28,1391,0.0,14,11,1,0,3,78.57142857
2015020416,28,2201,0.0,19,18,10,0,1,94.73684211
2015020416,20,3576,0.0,33,31,4,1,2,93.93939394
2015020417,6,3600,0.0,33,32,3,0,1,96.96969697
2015020417,8,3454,0.0,23,20,1,0,3,86.95652174
2015020418,5,3600,0.0,26,24,12,0,2,92.30769231
2015020418,21,3447,2.0,33,29,3,2,4,87.87878788
2015020419,28,3839,0.0,20,16,2,0,4,80.0
2015020419,22,3839,0.0,28,25,3,0,3,89.28571429
2015020420,3,3545,0.0,25,23,6,0,2,92.0
2015020420,23,3562,0.0,33,32,3,2,1,96.96969697
2015020421,8,3490,0.0,29,26,5,1,3,89.65517241
2015020421,17,3600,0.0,25,23,2,3,2,92.0
2015020422,9,3473,0.0,29,26,3,1,3,89.65517241
2015020422,14,3600,0.0,31,30,6,0,1,96.77419355
2015020423,15,3415,0.0,25,22,3,0,3,88.0
2015020423,13,3600,2.0,21,20,7,1,1,95.23809524
2015020424,4,3600,0.0,37,35,3,0,2,94.59459459
2015020424,19,3457,0.0,28,25,1,1,3,89.28571429
2015020425,16,3465,0.0,33,29,0,0,4,87.87878788
2015020425,18,3600,0.0,36,35,3,0,1,97.22222222
2015020426,29,3511,0.0,34,29,0,0,5,85.29411765
2015020426,52,3600,0.0,29,25,6,0,4,86.20689655
2015020427,7,3520,0.0,32,28,2,0,4,87.5
2015020427,20,3600,0.0,30,27,6,0,3,90.0
2015020428,17,3816,0.0,38,35,3,1,3,92.10526316
2015020428,1,3851,0.0,29,27,4,0,2,93.10344828
2015020429,26,3900,0.0,42,40,4,1,2,95.23809524
2015020429,5,3836,0.0,40,38,3,1,2,95.0
2015020430,52,3416,0.0,31,29,8,2,2,93.5483871
2015020430,16,3600,0.0,25,25,1,2,0,100.0
2015020431,4,3527,0.0,43,41,9,0,2,95.34883721
2015020431,25,3600,0.0,20,19,0,1,1,95.0
2015020432,3,2560,0.0,33,28,5,0,5,84.84848485
2015020432,3,986,0.0,3,2,0,0,1,66.66666667
2015020432,22,3600,2.0,34,29,4,0,5,85.29411765
2015020433,30,3634,0.0,21,19,7,0,2,90.47619048
2015020433,53,3613,0.0,28,27,6,0,1,96.42857143
2015020434,12,3600,0.0,32,31,1,0,1,96.875
2015020434,24,1173,0.0,6,5,0,0,1,83.33333333
2015020434,24,2400,0.0,17,14,1,0,3,82.35294118
2015020435,13,3598,0.0,24,22,1,1,2,91.66666667
2015020435,6,3600,0.0,27,26,0,0,1,96.2962963
2015020436,26,3799,0.0,30,28,2,0,2,93.33333333
2015020436,7,3791,0.0,21,20,0,0,1,95.23809524
2015020437,9,1585,0.0,31,28,3,0,3,90.32258065
2015020437,9,1909,0.0,11,11,4,0,0,100.0
2015020437,8,3600,0.0,26,25,1,0,1,96.15384615
2015020438,15,3593,0.0,36,35,4,0,1,97.22222222
2015020438,14,3530,0.0,20,18,3,1,2,90.0
2015020439,2,3736,0.0,30,28,0,0,2,93.33333333
2015020439,29,3736,0.0,19,16,3,0,3,84.21052632
2015020440,25,3597,0.0,26,23,5,1,3,88.46153846
2015020440,19,3595,0.0,26,26,7,1,0,100.0
2015020441,21,3600,0.0,36,34,9,1,2,94.44444444
2015020441,18,3509,0.0,25,22,3,1,3,88.0
2015020442,12,3653,0.0,29,25,2,0,4,86.20689655
2015020442,53,3577,0.0,33,28,4,1,5,84.84848485
2015020443,3,3695,0.0,27,22,4,1,5,81.48148148
2015020443,20,3729,0.0,29,25,4,1,4,86.20689655
2015020444,30,3600,0.0,25,25,3,0,0,100.0
2015020444,28,3515,0.0,29,28,2,1,1,96.55172414
2015020445,1,1648,0.0,18,15,4,0,3,83.33333333
2015020445,1,1952,0.0,12,11,1,0,1,91.66666667
2015020445,2,3579,0.0,27,27,3,3,0,100.0
2015020446,21,3600,0.0,43,42,4,1,1,97.6744186
2015020446,19,3539,0.0,17,15,0,0,2,88.23529412
2015020447,23,3442,0.0,29,26,1,0,3,89.65517241
2015020447,16,3600,0.0,30,30,6,0,0,100.0
2015020448,22,3634,0.0,49,47,7,0,2,95.91836735
2015020448,6,3641,0.0,24,21,3,2,3,87.5
2015020449,15,3600,0.0,45,44,4,4,1,97.77777778
2015020449,5,3555,0.0,34,30,7,0,4,88.23529412
2015020450,14,3597,0.0,26,25,3,0,1,96.15384615
2015020450,29,3496,0.0,29,27,2,0,2,93.10344828
2015020451,26,3514,0.0,21,16,4,0,5,76.19047619
2015020451,9,3583,0.0,36,33,5,0,3,91.66666667
2015020452,7,3599,0.0,33,32,3,0,1,96.96969697
2015020452,17,3475,0.0,30,28,3,0,2,93.33333333
2015020453,1,3600,0.0,25,25,3,0,0,100.0
2015020453,7,3458,0.0,21,19,0,0,2,90.47619048
2015020454,13,3600,0.0,34,33,7,2,1,97.05882353
2015020454,2,3489,0.0,16,12,1,0,4,75.0
2015020455,22,3541,0.0,20,17,6,2,3,85.0
2015020455,3,3590,0.0,20,18,4,1,2,90.0
2015020456,12,3702,0.0,31,27,6,0,4,87.09677419
2015020456,4,3702,0.0,32,29,9,0,3,90.625
2015020457,14,3721,0.0,37,33,9,0,4,89.18918919
2015020457,10,3721,0.0,27,22,3,0,5,81.48148148
2015020458,28,3600,0.0,27,26,3,0,1,96.2962963
2015020458,8,1759,0.0,12,9,0,0,3,75.0
2015020458,8,1726,0.0,6,6,0,0,0,100.0
2015020459,20,3673,0.0,22,21,2,1,1,95.45454545
2015020459,18,3683,0.0,21,19,2,0,2,90.47619048
2015020460,23,2400,0.0,36,30,10,0,6,83.33333333
2015020460,23,1200,0.0,5,5,0,0,0,100.0
2015020460,30,3593,0.0,31,29,0,1,2,93.5483871
2015020461,19,3600,0.0,36,33,3,1,3,91.66666667
2015020461,52,3544,0.0,26,22,1,1,4,84.61538462
2015020462,21,3600,0.0,29,29,3,1,0,100.0
2015020462,16,3530,0.0,26,24,4,1,2,92.30769231
2015020463,29,2400,0.0,27,23,1,0,4,85.18518519
2015020463,29,1200,0.0,7,6,0,0,1,85.71428571
2015020463,25,3600,0.0,35,34,3,1,1,97.14285714
2015020464,9,3417,0.0,25,23,2,0,2,92.0
2015020464,15,3595,0.0,27,26,6,0,1,96.2962963
2015020465,5,3578,0.0,28,26,6,1,2,92.85714286
2015020465,6,3590,0.0,34,34,2,1,0,100.0
2015020466,24,3418,0.0,22,19,4,0,3,86.36363636
2015020466,7,3600,0.0,44,44,6,1,0,100.0
2015020467,13,3568,0.0,16,15,2,0,1,93.75
2015020467,1,3584,0.0,25,21,2,0,4,84.0
2015020468,23,3468,0.0,31,29,9,0,2,93.5483871
2015020468,4,3600,0.0,36,36,7,0,0,100.0
2015020469,28,3710,0.0,31,27,4,0,4,87.09677419
2015020469,10,692,0.0,15,13,0,0,2,86.66666667
2015020469,10,3041,0.0,29,26,0,0,3,89.65517241
2015020470,26,3600,0.0,45,45,10,0,0,100.0
2015020470,8,3423,0.0,19,17,0,0,2,89.47368421
2015020471,18,3506,0.0,33,31,0,1,2,93.93939394
2015020471,19,3584,0.0,28,27,1,0,1,96.42857143
2015020472,3,2770,0.0,31,27,1,1,4,87.09677419
2015020472,3,829,0.0,4,3,0,0,1,75.0
2015020472,30,3600,0.0,23,21,3,0,2,91.30434783
2015020473,22,3600,0.0,37,33,6,0,4,89.18918919
2015020473,16,3598,0.0,33,33,0,0,0,100.0
2015020474,20,3600,0.0,36,35,4,2,1,97.22222222
2015020474,25,3439,0.0,27,24,9,0,3,88.88888889
2015020475,2,3499,0.0,30,28,3,0,2,93.33333333
2015020475,21,3598,0.0,34,33,5,0,1,97.05882353
2015020476,29,3600,0.0,32,27,8,0,5,84.375
2015020476,53,1700,0.0,10,8,0,0,2,80.0
2015020476,53,1823,0.0,10,6,1,0,4,60.0
2015020477,6,3600,0.0,32,30,3,0,2,93.75
2015020477,5,3590,0.0,34,28,8,0,6,82.35294118
2015020478,14,3566,0.0,22,18,6,1,4,81.81818182
2015020478,15,1856,0.0,7,7,0,0,0,100.0
2015020478,15,1737,0.0,12,9,3,0,3,75.0
2015020479,13,3570,0.0,24,24,3,0,0,100.0
2015020479,12,3467,0.0,17,16,1,0,1,94.11764706
2015020480,28,3463,0.0,35,31,5,1,4,88.57142857
2015020480,9,3600,0.0,33,31,3,0,2,93.93939394
2015020481,23,3900,0.0,28,25,4,1,3,89.28571429
2015020481,17,3842,0.0,40,37,5,1,3,92.5
2015020482,3,3484,0.0,35,31,5,0,4,88.57142857
2015020482,52,3599,0.0,28,26,3,0,2,92.85714286
2015020483,16,3847,0.0,27,25,2,0,2,92.59259259
2015020483,7,3900,0.0,28,26,2,2,2,92.85714286
2015020484,20,3529,0.0,22,19,0,1,3,86.36363636
2015020484,19,3600,0.0,38,36,12,0,2,94.73684211
2015020485,26,3600,0.0,34,29,0,0,5,85.29411765
2015020485,10,3600,0.0,26,26,1,0,0,100.0
2015020486,24,3600,0.0,22,21,2,0,1,95.45454545
2015020486,1,3522,0.0,18,16,0,0,2,88.88888889
2015020487,12,3600,0.0,38,37,2,2,1,97.36842105
2015020487,5,3541,0.0,26,24,5,0,2,92.30769231
2015020488,4,3900,0.0,37,35,11,1,2,94.59459459
2015020488,29,3900,0.0,32,30,3,2,2,93.75
2015020489,8,933,0.0,4,4,0,0,0,100.0
2015020489,8,2667,0.0,23,17,6,0,6,73.91304348
2015020489,25,3600,0.0,23,21,7,0,2,91.30434783
2015020490,30,3504,0.0,39,36,9,0,3,92.30769231
2015020490,18,3574,0.0,22,20,3,1,2,90.90909091
2015020491,2,3535,0.0,29,28,4,2,1,96.55172414
2015020491,53,3600,0.0,25,25,2,1,0,100.0
2015020492,22,3600,0.0,29,24,0,1,5,82.75862069
2015020492,21,3600,0.0,40,39,3,0,1,97.5
2015020493,23,3900,0.0,42,38,1,1,4,90.47619048
2015020493,23,0,0.0,0,0,0,0,0,
2015020493,13,3900,0.0,34,30,3,0,4,88.23529412
2015020494,1,3900,0.0,39,38,3,1,1,97.43589744
2015020494,6,3900,0.0,30,29,1,1,1,96.66666667
2015020495,9,3563,0.0,33,30,3,2,3,90.90909091
2015020495,14,3600,2.0,25,23,4,0,2,92.0
2015020496,20,3436,0.0,34,31,2,0,3,91.17647059
2015020496,17,3600,0.0,28,26,2,1,2,92.85714286
2015020497,15,3600,0.0,36,33,9,0,3,91.66666667
2015020497,3,2400,0.0,24,19,7,1,5,79.16666667
2015020497,3,1200,0.0,6,4,0,0,2,66.66666667
2015020498,28,3741,0.0,32,28,2,0,4,87.5
2015020498,16,3741,0.0,36,33,5,0,3,91.66666667
2015020499,24,1200,0.0,11,8,0,0,3,72.72727273
2015020499,24,2391,0.0,19,18,5,0,1,94.73684211
2015020499,2,3600,0.0,29,27,0,0,2,93.10344828
2015020500,19,3521,0.0,31,27,3,2,4,87.09677419
2015020500,4,3597,0.0,29,26,1,1,3,89.65517241
2015020501,29,3568,2.0,34,30,3,0,4,88.23529412
2015020501,5,3600,0.0,24,22,2,0,2,91.66666667
2015020502,15,3600,0.0,32,31,5,0,1,96.875
2015020502,12,3479,0.0,21,19,5,0,2,90.47619048
2015020503,8,2588,0.0,14,11,3,0,3,78.57142857
2015020503,8,995,0.0,4,3,0,0,1,75.0
2015020503,18,3600,0.0,36,35,1,0,1,97.22222222
2015020504,25,3104,0.0,31,30,0,0,1,96.77419355
2015020504,25,496,0.0,4,2,0,0,2,50.0
2015020504,30,3500,0.0,32,28,5,0,4,87.5
2015020505,10,3600,0.0,28,24,0,0,4,85.71428571
2015020505,21,3527,0.0,21,15,1,3,6,71.42857143
2015020506,52,1664,0.0,14,11,1,0,3,78.57142857
2015020506,52,1767,0.0,7,7,0,1,0,100.0
2015020506,22,3600,0.0,45,44,12,3,1,97.77777778
2015020507,19,3589,0.0,32,32,0,1,0,100.0
2015020507,6,3448,0.0,29,27,2,0,2,93.10344828
2015020508,24,3739,0.0,22,19,4,2,3,86.36363636
2015020508,3,3757,0.0,19,17,2,0,2,89.47368421
2015020509,1,3600,0.0,28,25,4,2,3,89.28571429
2015020509,17,857,0.0,6,3,0,0,3,50.0
2015020509,17,2637,0.0,11,10,3,0,1,90.90909091
2015020510,23,3600,0.0,27,26,9,0,1,96.2962963
2015020510,14,3461,0.0,19,17,1,4,2,89.47368421
2015020511,9,3900,0.0,40,39,13,0,1,97.5
2015020511,13,3880,0.0,16,15,1,0,1,93.75
2015020512,8,3475,0.0,22,20,0,0,2,90.90909091
2015020512,30,3600,0.0,25,24,0,0,1,96.0
2015020513,16,3600,0.0,32,28,9,1,4,87.5
2015020513,25,3600,0.0,20,20,0,0,0,100.0
2015020514,52,3592,0.0,32,29,9,1,3,90.625
2015020514,20,3600,0.0,20,19,1,0,1,95.0
2015020515,10,3472,0.0,26,23,3,0,3,88.46153846
2015020515,53,3600,0.0,39,37,1,5,2,94.87179487
2015020516,28,3600,0.0,36,33,6,0,3,91.66666667
2015020516,26,3573,0.0,22,18,1,0,4,81.81818182
2015020517,7,3600,0.0,33,30,7,0,3,90.90909091
2015020517,6,3541,0.0,27,23,7,0,4,85.18518519
2015020518,29,2400,0.0,18,14,3,0,4,77.77777778
2015020518,29,1200,0.0,7,6,0,0,1,85.71428571
2015020518,14,3600,0.0,32,30,2,2,2,93.75
2015020519,8,3460,0.0,33,30,1,1,3,90.90909091
2015020519,15,3600,0.0,30,29,2,0,1,96.66666667
2015020520,1,3524,0.0,25,22,1,0,3,88.0
2015020520,12,3600,0.0,20,19,1,0,1,95.0
2015020521,25,3900,0.0,37,35,6,0,2,94.59459459
2015020521,19,3900,0.0,24,22,0,1,2,91.66666667
2015020522,17,3585,0.0,26,24,2,0,2,92.30769231
2015020522,18,3506,0.0,23,20,2,0,3,86.95652174
2015020523,5,3600,0.0,26,25,9,0,1,96.15384615
2015020523,30,3484,0.0,32,29,4,1,3,90.625
2015020524,26,3636,0.0,27,24,7,1,3,88.88888889
2015020524,53,3634,0.0,33,29,10,1,4,87.87878788
2015020525,22,3841,0.0,24,22,2,1,2,91.66666667
2015020525,23,3826,0.0,33,32,4,0,1,96.96969697
2015020526,6,3559,0.0,21,19,1,0,2,90.47619048
2015020526,9,3600,0.0,39,38,5,1,1,97.43589744
2015020527,29,3522,0.0,32,29,14,0,3,90.625
2015020527,13,3589,0.0,17,15,4,0,2,88.23529412
2015020528,10,3585,0.0,26,25,1,1,1,96.15384615
2015020528,2,3550,0.0,37,35,5,0,2,94.59459459
2015020529,19,3559,0.0,37,35,3,0,2,94.59459459
2015020529,25,3600,0.0,22,22,2,1,0,100.0
2015020530,12,3600,0.0,36,35,0,0,1,97.22222222
2015020530,16,3432,0.0,27,25,0,0,2,92.59259259
2015020531,5,3523,0.0,28,27,2,2,1,96.42857143
2015020531,52,3598,0.0,30,30,3,0,0,100.0
2015020532,53,3857,0.0,39,38,3,3,1,97.43589744
2015020532,21,3857,0.0,28,26,2,1,2,92.85714286
2015020533,4,3538,2.0,37,33,4,0,4,89.18918919
2015020533,24,3600,0.0,26,24,9,0,2,92.30769231
2015020534,22,2400,0.0,30,26,2,1,4,86.66666667
2015020534,22,1200,0.0,7,6,0,0,1,85.71428571
2015020534,20,3600,0.0,31,28,1,0,3,90.32258065
2015020535,15,3600,0.0,31,31,2,0,0,100.0
2015020535,7,3497,0.0,26,24,1,0,2,92.30769231
2015020536,8,3900,0.0,39,36,4,0,3,92.30769231
2015020536,14,3884,0.0,34,31,6,1,3,91.17647059
2015020537,3,3127,0.0,35,30,2,0,5,85.71428571
2015020537,3,319,0.0,0,0,0,0,0,
2015020537,18,3600,0.0,29,26,3,1,3,89.65517241
2015020538,17,3486,0.0,34,32,0,0,2,94.11764706
2015020538,30,3600,0.0,29,28,7,0,1,96.55172414
2015020539,26,3600,0.0,27,27,6,0,0,100.0
2015020539,23,3598,0.0,38,33,2,0,5,86.84210526
2015020540,21,3599,0.0,38,35,4,1,3,92.10526316
2015020540,28,3510,0.0,25,20,7,0,5,80.0
2015020541,9,3600,0.0,37,30,6,4,7,81.08108108
2015020541,6,3586,0.0,32,29,3,2,3,90.625
2015020542,2,3600,0.0,33,30,5,1,3,90.90909091
2015020542,10,1200,0.0,6,6,0,0,0,100.0
2015020542,10,2385,0.0,15,9,1,0,6,60.0
2015020543,12,3496,0.0,24,21,3,1,3,87.5
2015020543,1,3571,0.0,28,26,1,0,2,92.85714286
2015020544,25,2239,0.0,18,16,0,0,2,88.88888889
2015020544,25,1200,0.0,14,11,1,0,3,78.57142857
2015020544,29,3565,0.0,43,40,6,2,3,93.02325581
2015020545,8,3507,0.0,30,27,1,0,3,90.0
2015020545,13,3575,0.0,30,29,3,2,1,96.66666667
2015020546,18,3833,0.0,25,21,4,0,4,84.0
2015020546,19,3841,0.0,33,30,8,0,3,90.90909091
2015020547,17,1903,0.0,14,10,3,1,4,71.42857143
2015020547,17,1697,0.0,11,11,0,0,0,100.0
2015020547,52,3600,0.0,34,33,9,0,1,97.05882353
2015020548,24,3597,0.0,14,14,3,0,0,100.0
2015020548,20,3479,0.0,21,20,1,0,1,95.23809524
2015020549,26,3597,0.0,44,42,7,1,2,95.45454545
2015020549,22,2042,0.0,19,17,1,0,2,89.47368421
2015020549,22,1558,0.0,14,11,0,0,3,78.57142857
2015020550,16,3600,0.0,37,32,13,1,5,86.48648649
2015020550,53,2352,0.0,22,19,3,2,3,86.36363636
2015020550,53,1200,0.0,5,2,1,0,3,40.0
2015020551,10,3900,0.0,41,39,9,2,2,95.12195122
2015020551,5,3900,0.0,36,34,4,5,2,94.44444444
2015020552,7,3542,0.0,42,38,5,1,4,90.47619048
2015020552,15,3582,0.0,27,25,6,1,2,92.59259259
2015020553,1,3567,0.0,36,36,10,0,0,100.0
2015020553,9,3484,2.0,20,18,3,1,2,90.0
2015020554,3,3600,0.0,22,20,1,0,2,90.90909091
2015020554,14,3560,0.0,24,21,4,0,3,87.5
2015020555,4,3600,0.0,33,29,9,0,4,87.87878788
2015020555,28,3600,0.0,19,17,3,0,2,89.47368421
2015020556,2,3587,0.0,43,42,14,1,1,97.6744186
2015020556,7,3485,0.0,33,31,3,0,2,93.93939394
2015020557,5,3600,0.0,35,33,5,0,2,94.28571429
2015020557,17,3443,0.0,36,32,4,0,4,88.88888889
2015020558,15,3549,0.0,36,33,7,0,3,91.66666667
2015020558,12,3600,0.0,32,30,0,0,2,93.75
2015020559,30,3600,0.0,34,33,4,0,1,97.05882353
2015020559,19,3492,0.0,28,26,3,1,2,92.85714286
2015020560,16,3787,0.0,30,27,1,2,3,90.0
2015020560,21,3809,0.0,43,39,5,2,4,90.69767442
2015020561,18,3600,0.0,32,27,2,1,5,84.375
2015020561,25,3600,0.0,34,33,0,1,1,97.05882353
2015020562,26,3600,0.0,24,23,6,0,1,95.83333333
2015020562,20,3458,0.0,23,20,0,1,3,86.95652174
2015020563,24,3600,0.0,21,21,4,0,0,100.0
2015020563,22,3502,0.0,35,34,4,0,1,97.14285714
2015020564,52,3479,0.0,20,17,4,0,3,85.0
2015020564,53,3589,0.0,37,35,4,1,2,94.59459459
2015020565,8,3589,0.0,28,27,7,1,1,96.42857143
2015020565,6,3584,0.0,30,25,6,0,5,83.33333333
2015020566,24,3900,0.0,25,24,3,0,1,96.0
2015020566,23,3900,0.0,28,27,5,0,1,96.42857143
2015020567,17,3586,0.0,35,32,5,2,3,91.42857143
2015020567,7,3496,0.0,23,19,3,1,4,82.60869565
2015020568,53,3900,0.0,41,38,7,1,3,92.68292683
2015020568,22,3900,0.0,34,31,6,1,3,91.17647059
2015020569,4,3491,0.0,32,30,6,1,2,93.75
2015020569,26,3600,0.0,30,29,9,2,1,96.66666667
2015020570,19,3481,0.0,32,29,4,0,3,90.625
2015020570,10,3600,0.0,40,39,0,3,1,97.5
2015020571,30,3900,0.0,30,28,2,1,2,93.33333333
2015020571,14,3900,0.0,32,30,9,0,2,93.75
2015020572,3,3600,0.0,20,17,4,2,3,85.0
2015020572,13,3588,0.0,40,40,6,1,0,100.0
2015020573,25,3707,0.0,30,27,3,0,3,90.0
2015020573,1,3658,0.0,31,29,3,1,2,93.5483871
2015020574,2,1857,0.0,26,22,5,0,4,84.61538462
2015020574,2,1743,0.0,17,16,2,0,1,94.11764706
2015020574,5,3600,0.0,40,38,1,0,2,95.0
2015020575,18,3789,0.0,28,27,4,1,1,96.42857143
2015020575,12,3789,0.0,21,19,3,1,2,90.47619048
2015020576,15,3875,0.0,29,25,0,0,4,86.20689655
2015020576,29,3622,0.0,27,23,8,0,4,85.18518519
2015020576,29,245,0.0,6,6,6,0,0,100.0
2015020577,20,3600,0.0,26,26,4,4,0,100.0
2015020577,21,1613,0.0,15,15,6,0,0,100.0
2015020577,21,1987,0.0,19,15,6,2,4,78.94736842
2015020578,52,3600,0.0,28,27,6,0,1,96.42857143
2015020578,28,2400,0.0,20,17,0,3,3,85.0
2015020578,28,1157,0.0,6,6,0,0,0,100.0
2015020579,25,3465,0.0,44,38,15,0,6,86.36363636
2015020579,2,3600,0.0,41,36,6,1,5,87.80487805
2015020580,30,3467,0.0,29,27,7,0,2,93.10344828
2015020580,13,3600,0.0,40,39,9,1,1,97.5
2015020581,9,3524,0.0,29,27,0,0,2,93.10344828
2015020581,16,3575,0.0,26,26,2,0,0,100.0
2015020582,52,3581,0.0,35,31,3,4,4,88.57142857
2015020582,24,3597,0.0,20,19,4,0,1,95.0
2015020583,17,3586,0.0,22,22,0,0,0,100.0
2015020583,1,3536,0.0,21,20,0,0,1,95.23809524
2015020584,9,3753,0.0,38,36,5,0,2,94.73684211
2015020584,19,3753,0.0,32,29,1,1,3,90.625
2015020585,26,3600,0.0,33,29,6,2,4,87.87878788
2015020585,21,3600,2.0,31,30,13,0,1,96.77419355
2015020586,12,3767,0.0,27,26,1,0,1,96.2962963
2015020586,22,3767,0.0,29,29,1,0,0,100.0
2015020587,53,3600,0.0,37,35,4,1,2,94.59459459
2015020587,23,3538,0.0,29,26,3,0,3,89.65517241
2015020588,15,3600,0.0,27,25,3,0,2,92.59259259
2015020588,6,3495,0.0,29,26,2,1,3,89.65517241
2015020589,13,3600,0.0,32,31,6,0,1,96.875
2015020589,7,3551,0.0,26,22,0,0,4,84.61538462
2015020590,25,3573,0.0,29,23,6,2,6,79.31034483
2015020590,3,3600,0.0,23,21,3,0,2,91.30434783
2015020591,8,3425,0.0,31,27,5,0,4,87.09677419
2015020591,4,3600,0.0,24,21,5,1,3,87.5
2015020592,16,3827,0.0,36,34,2,0,2,94.44444444
2015020592,5,3827,0.0,30,27,1,0,3,90.0
2015020593,30,3564,2.0,31,29,1,0,2,93.5483871
2015020593,29,3514,0.0,31,29,2,1,2,93.5483871
2015020594,52,3600,0.0,44,43,11,0,1,97.72727273
2015020594,18,3445,0.0,17,14,0,1,3,82.35294118
2015020595,14,3501,0.0,23,21,0,0,2,91.30434783
2015020595,20,3600,0.0,31,30,0,0,1,96.77419355
2015020596,1,3536,0.0,25,23,2,2,2,92.0
2015020596,8,3600,0.0,20,19,1,1,1,95.0
2015020597,5,3557,0.0,36,34,3,1,2,94.44444444
2015020597,16,3600,0.0,18,17,2,0,1,94.44444444
2015020598,19,3883,0.0,33,29,5,1,4,87.87878788
2015020598,21,3840,0.0,38,35,1,0,3,92.10526316
2015020599,12,3548,0.0,21,18,3,1,3,85.71428571
2015020599,23,3586,0.0,28,26,4,3,2,92.85714286
2015020600,10,3600,2.0,39,39,5,0,0,100.0
2015020600,24,1159,0.0,13,12,2,0,1,92.30769231
2015020600,24,2441,0.0,25,22,5,1,3,88.0
2015020601,15,3600,0.0,35,34,9,2,1,97.14285714
2015020601,2,3592,0.0,37,34,4,0,3,91.89189189
2015020602,13,3600,0.0,32,30,6,2,2,93.75
2015020602,9,3474,0.0,16,13,0,0,3,81.25
2015020603,4,3863,0.0,34,31,3,1,3,91.17647059
2015020603,30,3831,0.0,36,32,3,0,4,88.88888889
2015020604,52,3900,0.0,24,23,0,0,1,95.83333333
2015020604,25,3889,0.0,33,32,6,0,1,96.96969697
2015020605,53,3600,0.0,26,25,3,0,1,96.15384615
2015020605,20,3509,0.0,33,31,5,0,2,93.93939394
2015020606,10,3416,0.0,41,39,3,0,2,95.12195122
2015020606,26,3600,0.0,26,25,3,0,1,96.15384615
2015020607,17,3600,0.0,36,35,2,0,1,97.22222222
2015020607,28,3568,0.0,25,23,2,0,2,92.0
2015020608,6,3600,0.0,20,19,1,1,1,95.0
2015020608,1,3594,0.0,31,27,2,0,4,87.09677419
2015020609,29,3476,0.0,28,25,8,1,3,89.28571429
2015020609,12,3600,0.0,36,35,7,0,1,97.22222222
2015020610,7,3569,0.0,44,42,1,0,2,95.45454545
2015020610,16,3600,0.0,29,28,3,0,1,96.55172414
2015020611,18,3445,0.0,26,22,4,1,4,84.61538462
2015020611,21,3600,0.0,22,19,2,0,3,86.36363636
2015020612,14,3600,0.0,26,24,3,0,2,92.30769231
2015020612,22,3534,0.0,26,23,3,0,3,88.46153846
2015020613,19,2277,0.0,27,25,6,0,2,92.59259259
2015020613,19,1623,0.0,12,11,1,0,1,91.66666667
2015020613,24,3897,0.0,28,25,4,1,3,89.28571429
2015020614,15,3599,0.0,26,23,3,2,3,88.46153846
2015020614,3,3685,0.0,31,27,4,0,4,87.09677419
2015020615,2,3600,0.0,31,27,4,0,4,87.09677419
2015020615,4,3600,0.0,20,20,3,0,0,100.0
2015020616,5,3600,0.0,34,33,7,1,1,97.05882353
2015020616,8,3520,0.0,31,29,7,0,2,93.5483871
2015020617,6,3862,0.0,40,38,2,0,2,95.0
2015020617,9,3862,0.0,34,33,0,0,1,97.05882353
2015020618,12,3764,0.0,24,21,1,0,3,87.5
2015020618,29,3765,0.0,30,26,7,0,4,86.66666667
2015020619,10,3565,0.0,31,24,4,0,7,77.41935484
2015020619,28,3598,0.0,28,28,9,1,0,100.0
2015020620,30,3600,0.0,35,34,6,0,1,97.14285714
2015020620,25,3445,0.0,25,23,0,0,2,92.0
2015020621,18,3547,0.0,28,25,4,0,3,89.28571429
2015020621,53,3596,0.0,26,26,6,0,0,100.0
2015020622,14,3828,0.0,23,21,2,1,2,91.30434783
2015020622,23,3831,0.0,35,32,11,0,3,91.42857143
2015020623,19,3895,0.0,27,26,6,1,1,96.2962963
2015020623,26,3864,0.0,16,15,5,0,1,93.75
2015020624,7,3600,0.0,44,42,5,1,2,95.45454545
2015020624,52,3517,0.0,28,25,4,0,3,89.28571429
2015020625,9,3596,0.0,36,29,7,0,7,80.55555556
2015020625,15,3600,2.0,33,32,7,0,1,96.96969697
2015020626,21,1331,0.0,15,13,1,1,2,86.66666667
2015020626,21,1945,0.0,20,16,0,0,4,80.0
2015020626,16,3600,0.0,37,34,5,0,3,91.89189189
2015020627,1,3600,0.0,18,17,0,0,1,94.44444444
2015020627,30,3504,0.0,17,15,2,0,2,88.23529412
2015020628,17,3600,0.0,31,30,3,0,1,96.77419355
2015020628,24,3483,0.0,24,22,3,0,2,91.66666667
2015020629,13,3600,0.0,25,24,6,0,1,96.0
2015020629,22,3491,0.0,14,12,0,1,2,85.71428571
2015020630,6,3509,0.0,30,28,0,0,2,93.33333333
2015020630,3,3600,0.0,33,32,3,0,1,96.96969697
2015020631,28,3600,0.0,35,31,3,0,4,88.57142857
2015020631,20,3468,0.0,18,13,0,0,5,72.22222222
2015020632,13,3741,0.0,30,27,6,0,3,90.0
2015020632,23,3741,0.0,28,26,1,0,2,92.85714286
2015020633,17,3549,2.0,30,27,0,0,3,90.0
2015020633,26,3600,0.0,27,25,5,0,2,92.59259259
2015020634,29,3454,0.0,32,28,5,1,4,87.5
2015020634,2,3600,0.0,20,18,7,0,2,90.0
2015020635,5,3780,0.0,21,18,6,0,3,85.71428571
2015020635,12,3778,0.0,25,23,0,0,2,92.0
2015020636,1,3488,0.0,36,32,8,0,4,88.88888889
2015020636,19,3593,0.0,24,22,3,0,2,91.66666667
2015020637,7,3600,0.0,30,28,1,0,2,93.33333333
2015020637,30,3459,2.0,23,20,2,0,3,86.95652174
2015020638,28,3600,0.0,22,21,1,5,1,95.45454545
2015020638,52,3559,0.0,26,23,6,0,3,88.46153846
2015020639,18,3494,0.0,23,20,4,1,3,86.95652174
2015020639,16,3600,0.0,43,41,7,1,2,95.34883721
2015020640,14,3600,0.0,21,21,6,0,0,100.0
2015020640,21,3600,0.0,38,34,6,0,4,89.47368421
2015020641,22,3891,0.0,31,27,4,0,4,87.09677419
2015020641,53,3889,0.0,28,25,1,1,3,89.28571429
2015020642,29,3600,0.0,42,41,2,0,1,97.61904762
2015020642,10,3494,0.0,21,19,1,0,2,90.47619048
2015020643,6,3464,0.0,21,18,2,0,3,85.71428571
2015020643,4,3568,0.0,32,30,1,2,2,93.75
2015020644,13,2400,0.0,21,19,2,2,2,90.47619048
2015020644,13,1200,0.0,15,11,4,0,4,73.33333333
2015020644,20,3600,0.0,15,15,0,0,0,100.0
2015020645,9,3589,0.0,38,34,5,1,4,89.47368421
2015020645,24,3600,0.0,25,24,6,1,1,96.0
2015020646,3,3513,0.0,31,29,2,0,2,93.5483871
2015020646,2,3600,0.0,35,34,11,0,1,97.14285714
2015020647,23,3485,0.0,39,36,4,0,3,92.30769231
2015020647,15,3598,0.0,30,29,4,1,1,96.66666667
2015020648,16,3599,0.0,40,39,3,0,1,97.5
2015020648,8,3490,0.0,33,31,1,0,2,93.93939394
2015020649,12,3561,0.0,24,23,1,0,1,95.83333333
2015020649,19,2822,0.0,24,21,1,1,3,87.5
2015020649,19,767,0.0,4,3,0,0,1,75.0
2015020650,18,3458,0.0,24,19,4,0,5,79.16666667
2015020650,52,3651,0.0,35,31,2,1,4,88.57142857
2015020651,1,3482,0.0,25,23,1,2,2,92.0
2015020651,21,3590,0.0,27,27,3,2,0,100.0
2015020652,17,3728,0.0,29,27,2,0,2,93.10344828
2015020652,53,3728,0.0,25,22,5,0,3,88.0
2015020653,22,3898,0.0,37,36,10,0,1,97.2972973
2015020653,28,3900,0.0,25,24,0,0,1,96.0
2015020654,6,3600,0.0,34,33,7,1,1,97.05882353
2015020654,7,3566,0.0,30,27,1,1,3,90.0
2015020655,16,3600,0.0,29,28,6,1,1,96.55172414
2015020655,10,3522,0.0,28,25,2,1,3,89.28571429
2015020656,23,3795,0.0,40,38,7,0,2,95.0
2015020656,12,3805,0.0,22,19,0,0,3,86.36363636
2015020657,5,3731,0.0,25,20,1,0,5,80.0
2015020657,14,3731,0.0,40,36,8,0,4,90.0
2015020658,52,3600,0.0,24,24,6,0,0,100.0
2015020658,30,3470,0.0,26,25,3,0,1,96.15384615
2015020659,25,3478,0.0,35,31,8,1,4,88.57142857
2015020659,24,3600,0.0,24,22,4,0,2,91.66666667
2015020660,3,3900,0.0,36,34,7,0,2,94.44444444
2015020660,4,3864,0.0,31,29,6,0,2,93.5483871
2015020661,9,3600,0.0,33,30,6,0,3,90.90909091
2015020661,26,3537,0.0,22,18,2,0,4,81.81818182
2015020662,10,3564,0.0,45,42,3,2,3,93.33333333
2015020662,6,3600,0.0,29,27,9,0,2,93.10344828
2015020663,15,1966,0.0,13,12,9,0,1,92.30769231
2015020663,15,1634,0.0,16,13,5,1,3,81.25
2015020663,7,3578,0.0,34,33,13,2,1,97.05882353
2015020664,21,3533,0.0,21,19,3,0,2,90.47619048
2015020664,29,3597,0.0,30,29,4,1,1,96.66666667
2015020665,8,3710,0.0,22,18,1,3,4,81.81818182
2015020665,19,3723,0.0,49,46,14,1,3,93.87755102
2015020666,30,3561,0.0,24,22,3,1,2,91.66666667
2015020666,18,3600,0.0,29,29,2,1,0,100.0
2015020667,1,3599,0.0,38,38,9,2,0,100.0
2015020667,53,3431,0.0,16,14,2,1,2,87.5
2015020668,20,3900,0.0,37,36,2,2,1,97.2972973
2015020668,22,3900,0.0,32,31,6,0,1,96.875
2015020669,25,3672,0.0,39,35,2,0,4,89.74358974
2015020669,28,3672,0.0,35,32,6,1,3,91.42857143
2015020670,12,3600,0.0,32,27,4,0,5,84.375
2015020670,5,3600,0.0,22,22,7,0,0,100.0
2015020671,23,3900,0.0,48,47,10,4,1,97.91666667
2015020671,2,3868,0.0,26,25,8,0,1,96.15384615
2015020672,13,3596,0.0,31,29,4,1,2,93.5483871
2015020672,14,3600,0.0,27,26,6,0,1,96.2962963
2015020673,3,3539,0.0,23,19,1,1,4,82.60869565
2015020673,15,1338,0.0,11,11,1,0,0,100.0
2015020673,15,2262,0.0,22,20,3,0,2,90.90909091
2015020674,8,3573,0.0,32,28,7,0,4,87.5
2015020674,16,3596,0.0,29,27,5,1,2,93.10344828
2015020675,4,3900,0.0,30,29,8,0,1,96.66666667
2015020675,17,3897,0.0,31,30,13,1,1,96.77419355
2015020676,26,3600,0.0,32,30,9,0,2,93.75
2015020676,24,3578,2.0,26,23,3,0,3,88.46153846
2015020677,22,3597,0.0,33,31,5,0,2,93.93939394
2015020677,13,3599,0.0,24,20,2,0,4,83.33333333
2015020678,5,3402,0.0,24,20,3,1,4,83.33333333
2015020678,19,3600,0.0,38,36,7,1,2,94.73684211
2015020679,21,3578,0.0,37,36,2,1,1,97.2972973
2015020679,52,3479,0.0,34,32,2,0,2,94.11764706
2015020680,7,3600,0.0,27,26,13,1,1,96.2962963
2015020680,53,3502,0.0,28,26,2,3,2,92.85714286
2015020681,9,3900,0.0,35,32,5,0,3,91.42857143
2015020681,28,3892,0.0,17,14,0,0,3,82.35294118
2015020682,20,3500,0.0,25,22,1,1,3,88.0
2015020682,1,3600,0.0,28,26,3,1,2,92.85714286
2015020683,23,3834,0.0,49,46,0,0,3,93.87755102
2015020683,3,3826,0.0,20,18,0,0,2,90.0
2015020684,10,3594,0.0,33,31,3,1,2,93.93939394
2015020684,4,3592,0.0,35,32,4,0,3,91.42857143
2015020685,15,3600,0.0,35,32,6,0,3,91.42857143
2015020685,29,3460,0.0,27,22,2,0,5,81.48148148
2015020686,6,3594,0.0,39,38,6,2,1,97.43589744
2015020686,8,3562,0.0,23,20,4,1,3,86.95652174
2015020687,22,3546,0.0,30,25,0,2,5,83.33333333
2015020687,14,3600,0.0,26,22,4,1,4,84.61538462
2015020688,16,3600,0.0,39,38,6,0,1,97.43589744
2015020688,18,3531,0.0,26,23,1,0,3,88.46153846
2015020689,25,3461,2.0,29,26,2,0,3,89.65517241
2015020689,26,3600,0.0,29,27,0,0,2,93.10344828
2015020690,19,3600,0.0,30,29,3,0,1,96.66666667
2015020690,17,3478,0.0,20,18,2,0,2,90.0
2015020691,7,3583,0.0,35,33,5,0,2,94.28571429
2015020691,21,3600,0.0,28,27,4,3,1,96.42857143
2015020692,30,3551,0.0,26,24,3,1,2,92.30769231
2015020692,24,3581,0.0,26,25,3,0,1,96.15384615
2015020693,23,3600,0.0,30,28,0,0,2,93.33333333
2015020693,6,3497,0.0,26,23,0,0,3,88.46153846
2015020694,9,836,0.0,7,3,1,0,4,42.85714286
2015020694,9,2650,0.0,12,11,0,1,1,91.66666667
2015020694,1,3600,0.0,32,29,4,0,3,90.625
2015020695,4,3544,0.0,45,41,3,2,4,91.11111111
2015020695,5,3595,0.0,32,29,6,2,3,90.625
2015020696,20,3600,0.0,29,27,2,0,2,93.10344828
2015020696,29,1520,0.0,14,12,0,0,2,85.71428571
2015020696,29,1890,0.0,13,11,0,1,2,84.61538462
2015020697,12,3774,0.0,32,32,5,2,0,100.0
2015020697,10,3774,0.0,41,40,10,1,1,97.56097561
2015020698,16,3513,0.0,33,31,12,0,2,93.93939394
2015020698,14,3600,0.0,18,17,4,1,1,94.44444444
2015020699,18,3600,0.0,27,26,5,1,1,96.2962963
2015020699,52,3581,0.0,27,24,5,1,3,88.88888889
2015020700,22,3506,0.0,35,32,6,1,3,91.42857143
2015020700,25,3600,0.0,25,23,3,0,2,92.0
2015020701,28,3597,0.0,24,23,0,1,1,95.83333333
2015020701,53,3531,0.0,22,20,1,1,2,90.90909091
2015020702,30,3600,0.0,32,32,3,0,0,100.0
2015020702,26,3600,0.0,28,25,0,0,3,89.28571429
2015020703,17,3600,0.0,19,19,1,1,0,100.0
2015020703,7,3522,0.0,44,42,6,0,2,95.45454545
2015020704,24,3597,0.0,24,24,4,1,0,100.0
2015020704,15,3489,0.0,21,19,2,0,2,90.47619048
2015020705,3,3600,0.0,31,30,1,0,1,96.77419355
2015020705,12,3600,0.0,32,28,2,0,4,87.5
2015020706,2,3600,0.0,30,28,2,2,2,93.33333333
2015020706,9,3600,0.0,34,29,4,0,5,85.29411765
2015020707,16,3562,0.0,32,28,9,0,4,87.5
2015020707,13,3600,2.0,27,27,3,0,0,100.0
2015020708,19,3900,2.0,41,40,9,0,1,97.56097561
2015020708,21,3829,0.0,34,33,4,0,1,97.05882353
2015020709,23,3549,0.0,29,25,4,0,4,86.20689655
2015020709,5,3578,0.0,32,28,0,3,4,87.5
2015020710,30,3540,0.0,33,29,4,0,4,87.87878788
2015020710,28,3600,0.0,28,25,6,0,3,89.28571429
2015020711,29,3900,0.0,34,32,8,1,2,94.11764706
2015020711,6,3894,0.0,33,31,3,1,2,93.93939394
2015020712,8,3887,0.0,19,17,1,0,2,89.47368421
2015020712,10,3900,0.0,29,27,7,0,2,93.10344828
2015020713,24,3589,0.0,27,24,6,0,3,88.88888889
2015020713,17,3408,0.0,35,31,10,0,4,88.57142857
2015020714,14,2398,0.0,30,26,7,0,4,86.66666667
2015020714,14,854,0.0,4,4,0,1,0,100.0
2015020714,13,3600,0.0,40,38,11,1,2,95.0
2015020715,1,3576,0.0,23,22,1,0,1,95.65217391
2015020715,52,3446,0.0,16,13,1,0,3,81.25
2015020716,4,3600,0.0,17,15,4,0,2,88.23529412
2015020716,2,1200,0.0,9,7,2,0,2,77.77777778
2015020716,2,2400,0.0,18,15,0,1,3,83.33333333
2015020717,21,3600,0.0,43,42,6,1,1,97.6744186
2015020717,25,3427,0.0,15,12,1,0,3,80.0
2015020718,26,3600,0.0,24,21,5,0,3,87.5
2015020718,53,3600,0.0,28,26,6,0,2,92.85714286
2015020719,18,3600,0.0,24,23,2,0,1,95.83333333
2015020719,22,3510,0.0,24,21,3,0,3,87.5
2015020720,5,3539,0.0,37,34,5,1,3,91.89189189
2015020720,15,3598,0.0,30,28,1,2,2,93.33333333
2015020721,3,3595,0.0,32,30,2,0,2,93.75
2015020721,9,3578,0.0,35,35,6,0,0,100.0
2015020722,20,2170,0.0,17,15,5,0,2,88.23529412
2015020722,20,1430,0.0,19,16,2,0,3,84.21052632
2015020722,12,3600,0.0,35,33,2,0,2,94.28571429
2015020723,19,3480,0.0,25,23,2,0,2,92.0
2015020723,16,3600,0.0,25,25,1,0,0,100.0
2015020724,26,3812,0.0,32,30,3,0,2,93.75
2015020724,28,3846,0.0,32,29,4,3,3,90.625
2015020725,17,3600,0.0,29,27,3,0,2,93.10344828
2015020725,2,3577,0.0,25,22,1,1,3,88.0
2015020726,7,3512,0.0,32,27,8,1,5,84.375
2015020726,3,3600,0.0,26,23,1,1,3,88.46153846
2015020727,6,3600,0.0,36,34,7,1,2,94.44444444
2015020727,4,3516,0.0,31,28,6,1,3,90.32258065
2015020728,8,3585,0.0,24,20,4,0,4,83.33333333
2015020728,29,3600,0.0,34,32,1,0,2,94.11764706
2015020729,20,3500,0.0,30,28,2,1,2,93.33333333
2015020729,25,3596,0.0,24,23,7,0,1,95.83333333
2015020730,53,3874,0.0,35,34,2,2,1,97.14285714
2015020730,30,3900,0.0,24,23,1,0,1,95.83333333
2015020731,24,3600,0.0,34,32,9,2,2,94.11764706
2015020731,6,2351,0.0,22,19,2,0,3,86.36363636
2015020731,6,1200,0.0,16,14,6,1,2,87.5
2015020732,1,3486,0.0,31,29,1,2,2,93.5483871
2015020732,5,3600,0.0,25,25,1,0,0,100.0
2015020733,16,1200,0.0,16,13,2,0,3,81.25
2015020733,16,2400,0.0,24,22,1,0,2,91.66666667
2015020733,12,3587,0.0,26,26,3,1,0,100.0
2015020734,29,3600,0.0,30,28,5,3,2,93.33333333
2015020734,8,3561,0.0,25,21,0,1,4,84.0
2015020735,7,3598,0.0,36,34,8,1,2,94.44444444
2015020735,9,3462,0.0,22,19,2,0,3,86.36363636
2015020736,10,3594,0.0,27,22,6,0,5,81.48148148
2015020736,13,3576,0.0,23,22,1,0,1,95.65217391
2015020737,53,2397,0.0,25,20,1,1,5,80.0
2015020737,53,1200,0.0,12,12,3,0,0,100.0
2015020737,52,3600,0.0,34,32,5,0,2,94.11764706
2015020738,18,3600,0.0,29,28,3,0,1,96.55172414
2015020738,23,3511,0.0,19,17,3,0,2,89.47368421
2015020739,21,2361,0.0,20,16,3,0,4,80.0
2015020739,21,1108,0.0,3,2,0,0,1,66.66666667
2015020739,28,3600,0.0,22,21,3,1,1,95.45454545
2015020740,10,3488,0.0,29,28,7,0,1,96.55172414
2015020740,14,3600,0.0,30,30,7,1,0,100.0
2015020741,4,3627,0.0,30,27,2,1,3,90.0
2015020741,15,3638,4.0,32,28,1,2,4,87.5
2015020742,18,3600,0.0,27,26,7,0,1,96.2962963
2015020742,20,3486,0.0,24,22,4,0,2,91.66666667
2015020743,21,3600,0.0,38,35,7,0,3,92.10526316
2015020743,26,3520,0.0,19,15,5,0,4,78.94736842
2015020744,10,3749,0.0,42,39,4,0,3,92.85714286
2015020744,6,3784,0.0,35,31,6,0,4,88.57142857
2015020745,3,3540,0.0,25,22,5,0,3,88.0
2015020745,1,3586,0.0,33,31,6,0,2,93.93939394
2015020746,30,2692,0.0,30,25,0,0,5,83.33333333
2015020746,30,675,0.0,8,8,0,1,0,100.0
2015020746,2,3600,0.0,43,40,10,0,3,93.02325581
2015020747,8,3523,0.0,35,32,9,3,3,91.42857143
2015020747,4,3561,0.0,32,30,8,1,2,93.75
2015020748,9,3509,0.0,44,38,9,0,6,86.36363636
2015020748,5,3600,0.0,23,18,1,0,5,78.26086957
2015020749,13,3600,0.0,38,36,8,1,2,94.73684211
2015020749,15,3545,0.0,18,14,1,1,4,77.77777778
2015020750,19,3600,0.0,16,16,2,0,0,100.0
2015020750,18,3527,0.0,23,22,2,1,1,95.65217391
2015020751,25,3600,0.0,24,21,1,1,3,87.5
2015020751,52,3525,0.0,26,22,5,1,4,84.61538462
2015020752,16,3600,0.0,23,22,4,1,1,95.65217391
2015020752,21,3474,0.0,42,40,1,0,2,95.23809524
2015020753,29,3600,0.0,35,30,7,1,5,85.71428571
2015020753,22,3600,0.0,37,36,9,0,1,97.2972973
2015020754,26,3582,0.0,26,24,6,1,2,92.30769231
2015020754,53,2585,0.0,25,20,3,1,5,80.0
2015020754,53,1012,0.0,10,9,2,0,1,90.0
2015020755,28,3491,0.0,25,22,4,1,3,88.0
2015020755,24,3600,0.0,32,30,6,0,2,93.75
2015020756,7,3560,0.0,35,33,5,1,2,94.28571429
2015020756,8,3528,0.0,31,28,3,1,3,90.32258065
2015020757,17,3409,0.0,23,20,2,0,3,86.95652174
2015020757,14,3600,0.0,25,24,0,0,1,96.0
2015020758,12,3600,0.0,24,20,1,1,4,83.33333333
2015020758,20,3600,0.0,29,28,11,0,1,96.55172414
2015020759,6,3900,0.0,28,26,6,1,2,92.85714286
2015020759,7,3900,0.0,33,31,7,0,2,93.93939394
2015020760,30,3516,0.0,29,26,5,1,3,89.65517241
2015020760,3,3600,0.0,18,16,2,0,2,88.88888889
2015020761,2,3515,0.0,23,20,2,0,3,86.95652174
2015020761,15,3600,0.0,26,24,8,0,2,92.30769231
2015020762,1,3900,0.0,39,37,4,1,2,94.87179487
2015020762,10,3876,0.0,34,32,6,2,2,94.11764706
2015020763,22,3596,0.0,38,36,8,0,2,94.73684211
2015020763,9,701,0.0,10,7,1,0,3,70.0
2015020763,9,2899,0.0,18,14,1,0,4,77.77777778
2015020764,17,3496,0.0,32,27,4,3,5,84.375
2015020764,13,3600,0.0,39,36,17,0,3,92.30769231
2015020765,28,3598,0.0,27,26,4,1,1,96.2962963
2015020765,19,3431,0.0,32,29,4,1,3,90.625
2015020766,4,3600,0.0,40,37,10,0,3,92.5
2015020766,18,3600,0.0,19,13,3,1,6,68.42105263
2015020767,25,3635,0.0,24,21,3,0,3,87.5
2015020767,21,3635,0.0,44,40,2,1,4,90.90909091
2015020768,16,3867,0.0,28,24,9,0,4,85.71428571
2015020768,53,3869,0.0,40,35,5,0,5,87.5
2015020769,29,3900,0.0,38,37,6,0,1,97.36842105
2015020769,23,3900,0.0,28,27,1,0,1,96.42857143
2015020770,24,3600,0.0,25,23,5,1,2,92.0
2015020770,26,2220,0.0,15,14,3,0,1,93.33333333
2015020770,26,1361,0.0,9,6,3,0,3,66.66666667
2015020771,5,1755,0.0,14,10,3,1,4,71.42857143
2015020771,5,1786,0.0,14,13,0,0,1,92.85714286
2015020771,14,3600,0.0,30,27,5,0,3,90.0
2015020772,12,3595,0.0,36,33,4,2,3,91.66666667
2015020772,52,273,0.0,6,3,1,0,3,50.0
2015020772,52,3249,0.0,23,21,6,0,2,91.30434783
2015020773,29,3600,0.0,31,30,1,0,1,96.77419355
2015020773,20,3502,0.0,18,16,0,0,2,88.88888889
2015020774,53,3600,0.0,41,36,11,0,5,87.80487805
2015020774,24,3578,0.0,25,23,4,1,2,92.0
2015020775,15,3900,0.0,24,22,0,0,2,91.66666667
2015020775,1,3900,0.0,29,27,1,0,2,93.10344828
2015020776,3,3851,0.0,28,26,5,0,2,92.85714286
2015020776,4,3900,0.0,28,26,3,1,2,92.85714286
2015020777,22,1200,0.0,13,12,1,0,1,92.30769231
2015020777,22,2400,0.0,23,19,1,2,4,82.60869565
2015020777,8,3600,0.0,24,23,4,0,1,95.83333333
2015020778,2,1820,0.0,13,9,2,1,4,69.23076923
2015020778,2,1780,0.0,7,6,2,0,1,85.71428571
2015020778,17,3600,0.0,29,28,2,2,1,96.55172414
2015020779,7,3749,0.0,38,36,4,0,2,94.73684211
2015020779,6,3752,0.0,38,37,7,0,1,97.36842105
2015020780,10,458,0.0,8,5,0,1,3,62.5
2015020780,10,3142,0.0,17,14,0,0,3,82.35294118
2015020780,9,3598,0.0,27,26,4,2,1,96.2962963
2015020781,5,3680,0.0,44,42,9,0,2,95.45454545
2015020781,13,3687,0.0,35,32,7,1,3,91.42857143
2015020782,30,3587,0.0,24,20,7,2,4,83.33333333
2015020782,19,3600,0.0,39,38,17,0,1,97.43589744
2015020783,28,3556,0.0,29,24,3,1,5,82.75862069
2015020783,18,3600,0.0,30,28,5,0,2,93.33333333
2015020784,16,3580,0.0,37,36,10,1,1,97.2972973
2015020784,25,1200,0.0,11,8,0,1,3,72.72727273
2015020784,25,2400,0.0,15,13,3,0,2,86.66666667
2015020785,52,3600,0.0,34,32,4,1,2,94.11764706
2015020785,21,3439,0.0,39,35,1,0,4,89.74358974
2015020786,20,3600,0.0,35,34,2,0,1,97.14285714
2015020786,23,3503,0.0,28,26,3,0,2,92.85714286
2015020787,4,3517,0.0,30,27,1,1,3,90.0
2015020787,15,3600,0.0,35,33,8,2,2,94.28571429
2015020788,12,3900,0.0,34,33,3,0,1,97.05882353
2015020788,8,3900,0.0,35,34,6,1,1,97.14285714
2015020789,22,684,0.0,10,7,5,0,3,70.0
2015020789,22,2915,0.0,21,16,2,1,5,76.19047619
2015020789,2,3600,0.0,31,30,2,2,1,96.77419355
2015020790,1,3541,0.0,37,35,13,0,2,94.59459459
2015020790,3,3600,0.0,28,27,0,2,1,96.42857143
2015020791,24,793,0.0,4,4,0,0,0,100.0
2015020791,24,2807,0.0,31,25,3,0,6,80.64516129
2015020791,5,3600,0.0,38,36,3,0,2,94.73684211
2015020792,14,3329,0.0,28,24,8,0,4,85.71428571
2015020792,9,3600,0.0,32,31,1,1,1,96.875
2015020793,13,3600,0.0,31,28,5,0,3,90.32258065
2015020793,17,3600,0.0,23,23,5,1,0,100.0
2015020794,26,3600,0.0,37,35,3,0,2,94.59459459
2015020794,6,1949,0.0,32,27,4,0,5,84.375
2015020794,6,1638,0.0,25,21,0,0,4,84.0
2015020795,13,3600,0.0,34,30,6,0,4,88.23529412
2015020795,7,2348,0.0,22,20,3,0,2,90.90909091
2015020795,7,1222,0.0,12,8,0,0,4,66.66666667
2015020796,22,3455,0.0,26,24,7,1,2,92.30769231
2015020796,1,3600,0.0,20,19,3,1,1,95.0
2015020797,24,3600,0.0,29,28,10,1,1,96.55172414
2015020797,4,3504,0.0,25,22,3,2,3,88.0
2015020798,2,3900,0.0,31,29,3,0,2,93.5483871
2015020798,29,3900,0.0,46,44,0,0,2,95.65217391
2015020799,14,3397,0.0,27,23,3,0,4,85.18518519
2015020799,8,3600,0.0,39,37,5,0,2,94.87179487
2015020800,52,3900,0.0,22,21,2,2,1,95.45454545
2015020800,19,3894,0.0,33,32,7,1,1,96.96969697
2015020801,15,3600,0.0,26,23,7,0,3,88.46153846
2015020801,18,3530,0.0,22,18,0,1,4,81.81818182
2015020802,25,3754,0.0,40,37,8,0,3,92.5
2015020802,30,3730,0.0,30,26,4,0,4,86.66666667
2015020803,28,3600,0.0,33,33,4,0,0,100.0
2015020803,16,3505,0.0,26,25,0,0,1,96.15384615
2015020804,23,3600,0.0,30,29,8,0,1,96.66666667
2015020804,21,3392,0.0,28,25,2,0,3,89.28571429
2015020805,10,3462,0.0,22,18,1,0,4,81.81818182
2015020805,20,3600,0.0,36,33,2,1,3,91.66666667
2015020806,9,3472,0.0,28,26,1,1,2,92.85714286
2015020806,17,3599,0.0,23,22,3,0,1,95.65217391
2015020807,3,3600,0.0,34,34,5,1,0,100.0
2015020807,5,3579,0.0,21,19,0,0,2,90.47619048
2015020808,23,3600,0.0,34,33,4,3,1,97.05882353
2015020808,53,3526,0.0,26,24,1,2,2,92.30769231
2015020809,26,3508,0.0,29,25,0,2,4,86.20689655
2015020809,2,3598,0.0,30,28,2,3,2,93.33333333
2015020810,7,3600,2.0,28,23,5,1,5,82.14285714
2015020810,4,3591,0.0,42,41,6,2,1,97.61904762
2015020811,24,3880,0.0,34,31,4,0,3,91.17647059
2015020811,29,3900,0.0,27,24,3,1,3,88.88888889
2015020812,21,3600,0.0,29,26,1,1,3,89.65517241
2015020812,9,3506,0.0,26,23,7,1,3,88.46153846
2015020813,15,3599,0.0,36,33,7,2,3,91.66666667
2015020813,30,3472,0.0,32,29,7,1,3,90.625
2015020814,6,3599,0.0,36,34,10,0,2,94.44444444
2015020814,52,1197,0.0,11,8,0,0,3,72.72727273
2015020814,52,2379,0.0,27,25,14,1,2,92.59259259
2015020815,25,3600,0.0,46,44,5,1,2,95.65217391
2015020815,16,1200,0.0,18,14,2,0,4,77.77777778
2015020815,16,2196,0.0,14,14,0,1,0,100.0
2015020816,10,3505,0.0,34,30,10,0,4,88.23529412
2015020816,22,3600,0.0,36,34,14,0,2,94.44444444
2015020817,20,480,0.0,8,8,5,0,0,100.0
2015020817,20,3420,0.0,34,29,8,0,5,85.29411765
2015020817,28,3900,0.0,22,17,4,1,5,77.27272727
2015020818,8,2267,0.0,13,11,2,0,2,84.61538462
2015020818,8,1288,0.0,8,5,1,0,3,62.5
2015020818,7,3600,0.0,30,26,1,0,4,86.66666667
2015020819,26,3738,0.0,28,24,0,1,4,85.71428571
2015020819,3,3790,0.0,34,29,1,0,5,85.29411765
2015020820,5,3900,0.0,30,29,0,0,1,96.66666667
2015020820,12,3900,0.0,26,25,0,0,1,96.15384615
2015020821,21,3900,0.0,45,43,7,0,2,95.55555556
2015020821,17,3900,0.0,21,19,3,1,2,90.47619048
2015020822,18,3664,0.0,28,24,3,0,4,85.71428571
2015020822,14,3622,0.0,30,27,3,1,3,90.0
2015020823,19,3600,0.0,32,29,3,0,3,90.625
2015020823,13,2279,0.0,15,13,0,1,2,86.66666667
2015020823,13,1200,0.0,13,10,0,0,3,76.92307692
2015020824,20,3587,0.0,35,31,12,2,4,88.57142857
2015020824,53,3587,0.0,27,26,8,0,1,96.2962963
2015020825,1,3776,0.0,32,31,8,0,1,96.875
2015020825,4,3776,0.0,24,22,2,0,2,91.66666667
2015020826,6,3589,0.0,33,31,5,0,2,93.93939394
2015020826,30,3564,0.0,18,15,7,2,3,83.33333333
2015020827,18,3600,0.0,22,22,2,1,0,100.0
2015020827,13,3600,0.0,28,23,5,1,5,82.14285714
2015020828,2,1175,0.0,3,3,0,0,0,100.0
2015020828,2,2400,0.0,28,22,2,0,6,78.57142857
2015020828,12,2254,0.0,16,14,2,0,2,87.5
2015020828,12,1346,0.0,10,9,0,0,1,90.0
2015020829,9,3505,0.0,39,36,2,2,3,92.30769231
2015020829,29,3600,0.0,35,33,3,1,2,94.28571429
2015020830,10,3594,0.0,19,17,2,0,2,89.47368421
2015020830,23,3494,0.0,36,33,13,1,3,91.66666667
2015020831,15,1095,0.0,10,10,5,0,0,100.0
2015020831,15,2400,0.0,25,21,4,0,4,84.0
2015020831,25,3600,0.0,23,20,4,0,3,86.95652174
2015020832,24,1336,0.0,6,5,0,0,1,83.33333333
2015020832,24,2398,0.0,17,16,1,0,1,94.11764706
2015020832,16,3736,0.0,44,41,6,0,3,93.18181818
2015020833,52,3882,0.0,22,21,4,1,1,95.45454545
2015020833,22,3881,0.0,33,32,9,0,1,96.96969697
2015020834,53,3590,0.0,27,24,3,0,3,88.88888889
2015020834,28,3598,0.0,23,22,7,2,1,95.65217391
2015020835,21,3208,0.0,18,17,3,1,1,94.44444444
2015020835,21,282,0.0,2,0,0,0,2,0.0
2015020835,7,3590,0.0,35,34,6,2,1,97.14285714
2015020836,26,3513,0.0,18,17,2,1,1,94.44444444
2015020836,1,3600,0.0,28,28,2,0,0,100.0
2015020837,6,1861,0.0,24,19,7,0,5,79.16666667
2015020837,6,1619,0.0,11,10,1,0,1,90.90909091
2015020837,17,3600,2.0,22,17,1,0,5,77.27272727
2015020838,19,3587,0.0,38,37,5,1,1,97.36842105
2015020838,14,3539,0.0,21,19,3,0,2,90.47619048
2015020839,4,3345,0.0,30,27,3,1,3,90.0
2015020839,3,3600,0.0,22,21,6,0,1,95.45454545
2015020840,17,3600,0.0,32,28,6,2,4,87.5
2015020840,2,3592,0.0,29,28,5,0,1,96.55172414
2015020841,24,3600,0.0,37,33,4,0,4,89.18918919
2015020841,20,1341,0.0,17,13,4,0,4,76.47058824
2015020841,20,2018,0.0,11,9,0,0,2,81.81818182
2015020842,5,3900,0.0,28,27,5,0,1,96.42857143
2015020842,13,3900,0.0,32,31,5,1,1,96.875
2015020843,25,3829,0.0,26,24,1,0,2,92.30769231
2015020843,18,3826,0.0,32,29,2,0,3,90.625
2015020844,10,3600,0.0,32,25,4,1,7,78.125
2015020844,16,3551,0.0,37,35,12,0,2,94.59459459
2015020845,8,3600,0.0,27,21,2,0,6,77.77777778
2015020845,53,3600,0.0,19,17,1,2,2,89.47368421
2015020846,30,3600,0.0,26,24,2,1,2,92.30769231
2015020846,23,3600,0.0,34,29,8,0,5,85.29411765
2015020847,4,3600,0.0,24,21,11,1,3,87.5
2015020847,1,3595,0.0,25,20,2,2,5,80.0
2015020848,26,3545,0.0,31,29,5,0,2,93.5483871
2015020848,15,3600,0.0,40,39,5,4,1,97.5
2015020849,52,3475,0.0,29,27,8,1,2,93.10344828
2015020849,12,3600,0.0,21,20,1,1,1,95.23809524
2015020850,6,3633,0.0,29,28,2,2,1,96.55172414
2015020850,29,3633,0.0,30,28,5,0,2,93.33333333
2015020851,7,3898,0.0,26,25,2,0,1,96.15384615
2015020851,9,3889,0.0,39,38,7,1,1,97.43589744
2015020852,28,3594,0.0,30,28,3,0,2,93.33333333
2015020852,14,3504,0.0,31,27,7,0,4,87.09677419
2015020853,25,3671,0.0,22,20,5,4,2,90.90909091
2015020853,19,3667,0.0,18,17,4,0,1,94.44444444
2015020854,24,3600,0.0,27,24,4,0,3,88.88888889
2015020854,22,3549,0.0,29,26,6,0,3,89.65517241
2015020855,16,3596,0.0,34,31,2,1,3,91.17647059
2015020855,3,3520,0.0,19,15,1,0,4,78.94736842
2015020856,8,3536,0.0,28,25,4,1,3,89.28571429
2015020856,21,3593,0.0,34,32,5,0,2,94.11764706
2015020857,30,3589,0.0,28,25,3,1,3,89.28571429
2015020857,20,3498,0.0,23,19,5,0,4,82.60869565
2015020858,15,3849,0.0,22,20,3,0,2,90.90909091
2015020858,2,3836,2.0,35,32,6,0,3,91.42857143
2015020859,17,668,0.0,6,6,0,0,0,100.0
2015020859,17,2786,0.0,32,27,1,0,5,84.375
2015020859,5,3600,0.0,38,35,3,0,3,92.10526316
2015020860,3,3600,0.0,37,35,5,3,2,94.59459459
2015020860,10,3530,0.0,19,16,1,3,3,84.21052632
2015020861,12,3432,0.0,21,18,3,0,3,85.71428571
2015020861,9,3595,0.0,32,30,2,0,2,93.75
2015020862,52,3897,0.0,26,21,5,0,5,80.76923077
2015020862,14,3900,0.0,41,36,6,1,5,87.80487805
2015020863,28,3898,0.0,20,19,3,1,1,95.0
2015020863,13,3891,0.0,18,17,3,0,1,94.44444444
2015020864,26,3700,2.0,32,30,6,0,2,93.75
2015020864,19,3675,0.0,35,34,8,2,1,97.14285714
2015020865,6,3409,0.0,24,22,2,0,2,91.66666667
2015020865,18,3600,0.0,29,29,6,0,0,100.0
2015020866,30,3597,0.0,33,31,5,0,2,93.93939394
2015020866,22,3448,0.0,26,22,4,0,4,84.61538462
2015020867,25,3557,0.0,41,36,5,1,5,87.80487805
2015020867,53,3592,0.0,39,36,5,0,3,92.30769231
2015020868,24,3600,0.0,21,19,2,0,2,90.47619048
2015020868,23,3555,0.0,32,28,4,0,4,87.5
2015020869,2,3600,0.0,27,27,0,2,0,100.0
2015020869,1,3511,0.0,24,23,2,0,1,95.83333333
2015020870,28,3564,0.0,36,32,6,0,4,88.88888889
2015020870,12,3600,0.0,24,22,0,0,2,91.66666667
2015020871,7,3600,4.0,38,38,4,2,0,100.0
2015020871,29,3090,0.0,31,27,4,0,4,87.09677419
2015020871,29,510,0.0,4,4,3,0,0,100.0
2015020872,4,3900,0.0,31,29,4,2,2,93.5483871
2015020872,8,3898,0.0,37,35,6,3,2,94.59459459
2015020873,23,3598,0.0,33,28,5,0,5,84.84848485
2015020873,20,3600,0.0,28,26,2,0,2,92.85714286
2015020874,14,3600,0.0,39,37,3,2,2,94.87179487
2015020874,5,3408,0.0,20,16,3,0,4,80.0
2015020875,4,1019,0.0,10,9,0,0,1,90.0
2015020875,4,2610,0.0,14,11,0,0,3,78.57142857
2015020875,10,2372,0.0,15,13,0,1,2,86.66666667
2015020875,10,1257,0.0,13,10,0,0,3,76.92307692
2015020876,17,3894,0.0,27,25,6,1,2,92.59259259
2015020876,9,3900,0.0,31,29,4,0,2,93.5483871
2015020877,52,3448,0.0,32,29,3,0,3,90.625
2015020877,13,3600,0.0,30,29,3,1,1,96.66666667
2015020878,1,3539,0.0,32,28,4,0,4,87.5
2015020878,15,3600,0.0,24,21,0,0,3,87.5
2015020879,26,3678,0.0,34,33,10,0,1,97.05882353
2015020879,18,3655,0.0,30,28,6,1,2,93.33333333
2015020880,6,3600,0.0,29,26,0,2,3,89.65517241
2015020880,25,3585,0.0,41,35,9,2,6,85.36585366
2015020881,19,3600,0.0,22,18,1,0,4,81.81818182
2015020881,53,2939,0.0,35,30,3,3,5,85.71428571
2015020881,53,594,0.0,4,4,0,0,0,100.0
2015020882,21,3595,0.0,27,25,2,0,2,92.59259259
2015020882,22,3361,0.0,29,26,6,0,3,89.65517241
2015020883,5,3600,0.0,27,24,1,0,3,88.88888889
2015020883,7,3523,0.0,31,27,6,1,4,87.09677419
2015020884,16,2400,2.0,23,19,7,0,4,82.60869565
2015020884,16,1157,0.0,9,8,1,0,1,88.88888889
2015020884,30,3600,0.0,32,31,4,4,1,96.875
2015020885,17,3719,0.0,30,29,7,0,1,96.66666667
2015020885,3,3715,0.0,22,22,1,0,0,100.0
2015020886,14,3600,0.0,31,29,1,1,2,93.5483871
2015020886,12,3467,0.0,17,14,4,0,3,82.35294118
2015020887,20,3587,0.0,33,28,2,1,5,84.84848485
2015020887,24,3600,0.0,24,22,5,0,2,91.66666667
2015020888,21,3482,2.0,28,24,1,1,4,85.71428571
2015020888,23,3600,0.0,38,37,4,2,1,97.36842105
2015020889,29,3600,0.0,30,26,3,1,4,86.66666667
2015020889,6,3421,0.0,34,29,1,2,5,85.29411765
2015020890,53,3517,0.0,34,31,10,2,3,91.17647059
2015020890,15,3600,0.0,27,25,3,0,2,92.59259259
2015020891,18,3881,0.0,29,28,2,0,1,96.55172414
2015020891,8,3900,0.0,30,29,2,0,1,96.66666667
2015020892,28,3600,0.0,28,25,1,1,3,89.28571429
2015020892,19,779,0.0,15,12,6,0,3,80.0
2015020892,19,2714,0.0,17,15,5,1,2,88.23529412
2015020893,3,3543,0.0,35,31,2,0,4,88.57142857
2015020893,1,3597,0.0,19,17,0,1,2,89.47368421
2015020894,4,3458,0.0,18,15,3,0,3,83.33333333
2015020894,12,3600,0.0,37,36,3,0,1,97.2972973
2015020895,18,3600,0.0,27,25,3,2,2,92.59259259
2015020895,10,3497,0.0,26,23,2,2,3,88.46153846
2015020896,29,3879,0.0,28,27,1,0,1,96.42857143
2015020896,17,3900,0.0,29,28,2,1,1,96.55172414
2015020897,53,3508,0.0,36,34,3,0,2,94.44444444
2015020897,14,3600,0.0,30,29,4,0,1,96.66666667
2015020898,2,3600,0.0,31,30,7,0,1,96.77419355
2015020898,30,3590,0.0,30,27,3,3,3,90.0
2015020899,25,3596,0.0,25,22,6,0,3,88.0
2015020899,52,3440,0.0,26,22,3,1,4,84.61538462
2015020900,9,3596,0.0,32,31,6,0,1,96.875
2015020900,22,3587,0.0,24,21,2,2,3,87.5
2015020901,20,3528,0.0,37,35,6,0,2,94.59459459
2015020901,26,3600,0.0,23,22,0,0,1,95.65217391
2015020902,8,3600,0.0,36,33,5,0,3,91.66666667
2015020902,15,2190,0.0,16,15,1,0,1,93.75
2015020902,15,1314,0.0,18,15,2,0,3,83.33333333
2015020903,5,3598,0.0,29,24,0,0,5,82.75862069
2015020903,6,3600,0.0,42,41,0,0,1,97.61904762
2015020904,28,3836,0.0,41,38,2,0,3,92.68292683
2015020904,21,3900,0.0,33,30,1,0,3,90.90909091
2015020905,7,3555,0.0,29,28,8,1,1,96.55172414
2015020905,24,3600,0.0,26,26,6,0,0,100.0
2015020906,30,3532,0.0,31,28,1,2,3,90.32258065
2015020906,4,3600,0.0,26,24,4,0,2,92.30769231
2015020907,1,1185,0.0,11,8,0,1,3,72.72727273
2015020907,1,2400,0.0,13,10,0,0,3,76.92307692
2015020907,29,3600,0.0,26,25,7,2,1,96.15384615
2015020908,12,3465,0.0,29,26,5,1,3,89.65517241
2015020908,10,3573,0.0,31,30,5,3,1,96.77419355
2015020909,53,3500,0.0,25,22,7,0,3,88.0
2015020909,13,3598,0.0,24,22,5,1,2,91.66666667
2015020910,3,3600,0.0,36,35,3,1,1,97.22222222
2015020910,19,3541,0.0,23,21,1,1,2,91.30434783
2015020911,18,3600,0.0,39,38,2,1,1,97.43589744
2015020911,16,3516,0.0,31,29,1,0,2,93.5483871
2015020912,52,3600,0.0,30,27,4,0,3,90.0
2015020912,25,1200,0.0,8,5,0,0,3,62.5
2015020912,25,2393,0.0,20,17,2,1,3,85.0
2015020913,2,3882,0.0,32,31,4,0,1,96.875
2015020913,20,3881,0.0,34,32,3,0,2,94.11764706
2015020914,9,3508,0.0,35,31,1,0,4,88.57142857
2015020914,23,3600,0.0,30,27,2,3,3,90.0
2015020915,22,3510,0.0,36,34,1,0,2,94.44444444
2015020915,26,3596,0.0,27,26,2,0,1,96.2962963
2015020916,14,3573,0.0,21,21,0,0,0,100.0
2015020916,1,3600,0.0,36,32,7,0,4,88.88888889
2015020917,30,3512,2.0,27,24,0,0,3,88.88888889
2015020917,15,3600,0.0,32,30,0,0,2,93.75
2015020918,6,3600,0.0,40,39,5,0,1,97.5
2015020918,12,3444,0.0,21,18,1,1,3,85.71428571
2015020919,22,3684,0.0,34,32,2,0,2,94.11764706
2015020919,24,3678,0.0,18,17,1,0,1,94.44444444
2015020920,7,3600,0.0,25,24,0,0,1,96.0
2015020920,28,3534,0.0,21,19,0,0,2,90.47619048
2015020921,53,3476,0.0,33,29,4,0,4,87.87878788
2015020921,4,3597,0.0,31,29,4,0,2,93.5483871
2015020922,52,3600,0.0,33,29,2,0,4,87.87878788
2015020922,5,3600,0.0,28,27,1,1,1,96.42857143
2015020923,13,3865,0.0,25,22,5,0,3,88.0
2015020923,29,3900,0.0,31,28,6,3,3,90.32258065
2015020924,19,1466,0.0,6,5,1,0,1,83.33333333
2015020924,19,2134,0.0,23,19,4,0,4,82.60869565
2015020924,18,3588,0.0,28,28,1,3,0,100.0
2015020925,3,3600,0.0,38,36,0,0,2,94.73684211
2015020925,25,3528,0.0,29,26,2,0,3,89.65517241
2015020926,10,3576,0.0,36,32,5,1,4,88.88888889
2015020926,8,3561,0.0,32,31,7,3,1,96.875
2015020927,17,3594,0.0,27,24,0,1,3,88.88888889
2015020927,21,3560,0.0,27,23,6,0,4,85.18518519
2015020928,9,3600,0.0,38,34,4,1,4,89.47368421
2015020928,20,3483,0.0,25,20,3,1,5,80.0
2015020929,7,3496,0.0,35,33,3,2,2,94.28571429
2015020929,26,3600,0.0,23,23,3,0,0,100.0
2015020930,15,3519,0.0,23,20,3,1,3,86.95652174
2015020930,16,3600,0.0,30,28,6,1,2,93.33333333
2015020931,19,3591,0.0,34,32,4,0,2,94.11764706
2015020931,12,3600,0.0,40,35,2,0,5,87.5
2015020932,13,445,0.0,4,3,0,0,1,75.0
2015020932,13,3101,0.0,22,21,4,0,1,95.45454545
2015020932,30,3600,0.0,18,17,1,0,1,94.44444444
2015020933,14,3600,0.0,33,32,11,1,1,96.96969697
2015020933,6,3582,0.0,30,26,1,2,4,86.66666667
2015020934,28,3581,0.0,24,23,3,0,1,95.83333333
2015020934,23,3421,0.0,27,24,8,0,3,88.88888889
2015020935,26,3449,2.0,29,25,5,1,4,86.20689655
2015020935,24,3587,0.0,29,27,8,0,2,93.10344828
2015020936,2,3399,0.0,26,23,0,0,3,88.46153846
2015020936,22,3600,0.0,37,36,7,0,1,97.2972973
2015020937,29,3532,0.0,23,21,2,0,2,91.30434783
2015020937,3,3600,0.0,27,26,0,0,1,96.2962963
2015020938,20,3570,0.0,28,24,3,2,4,85.71428571
2015020938,4,3600,0.0,32,29,5,0,3,90.625
2015020939,53,3568,0.0,33,27,3,1,6,81.81818182
2015020939,5,3589,0.0,30,30,6,2,0,100.0
2015020940,14,3597,0.0,32,31,3,0,1,96.875
2015020940,10,3470,0.0,28,26,2,0,2,92.85714286
2015020941,17,3753,0.0,41,39,7,0,2,95.12195122
2015020941,25,3710,0.0,33,30,5,1,3,90.90909091
2015020942,8,3600,0.0,36,30,5,1,6,83.33333333
2015020942,28,3600,0.0,23,21,2,1,2,91.30434783
2015020943,20,3467,0.0,25,23,7,1,2,92.0
2015020943,6,3600,0.0,25,24,3,1,1,96.0
2015020944,22,3828,0.0,32,31,1,0,1,96.875
2015020944,7,3828,0.0,41,39,7,0,2,95.12195122
2015020945,12,3548,0.0,30,29,3,2,1,96.66666667
2015020945,1,3521,0.0,18,16,4,0,2,88.88888889
2015020946,19,3900,0.0,43,40,4,3,3,93.02325581
2015020946,9,2021,0.0,31,28,4,2,3,90.32258065
2015020946,9,1755,0.0,17,17,0,1,0,100.0
2015020947,25,1788,0.0,18,14,0,0,4,77.77777778
2015020947,25,1684,0.0,16,15,3,1,1,93.75
2015020947,18,3598,0.0,38,35,4,0,3,92.10526316
2015020948,21,2291,0.0,16,15,5,1,1,93.75
2015020948,21,1200,0.0,12,9,0,0,3,75.0
2015020948,30,3600,0.0,33,30,4,0,3,90.90909091
2015020949,13,3600,0.0,32,30,7,0,2,93.75
2015020949,52,3518,0.0,22,19,5,0,3,86.36363636
2015020950,2,3600,0.0,33,31,2,0,2,93.93939394
2015020950,23,3454,0.0,24,21,0,1,3,87.5
2015020951,10,3473,0.0,23,20,2,1,3,86.95652174
2015020951,15,3600,0.0,29,27,6,0,2,93.10344828
2015020952,16,3600,0.0,33,31,5,0,2,93.93939394
2015020952,17,3600,0.0,33,28,4,0,5,84.84848485
2015020953,8,3895,0.0,35,33,9,0,2,94.28571429
2015020953,24,3900,0.0,27,25,5,0,2,92.59259259
2015020954,16,3395,0.0,25,21,0,0,4,84.0
2015020954,6,3600,0.0,27,25,3,0,2,92.59259259
2015020955,20,3554,0.0,34,29,8,1,5,85.29411765
2015020955,7,3592,0.0,29,26,4,0,3,89.65517241
2015020956,22,3598,0.0,35,35,15,0,0,100.0
2015020956,4,3542,0.0,31,27,3,1,4,87.09677419
2015020957,3,2400,2.0,22,19,3,1,3,86.36363636
2015020957,3,1160,0.0,3,3,0,0,0,100.0
2015020957,5,3597,0.0,28,27,2,1,1,96.42857143
2015020958,30,3600,0.0,22,21,0,0,1,95.45454545
2015020958,10,3471,0.0,22,20,2,0,2,90.90909091
2015020959,14,3600,0.0,34,33,6,0,1,97.05882353
2015020959,9,3550,0.0,28,25,1,0,3,89.28571429
2015020960,1,3677,0.0,34,30,1,0,4,88.23529412
2015020960,18,3714,2.0,33,28,4,0,5,84.84848485
2015020961,2,3681,0.0,29,26,3,1,3,89.65517241
2015020961,52,3740,0.0,27,23,5,1,4,85.18518519
2015020962,13,3497,0.0,26,23,2,0,3,88.46153846
2015020962,21,3597,0.0,40,38,7,0,2,95.0
2015020963,24,3581,0.0,28,27,10,3,1,96.42857143
2015020963,53,1199,0.0,5,5,1,0,0,100.0
2015020963,53,2388,2.0,16,11,3,2,5,68.75
2015020964,28,3600,0.0,30,28,3,0,2,93.33333333
2015020964,23,3447,0.0,30,27,1,0,3,90.0
2015020965,8,3501,0.0,31,28,4,0,3,90.32258065
2015020965,26,3600,0.0,15,13,2,0,2,86.66666667
2015020966,3,3595,0.0,34,32,2,0,2,94.11764706
2015020966,15,3511,0.0,23,20,1,0,3,86.95652174
2015020967,22,3600,0.0,27,21,4,1,6,77.77777778
2015020967,29,3600,0.0,36,33,2,1,3,91.66666667
2015020968,1,2517,0.0,18,15,7,0,3,83.33333333
2015020968,1,1026,0.0,6,6,0,0,0,100.0
2015020968,25,3600,0.0,20,18,5,1,2,90.0
2015020969,30,3900,0.0,32,30,3,0,2,93.75
2015020969,7,3900,0.0,30,28,0,0,2,93.33333333
2015020970,20,3600,0.0,31,29,6,1,2,93.5483871
2015020970,5,3395,0.0,30,26,5,1,4,86.66666667
2015020971,18,3587,0.0,36,34,4,1,2,94.44444444
2015020971,21,3523,0.0,38,35,11,3,3,92.10526316
2015020972,24,3600,0.0,34,32,9,0,2,94.11764706
2015020972,26,3527,0.0,22,19,2,0,3,86.36363636
2015020973,15,3749,0.0,34,33,9,0,1,97.05882353
2015020973,6,3756,0.0,30,28,3,1,2,93.33333333
2015020974,9,3600,0.0,43,41,3,1,2,95.34883721
2015020974,10,3473,0.0,31,28,0,0,3,90.32258065
2015020975,12,3853,0.0,30,26,4,0,4,86.66666667
2015020975,14,3857,0.0,27,24,4,1,3,88.88888889
2015020976,29,3600,0.0,36,30,6,0,6,83.33333333
2015020976,4,3600,0.0,19,19,4,1,0,100.0
2015020977,8,3535,0.0,29,26,6,0,3,89.65517241
2015020977,52,3587,0.0,28,26,0,0,2,92.85714286
2015020978,13,3598,0.0,26,21,2,1,5,80.76923077
2015020978,53,3600,0.0,33,32,6,0,1,96.96969697
2015020979,23,3564,2.0,34,32,2,1,2,94.11764706
2015020979,28,3452,0.0,25,22,9,0,3,88.0
2015020980,25,3600,0.0,24,23,3,0,1,95.83333333
2015020980,9,3479,0.0,25,23,2,1,2,92.0
2015020981,5,3566,0.0,18,17,4,0,1,94.44444444
2015020981,1,3600,0.0,30,24,4,3,6,80.0
2015020982,2,3597,0.0,26,22,2,2,4,84.61538462
2015020982,3,3581,0.0,31,26,1,2,5,83.87096774
2015020983,17,3042,0.0,21,19,0,1,2,90.47619048
2015020983,17,379,0.0,5,3,2,0,2,60.0
2015020983,16,3599,0.0,34,33,6,0,1,97.05882353
2015020984,22,3600,0.0,40,39,3,1,1,97.5
2015020984,52,3483,0.0,31,29,1,0,2,93.5483871
2015020985,19,3600,0.0,32,30,4,2,2,93.75
2015020985,30,1817,0.0,16,13,0,2,3,81.25
2015020985,30,1675,0.0,18,18,0,0,0,100.0
2015020986,14,3574,0.0,39,36,2,0,3,92.30769231
2015020986,4,3550,0.0,18,16,0,0,2,88.88888889
2015020987,7,3874,0.0,33,30,5,0,3,90.90909091
2015020987,10,3900,0.0,27,24,1,0,3,88.88888889
2015020988,6,3840,0.0,51,47,7,1,4,92.15686275
2015020988,13,2640,0.0,16,15,1,0,1,93.75
2015020988,13,1200,0.0,16,12,3,0,4,75.0
2015020989,53,3456,0.0,37,34,3,0,3,91.89189189
2015020989,21,3600,0.0,38,37,2,2,1,97.36842105
2015020990,28,3619,0.0,48,47,15,0,1,97.91666667
2015020990,20,3599,0.0,23,21,0,1,2,91.30434783
2015020991,15,3900,0.0,28,27,2,1,1,96.42857143
2015020991,24,3889,0.0,32,31,7,0,1,96.875
2015020992,23,3502,0.0,28,24,2,0,4,85.71428571
2015020992,26,3600,0.0,22,21,8,0,1,95.45454545
2015020993,3,3600,0.0,36,34,7,1,2,94.44444444
2015020993,7,1939,0.0,11,11,0,0,0,100.0
2015020993,7,1565,0.0,14,11,3,0,3,78.57142857
2015020994,5,3524,0.0,27,25,5,0,2,92.59259259
2015020994,2,3338,0.0,32,31,3,0,1,96.875
2015020994,2,262,0.0,3,3,1,0,0,100.0
2015020995,9,3896,0.0,37,34,3,0,3,91.89189189
2015020995,12,3782,0.0,24,21,1,0,3,87.5
2015020996,17,3341,0.0,31,27,4,2,4,87.09677419
2015020996,29,3597,0.0,35,32,4,1,3,91.42857143
2015020997,25,3680,0.0,28,24,1,0,4,85.71428571
2015020997,8,3719,0.0,33,30,3,0,3,90.90909091
2015020998,6,3610,0.0,42,42,7,0,0,100.0
2015020998,14,3610,0.0,33,32,0,2,1,96.96969697
2015020999,18,3600,0.0,23,21,4,1,2,91.30434783
2015020999,52,3483,0.0,31,27,7,3,4,87.09677419
2015021000,28,3585,0.0,31,31,1,0,0,100.0
2015021000,22,3600,0.0,22,19,0,1,3,86.36363636
2015021001,2,3900,0.0,36,33,4,0,3,91.66666667
2015021001,10,3856,0.0,27,24,1,0,3,88.88888889
2015021002,16,3871,0.0,30,28,1,3,2,93.33333333
2015021002,19,3900,0.0,35,33,8,0,2,94.28571429
2015021003,18,3656,0.0,34,31,3,3,3,91.17647059
2015021003,20,3672,0.0,26,24,5,0,2,92.30769231
2015021004,24,3600,0.0,26,23,2,2,3,88.46153846
2015021004,21,3600,0.0,37,37,4,2,0,100.0
2015021005,53,3702,0.0,31,28,7,0,3,90.32258065
2015021005,23,3701,0.0,34,32,0,0,2,94.11764706
2015021006,15,3769,0.0,30,26,5,0,4,86.66666667
2015021006,26,3770,0.0,32,29,1,1,3,90.625
2015021007,12,3690,0.0,32,30,4,0,2,93.75
2015021007,6,3690,0.0,28,25,6,0,3,89.28571429
2015021008,7,3454,0.0,34,31,10,1,3,91.17647059
2015021008,8,3600,0.0,38,36,5,4,2,94.73684211
2015021009,52,3531,0.0,35,32,7,0,3,91.42857143
2015021009,17,3600,0.0,25,23,4,0,2,92.0
2015021010,9,3600,0.0,31,25,1,0,6,80.64516129
2015021010,13,3600,0.0,28,26,2,0,2,92.85714286
2015021011,22,3600,0.0,30,29,5,2,1,96.66666667
2015021011,30,3509,0.0,25,23,3,1,2,92.0
2015021012,1,3600,2.0,30,30,7,0,0,100.0
2015021012,28,3518,0.0,15,13,2,0,2,86.66666667
2015021013,5,3600,0.0,27,25,2,0,2,92.59259259
2015021013,29,3503,2.0,31,28,4,0,3,90.32258065
2015021014,4,3600,0.0,19,18,0,0,1,94.73684211
2015021014,14,3396,0.0,22,19,3,1,3,86.36363636
2015021015,24,3553,0.0,22,18,4,0,4,81.81818182
2015021015,19,3597,0.0,28,26,3,0,2,92.85714286
2015021016,16,1842,0.0,20,16,9,0,4,80.0
2015021016,16,1613,0.0,11,10,4,0,1,90.90909091
2015021016,25,3600,0.0,23,21,4,0,2,91.30434783
2015021017,53,3600,0.0,25,24,3,0,1,96.0
2015021017,20,3546,0.0,25,22,0,0,3,88.0
2015021018,2,3473,0.0,31,28,1,0,3,90.32258065
2015021018,6,3586,0.0,26,25,0,0,1,96.15384615
2015021019,3,3783,0.0,43,40,4,0,3,93.02325581
2015021019,17,3688,0.0,25,23,3,1,2,92.0
2015021020,12,3899,0.0,24,21,4,0,3,87.5
2015021020,7,3899,0.0,30,28,2,1,2,93.33333333
2015021021,30,3600,0.0,31,30,1,0,1,96.77419355
2015021021,8,3579,0.0,21,18,1,0,3,85.71428571
2015021022,10,3600,0.0,17,13,0,2,4,76.47058824
2015021022,9,3592,0.0,29,29,4,0,0,100.0
2015021023,4,3895,0.0,29,25,3,0,4,86.20689655
2015021023,13,3900,0.0,26,22,6,1,4,84.61538462
2015021024,21,3458,0.0,30,27,4,1,3,90.0
2015021024,52,3597,0.0,37,35,7,2,2,94.59459459
2015021025,19,3683,0.0,38,34,3,1,4,89.47368421
2015021025,25,3679,0.0,36,31,2,0,5,86.11111111
2015021026,53,3579,0.0,44,44,9,0,0,100.0
2015021026,22,3561,0.0,29,25,1,2,4,86.20689655
2015021027,18,3499,0.0,27,24,9,0,3,88.88888889
2015021027,23,3598,0.0,37,35,3,1,2,94.59459459
2015021028,1,3856,0.0,23,22,7,0,1,95.65217391
2015021028,26,3884,0.0,24,22,3,3,2,91.66666667
2015021029,15,3499,0.0,27,23,1,1,4,85.18518519
2015021029,28,3598,0.0,25,23,2,2,2,92.0
2015021030,5,3600,0.0,27,24,7,0,3,88.88888889
2015021030,3,3515,0.0,32,28,7,0,4,87.5
2015021031,14,3574,0.0,37,37,8,0,0,100.0
2015021031,29,3594,0.0,37,33,5,1,4,89.18918919
2015021032,10,3600,0.0,38,38,3,1,0,100.0
2015021032,17,3518,0.0,27,26,5,0,1,96.2962963
2015021033,13,3543,0.0,28,25,1,2,3,89.28571429
2015021033,2,3600,0.0,25,23,0,1,2,92.0
2015021034,26,3600,0.0,32,32,16,0,0,100.0
2015021034,16,3600,0.0,25,20,2,0,5,80.0
2015021035,19,1863,0.0,17,13,2,0,4,76.47058824
2015021035,19,1638,0.0,14,12,2,0,2,85.71428571
2015021035,20,3582,0.0,35,31,4,0,4,88.57142857
2015021036,18,3600,0.0,30,28,6,1,2,93.33333333
2015021036,22,3471,0.0,25,22,2,0,3,88.0
2015021037,52,3577,0.0,28,26,5,1,2,92.85714286
2015021037,23,3600,0.0,29,24,4,1,5,82.75862069
2015021038,1,2776,0.0,24,18,2,0,6,75.0
2015021038,1,824,0.0,3,2,1,0,1,66.66666667
2015021038,24,3596,0.0,25,24,6,1,1,96.0
2015021039,17,3554,0.0,46,42,10,1,4,91.30434783
2015021039,4,3600,0.0,37,34,2,1,3,91.89189189
2015021040,2,3881,0.0,34,33,1,3,1,97.05882353
2015021040,5,3900,0.0,26,25,4,2,1,96.15384615
2015021041,12,3687,0.0,31,29,0,1,2,93.5483871
2015021041,15,3693,0.0,26,25,3,0,1,96.15384615
2015021042,14,3486,0.0,22,20,3,1,2,90.90909091
2015021042,10,3600,0.0,27,26,5,1,1,96.2962963
2015021043,13,3600,0.0,28,27,0,0,1,96.42857143
2015021043,8,3600,0.0,36,32,6,0,4,88.88888889
2015021044,30,3851,0.0,20,17,2,0,3,85.0
2015021044,9,3776,0.0,25,23,2,0,2,92.0
2015021045,26,3600,0.0,26,24,3,1,2,92.30769231
2015021045,25,2333,0.0,11,10,1,0,1,90.90909091
2015021045,25,1267,0.0,11,7,0,0,4,63.63636364
2015021046,6,3517,0.0,27,24,3,0,3,88.88888889
2015021046,28,3600,0.0,23,21,0,3,2,91.30434783
2015021047,8,3791,0.0,43,41,8,3,2,95.34883721
2015021047,7,3794,2.0,22,19,6,0,3,86.36363636
2015021048,4,3582,0.0,26,24,2,1,2,92.30769231
2015021048,16,3473,0.0,29,26,2,2,3,89.65517241
2015021049,19,3541,0.0,26,21,8,0,5,80.76923077
2015021049,22,3594,0.0,28,24,4,2,4,85.71428571
2015021050,52,3584,0.0,21,17,3,1,4,80.95238095
2015021050,20,3600,0.0,29,28,1,0,1,96.55172414
2015021051,21,3592,0.0,29,28,3,0,1,96.55172414
2015021051,23,3454,0.0,34,31,3,0,3,91.17647059
2015021052,3,3600,0.0,23,22,0,1,1,95.65217391
2015021052,24,3552,0.0,23,21,3,0,2,91.30434783
2015021053,30,1024,0.0,8,5,0,0,3,62.5
2015021053,30,2368,0.0,17,13,1,1,4,76.47058824
2015021053,1,3600,0.0,32,28,2,0,4,87.5
2015021054,12,3595,0.0,48,44,3,1,4,91.66666667
2015021054,5,3600,0.0,33,31,6,0,2,93.93939394
2015021055,17,3600,0.0,28,27,4,1,1,96.42857143
2015021055,29,3559,0.0,22,19,3,0,3,86.36363636
2015021056,13,3600,0.0,33,32,2,2,1,96.96969697
2015021056,10,3445,0.0,30,28,4,0,2,93.33333333
2015021057,2,3595,0.0,31,28,0,0,3,90.32258065
2015021057,18,3584,0.0,22,20,0,0,2,90.90909091
2015021058,14,3517,0.0,33,29,2,0,4,87.87878788
2015021058,25,3600,0.0,20,17,4,0,3,85.0
2015021059,28,3580,0.0,21,19,1,0,2,90.47619048
2015021059,53,3600,0.0,28,27,4,1,1,96.42857143
2015021060,3,3694,0.0,37,33,5,0,4,89.18918919
2015021060,26,3694,0.0,26,23,2,0,3,88.46153846
2015021061,9,3551,0.0,34,31,3,2,3,91.17647059
2015021061,7,3600,0.0,33,32,2,0,1,96.96969697
2015021062,18,3587,0.0,29,25,5,0,4,86.20689655
2015021062,15,3600,0.0,21,20,1,1,1,95.23809524
2015021063,16,3600,0.0,28,28,6,0,0,100.0
2015021063,52,3600,0.0,36,32,1,0,4,88.88888889
2015021064,21,3900,0.0,33,30,4,2,3,90.90909091
2015021064,20,3879,2.0,28,25,3,1,3,89.28571429
2015021065,23,3486,0.0,25,23,2,1,2,92.0
2015021065,22,3580,0.0,40,40,3,0,0,100.0
2015021066,6,3600,0.0,26,22,0,2,4,84.61538462
2015021066,24,3600,0.0,38,38,4,0,0,100.0
2015021067,5,3600,0.0,17,16,3,0,1,94.11764706
2015021067,4,3579,0.0,34,31,4,2,3,91.17647059
2015021068,12,3900,0.0,32,30,1,1,2,93.75
2015021068,30,3900,0.0,33,31,4,0,2,93.93939394
2015021069,3,2945,0.0,47,43,3,1,4,91.4893617
2015021069,3,655,0.0,5,5,0,1,0,100.0
2015021069,28,3600,0.0,26,25,4,0,1,96.15384615
2015021070,7,3600,0.0,31,27,1,1,4,87.09677419
2015021070,10,3600,0.0,21,20,4,0,1,95.23809524
2015021071,8,3587,0.0,44,39,3,0,5,88.63636364
2015021071,9,3600,0.0,30,30,4,0,0,100.0
2015021072,17,3591,0.0,26,23,6,0,3,88.46153846
2015021072,13,3578,0.0,29,25,5,0,4,86.20689655
2015021073,1,1370,0.0,19,16,2,0,3,84.21052632
2015021073,1,2206,0.0,15,12,0,1,3,80.0
2015021073,29,3600,0.0,30,27,3,0,3,90.0
2015021074,2,3528,0.0,35,33,7,1,2,94.28571429
2015021074,25,3600,0.0,27,27,0,1,0,100.0
2015021075,19,3600,0.0,19,19,4,0,0,100.0
2015021075,23,3536,0.0,49,47,8,0,2,95.91836735
2015021076,14,3600,0.0,32,32,7,1,0,100.0
2015021076,53,3549,0.0,35,34,6,0,1,97.14285714
2015021077,6,3501,0.0,20,18,1,0,2,90.0
2015021077,26,3600,0.0,28,27,11,1,1,96.42857143
2015021078,24,3841,0.0,29,27,3,1,2,93.10344828
2015021078,52,3827,0.0,33,30,3,0,3,90.90909091
2015021079,29,3484,0.0,22,20,4,1,2,90.90909091
2015021079,1,3598,0.0,28,27,5,2,1,96.42857143
2015021080,15,762,0.0,5,4,3,0,1,80.0
2015021080,15,2838,0.0,26,21,5,2,5,80.76923077
2015021080,5,3600,0.0,18,16,2,0,2,88.88888889
2015021081,20,3585,0.0,22,21,0,0,1,95.45454545
2015021081,8,3574,0.0,35,31,6,0,4,88.57142857
2015021082,30,3900,0.0,31,29,2,0,2,93.5483871
2015021082,16,3900,0.0,34,32,8,1,2,94.11764706
2015021083,21,3600,0.0,28,26,5,0,2,92.85714286
2015021083,22,3537,0.0,25,22,2,1,3,88.0
2015021084,53,3577,0.0,35,33,9,0,2,94.28571429
2015021084,28,3600,0.0,25,25,10,1,0,100.0
2015021085,4,3585,0.0,24,23,5,1,1,95.83333333
2015021085,2,3439,0.0,26,23,4,0,3,88.46153846
2015021086,13,3499,0.0,31,28,1,0,3,90.32258065
2015021086,3,3600,0.0,27,25,1,1,2,92.59259259
2015021087,20,3549,0.0,24,21,4,1,3,87.5
2015021087,10,3571,0.0,25,23,6,0,2,92.0
2015021088,26,1124,0.0,2,1,0,0,1,50.0
2015021088,26,2400,0.0,27,24,3,0,3,88.88888889
2015021088,18,3600,0.0,30,28,5,0,2,93.33333333
2015021089,7,3600,0.0,27,25,1,0,2,92.59259259
2015021089,12,3467,0.0,25,22,2,2,3,88.0
2015021090,4,3900,0.0,53,51,9,2,2,96.22641509
2015021090,29,3797,0.0,33,31,9,1,2,93.93939394
2015021091,24,3520,0.0,23,19,1,0,4,82.60869565
2015021091,8,3587,0.0,35,32,3,1,3,91.42857143
2015021092,15,3600,0.0,30,28,6,1,2,93.33333333
2015021092,9,3520,0.0,21,18,3,0,3,85.71428571
2015021093,17,1233,0.0,16,13,2,0,3,81.25
2015021093,17,2367,0.0,18,15,5,0,3,83.33333333
2015021093,14,3600,0.0,25,23,1,0,2,92.0
2015021094,26,3574,0.0,18,16,3,0,2,88.88888889
2015021094,30,3590,0.0,39,38,7,1,1,97.43589744
2015021095,23,3553,0.0,48,47,4,2,1,97.91666667
2015021095,52,3600,0.0,28,28,3,3,0,100.0
2015021096,25,3600,0.0,32,30,3,1,2,93.75
2015021096,16,2369,0.0,17,16,5,0,1,94.11764706
2015021096,16,1191,0.0,15,11,1,0,4,73.33333333
2015021097,22,3524,0.0,30,27,1,2,3,90.0
2015021097,53,3600,0.0,29,27,3,0,2,93.10344828
2015021098,19,3600,0.0,37,37,12,0,0,100.0
2015021098,28,3491,0.0,24,23,4,1,1,95.83333333
2015021099,9,3490,0.0,23,20,2,0,3,86.95652174
2015021099,2,3600,0.0,23,22,0,2,1,95.65217391
2015021100,6,1200,0.0,8,6,3,0,2,75.0
2015021100,6,2385,0.0,15,13,4,2,2,86.66666667
2015021100,3,3600,0.0,41,39,4,3,2,95.12195122
2015021101,13,3600,0.0,35,34,4,2,1,97.14285714
2015021101,6,3505,0.0,35,32,8,1,3,91.42857143
2015021102,1,3600,0.0,39,39,3,0,0,100.0
2015021102,5,3378,0.0,24,21,3,1,3,87.5
2015021103,12,3600,0.0,44,42,2,0,2,95.45454545
2015021103,29,3510,0.0,24,21,3,1,3,87.5
2015021104,24,3641,0.0,26,20,1,0,6,76.92307692
2015021104,10,3621,0.0,38,33,6,1,5,86.84210526
2015021105,8,3535,0.0,40,36,6,0,4,90.0
2015021105,17,3569,0.0,29,26,1,2,3,89.65517241
2015021106,23,3900,0.0,32,30,5,0,2,93.75
2015021106,18,3807,0.0,25,23,2,0,2,92.0
2015021107,20,3589,0.0,29,23,2,0,6,79.31034483
2015021107,30,3600,2.0,33,31,8,1,2,93.93939394
2015021108,26,3584,0.0,23,20,3,0,3,86.95652174
2015021108,52,3588,0.0,34,33,9,1,1,97.05882353
2015021109,4,3600,0.0,34,32,0,2,2,94.11764706
2015021109,21,3477,0.0,44,41,4,0,3,93.18181818
2015021110,25,3460,0.0,30,27,4,1,3,90.0
2015021110,53,3595,0.0,38,37,3,3,1,97.36842105
2015021111,22,3600,0.0,26,23,3,1,3,88.46153846
2015021111,28,3549,0.0,21,16,0,0,5,76.19047619
2015021112,15,3737,0.0,22,22,7,0,0,100.0
2015021112,1,3737,0.0,26,25,1,0,1,96.15384615
2015021113,2,3448,0.0,41,35,6,0,6,85.36585366
2015021113,14,3600,0.0,31,27,6,0,4,87.09677419
2015021114,23,3600,0.0,37,33,3,1,4,89.18918919
2015021114,19,3600,0.0,15,15,1,0,0,100.0
2015021115,5,3600,0.0,23,21,0,3,2,91.30434783
2015021115,17,1489,0.0,14,11,5,0,3,78.57142857
2015021115,17,2111,0.0,27,23,2,0,4,85.18518519
2015021116,52,3548,0.0,29,26,5,0,3,89.65517241
2015021116,7,3600,0.0,19,17,1,0,2,89.47368421
2015021117,30,3600,0.0,29,29,3,1,0,100.0
2015021117,21,3526,0.0,34,31,11,2,3,91.17647059
2015021118,25,3600,0.0,36,34,10,0,2,94.44444444
2015021118,28,3573,0.0,16,13,3,0,3,81.25
2015021119,6,3600,0.0,26,25,3,1,1,96.15384615
2015021119,10,3440,0.0,32,30,2,0,2,93.75
2015021120,3,3586,0.0,26,24,6,0,2,92.30769231
2015021120,8,1195,0.0,4,4,1,2,0,100.0
2015021120,8,2400,0.0,19,14,0,1,5,73.68421053
2015021121,24,3730,0.0,33,30,4,1,3,90.90909091
2015021121,9,3758,0.0,39,35,6,0,4,89.74358974
2015021122,13,3600,0.0,35,33,4,1,2,94.28571429
2015021122,14,3248,0.0,26,22,5,0,4,84.61538462
2015021123,19,3600,0.0,32,32,4,0,0,100.0
2015021123,15,3584,0.0,29,25,0,1,4,86.20689655
2015021124,2,3883,0.0,36,33,1,0,3,91.66666667
2015021124,12,3886,0.0,31,27,1,2,4,87.09677419
2015021125,29,3600,0.0,48,43,5,0,5,89.58333333
2015021125,18,3600,0.0,19,18,1,0,1,94.73684211
2015021126,16,3600,0.0,32,31,7,1,1,96.875
2015021126,20,3531,0.0,25,23,4,1,2,92.0
2015021127,4,3440,0.0,17,15,1,0,2,88.23529412
2015021127,53,3579,0.0,35,34,7,0,1,97.14285714
2015021128,22,3482,0.0,32,27,0,1,5,84.375
2015021128,26,3598,0.0,29,25,2,0,4,86.20689655
2015021129,1,3510,0.0,23,20,8,0,3,86.95652174
2015021129,12,3600,0.0,25,23,1,1,2,92.0
2015021130,5,3870,0.0,27,25,4,0,2,92.59259259
2015021130,3,3870,0.0,32,29,2,1,3,90.625
2015021131,16,3600,0.0,28,26,3,0,2,92.85714286
2015021131,23,3550,0.0,32,29,1,2,3,90.625
2015021132,52,3886,0.0,32,29,3,0,3,90.625
2015021132,4,3886,0.0,28,26,0,0,2,92.85714286
2015021133,29,3590,0.0,39,36,5,1,3,92.30769231
2015021133,15,3600,0.0,22,21,1,0,1,95.45454545
2015021134,7,3428,0.0,28,26,6,0,2,92.85714286
2015021134,17,3586,0.0,20,18,3,1,2,90.0
2015021135,10,3600,0.0,18,15,2,0,3,83.33333333
2015021135,14,3600,0.0,34,34,10,0,0,100.0
2015021136,21,3600,0.0,35,32,3,0,3,91.42857143
2015021136,18,700,0.0,10,7,0,0,3,70.0
2015021136,18,2779,0.0,17,16,1,1,1,94.11764706
2015021137,24,3567,0.0,28,27,5,0,1,96.42857143
2015021137,22,3508,0.0,25,23,6,0,2,92.0
2015021138,20,3600,0.0,24,22,4,0,2,91.66666667
2015021138,53,3519,0.0,20,16,0,0,4,80.0
2015021139,26,3467,0.0,30,26,4,0,4,86.66666667
2015021139,28,3598,0.0,32,30,4,0,2,93.75
2015021140,6,3531,0.0,15,13,1,0,2,86.66666667
2015021140,1,3598,0.0,40,39,3,0,1,97.5
2015021141,12,3900,0.0,31,30,4,0,1,96.77419355
2015021141,2,3900,0.0,27,26,2,0,1,96.2962963
2015021142,7,3900,0.0,46,42,8,0,4,91.30434783
2015021142,5,3900,0.0,30,26,2,2,4,86.66666667
2015021143,17,2789,0.0,20,18,2,0,2,90.0
2015021143,17,685,0.0,7,5,0,0,2,71.42857143
2015021143,8,3596,0.0,42,39,4,4,3,92.85714286
2015021144,10,3563,0.0,34,32,4,0,2,94.11764706
2015021144,13,3548,0.0,28,24,7,1,4,85.71428571
2015021145,21,3321,0.0,27,24,3,0,3,88.88888889
2015021145,19,3600,0.0,21,20,3,0,1,95.23809524
2015021146,16,3481,0.0,17,14,7,0,3,82.35294118
2015021146,30,3600,0.0,19,18,3,0,1,94.73684211
2015021147,18,3574,0.0,23,20,3,0,3,86.95652174
2015021147,25,3600,0.0,30,28,6,0,2,93.33333333
2015021148,28,3600,0.0,24,23,2,1,1,95.83333333
2015021148,23,3482,0.0,30,27,6,1,3,90.0
2015021149,9,3600,0.0,21,20,2,0,1,95.23809524
2015021149,52,3529,0.0,19,17,5,1,2,89.47368421
2015021150,15,3831,2.0,34,33,5,1,1,97.05882353
2015021150,4,3900,0.0,30,29,2,0,1,96.66666667
2015021151,20,411,0.0,5,2,0,0,3,40.0
2015021151,20,3189,0.0,22,17,5,0,5,77.27272727
2015021151,24,692,0.0,5,2,0,0,3,40.0
2015021151,24,2908,0.0,21,21,1,0,0,100.0
2015021152,10,3409,0.0,36,33,5,0,3,91.66666667
2015021152,7,3599,0.0,26,25,5,1,1,96.15384615
2015021153,29,3503,0.0,27,23,3,0,4,85.18518519
2015021153,2,3600,0.0,24,21,3,0,3,87.5
2015021154,18,2400,0.0,29,25,6,0,4,86.20689655
2015021154,18,1200,0.0,12,11,0,1,1,91.66666667
2015021154,5,3559,0.0,24,22,9,0,2,91.66666667
2015021155,3,3469,0.0,28,24,3,0,4,85.71428571
2015021155,12,3600,0.0,27,24,1,0,3,88.88888889
2015021156,8,3600,0.0,26,26,4,1,0,100.0
2015021156,14,3451,0.0,23,21,2,1,2,91.30434783
2015021157,1,3513,0.0,40,37,7,3,3,92.5
2015021157,13,3597,0.0,25,23,7,0,2,92.0
2015021158,9,3600,0.0,25,23,4,1,2,92.0
2015021158,30,3543,0.0,22,19,1,0,3,86.36363636
2015021159,53,3575,0.0,32,29,2,1,3,90.625
2015021159,25,3600,0.0,32,31,0,0,1,96.875
2015021160,20,3597,0.0,29,26,1,1,3,89.65517241
2015021160,26,3597,0.0,21,21,0,1,0,100.0
2015021161,23,3598,0.0,34,32,6,1,2,94.11764706
2015021161,28,3507,0.0,25,22,7,2,3,88.0
2015021162,30,3531,0.0,29,26,3,0,3,89.65517241
2015021162,17,3600,0.0,22,20,1,0,2,90.90909091
2015021163,6,3600,0.0,30,25,3,1,5,83.33333333
2015021163,19,2400,0.0,23,18,4,2,5,78.26086957
2015021163,19,1140,0.0,5,4,1,0,1,80.0
2015021164,16,3662,0.0,32,28,4,0,4,87.5
2015021164,52,3662,0.0,27,22,4,1,5,81.48148148
2015021165,15,3586,0.0,19,17,2,0,2,89.47368421
2015021165,21,3470,0.0,46,43,6,0,3,93.47826087
2015021166,23,3582,0.0,36,34,3,1,2,94.44444444
2015021166,24,3476,0.0,28,25,2,0,3,89.28571429
2015021167,5,3600,0.0,24,24,4,0,0,100.0
2015021167,2,3588,0.0,33,28,4,1,5,84.84848485
2015021168,9,3543,0.0,36,33,6,0,3,91.66666667
2015021168,4,3600,0.0,35,33,1,0,2,94.28571429
2015021169,25,3600,0.0,26,24,1,0,2,92.30769231
2015021169,26,3523,0.0,39,36,5,0,3,92.30769231
2015021170,17,3600,0.0,34,32,3,0,2,94.11764706
2015021170,10,3435,0.0,26,23,4,1,3,88.46153846
2015021171,1,3542,0.0,35,33,8,2,2,94.28571429
2015021171,14,3591,0.0,26,25,12,0,1,96.15384615
2015021172,8,3584,0.0,39,35,5,0,4,89.74358974
2015021172,13,3596,0.0,28,25,0,1,3,89.28571429
2015021173,7,3600,0.0,36,33,5,1,3,91.66666667
2015021173,3,1246,0.0,9,6,0,0,3,66.66666667
2015021173,3,2271,0.0,15,14,2,0,1,93.33333333
2015021174,29,3600,0.0,27,26,2,0,1,96.2962963
2015021174,12,3599,0.0,27,22,6,1,5,81.48148148
2015021175,28,3900,0.0,30,28,2,0,2,93.33333333
2015021175,18,3900,0.0,40,38,9,0,2,95.0
2015021176,20,3575,0.0,28,28,3,0,0,100.0
2015021176,22,3591,0.0,35,30,6,3,5,85.71428571
2015021177,15,3600,0.0,27,24,2,2,3,88.88888889
2015021177,53,3600,0.0,31,31,2,0,0,100.0
2015021178,6,1320,0.0,22,18,0,0,4,81.81818182
2015021178,6,2118,0.0,12,10,0,0,2,83.33333333
2015021178,16,3600,0.0,46,42,5,0,4,91.30434783
2015021179,4,3586,0.0,38,33,4,0,5,86.84210526
2015021179,5,3600,0.0,30,28,3,0,2,93.33333333
2015021180,30,3557,0.0,33,29,5,0,4,87.87878788
2015021180,52,3600,0.0,29,28,1,0,1,96.55172414
2015021181,19,1200,0.0,11,11,2,2,0,100.0
2015021181,19,2400,0.0,20,19,3,0,1,95.0
2015021181,21,2335,0.0,24,23,3,1,1,95.83333333
2015021181,21,1200,0.0,14,11,0,0,3,78.57142857
2015021182,25,3482,0.0,24,22,4,2,2,91.66666667
2015021182,24,3600,0.0,25,24,4,1,1,96.0
2015021183,14,2668,0.0,23,18,2,1,5,78.26086957
2015021183,14,932,0.0,13,13,0,2,0,100.0
2015021183,2,3600,0.0,34,32,9,0,2,94.11764706
2015021184,3,3600,0.0,29,27,5,0,2,93.10344828
2015021184,29,3505,0.0,29,26,4,1,3,89.65517241
2015021185,13,3592,0.0,26,23,3,3,3,88.46153846
2015021185,10,3510,0.0,36,32,7,1,4,88.88888889
2015021186,53,3600,0.0,26,21,4,0,5,80.76923077
2015021186,19,3590,0.0,27,25,6,2,2,92.59259259
2015021187,26,3579,2.0,24,21,3,0,3,87.5
2015021187,23,3600,0.0,42,40,7,1,2,95.23809524
2015021188,12,3900,0.0,36,35,6,1,1,97.22222222
2015021188,6,3895,0.0,28,27,4,1,1,96.42857143
2015021189,7,3600,0.0,19,18,3,2,1,94.73684211
2015021189,1,3563,0.0,17,15,6,0,2,88.23529412
2015021190,14,3535,0.0,28,25,7,2,3,89.28571429
2015021190,3,3600,2.0,41,39,14,1,2,95.12195122
2015021191,2,3733,0.0,32,29,0,0,3,90.625
2015021191,15,3733,0.0,27,23,3,0,4,85.18518519
2015021192,13,3573,0.0,33,32,8,2,1,96.96969697
2015021192,8,3441,0.0,19,15,0,0,4,78.94736842
2015021193,5,3596,0.0,30,27,6,0,3,90.0
2015021193,9,3493,0.0,27,23,3,0,4,85.18518519
2015021194,21,3355,0.0,28,24,3,1,4,85.71428571
2015021194,18,3600,0.0,28,25,5,1,3,89.28571429
2015021195,28,3600,0.0,29,29,3,1,0,100.0
2015021195,30,3600,0.0,20,17,3,1,3,85.0
2015021196,53,3595,0.0,32,26,8,2,6,81.25
2015021196,16,3600,0.0,31,29,8,1,2,93.5483871
2015021197,26,3605,0.0,23,19,3,0,4,82.60869565
2015021197,20,3640,0.0,26,21,2,0,5,80.76923077
2015021198,52,3787,0.0,28,27,4,3,1,96.42857143
2015021198,24,3787,0.0,26,24,5,2,2,92.30769231
2015021199,29,3600,0.0,27,26,4,1,1,96.2962963
2015021199,10,3581,0.0,32,27,2,0,5,84.375
2015021200,4,3567,0.0,25,23,5,1,2,92.0
2015021200,17,3600,0.0,30,30,4,1,0,100.0
2015021201,23,3600,0.0,38,32,12,0,6,84.21052632
2015021201,22,3597,0.0,27,25,2,0,2,92.59259259
2015021202,17,2445,0.0,26,21,2,2,5,80.76923077
2015021202,17,1155,0.0,8,8,3,0,0,100.0
2015021202,6,3600,0.0,15,13,2,2,2,86.66666667
2015021203,14,3600,0.0,22,20,3,1,2,90.90909091
2015021203,1,3579,0.0,21,18,5,0,3,85.71428571
2015021204,2,3600,0.0,37,36,6,0,1,97.2972973
2015021204,3,2400,0.0,16,13,1,1,3,81.25
2015021204,3,1106,0.0,6,6,0,1,0,100.0
2015021205,10,3771,0.0,44,41,8,0,3,93.18181818
2015021205,4,3755,0.0,26,22,0,1,4,84.61538462
2015021206,5,3828,0.0,30,27,2,2,3,90.0
2015021206,15,3840,0.0,35,31,7,4,4,88.57142857
2015021207,8,3600,0.0,28,26,0,0,2,92.85714286
2015021207,12,3411,0.0,31,27,0,0,4,87.09677419
2015021208,13,3479,0.0,23,20,3,0,3,86.95652174
2015021208,9,3600,0.0,34,33,4,2,1,97.05882353
2015021209,53,3620,2.0,31,28,2,0,3,90.32258065
2015021209,18,3517,0.0,18,16,0,0,2,88.88888889
2015021210,19,3813,0.0,25,24,3,0,1,96.0
2015021210,16,3817,0.0,35,33,1,1,2,94.28571429
2015021211,21,3530,0.0,30,27,7,0,3,90.0
2015021211,25,3593,0.0,19,17,3,2,2,89.47368421
2015021212,23,3579,0.0,43,36,7,1,7,83.72093023
2015021212,20,3568,0.0,27,24,3,1,3,88.88888889
2015021213,24,71,0.0,2,2,0,0,0,100.0
2015021213,24,3399,0.0,29,27,5,0,2,93.10344828
2015021213,26,3600,2.0,20,19,6,0,1,95.0
2015021214,52,3600,0.0,25,21,4,0,4,84.0
2015021214,28,3581,0.0,26,21,3,0,5,80.76923077
2015021215,29,3596,0.0,35,34,4,0,1,97.14285714
2015021215,7,3600,0.0,30,26,2,0,4,86.66666667
2015021216,9,3600,0.0,40,39,5,0,1,97.5
2015021216,6,3531,0.0,34,30,0,0,4,88.23529412
2015021217,17,3457,0.0,19,17,1,0,2,89.47368421
2015021217,3,3600,0.0,33,31,3,0,2,93.93939394
2015021218,5,2526,0.0,24,22,5,0,2,91.66666667
2015021218,5,1045,0.0,11,11,2,0,0,100.0
2015021218,4,3574,0.0,19,18,0,0,1,94.73684211
2015021219,24,3594,0.0,32,29,10,0,3,90.625
2015021219,21,3586,0.0,31,26,4,2,5,83.87096774
2015021220,14,3513,0.0,28,24,1,1,4,85.71428571
2015021220,8,3600,0.0,23,21,2,1,2,91.30434783
2015021221,12,3460,0.0,20,16,0,0,4,80.0
2015021221,13,3600,0.0,28,26,1,1,2,92.85714286
2015021222,10,3585,0.0,35,31,10,0,4,88.57142857
2015021222,1,3600,0.0,20,19,2,1,1,95.0
2015021223,16,3748,0.0,25,20,2,2,5,80.0
2015021223,29,3743,0.0,26,22,7,0,4,84.61538462
2015021224,20,3600,0.0,36,35,11,2,1,97.22222222
2015021224,30,1806,0.0,6,6,0,0,0,100.0
2015021224,30,1716,0.0,19,17,3,2,2,89.47368421
2015021225,7,3757,0.0,24,21,4,0,3,87.5
2015021225,2,3766,0.0,26,22,2,0,4,84.61538462
2015021226,15,3600,0.0,20,19,0,0,1,95.0
2015021226,19,2391,0.0,26,22,2,1,4,84.61538462
2015021226,19,1200,0.0,10,9,0,0,1,90.0
2015021227,18,3547,0.0,24,21,0,1,3,87.5
2015021227,25,3597,0.0,30,28,5,2,2,93.33333333
2015021228,22,3900,0.0,28,25,3,0,3,89.28571429
2015021228,23,3900,0.0,38,35,9,1,3,92.10526316
2015021229,52,3900,0.0,29,26,0,1,3,89.65517241
2015021229,26,3898,0.0,31,28,5,0,3,90.32258065
2015021230,53,3455,0.0,32,31,8,3,1,96.875
2015021230,28,3594,0.0,20,20,3,2,0,100.0
2015030111,2,3600,0.0,46,42,4,1,4,91.30434783
2015030111,13,3552,0.0,26,21,2,0,5,80.76923077
2015030112,2,3495,0.0,30,28,2,0,2,93.33333333
2015030112,13,3598,0.0,42,41,5,0,1,97.61904762
2015030113,13,4351,0.0,39,35,2,3,4,89.74358974
2015030113,2,4348,0.0,39,36,4,0,3,92.30769231
2015030114,13,3600,0.0,27,26,5,2,1,96.2962963
2015030114,2,3515,0.0,29,27,4,2,2,93.10344828
2015030115,2,5758,0.0,48,47,0,0,1,97.91666667
2015030115,13,5760,0.0,42,40,5,0,2,95.23809524
2015030116,13,5439,0.0,51,49,4,1,2,96.07843137
2015030116,2,5396,0.0,42,41,4,1,1,97.61904762
2015030121,17,3479,0.0,34,31,2,1,3,91.17647059
2015030121,14,3600,0.0,36,34,5,1,2,94.44444444
2015030122,17,3550,0.0,30,26,6,1,4,86.66666667
2015030122,14,3576,0.0,32,30,5,0,2,93.75
2015030123,14,3552,0.0,30,28,6,0,2,93.33333333
2015030123,17,3600,0.0,16,16,1,2,0,100.0
2015030124,14,3599,0.0,28,26,5,0,2,92.85714286
2015030124,17,3503,0.0,33,30,7,1,3,90.90909091
2015030125,17,3527,0.0,24,23,4,1,1,95.83333333
2015030125,14,3566,0.0,34,34,5,2,0,100.0
2015030131,4,3487,0.0,31,29,12,2,2,93.5483871
2015030131,15,3594,0.0,19,19,8,1,0,100.0
2015030132,4,3479,0.0,23,19,0,0,4,82.60869565
2015030132,15,3600,0.0,42,41,8,0,1,97.61904762
2015030133,15,3600,0.0,32,31,5,1,1,96.875
2015030133,4,3600,0.0,27,21,8,0,6,77.77777778
2015030134,15,3539,0.0,25,23,0,0,2,92.0
2015030134,4,3600,0.0,32,31,2,0,1,96.875
2015030135,4,3600,0.0,44,44,4,5,0,100.0
2015030135,15,3550,0.0,10,9,5,0,1,90.0
2015030136,15,3587,0.0,26,26,3,1,0,100.0
2015030136,4,3505,0.0,29,28,9,0,1,96.55172414
2015030141,3,1200,0.0,11,10,0,0,1,90.90909091
2015030141,3,2394,0.0,19,16,4,0,3,84.21052632
2015030141,5,3587,0.0,37,35,7,3,2,94.59459459
2015030142,3,3598,0.0,31,29,3,0,2,93.5483871
2015030142,5,3446,0.0,28,24,3,1,4,85.71428571
2015030143,5,3599,0.0,17,16,3,0,1,94.11764706
2015030143,3,3527,0.0,30,28,2,2,2,93.33333333
2015030144,5,3600,0.0,31,31,6,0,0,100.0
2015030144,3,1564,0.0,18,14,1,0,4,77.77777778
2015030144,3,2036,0.0,14,13,3,1,1,92.85714286
2015030145,3,2400,0.0,23,17,1,0,6,73.91304348
2015030145,3,1200,0.0,5,5,0,0,0,100.0
2015030145,5,3600,2.0,41,38,7,0,3,92.68292683
2015030151,30,3560,0.0,31,28,15,0,3,90.32258065
2015030151,25,3600,0.0,22,22,0,1,0,100.0
2015030152,30,3560,0.0,28,26,4,1,2,92.85714286
2015030152,25,3541,0.0,26,25,1,2,1,96.15384615
2015030153,25,3536,0.0,24,20,2,0,4,83.33333333
2015030153,30,3600,0.0,17,14,1,0,3,82.35294118
2015030154,25,3600,0.0,30,28,4,1,2,93.33333333
2015030154,30,3440,0.0,22,19,2,0,3,86.36363636
2015030155,30,3895,0.0,41,37,4,0,4,90.24390244
2015030155,25,3895,0.0,24,19,0,0,5,79.16666667
2015030156,25,3600,0.0,29,25,5,0,4,86.20689655
2015030156,30,3476,0.0,24,19,3,0,5,79.16666667
2015030161,16,4144,0.0,18,17,3,0,1,94.44444444
2015030161,19,4144,0.0,35,35,7,2,0,100.0
2015030162,16,3600,0.0,31,29,1,0,2,93.5483871
2015030162,19,3494,0.0,28,26,4,0,2,92.85714286
2015030163,19,3598,0.0,46,44,7,1,2,95.65217391
2015030163,16,3530,0.0,36,33,2,0,3,91.66666667
2015030164,19,3597,0.0,42,39,2,0,3,92.85714286
2015030164,16,3514,2.0,20,16,4,0,4,80.0
2015030165,16,4987,0.0,46,43,6,0,3,93.47826087
2015030165,19,4987,0.0,35,31,1,1,4,88.57142857
2015030166,19,3569,0.0,35,30,3,0,5,85.71428571
2015030166,16,3600,0.0,28,25,2,2,3,89.28571429
2015030167,16,3493,0.0,26,23,2,0,3,88.46153846
2015030167,19,3600,0.0,33,31,0,1,2,93.93939394
2015030171,18,3600,0.0,29,27,7,1,2,93.10344828
2015030171,24,3489,0.0,33,30,10,1,3,90.90909091
2015030172,18,3600,0.0,29,27,1,1,2,93.10344828
2015030172,24,3516,0.0,27,24,6,1,3,88.88888889
2015030173,24,3600,0.0,27,27,7,2,0,100.0
2015030173,18,3518,0.0,21,18,1,0,3,85.71428571
2015030174,24,3600,0.0,31,30,9,1,1,96.77419355
2015030174,18,3600,0.0,25,21,2,0,4,84.0
2015030175,18,3543,0.0,31,27,9,0,4,87.09677419
2015030175,24,3600,0.0,29,27,1,2,2,93.10344828
2015030176,24,3539,0.0,25,23,1,0,2,92.0
2015030176,18,3600,0.0,27,26,2,0,1,96.2962963
2015030177,18,3538,0.0,37,36,7,0,1,97.2972973
2015030177,24,3503,0.0,20,18,3,0,2,90.0
2015030181,28,3584,0.0,24,21,4,1,3,87.5
2015030181,26,3503,0.0,23,19,4,0,4,82.60869565
2015030182,28,3600,0.0,27,26,6,0,1,96.2962963
2015030182,26,3504,0.0,23,21,9,0,2,91.30434783
2015030183,26,3813,0.0,30,29,3,0,1,96.66666667
2015030183,28,3827,0.0,24,22,8,1,2,91.66666667
2015030184,26,3536,0.0,29,26,4,0,3,89.65517241
2015030184,28,3585,0.0,28,26,4,0,2,92.85714286
2015030185,28,3600,0.0,22,19,0,1,3,86.36363636
2015030185,26,3379,0.0,27,22,4,0,5,81.48148148
2015030211,2,3600,0.0,36,33,1,3,3,91.66666667
2015030211,14,1739,0.0,13,9,4,0,4,69.23076923
2015030211,14,1780,0.0,8,8,1,0,0,100.0
2015030212,2,3503,0.0,30,27,2,1,3,90.0
2015030212,14,3600,0.0,20,19,4,0,1,95.0
2015030213,14,3676,0.0,39,35,7,2,4,89.74358974
2015030213,2,3768,0.0,41,36,4,1,5,87.80487805
2015030214,14,3693,0.0,28,27,4,1,1,96.42857143
2015030214,2,3405,0.0,22,20,2,0,2,90.90909091
2015030214,2,287,0.0,2,2,2,0,0,100.0
2015030215,2,3600,0.0,25,21,6,0,4,84.0
2015030215,14,3600,0.0,28,28,2,2,0,100.0
2015030221,5,4173,0.0,35,31,6,0,4,88.57142857
2015030221,15,4139,0.0,45,42,2,2,3,93.33333333
2015030222,5,3600,0.0,24,23,1,1,1,95.83333333
2015030222,15,3483,0.0,35,33,9,0,2,94.28571429
2015030223,15,3471,0.0,23,20,3,1,3,86.95652174
2015030223,5,3600,0.0,49,47,5,0,2,95.91836735
2015030224,15,3737,0.0,33,30,4,1,3,90.90909091
2015030224,5,3754,0.0,36,34,1,0,2,94.44444444
2015030225,5,3405,0.0,19,16,4,0,3,84.21052632
2015030225,15,3600,0.0,31,30,7,0,1,96.77419355
2015030226,15,3992,0.0,42,38,3,0,4,90.47619048
2015030226,5,3992,0.0,39,36,6,0,3,92.30769231
2015030231,19,3500,2.0,42,40,4,0,2,95.23809524
2015030231,25,3600,0.0,32,31,3,1,1,96.875
2015030232,19,4258,0.0,34,31,4,1,3,91.17647059
2015030232,25,3058,0.0,20,19,4,0,1,95.0
2015030232,25,1200,0.0,5,2,1,0,3,40.0
2015030233,25,1354,0.0,12,9,0,0,3,75.0
2015030233,25,2246,0.0,27,24,6,1,3,88.88888889
2015030233,19,3600,0.0,26,25,1,3,1,96.15384615
2015030234,25,3776,0.0,26,24,1,0,2,92.30769231
2015030234,19,3778,0.0,28,25,2,1,3,89.28571429
2015030235,19,3598,0.0,28,27,3,0,1,96.42857143
2015030235,25,3388,0.0,21,18,1,0,3,85.71428571
2015030236,25,3600,0.0,37,35,3,0,2,94.59459459
2015030236,19,1009,0.0,7,4,0,0,3,57.14285714
2015030236,19,2484,0.0,7,7,0,0,0,100.0
2015030237,19,3600,0.0,32,31,7,0,1,96.875
2015030237,25,2314,0.0,10,8,0,0,2,80.0
2015030237,25,1200,0.0,8,5,3,0,3,62.5
2015030241,18,3446,0.0,36,33,6,1,3,91.66666667
2015030241,18,50,0.0,0,0,0,0,0,
2015030241,28,3600,0.0,31,29,3,0,2,93.5483871
2015030242,18,3478,0.0,24,22,5,1,2,91.66666667
2015030242,28,3600,0.0,39,37,6,0,2,94.87179487
2015030243,28,3600,0.0,25,21,8,1,4,84.0
2015030243,18,3590,0.0,27,26,4,1,1,96.2962963
2015030244,28,6672,0.0,45,41,9,0,4,91.11111111
2015030244,18,6672,0.0,47,44,4,1,3,93.61702128
2015030245,18,3416,0.0,27,23,0,0,4,85.18518519
2015030245,18,181,0.0,2,1,1,0,1,50.0
2015030245,28,3600,0.0,25,24,5,2,1,96.0
2015030246,28,3717,0.0,32,28,1,0,4,87.5
2015030246,18,3723,0.0,18,15,1,0,3,83.33333333
2015030247,18,2634,0.0,26,21,3,0,5,80.76923077
2015030247,18,966,0.0,1,1,0,0,0,100.0
2015030247,28,3600,0.0,20,20,2,1,0,100.0
2015030311,14,745,0.0,9,9,4,0,0,100.0
2015030311,14,2835,0.0,26,25,6,0,1,96.15384615
2015030311,5,3464,0.0,20,17,2,0,3,85.0
2015030312,14,3640,0.0,41,38,3,0,3,92.68292683
2015030312,5,3640,2.0,21,19,2,0,2,90.47619048
2015030313,5,3600,0.0,28,26,0,2,2,92.85714286
2015030313,14,3504,0.0,48,44,6,0,4,91.66666667
2015030314,5,1106,0.0,7,7,0,0,0,100.0
2015030314,5,2400,0.0,30,26,7,2,4,86.66666667
2015030314,14,3585,0.0,38,35,4,2,3,92.10526316
2015030315,14,3647,0.0,34,31,4,0,3,91.17647059
2015030315,5,3653,0.0,25,21,5,1,4,84.0
2015030316,5,3600,0.0,30,28,1,0,2,93.33333333
2015030316,14,3541,0.0,33,29,6,1,4,87.87878788
2015030317,14,3533,0.0,39,37,9,0,2,94.87179487
2015030317,5,3593,0.0,17,16,0,0,1,94.11764706
2015030321,28,3418,0.0,23,21,2,1,2,91.30434783
2015030321,19,3600,0.0,32,31,5,0,1,96.875
2015030322,28,3600,0.0,26,26,12,0,0,100.0
2015030322,19,3370,0.0,23,20,5,0,3,86.95652174
2015030323,19,2769,0.0,14,11,1,1,3,78.57142857
2015030323,19,513,0.0,2,2,0,0,0,100.0
2015030323,28,3600,0.0,22,22,1,2,0,100.0
2015030324,19,3600,0.0,34,31,2,1,3,91.17647059
2015030324,28,1811,0.0,19,15,3,0,4,78.94736842
2015030324,28,1745,0.0,7,6,0,0,1,85.71428571
2015030325,28,3597,0.0,21,18,0,1,3,85.71428571
2015030325,19,3536,0.0,25,21,3,0,4,84.0
2015030326,19,3389,0.0,26,22,3,0,4,84.61538462
2015030326,19,13,0.0,0,0,0,0,0,
2015030326,28,3600,0.0,26,24,0,2,2,92.30769231
2015030411,28,3522,0.0,41,38,5,0,3,92.68292683
2015030411,5,3600,0.0,26,24,1,0,2,92.30769231
2015030412,28,3755,0.0,30,28,3,0,2,93.33333333
2015030412,5,3755,0.0,22,21,2,0,1,95.45454545
2015030413,5,4338,0.0,26,23,6,0,3,88.46153846
2015030413,28,4314,0.0,42,40,1,0,2,95.23809524
2015030414,5,3600,0.0,24,23,3,0,1,95.83333333
2015030414,28,3489,0.0,20,17,2,1,3,85.0
2015030415,28,3600,0.0,46,44,4,0,2,95.65217391
2015030415,5,3523,0.0,21,18,5,0,3,85.71428571
2015030416,5,3600,0.0,19,18,0,0,1,94.73684211
2015030416,28,3507,0.0,26,24,0,0,2,92.30769231
2016020001,10,3637,0.0,30,25,4,1,5,83.33333333
2016020001,9,3637,0.0,38,34,7,0,4,89.47368421
2016020002,19,3600,0.0,19,17,7,0,2,89.47368421
2016020002,16,3473,0.0,32,29,10,0,3,90.625
2016020003,20,3556,0.0,27,21,2,1,6,77.77777778
2016020003,22,3573,0.0,41,37,8,3,4,90.24390244
2016020004,26,2336,0.0,16,15,1,0,1,93.75
2016020004,26,1196,2.0,15,14,2,0,1,93.33333333
2016020004,28,3598,0.0,22,21,0,0,1,95.45454545
2016020005,8,3600,0.0,31,30,6,1,1,96.77419355
2016020005,7,3476,0.0,24,20,1,2,4,83.33333333
2016020006,2,3542,0.0,38,34,11,2,4,89.47368421
2016020006,3,3600,0.0,28,25,3,0,3,89.28571429
2016020007,15,3884,0.0,30,28,0,0,2,93.33333333
2016020007,5,3900,0.0,41,39,2,0,2,95.12195122
2016020008,6,3562,0.0,31,28,2,2,3,90.32258065
2016020008,29,3493,0.0,36,31,5,2,5,86.11111111
2016020009,17,3535,0.0,35,30,6,0,5,85.71428571
2016020009,14,3579,0.0,32,28,3,0,4,87.5
2016020010,1,3768,0.0,34,32,2,0,2,94.11764706
2016020010,13,3743,0.0,24,23,0,0,1,95.83333333
2016020011,30,3485,0.0,31,28,4,0,3,90.32258065
2016020011,19,3600,0.0,21,19,4,1,2,90.47619048
2016020012,12,3761,0.0,26,21,2,0,5,80.76923077
2016020012,52,3745,0.0,27,23,3,1,4,85.18518519
2016020013,24,3416,0.0,20,16,4,0,4,80.0
2016020013,25,3594,0.0,35,33,9,3,2,94.28571429
2016020014,16,3494,0.0,27,24,3,0,3,88.88888889
2016020014,18,3586,0.0,24,22,7,0,2,91.66666667
2016020015,22,3600,0.0,35,32,5,0,3,91.42857143
2016020015,20,3542,0.0,28,24,6,0,4,85.71428571
2016020016,4,3600,0.0,25,23,1,0,2,92.0
2016020016,26,3508,0.0,30,26,4,1,4,86.66666667
2016020017,6,3582,2.0,24,20,4,0,4,83.33333333
2016020017,10,3600,0.0,25,24,2,3,1,96.0
2016020018,8,3900,0.0,38,35,4,0,3,92.10526316
2016020018,9,3900,0.0,24,21,4,0,3,87.5
2016020019,1,3499,0.0,34,31,5,1,3,91.17647059
2016020019,14,3565,0.0,34,32,8,0,2,94.11764706
2016020020,17,3562,0.0,37,34,4,0,3,91.89189189
2016020020,13,3600,0.0,22,21,1,0,1,95.45454545
2016020021,24,3556,0.0,45,42,8,0,3,93.33333333
2016020021,5,3600,0.0,36,34,4,0,2,94.44444444
2016020022,2,3496,0.0,28,26,7,0,2,92.85714286
2016020022,15,3582,0.0,22,21,3,1,1,95.45454545
2016020023,28,3600,0.0,28,26,2,1,2,92.85714286
2016020023,29,3532,0.0,37,35,11,1,2,94.59459459
2016020024,52,3454,0.0,31,27,3,2,4,87.09677419
2016020024,30,3600,0.0,17,14,2,0,3,82.35294118
2016020025,3,3519,0.0,18,15,3,0,3,83.33333333
2016020025,19,3587,0.0,35,33,1,4,2,94.28571429
2016020026,18,3506,0.0,27,22,7,0,5,81.48148148
2016020026,16,3600,0.0,36,33,3,0,3,91.66666667
2016020027,25,1625,0.0,20,15,4,2,5,75.0
2016020027,25,1917,0.0,13,12,0,0,1,92.30769231
2016020027,21,3600,0.0,28,23,1,3,5,82.14285714
2016020028,4,3792,0.0,35,31,11,1,4,88.57142857
2016020028,53,3782,0.0,30,27,4,0,3,90.0
2016020029,20,3900,0.0,31,30,8,0,1,96.77419355
2016020029,23,3897,0.0,25,25,4,1,0,100.0
2016020030,24,3610,0.0,30,27,5,0,3,90.0
2016020030,2,3652,0.0,26,24,7,0,2,92.30769231
2016020031,7,3600,0.0,33,31,6,1,2,93.93939394
2016020031,22,604,0.0,1,1,0,0,0,100.0
2016020031,22,2996,0.0,23,17,6,0,6,73.91304348
2016020032,12,3625,0.0,31,27,2,0,4,87.09677419
2016020032,23,3623,0.0,22,19,4,3,3,86.36363636
2016020033,28,3541,0.0,27,22,5,0,5,81.48148148
2016020033,3,3598,0.0,31,27,5,0,4,87.09677419
2016020034,21,3622,0.0,31,28,1,0,3,90.32258065
2016020034,5,3572,0.0,31,27,6,1,4,87.09677419
2016020035,9,3600,0.0,25,20,2,0,5,80.0
2016020035,17,3598,0.0,32,31,5,1,1,96.875
2016020036,6,3600,0.0,35,34,14,2,1,97.14285714
2016020036,52,3550,0.0,24,21,5,1,3,87.5
2016020037,24,3519,0.0,28,26,10,0,2,92.85714286
2016020037,1,3598,0.0,24,23,8,2,1,95.83333333
2016020038,28,3600,0.0,23,21,2,0,2,91.30434783
2016020038,2,3513,0.0,27,24,2,1,3,88.88888889
2016020039,21,3600,0.0,40,37,9,2,3,92.5
2016020039,15,3600,0.0,18,18,2,0,0,100.0
2016020040,5,3600,0.0,32,28,4,2,4,87.5
2016020040,8,3600,0.0,36,36,3,2,0,100.0
2016020041,53,2830,0.0,30,27,3,0,3,90.0
2016020041,53,698,0.0,11,8,0,1,3,72.72727273
2016020041,9,3600,0.0,35,31,4,0,4,88.57142857
2016020042,13,3887,0.0,28,25,0,1,3,89.28571429
2016020042,14,3838,0.0,31,28,1,0,3,90.32258065
2016020043,25,3599,0.0,28,27,4,1,1,96.42857143
2016020043,18,3482,0.0,37,35,7,1,2,94.59459459
2016020044,26,2400,0.0,16,11,5,0,5,68.75
2016020044,26,1193,0.0,9,9,1,0,0,100.0
2016020044,30,3600,0.0,30,27,6,0,3,90.0
2016020045,4,1504,0.0,16,12,1,0,4,75.0
2016020045,4,2011,0.0,11,9,1,0,2,81.81818182
2016020045,16,3598,0.0,27,23,2,0,4,85.18518519
2016020046,7,3728,0.0,34,30,5,1,4,88.23529412
2016020046,20,3742,0.0,21,18,1,2,3,85.71428571
2016020047,12,3480,0.0,28,25,4,0,3,89.28571429
2016020047,22,3600,0.0,33,31,4,2,2,93.93939394
2016020048,19,3700,0.0,26,24,6,0,2,92.30769231
2016020048,23,3700,0.0,24,23,0,2,1,95.83333333
2016020049,17,3600,0.0,33,32,7,2,1,96.96969697
2016020049,3,3521,0.0,18,16,2,1,2,88.88888889
2016020050,10,3760,0.0,34,29,5,0,5,85.29411765
2016020050,52,3719,0.0,40,36,4,0,4,90.0
2016020051,1,3533,0.0,36,34,4,1,2,94.44444444
2016020051,6,3600,0.0,29,28,1,1,1,96.55172414
2016020052,24,3584,0.0,22,20,4,0,2,90.90909091
2016020052,4,3534,0.0,26,23,6,0,3,88.46153846
2016020053,28,3468,0.0,20,17,9,0,3,85.0
2016020053,5,3600,0.0,34,32,5,1,2,94.11764706
2016020054,53,1549,0.0,19,15,2,1,4,78.94736842
2016020054,53,2051,0.0,24,23,1,0,1,95.83333333
2016020054,8,3551,0.0,29,27,1,1,2,93.10344828
2016020055,21,3600,0.0,27,27,5,1,0,100.0
2016020055,14,3347,0.0,16,12,0,1,4,75.0
2016020056,15,3600,0.0,28,26,5,1,2,92.85714286
2016020056,13,3547,0.0,29,25,2,0,4,86.20689655
2016020057,10,3503,0.0,27,24,5,0,3,88.88888889
2016020057,30,3600,0.0,33,31,10,0,2,93.93939394
2016020058,26,3680,0.0,20,17,3,0,3,85.0
2016020058,25,3642,0.0,39,35,7,2,4,89.74358974
2016020059,12,3594,0.0,26,24,9,0,2,92.30769231
2016020059,20,3569,0.0,32,28,5,3,4,87.5
2016020060,19,3558,0.0,22,20,2,0,2,90.90909091
2016020060,22,3600,0.0,35,34,8,1,1,97.14285714
2016020061,7,3526,0.0,20,18,2,1,2,90.0
2016020061,23,3600,0.0,27,26,3,0,1,96.2962963
2016020062,53,3521,0.0,31,28,2,3,3,90.32258065
2016020062,2,3593,0.0,25,23,2,0,2,92.0
2016020063,16,3435,0.0,28,25,1,0,3,89.28571429
2016020063,29,3598,0.0,34,32,9,0,2,94.11764706
2016020064,18,3562,0.0,42,38,4,1,4,90.47619048
2016020064,17,3597,0.0,33,30,4,0,3,90.90909091
2016020065,8,3600,0.0,21,19,7,0,2,90.47619048
2016020065,6,3436,0.0,29,25,4,0,4,86.20689655
2016020066,14,3600,0.0,28,27,8,0,1,96.42857143
2016020066,9,3600,0.0,35,31,4,1,4,88.57142857
2016020067,28,3407,0.0,32,29,9,0,3,90.625
2016020067,17,3597,0.0,30,30,6,2,0,100.0
2016020068,21,3597,0.0,38,33,6,3,5,86.84210526
2016020068,13,3583,0.0,28,26,0,2,2,92.85714286
2016020069,30,3629,0.0,32,30,3,1,2,93.75
2016020069,1,3629,0.0,29,28,4,0,1,96.55172414
2016020070,12,3597,0.0,27,21,6,1,6,77.77777778
2016020070,4,3566,0.0,30,27,2,0,3,90.0
2016020071,3,3581,0.0,28,26,1,1,2,92.85714286
2016020071,15,3509,0.0,25,22,3,0,3,88.0
2016020072,10,3856,0.0,35,31,4,0,4,88.57142857
2016020072,16,3857,0.0,34,30,2,2,4,88.23529412
2016020073,5,2400,2.0,23,18,3,0,5,78.26086957
2016020073,5,1200,0.0,7,7,0,1,0,100.0
2016020073,18,3562,0.0,35,34,6,2,1,97.14285714
2016020074,29,3600,0.0,32,32,6,0,0,100.0
2016020074,25,3566,0.0,25,23,0,1,2,92.0
2016020075,19,3600,0.0,27,23,7,1,4,85.18518519
2016020075,20,3563,0.0,39,34,5,1,5,87.17948718
2016020076,23,3878,0.0,31,28,7,1,3,90.32258065
2016020076,26,3900,0.0,25,22,7,0,3,88.0
2016020077,22,3600,0.0,31,31,12,0,0,100.0
2016020077,52,3284,0.0,32,29,4,2,3,90.625
2016020078,30,3592,0.0,32,27,2,0,5,84.375
2016020078,2,3600,0.0,29,26,5,0,3,89.65517241
2016020079,53,3530,0.0,26,23,2,0,3,88.46153846
2016020079,3,3596,0.0,29,27,1,0,2,93.10344828
2016020080,23,3540,0.0,37,33,3,1,4,89.18918919
2016020080,24,3600,0.0,19,17,3,0,2,89.47368421
2016020081,4,3515,0.0,32,30,3,0,2,93.75
2016020081,8,3599,0.0,32,31,1,1,1,96.875
2016020082,20,3883,0.0,33,31,3,0,2,93.93939394
2016020082,16,3900,0.0,31,29,6,1,2,93.5483871
2016020083,30,3600,0.0,27,27,3,0,0,100.0
2016020083,6,1836,0.0,16,13,1,0,3,81.25
2016020083,6,1764,0.0,17,15,4,0,2,88.23529412
2016020084,53,3524,0.0,34,30,1,0,4,88.23529412
2016020084,1,3600,0.0,31,28,1,0,3,90.32258065
2016020085,7,3884,0.0,41,38,6,1,3,92.68292683
2016020085,4,2143,0.0,17,14,4,0,3,82.35294118
2016020085,4,1757,0.0,8,8,1,0,0,100.0
2016020086,13,3574,0.0,22,19,0,1,3,86.36363636
2016020086,5,3600,0.0,22,20,6,0,2,90.90909091
2016020087,14,3600,0.0,43,40,8,0,3,93.02325581
2016020087,10,3600,0.0,24,17,4,0,7,70.83333333
2016020088,12,3485,2.0,25,21,2,2,4,84.0
2016020088,17,3600,0.0,31,29,2,0,2,93.5483871
2016020089,20,3600,0.0,24,23,6,0,1,95.83333333
2016020089,19,3555,0.0,29,26,4,0,3,89.65517241
2016020090,52,3536,0.0,26,23,8,1,3,88.46153846
2016020090,25,3593,0.0,30,28,5,0,2,93.33333333
2016020091,9,3597,0.0,22,22,0,0,0,100.0
2016020091,23,3546,0.0,27,25,0,1,2,92.59259259
2016020092,29,3674,0.0,30,27,0,0,3,90.0
2016020092,26,3674,0.0,21,19,0,1,2,90.47619048
2016020093,24,2484,0.0,25,24,7,0,1,96.0
2016020093,24,1200,0.0,11,10,4,0,1,90.90909091
2016020093,28,3653,0.0,20,19,7,1,1,95.0
2016020094,8,3600,0.0,28,26,1,0,2,92.85714286
2016020094,2,3523,0.0,29,26,1,1,3,89.65517241
2016020095,6,3598,0.0,31,26,15,0,5,83.87096774
2016020095,3,3600,0.0,29,27,2,0,2,93.10344828
2016020096,15,3600,0.0,29,25,4,0,4,86.20689655
2016020096,22,3597,2.0,35,34,9,0,1,97.14285714
2016020097,18,2104,0.0,17,13,3,2,4,76.47058824
2016020097,18,1496,0.0,9,7,2,0,2,77.77777778
2016020097,24,3600,0.0,29,28,7,0,1,96.55172414
2016020098,30,3600,0.0,38,38,4,0,0,100.0
2016020098,7,3570,0.0,21,18,3,0,3,85.71428571
2016020099,53,3600,0.0,32,28,11,0,4,87.5
2016020099,4,3516,0.0,25,20,3,4,5,80.0
2016020100,2,3488,0.0,35,31,3,3,4,88.57142857
2016020100,5,3597,2.0,37,35,11,1,2,94.59459459
2016020101,13,3535,0.0,28,25,4,1,3,89.28571429
2016020101,10,3600,0.0,31,29,4,0,2,93.5483871
2016020102,14,3534,0.0,25,23,1,0,2,92.0
2016020102,8,3600,0.0,31,30,4,0,1,96.77419355
2016020103,17,3900,0.0,32,31,9,0,1,96.875
2016020103,19,3893,0.0,27,26,6,0,1,96.2962963
2016020104,25,3313,0.0,36,32,12,1,4,88.88888889
2016020104,52,3597,0.0,39,38,14,1,1,97.43589744
2016020105,18,3871,0.0,45,42,9,1,3,93.33333333
2016020105,26,3871,0.0,26,24,3,0,2,92.30769231
2016020106,29,3492,0.0,28,26,3,1,2,92.85714286
2016020106,28,3594,0.0,25,24,6,0,1,96.0
2016020107,16,3608,0.0,32,30,4,0,2,93.75
2016020107,1,3664,0.0,29,26,6,0,3,89.65517241
2016020108,3,3554,0.0,21,18,1,0,3,85.71428571
2016020108,12,3600,0.0,30,28,4,0,2,93.33333333
2016020109,52,3600,0.0,37,37,6,1,0,100.0
2016020109,21,3506,0.0,21,20,4,1,1,95.23809524
2016020110,9,2400,0.0,15,11,1,0,4,73.33333333
2016020110,9,1200,0.0,4,3,0,0,1,75.0
2016020110,20,3547,0.0,33,31,6,4,2,93.93939394
2016020111,22,3600,0.0,26,26,1,1,0,100.0
2016020111,23,3496,0.0,26,25,1,0,1,96.15384615
2016020112,29,3600,0.0,35,35,5,2,0,100.0
2016020112,24,587,0.0,5,5,2,0,0,100.0
2016020112,24,2993,0.0,32,28,2,3,4,87.5
2016020113,13,3584,0.0,25,22,7,0,3,88.0
2016020113,7,3598,0.0,33,33,9,1,0,100.0
2016020114,10,3466,0.0,31,29,3,1,2,93.5483871
2016020114,8,3600,0.0,38,37,6,0,1,97.36842105
2016020115,6,3600,0.0,24,24,3,0,0,100.0
2016020115,17,3512,0.0,36,35,5,1,1,97.22222222
2016020116,14,3380,0.0,23,20,3,0,3,86.95652174
2016020116,1,3600,0.0,33,32,9,0,1,96.96969697
2016020117,5,3600,0.0,42,38,6,3,4,90.47619048
2016020117,4,2278,0.0,14,12,1,0,2,85.71428571
2016020117,4,1200,0.0,13,10,0,0,3,76.92307692
2016020118,26,3585,0.0,25,24,7,0,1,96.0
2016020118,19,3586,2.0,27,27,10,1,0,100.0
2016020119,25,3600,0.0,15,11,1,0,4,73.33333333
2016020119,30,3600,0.0,29,29,4,0,0,100.0
2016020120,21,3600,0.0,26,24,5,1,2,92.30769231
2016020120,53,3523,0.0,34,31,5,2,3,91.17647059
2016020121,15,3600,0.0,25,23,5,0,2,92.0
2016020121,23,3589,0.0,34,30,2,0,4,88.23529412
2016020122,18,3531,0.0,26,23,2,0,3,88.46153846
2016020122,28,3599,0.0,28,27,2,0,1,96.42857143
2016020123,7,3600,0.0,38,37,12,2,1,97.36842105
2016020123,52,1389,0.0,13,13,2,1,0,100.0
2016020123,52,2039,0.0,15,12,0,2,3,80.0
2016020124,13,3600,0.0,36,34,10,1,2,94.44444444
2016020124,17,1897,0.0,14,13,5,1,1,92.85714286
2016020124,17,1502,0.0,10,6,0,0,4,60.0
2016020125,4,3600,0.0,29,26,3,0,3,89.65517241
2016020125,12,3498,0.0,28,24,2,0,4,85.71428571
2016020126,10,3598,0.0,35,30,3,0,5,85.71428571
2016020126,2,3600,0.0,34,33,3,1,1,97.05882353
2016020127,14,3600,0.0,37,31,4,1,6,83.78378378
2016020127,3,3572,0.0,32,31,4,0,1,96.875
2016020128,26,3585,0.0,28,26,4,0,2,92.85714286
2016020128,16,3600,0.0,32,32,2,0,0,100.0
2016020129,9,3600,0.0,37,37,4,2,0,100.0
2016020129,22,3534,0.0,21,20,5,0,1,95.23809524
2016020130,15,3600,0.0,22,21,1,0,1,95.45454545
2016020130,20,3549,0.0,28,26,3,0,2,92.85714286
2016020131,14,3600,0.0,27,26,8,0,1,96.2962963
2016020131,2,814,0.0,11,8,3,0,3,72.72727273
2016020131,2,2786,0.0,25,22,11,2,3,88.0
2016020132,19,1625,0.0,9,8,2,0,1,88.88888889
2016020132,19,1975,0.0,20,16,3,0,4,80.0
2016020132,3,3600,0.0,35,35,2,1,0,100.0
2016020133,25,3646,0.0,28,25,1,1,3,89.28571429
2016020133,29,3567,0.0,38,36,5,0,2,94.73684211
2016020134,22,3612,0.0,31,28,0,0,3,90.32258065
2016020134,10,3594,0.0,46,44,6,0,2,95.65217391
2016020135,12,3789,0.0,32,30,1,0,2,93.75
2016020135,9,3787,0.0,33,32,2,1,1,96.96969697
2016020136,6,3600,0.0,34,33,6,1,1,97.05882353
2016020136,13,3413,0.0,26,24,2,1,2,92.30769231
2016020137,7,3600,0.0,28,27,1,0,1,96.42857143
2016020137,30,3494,0.0,24,22,2,0,2,91.66666667
2016020138,15,3596,0.0,45,43,9,0,2,95.55555556
2016020138,52,3577,0.0,27,24,3,0,3,88.88888889
2016020139,20,3592,0.0,21,17,3,2,4,80.95238095
2016020139,16,3600,0.0,34,33,5,1,1,97.05882353
2016020140,18,3590,0.0,29,28,7,3,1,96.55172414
2016020140,21,3580,0.0,36,31,8,0,5,86.11111111
2016020141,28,3417,0.0,30,27,3,1,3,90.0
2016020141,53,3600,0.0,41,39,6,0,2,95.12195122
2016020142,24,3600,0.0,30,30,3,0,0,100.0
2016020142,26,1200,0.0,5,5,1,0,0,100.0
2016020142,26,2400,0.0,16,12,1,0,4,75.0
2016020143,23,3585,0.0,21,19,0,1,2,90.47619048
2016020143,8,3600,0.0,42,42,4,1,0,100.0
2016020144,17,3701,0.0,40,36,2,0,4,90.0
2016020144,4,3680,0.0,25,22,1,1,3,88.0
2016020145,5,3595,0.0,33,32,5,1,1,96.96969697
2016020145,24,3076,0.0,34,29,1,0,5,85.29411765
2016020145,24,520,0.0,0,0,0,0,0,
2016020146,10,3600,0.0,43,42,7,0,1,97.6744186
2016020146,7,3512,0.0,29,27,0,1,2,93.10344828
2016020147,4,3872,0.0,27,25,4,1,2,92.59259259
2016020147,2,3900,0.0,42,40,11,0,2,95.23809524
2016020148,22,3590,0.0,30,26,2,0,4,86.66666667
2016020148,3,3600,0.0,24,21,4,1,3,87.5
2016020149,52,3801,0.0,32,28,8,0,4,87.5
2016020149,15,3801,0.0,27,24,3,0,3,88.88888889
2016020150,23,3502,0.0,24,23,1,0,1,95.83333333
2016020150,9,3600,0.0,27,27,2,1,0,100.0
2016020151,6,3896,0.0,30,27,4,0,3,90.0
2016020151,14,3900,0.0,31,28,6,0,3,90.32258065
2016020152,1,3828,0.0,31,27,4,0,4,87.09677419
2016020152,13,3847,2.0,34,31,7,0,3,91.17647059
2016020153,21,3600,0.0,21,17,4,0,4,80.95238095
2016020153,16,3600,0.0,38,38,5,0,0,100.0
2016020154,19,3583,0.0,26,21,4,0,5,80.76923077
2016020154,25,3596,0.0,30,28,4,1,2,93.33333333
2016020155,18,3884,0.0,28,26,3,1,2,92.85714286
2016020155,53,3900,0.0,37,35,13,0,2,94.59459459
2016020156,5,3757,0.0,27,24,1,1,3,88.88888889
2016020156,26,3750,0.0,23,21,1,0,2,91.30434783
2016020157,20,3600,0.0,28,26,6,1,2,92.85714286
2016020157,28,3495,0.0,22,19,0,1,3,86.36363636
2016020158,8,3600,0.0,40,30,6,0,10,75.0
2016020158,29,3600,2.0,30,30,3,1,0,100.0
2016020159,52,3600,0.0,33,30,6,0,3,90.90909091
2016020159,17,3580,0.0,30,26,0,0,4,86.66666667
2016020160,53,1200,0.0,21,18,0,0,3,85.71428571
2016020160,53,2400,0.0,12,10,0,0,2,83.33333333
2016020160,24,3600,0.0,22,21,0,1,1,95.45454545
2016020161,30,3538,4.0,32,31,2,1,1,96.875
2016020161,21,3600,0.0,32,32,5,0,0,100.0
2016020162,3,3600,0.0,37,35,5,0,2,94.59459459
2016020162,6,3587,0.0,24,19,5,1,5,79.16666667
2016020163,23,3292,22.0,42,36,5,2,6,85.71428571
2016020163,23,308,0.0,0,0,0,0,0,
2016020163,10,308,0.0,3,3,3,0,0,100.0
2016020163,10,3289,12.0,26,23,1,1,3,88.46153846
2016020164,4,3557,0.0,17,12,3,0,5,70.58823529
2016020164,8,3600,0.0,38,34,8,2,4,89.47368421
2016020165,7,3600,0.0,33,32,4,1,1,96.96969697
2016020165,9,3541,0.0,32,30,1,0,2,93.75
2016020166,1,3597,0.0,35,31,6,1,4,88.57142857
2016020166,14,3600,0.0,38,37,6,1,1,97.36842105
2016020167,22,3900,0.0,33,30,2,0,3,90.90909091
2016020167,2,3900,0.0,23,20,2,0,3,86.95652174
2016020168,13,3522,0.0,36,32,13,0,4,88.88888889
2016020168,15,3585,0.0,24,22,1,1,2,91.66666667
2016020169,29,3857,0.0,30,28,6,0,2,93.33333333
2016020169,19,3844,0.0,21,20,4,1,1,95.23809524
2016020170,12,3900,0.0,27,25,3,0,2,92.59259259
2016020170,18,3900,0.0,25,23,3,1,2,92.0
2016020171,16,3600,0.0,33,31,8,2,2,93.93939394
2016020171,25,3491,0.0,32,29,3,1,3,90.625
2016020172,20,3600,0.0,39,34,9,0,5,87.17948718
2016020172,26,3600,0.0,24,24,4,0,0,100.0
2016020173,5,3600,0.0,32,32,10,0,0,100.0
2016020173,28,1213,0.0,7,4,0,0,3,57.14285714
2016020173,28,2387,0.0,18,16,4,3,2,88.88888889
2016020174,22,3600,0.0,23,22,2,0,1,95.65217391
2016020174,17,3508,0.0,28,26,1,0,2,92.85714286
2016020175,21,1200,0.0,3,3,0,0,0,100.0
2016020175,21,2400,0.0,25,20,5,4,5,80.0
2016020175,19,3564,0.0,23,22,7,0,1,95.65217391
2016020176,1,3590,0.0,34,33,8,0,1,97.05882353
2016020176,12,3409,0.0,20,17,4,0,3,85.0
2016020177,52,2184,0.0,16,12,0,0,4,75.0
2016020177,52,1278,0.0,2,1,0,0,1,50.0
2016020177,3,3591,0.0,26,24,5,0,2,92.30769231
2016020178,25,3847,0.0,33,29,3,0,4,87.87878788
2016020178,16,3870,0.0,35,32,7,1,3,91.42857143
2016020179,20,3600,0.0,21,17,1,3,4,80.95238095
2016020179,24,3600,0.0,26,25,3,0,1,96.15384615
2016020180,7,3600,0.0,42,38,13,3,4,90.47619048
2016020180,6,3594,0.0,32,32,4,2,0,100.0
2016020181,23,3469,0.0,32,28,5,0,4,87.5
2016020181,2,3590,0.0,32,30,1,0,2,93.75
2016020182,14,3539,0.0,31,29,5,0,2,93.5483871
2016020182,13,3600,0.0,35,34,3,0,1,97.14285714
2016020183,12,3900,0.0,41,39,3,0,2,95.12195122
2016020183,1,3900,0.0,33,31,1,1,2,93.93939394
2016020184,23,3600,0.0,26,23,2,3,3,88.46153846
2016020184,3,379,0.0,6,4,1,0,2,66.66666667
2016020184,3,3185,0.0,22,20,1,5,2,90.90909091
2016020185,17,3900,0.0,25,23,3,0,2,92.0
2016020185,4,3883,0.0,35,33,5,0,2,94.28571429
2016020186,22,3531,0.0,31,27,4,1,4,87.09677419
2016020186,5,3600,0.0,28,25,0,1,3,89.28571429
2016020187,28,3600,0.0,24,24,5,1,0,100.0
2016020187,15,3511,0.0,22,20,4,0,2,90.90909091
2016020188,26,3592,0.0,19,19,1,0,0,100.0
2016020188,10,1578,0.0,17,14,3,1,3,82.35294118
2016020188,10,2013,0.0,26,22,7,0,4,84.61538462
2016020189,6,3548,0.0,23,20,1,0,3,86.95652174
2016020189,8,3600,0.0,43,41,5,0,2,95.34883721
2016020190,9,3500,0.0,30,27,2,0,3,90.0
2016020190,18,3594,0.0,34,33,2,0,1,97.05882353
2016020191,25,1789,0.0,20,16,5,2,4,80.0
2016020191,25,1807,0.0,11,7,3,0,4,63.63636364
2016020191,52,3600,0.0,30,28,7,0,2,93.33333333
2016020192,53,3594,0.0,27,25,0,1,2,92.59259259
2016020192,21,3518,0.0,25,21,2,0,4,84.0
2016020193,24,3644,0.0,18,15,2,1,3,83.33333333
2016020193,29,3681,0.0,32,30,9,0,2,93.75
2016020194,9,3891,0.0,32,31,5,1,1,96.875
2016020194,7,3900,0.0,29,28,6,0,1,96.55172414
2016020195,16,3625,0.0,28,27,5,1,1,96.42857143
2016020195,19,3625,0.0,30,28,11,0,2,93.33333333
2016020196,29,2832,0.0,23,22,4,0,1,95.65217391
2016020196,29,768,0.0,9,5,0,0,4,55.55555556
2016020196,6,3600,0.0,17,15,3,0,2,88.23529412
2016020197,30,3600,2.0,41,39,10,0,2,95.12195122
2016020197,5,3571,0.0,43,40,6,0,3,93.02325581
2016020198,24,3600,2.0,30,28,3,0,2,93.33333333
2016020198,12,3485,0.0,26,23,7,0,3,88.46153846
2016020198,12,28,0.0,0,0,0,0,0,
2016020199,26,3593,0.0,22,19,1,0,3,86.36363636
2016020199,8,3600,0.0,24,23,8,0,1,95.83333333
2016020200,23,3516,0.0,27,24,3,1,3,88.88888889
2016020200,17,3552,0.0,37,36,3,1,1,97.2972973
2016020201,2,2230,0.0,12,11,4,0,1,91.66666667
2016020201,2,1370,0.0,16,13,5,0,3,81.25
2016020201,14,3592,0.0,32,31,0,3,1,96.875
2016020202,28,3600,0.0,24,22,1,0,2,91.66666667
2016020202,13,3569,0.0,28,25,3,0,3,89.28571429
2016020203,19,3459,2.0,28,25,8,0,3,89.28571429
2016020203,18,3598,0.0,24,23,0,0,1,95.83333333
2016020204,25,3591,0.0,31,29,4,2,2,93.5483871
2016020204,20,3559,0.0,21,18,0,0,3,85.71428571
2016020205,52,3593,0.0,25,23,1,1,2,92.0
2016020205,53,3537,0.0,27,24,1,0,3,88.88888889
2016020206,1,3629,0.0,26,25,1,1,1,96.15384615
2016020206,7,3629,0.0,43,41,15,0,2,95.34883721
2016020207,4,3600,0.0,23,17,2,0,6,73.91304348
2016020207,10,3596,0.0,33,30,0,4,3,90.90909091
2016020208,26,2379,0.0,18,18,5,0,0,100.0
2016020208,26,1200,0.0,15,13,0,0,2,86.66666667
2016020208,9,3600,0.0,33,32,5,1,1,96.96969697
2016020209,15,3740,0.0,34,32,1,0,2,94.11764706
2016020209,16,3535,0.0,27,24,0,0,3,88.88888889
2016020209,16,78,0.0,1,1,0,0,0,100.0
2016020210,52,3683,0.0,28,25,4,5,3,89.28571429
2016020210,21,3661,0.0,18,16,7,0,2,88.88888889
2016020211,25,3600,0.0,42,40,5,2,2,95.23809524
2016020211,22,3448,0.0,30,27,2,1,3,90.0
2016020212,17,2400,0.0,25,20,1,1,5,80.0
2016020212,17,1180,0.0,12,12,0,0,0,100.0
2016020212,8,3596,0.0,25,25,8,1,0,100.0
2016020213,28,3600,0.0,26,25,3,0,1,96.15384615
2016020213,14,3432,0.0,20,17,1,0,3,85.0
2016020214,2,3848,0.0,43,40,14,0,3,93.02325581
2016020214,13,3817,0.0,21,19,7,2,2,90.47619048
2016020214,13,20,0.0,0,0,0,0,0,
2016020215,7,3600,0.0,27,23,5,0,4,85.18518519
2016020215,1,3600,0.0,23,21,0,1,2,91.30434783
2016020216,30,3513,0.0,36,33,8,0,3,91.66666667
2016020216,4,1200,0.0,7,6,0,0,1,85.71428571
2016020216,4,2400,0.0,20,19,2,0,1,95.0
2016020217,10,3600,0.0,49,45,4,1,4,91.83673469
2016020217,5,3600,0.0,36,35,2,3,1,97.22222222
2016020218,15,3573,0.0,37,33,4,2,4,89.18918919
2016020218,12,3600,0.0,21,20,4,0,1,95.23809524
2016020219,19,2115,0.0,18,14,1,1,4,77.77777778
2016020219,19,1476,0.0,12,8,1,0,4,66.66666667
2016020219,29,3600,0.0,37,33,5,2,4,89.18918919
2016020220,24,2217,0.0,18,14,1,0,4,77.77777778
2016020220,24,1380,0.0,9,8,3,0,1,88.88888889
2016020220,18,3578,0.0,27,27,9,0,0,100.0
2016020221,6,3600,0.0,32,31,3,0,1,96.875
2016020221,53,3536,0.0,29,27,0,1,2,93.10344828
2016020222,3,3600,0.0,36,35,4,0,1,97.22222222
2016020222,20,3600,0.0,28,24,5,1,4,85.71428571
2016020223,26,3883,0.0,29,27,6,1,2,93.10344828
2016020223,52,3900,0.0,29,27,5,2,2,93.10344828
2016020224,25,3687,0.0,30,25,4,1,5,83.33333333
2016020224,23,3681,0.0,21,17,2,0,4,80.95238095
2016020225,30,3828,0.0,36,35,5,2,1,97.22222222
2016020225,9,3833,0.0,42,40,5,1,2,95.23809524
2016020226,8,3454,2.0,35,32,3,0,3,91.42857143
2016020226,16,3600,0.0,23,21,1,2,2,91.30434783
2016020227,6,3600,0.0,21,21,3,0,0,100.0
2016020227,21,3561,0.0,45,44,7,0,1,97.77777778
2016020228,3,3592,0.0,39,38,4,0,1,97.43589744
2016020228,22,3476,0.0,27,24,0,1,3,88.88888889
2016020229,14,3600,0.0,34,34,11,0,0,100.0
2016020229,2,3596,0.0,31,27,13,0,4,87.09677419
2016020230,9,3900,0.0,35,33,4,2,2,94.28571429
2016020230,4,3869,0.0,26,24,1,2,2,92.30769231
2016020231,28,3488,0.0,33,32,0,0,1,96.96969697
2016020231,12,3587,0.0,22,22,4,0,0,100.0
2016020232,15,3637,0.0,27,25,5,0,2,92.59259259
2016020232,29,3634,0.0,22,21,2,2,1,95.45454545
2016020233,18,3600,0.0,32,26,0,0,6,81.25
2016020233,10,3600,0.0,34,32,2,0,2,94.11764706
2016020234,13,3765,0.0,37,34,5,1,3,91.89189189
2016020234,8,3779,0.0,24,20,3,0,4,83.33333333
2016020235,14,3553,0.0,28,25,6,2,3,89.28571429
2016020235,17,3570,0.0,22,18,1,1,4,81.81818182
2016020236,7,3587,0.0,30,27,0,1,3,90.0
2016020236,19,3600,0.0,24,23,1,0,1,95.83333333
2016020237,20,3600,0.0,27,27,2,1,0,100.0
2016020237,30,3506,0.0,27,26,8,2,1,96.2962963
2016020238,16,2923,0.0,22,18,1,1,4,81.81818182
2016020238,16,677,0.0,2,2,0,0,0,100.0
2016020238,52,3600,0.0,27,27,4,1,0,100.0
2016020239,1,3644,0.0,24,23,3,1,1,95.83333333
2016020239,25,3644,0.0,33,31,1,0,2,93.93939394
2016020240,26,3585,0.0,29,26,4,2,3,89.65517241
2016020240,21,3600,0.0,33,32,8,3,1,96.96969697
2016020241,3,3600,0.0,38,36,6,1,2,94.73684211
2016020241,23,3600,0.0,25,18,3,2,7,72.0
2016020242,22,3595,0.0,27,23,6,2,4,85.18518519
2016020242,24,3600,0.0,34,33,4,1,1,97.05882353
2016020243,5,2424,0.0,25,20,5,2,5,80.0
2016020243,5,1176,0.0,14,12,0,1,2,85.71428571
2016020243,15,3594,0.0,26,25,1,2,1,96.15384615
2016020244,53,3649,0.0,24,22,4,0,2,91.66666667
2016020244,20,3646,0.0,21,20,3,0,1,95.23809524
2016020245,14,3600,0.0,33,32,8,0,1,96.96969697
2016020245,7,3589,0.0,38,34,5,1,4,89.47368421
2016020246,52,3522,0.0,21,17,1,0,4,80.95238095
2016020246,4,3600,0.0,32,30,3,1,2,93.75
2016020247,13,3600,0.0,30,24,7,1,6,80.0
2016020247,10,3600,0.0,27,26,11,3,1,96.2962963
2016020248,18,3600,0.0,31,30,4,0,1,96.77419355
2016020248,9,3600,0.0,40,35,3,1,5,87.5
2016020249,28,3501,0.0,25,22,5,0,3,88.0
2016020249,19,3600,0.0,31,29,9,0,2,93.5483871
2016020250,6,3565,0.0,29,28,2,0,1,96.55172414
2016020250,30,3600,0.0,25,25,2,0,0,100.0
2016020251,21,3543,0.0,22,19,2,0,3,86.36363636
2016020251,25,3600,0.0,36,34,3,4,2,94.44444444
2016020252,53,3754,0.0,42,39,4,1,3,92.85714286
2016020252,23,3754,0.0,36,34,2,1,2,94.44444444
2016020253,1,3505,0.0,23,20,2,1,3,86.95652174
2016020253,24,3600,0.0,29,27,5,0,2,93.10344828
2016020254,22,3477,0.0,25,21,3,0,4,84.0
2016020254,26,3584,0.0,30,28,1,1,2,93.33333333
2016020255,5,3684,0.0,22,20,2,3,2,90.90909091
2016020255,2,3681,0.0,35,32,5,0,3,91.42857143
2016020256,17,3511,0.0,28,27,3,2,1,96.42857143
2016020256,15,3600,0.0,25,25,6,0,0,100.0
2016020257,3,3535,0.0,23,20,0,0,3,86.95652174
2016020257,29,3600,0.0,27,25,2,0,2,92.59259259
2016020258,8,3549,0.0,18,15,2,0,3,83.33333333
2016020258,12,3600,0.0,33,31,1,0,2,93.93939394
2016020259,16,3600,0.0,30,28,5,0,2,93.33333333
2016020259,20,3534,0.0,24,21,0,2,3,87.5
2016020260,14,3590,0.0,32,32,9,1,0,100.0
2016020260,4,3578,0.0,18,15,1,0,3,83.33333333
2016020261,1,3503,0.0,27,24,4,1,3,88.88888889
2016020261,26,3600,0.0,23,21,2,0,2,91.30434783
2016020262,52,3600,0.0,38,34,8,0,4,89.47368421
2016020262,6,3586,0.0,12,11,7,0,1,91.66666667
2016020263,5,3900,0.0,33,32,9,0,1,96.96969697
2016020263,7,3900,0.0,47,46,2,1,1,97.87234043
2016020264,10,3496,0.0,29,27,4,0,2,93.10344828
2016020264,8,3595,0.0,32,31,6,2,1,96.875
2016020265,13,3600,0.0,40,39,5,0,1,97.5
2016020265,9,3582,0.0,23,19,0,0,4,82.60869565
2016020266,22,3600,0.0,33,31,4,1,2,93.93939394
2016020266,25,2023,0.0,16,15,2,0,1,93.75
2016020266,25,1577,0.0,13,9,0,1,4,69.23076923
2016020267,18,3439,0.0,34,31,7,0,3,91.17647059
2016020267,19,3597,0.0,31,30,7,2,1,96.77419355
2016020268,21,3600,0.0,43,41,8,0,2,95.34883721
2016020268,30,3483,0.0,37,34,5,1,3,91.89189189
2016020269,28,3676,0.0,26,23,2,2,3,88.46153846
2016020269,53,3676,0.0,45,43,1,1,2,95.55555556
2016020270,16,3826,0.0,27,24,3,0,3,88.88888889
2016020270,23,3844,0.0,32,28,3,0,4,87.5
2016020271,29,3599,0.0,21,19,0,0,2,90.47619048
2016020271,15,3558,0.0,23,20,1,0,3,86.95652174
2016020272,13,3900,0.0,35,33,5,1,2,94.28571429
2016020272,3,3900,0.0,30,28,6,0,2,93.33333333
2016020273,52,3520,0.0,40,37,6,1,3,92.5
2016020273,12,3563,0.0,29,28,6,0,1,96.55172414
2016020274,20,3600,0.0,23,21,1,1,2,91.30434783
2016020274,17,3533,2.0,26,23,2,1,3,88.46153846
2016020275,26,3571,0.0,30,28,11,0,2,93.33333333
2016020275,24,3493,0.0,29,26,2,1,3,89.65517241
2016020276,20,3504,0.0,32,28,5,0,4,87.5
2016020276,7,3591,0.0,31,29,5,1,2,93.5483871
2016020277,3,3597,0.0,31,29,2,0,2,93.5483871
2016020277,5,3508,0.0,35,31,4,0,4,88.57142857
2016020278,21,3709,0.0,42,40,0,0,2,95.23809524
2016020278,29,3626,0.0,27,24,2,0,3,88.88888889
2016020279,14,3515,0.0,30,27,5,0,3,90.0
2016020279,18,3600,0.0,25,24,1,0,1,96.0
2016020280,30,3683,0.0,32,29,1,0,3,90.625
2016020280,25,3683,0.0,29,27,3,1,2,93.10344828
2016020281,16,3600,0.0,27,22,5,0,5,81.48148148
2016020281,22,3600,0.0,31,31,7,0,0,100.0
2016020282,1,3596,0.0,41,37,7,1,4,90.24390244
2016020282,28,3600,0.0,26,26,2,0,0,100.0
2016020283,19,3600,0.0,41,39,7,3,2,95.12195122
2016020283,6,3538,0.0,27,24,2,0,3,88.88888889
2016020284,12,3600,0.0,26,25,3,1,1,96.15384615
2016020284,10,3495,0.0,29,27,2,1,2,93.10344828
2016020285,9,3594,0.0,39,36,11,0,3,92.30769231
2016020285,8,3521,0.0,23,19,4,0,4,82.60869565
2016020286,4,3600,0.0,39,38,11,0,1,97.43589744
2016020286,13,3510,0.0,28,25,2,3,3,89.28571429
2016020287,2,3900,0.0,41,39,1,1,2,95.12195122
2016020287,24,3895,0.0,35,33,16,0,2,94.28571429
2016020288,17,3900,0.0,33,32,2,1,1,96.96969697
2016020288,7,3900,0.0,24,23,7,1,1,95.83333333
2016020289,10,3879,0.0,30,26,4,1,4,86.66666667
2016020289,1,3900,0.0,31,27,5,1,4,87.09677419
2016020290,5,3596,0.0,17,16,4,1,1,94.11764706
2016020290,3,1977,0.0,17,13,6,0,4,76.47058824
2016020290,3,1623,0.0,21,19,2,0,2,90.47619048
2016020291,19,3567,0.0,25,21,3,1,4,84.0
2016020291,15,3600,0.0,21,18,6,0,3,85.71428571
2016020292,20,3600,0.0,34,34,7,0,0,100.0
2016020292,29,3439,0.0,20,18,2,2,2,90.0
2016020293,52,3560,0.0,25,23,2,0,2,92.0
2016020293,30,3586,0.0,16,15,1,1,1,93.75
2016020294,4,3505,0.0,29,25,7,1,4,86.20689655
2016020294,14,3600,0.0,31,29,6,3,2,93.5483871
2016020295,25,3548,0.0,20,16,4,0,4,80.0
2016020295,18,3600,0.0,35,33,3,0,2,94.28571429
2016020296,22,3556,0.0,28,25,6,1,3,89.28571429
2016020296,21,3479,0.0,40,35,5,0,5,87.5
2016020297,23,3600,0.0,36,35,4,0,1,97.22222222
2016020297,53,1609,0.0,17,13,4,0,4,76.47058824
2016020297,53,1991,0.0,10,10,1,0,0,100.0
2016020298,2,3488,0.0,27,24,1,0,3,88.88888889
2016020298,26,3600,0.0,24,22,1,0,2,91.66666667
2016020299,16,3508,0.0,35,33,5,0,2,94.28571429
2016020299,28,3600,0.0,34,33,2,0,1,97.05882353
2016020300,12,3499,0.0,22,20,4,0,2,90.90909091
2016020300,8,3597,0.0,32,31,1,0,1,96.875
2016020301,6,3473,0.0,26,23,3,0,3,88.46153846
2016020301,9,3600,0.0,20,19,0,1,1,95.0
2016020302,3,3600,0.0,42,40,0,1,2,95.23809524
2016020302,4,3478,0.0,23,20,1,0,3,86.95652174
2016020303,5,3593,0.0,36,30,6,3,6,83.33333333
2016020303,30,3598,0.0,36,34,3,1,2,94.44444444
2016020304,16,3600,0.0,36,34,5,0,2,94.44444444
2016020304,24,3539,0.0,25,22,2,0,3,88.0
2016020305,2,3546,0.0,28,25,2,0,3,89.28571429
2016020305,28,3600,0.0,28,26,0,0,2,92.85714286
2016020306,7,3497,0.0,32,29,8,0,3,90.625
2016020306,15,3600,0.0,33,32,7,1,1,96.96969697
2016020307,52,3600,0.0,30,25,3,1,5,83.33333333
2016020307,18,3600,0.0,23,22,1,3,1,95.65217391
2016020308,20,3600,0.0,36,35,9,0,1,97.22222222
2016020308,6,3525,0.0,29,27,1,1,2,93.10344828
2016020309,29,3600,0.0,28,25,0,0,3,89.28571429
2016020309,14,3277,0.0,38,33,1,0,5,86.84210526
2016020310,17,691,0.0,3,2,2,0,1,66.66666667
2016020310,17,3107,0.0,16,13,3,0,3,81.25
2016020310,1,3725,0.0,33,28,1,2,5,84.84848485
2016020311,23,3517,0.0,28,26,1,0,2,92.85714286
2016020311,25,3600,0.0,31,30,2,1,1,96.77419355
2016020312,22,3896,2.0,41,39,5,2,2,95.12195122
2016020312,53,3900,0.0,34,32,5,0,2,94.11764706
2016020313,15,3474,0.0,37,33,6,0,4,89.18918919
2016020313,10,3582,0.0,35,33,7,3,2,94.28571429
2016020314,12,3468,0.0,24,22,1,0,2,91.66666667
2016020314,9,3600,0.0,33,32,1,1,1,96.96969697
2016020315,8,3817,0.0,33,32,4,0,1,96.96969697
2016020315,17,3817,0.0,24,22,1,0,2,91.66666667
2016020316,29,3865,0.0,23,22,2,1,1,95.65217391
2016020316,13,3900,0.0,37,36,4,0,1,97.2972973
2016020317,1,3900,0.0,49,46,10,1,3,93.87755102
2016020317,5,3840,0.0,30,27,1,1,3,90.0
2016020318,30,3870,0.0,38,35,2,0,3,92.10526316
2016020318,19,3900,0.0,31,28,6,0,3,90.32258065
2016020319,23,3869,2.0,35,33,6,2,2,94.28571429
2016020319,21,3900,0.0,31,29,4,0,2,93.5483871
2016020320,16,3662,0.0,29,27,3,0,2,93.10344828
2016020320,26,3657,0.0,19,18,3,0,1,94.73684211
2016020321,24,3600,0.0,23,21,5,0,2,91.30434783
2016020321,28,3516,0.0,26,23,1,0,3,88.46153846
2016020322,14,3600,0.0,30,26,1,1,4,86.66666667
2016020322,6,3599,0.0,31,30,1,0,1,96.77419355
2016020323,53,3600,0.0,42,41,5,1,1,97.61904762
2016020323,22,3521,0.0,23,21,3,0,2,91.30434783
2016020324,13,3521,0.0,27,24,1,2,3,88.88888889
2016020324,12,3600,0.0,33,31,8,1,2,93.93939394
2016020325,18,3500,0.0,22,21,4,1,1,95.45454545
2016020325,52,3600,0.0,42,42,13,1,0,100.0
2016020326,9,3600,0.0,33,33,4,0,0,100.0
2016020326,3,3461,0.0,20,18,0,0,2,90.0
2016020327,20,3539,0.0,43,38,11,0,5,88.37209302
2016020327,4,3600,0.0,32,29,2,1,3,90.625
2016020328,20,3690,0.0,27,25,5,0,2,92.59259259
2016020328,2,3710,0.0,26,25,0,0,1,96.15384615
2016020329,25,3770,0.0,31,27,3,0,4,87.09677419
2016020329,19,3804,0.0,21,18,1,0,3,85.71428571
2016020330,12,3519,0.0,21,18,3,0,3,85.71428571
2016020330,3,3600,0.0,28,26,5,1,2,92.85714286
2016020331,6,3882,0.0,21,19,4,0,2,90.47619048
2016020331,4,3888,0.0,47,45,4,1,2,95.74468085
2016020332,14,3600,0.0,38,33,5,1,5,86.84210526
2016020332,29,3588,0.0,27,26,3,0,1,96.2962963
2016020333,7,1068,0.0,6,5,0,0,1,83.33333333
2016020333,7,2519,0.0,29,26,4,0,3,89.65517241
2016020333,9,3480,0.0,28,23,2,1,5,82.14285714
2016020334,25,3483,0.0,19,17,2,0,2,89.47368421
2016020334,17,3600,2.0,35,34,11,0,1,97.14285714
2016020335,1,3491,0.0,29,26,8,1,3,89.65517241
2016020335,52,3600,0.0,25,23,6,2,2,92.0
2016020336,13,3900,0.0,33,32,1,1,1,96.96969697
2016020336,16,3900,0.0,39,38,5,2,1,97.43589744
2016020337,18,3600,0.0,40,37,3,2,3,92.5
2016020337,21,3485,0.0,33,28,1,1,5,84.84848485
2016020338,10,3600,0.0,30,28,6,0,2,93.33333333
2016020338,22,1140,0.0,9,9,2,0,0,100.0
2016020338,22,2400,0.0,14,10,1,0,4,71.42857143
2016020339,30,3531,0.0,35,30,4,0,5,85.71428571
2016020339,23,3600,0.0,42,38,4,1,4,90.47619048
2016020340,8,3451,0.0,38,36,9,2,2,94.73684211
2016020340,24,3600,0.0,40,39,3,0,1,97.5
2016020341,53,3619,0.0,42,40,5,0,2,95.23809524
2016020341,28,3619,0.0,19,18,3,0,1,94.73684211
2016020342,5,3573,0.0,29,25,4,0,4,86.20689655
2016020342,2,3600,0.0,34,31,2,1,3,91.17647059
2016020343,10,3600,0.0,29,26,2,1,3,89.65517241
2016020343,20,3600,0.0,39,39,8,0,0,100.0
2016020344,28,3600,0.0,27,26,3,0,1,96.2962963
2016020344,26,3568,0.0,23,20,2,0,3,86.95652174
2016020345,12,3900,0.0,35,34,3,0,1,97.14285714
2016020345,6,3859,0.0,30,29,2,1,1,96.66666667
2016020346,3,3551,0.0,34,30,2,0,4,88.23529412
2016020346,7,3600,0.0,25,22,8,0,3,88.0
2016020347,25,3592,0.0,39,34,7,0,5,87.17948718
2016020347,5,3600,0.0,35,33,2,0,2,94.28571429
2016020348,2,3600,0.0,38,38,6,1,0,100.0
2016020348,15,3417,0.0,28,25,2,3,3,89.28571429
2016020349,4,3640,0.0,21,19,0,0,2,90.47619048
2016020349,9,3640,0.0,32,29,7,0,3,90.625
2016020350,13,3709,0.0,21,20,5,1,1,95.23809524
2016020350,17,3724,0.0,30,28,9,0,2,93.33333333
2016020351,14,2214,0.0,10,9,2,0,1,90.0
2016020351,14,1304,0.0,16,12,2,0,4,75.0
2016020351,19,3600,0.0,26,22,0,0,4,84.61538462
2016020352,22,3600,0.0,25,22,1,0,3,88.0
2016020352,52,2853,0.0,29,23,4,1,6,79.31034483
2016020352,52,747,0.0,4,4,0,0,0,100.0
2016020353,1,3691,0.0,33,29,4,0,4,87.87878788
2016020353,16,3661,0.0,33,30,3,1,3,90.90909091
2016020354,29,3600,0.0,20,18,5,0,2,90.0
2016020354,21,3465,0.0,37,34,6,1,3,91.89189189
2016020355,26,2400,0.0,26,25,7,2,1,96.15384615
2016020355,26,1200,0.0,6,4,1,1,2,66.66666667
2016020355,53,3488,0.0,33,29,8,0,4,87.87878788
2016020356,24,3600,0.0,28,27,4,0,1,96.42857143
2016020356,23,3503,0.0,24,21,2,1,3,87.5
2016020357,30,3900,0.0,31,29,6,1,2,93.5483871
2016020357,20,3877,0.0,25,23,2,0,2,92.0
2016020358,8,3507,0.0,30,28,5,0,2,93.33333333
2016020358,28,3543,0.0,32,31,2,0,1,96.875
2016020359,6,3600,0.0,36,35,4,0,1,97.22222222
2016020359,7,3532,0.0,33,31,3,1,2,93.93939394
2016020360,12,3503,0.0,23,19,1,0,4,82.60869565
2016020360,3,3600,0.0,28,26,0,0,2,92.85714286
2016020361,16,3508,0.0,30,27,5,0,3,90.0
2016020361,4,3600,0.0,27,26,0,1,1,96.2962963
2016020362,1,3882,0.0,42,38,0,1,4,90.47619048
2016020362,18,3882,0.0,22,17,3,0,5,77.27272727
2016020363,13,3463,0.0,21,19,6,1,2,90.47619048
2016020363,9,3600,0.0,24,24,6,3,0,100.0
2016020364,15,3840,0.0,33,32,2,2,1,96.96969697
2016020364,14,3900,0.0,35,34,10,1,1,97.14285714
2016020365,17,3504,0.0,36,32,3,1,4,88.88888889
2016020365,5,3572,0.0,31,28,4,1,3,90.32258065
2016020366,52,3615,0.0,22,20,4,0,2,90.90909091
2016020366,19,3608,0.0,23,20,1,2,3,86.95652174
2016020367,10,3883,0.0,24,22,2,1,2,91.66666667
2016020367,23,3896,0.0,40,38,4,0,2,95.0
2016020368,29,3900,0.0,34,32,2,0,2,94.11764706
2016020368,53,3900,2.0,60,58,9,0,2,96.66666667
2016020369,25,3598,0.0,23,23,4,0,0,100.0
2016020369,21,3529,0.0,32,30,5,2,2,93.75
2016020370,24,3775,0.0,32,29,2,0,3,90.625
2016020370,22,3796,0.0,33,31,2,0,2,93.93939394
2016020371,14,3648,0.0,30,29,6,1,1,96.66666667
2016020371,12,3686,0.0,30,30,7,3,0,100.0
2016020372,17,3662,0.0,35,32,4,0,3,91.42857143
2016020372,2,3662,0.0,34,30,0,1,4,88.23529412
2016020373,4,3600,0.0,32,30,3,0,2,93.75
2016020373,18,3511,0.0,27,24,9,0,3,88.88888889
2016020374,52,3600,0.0,26,25,4,1,1,96.15384615
2016020374,16,3497,0.0,32,30,1,1,2,93.75
2016020375,24,3598,0.0,25,17,1,1,8,68.0
2016020375,20,3600,0.0,33,30,7,1,3,90.90909091
2016020376,30,3791,0.0,29,28,2,0,1,96.55172414
2016020376,22,3791,0.0,33,31,0,0,2,93.93939394
2016020377,8,3900,0.0,31,27,3,0,4,87.09677419
2016020377,26,3889,0.0,30,26,3,1,4,86.66666667
2016020378,13,3661,0.0,36,32,5,1,4,88.88888889
2016020378,6,3677,0.0,30,27,5,1,3,90.0
2016020379,9,3156,0.0,43,36,9,0,7,83.72093023
2016020379,9,434,0.0,2,2,0,0,0,100.0
2016020379,5,1628,0.0,16,12,2,0,4,75.0
2016020379,5,1972,0.0,18,17,7,1,1,94.44444444
2016020380,7,3729,0.0,33,30,3,4,3,90.90909091
2016020380,15,3743,0.0,33,31,3,0,2,93.93939394
2016020381,53,3600,0.0,34,30,6,0,4,88.23529412
2016020381,29,3581,0.0,18,17,0,1,1,94.44444444
2016020382,22,3628,0.0,26,22,6,0,4,84.61538462
2016020382,7,3603,0.0,37,34,8,1,3,91.89189189
2016020383,23,3524,0.0,22,19,3,0,3,86.36363636
2016020383,1,3600,0.0,24,22,3,1,2,91.66666667
2016020384,3,3444,0.0,32,28,2,1,4,87.5
2016020384,2,3600,0.0,38,36,13,0,2,94.73684211
2016020385,13,3891,0.0,25,22,5,0,3,88.0
2016020385,4,3878,0.0,44,42,3,0,2,95.45454545
2016020386,8,3818,0.0,31,28,8,0,3,90.32258065
2016020386,19,3818,0.0,30,28,2,0,2,93.33333333
2016020387,21,3506,0.0,32,28,5,0,4,87.5
2016020387,18,3569,0.0,28,25,8,0,3,89.28571429
2016020388,17,3887,0.0,34,31,8,0,3,91.17647059
2016020388,52,3900,0.0,30,27,3,0,3,90.0
2016020389,53,3600,0.0,27,23,2,2,4,85.18518519
2016020389,16,3600,0.0,22,22,0,0,0,100.0
2016020390,20,3600,0.0,30,29,3,0,1,96.66666667
2016020390,25,3517,0.0,20,18,1,1,2,90.0
2016020391,30,3600,0.0,37,35,6,0,2,94.59459459
2016020391,10,3460,2.0,20,17,0,0,3,85.0
2016020392,6,3696,0.0,20,16,1,0,4,80.0
2016020392,15,3696,0.0,34,31,3,0,3,91.17647059
2016020393,12,3897,0.0,38,33,6,0,5,86.84210526
2016020393,24,3882,0.0,34,29,9,0,5,85.29411765
2016020394,9,3600,0.0,37,35,10,2,2,94.59459459
2016020394,28,3543,0.0,16,13,3,0,3,81.25
2016020395,21,3579,0.0,31,29,1,2,2,93.5483871
2016020395,6,3484,0.0,22,18,1,2,4,81.81818182
2016020396,19,3478,0.0,27,24,1,0,3,88.88888889
2016020396,2,3600,0.0,26,24,0,0,2,92.30769231
2016020397,22,3531,0.0,31,25,6,0,6,80.64516129
2016020397,4,3593,0.0,33,28,7,4,5,84.84848485
2016020398,1,3600,0.0,49,44,0,1,5,89.79591837
2016020398,8,3600,4.0,21,19,2,0,2,90.47619048
2016020399,23,3238,0.0,39,38,9,2,1,97.43589744
2016020399,23,362,0.0,2,2,2,0,0,100.0
2016020399,14,2400,0.0,20,16,3,0,4,80.0
2016020399,14,1200,0.0,10,9,0,0,1,90.0
2016020400,5,3597,0.0,29,28,3,3,1,96.55172414
2016020400,13,3429,0.0,29,25,5,0,4,86.20689655
2016020401,3,3600,0.0,18,17,2,1,1,94.44444444
2016020401,52,3539,0.0,24,22,3,0,2,91.66666667
2016020402,18,1547,2.0,18,14,1,0,4,77.77777778
2016020402,18,2053,0.0,19,18,4,1,1,94.73684211
2016020402,25,3600,0.0,36,34,3,0,2,94.44444444
2016020403,20,3640,0.0,28,27,7,1,1,96.42857143
2016020403,53,3669,0.0,35,33,2,0,2,94.28571429
2016020404,12,3600,0.0,22,21,5,0,1,95.45454545
2016020404,26,3484,0.0,18,15,0,0,3,83.33333333
2016020405,15,3600,0.0,28,27,7,0,1,96.42857143
2016020405,7,3528,0.0,28,25,2,1,3,89.28571429
2016020406,29,3600,0.0,33,32,6,0,1,96.96969697
2016020406,17,1433,0.0,7,7,0,0,0,100.0
2016020406,17,2008,0.0,17,14,0,1,3,82.35294118
2016020407,19,3600,0.0,21,20,4,0,1,95.23809524
2016020407,1,3586,0.0,32,28,7,0,4,87.5
2016020408,22,3898,0.0,36,34,12,0,2,94.44444444
2016020408,30,3877,0.0,27,25,1,0,2,92.59259259
2016020409,3,3655,0.0,26,26,3,0,0,100.0
2016020409,16,3655,0.0,37,36,1,0,1,97.2972973
2016020410,28,3511,0.0,32,29,10,2,3,90.625
2016020410,24,3600,0.0,24,22,1,0,2,91.66666667
2016020411,25,3579,0.0,21,18,3,1,3,85.71428571
2016020411,4,3600,0.0,23,21,2,1,2,91.30434783
2016020412,9,3600,0.0,19,15,3,0,4,78.94736842
2016020412,26,3598,0.0,20,19,3,2,1,95.0
2016020413,10,3600,0.0,33,32,4,2,1,96.96969697
2016020413,6,3563,0.0,19,16,4,0,3,84.21052632
2016020414,21,1632,0.0,20,16,0,0,4,80.0
2016020414,21,1968,0.0,16,10,2,0,6,62.5
2016020414,8,3600,0.0,16,15,1,0,1,93.75
2016020415,5,3600,0.0,23,20,4,0,3,86.95652174
2016020415,14,3491,0.0,37,33,5,2,4,89.18918919
2016020416,23,3534,0.0,41,38,7,2,3,92.68292683
2016020416,13,3600,0.0,39,37,6,0,2,94.87179487
2016020417,2,3263,0.0,38,32,2,0,6,84.21052632
2016020417,2,337,0.0,1,1,0,0,0,100.0
2016020417,29,3600,0.0,30,28,1,2,2,93.33333333
2016020418,18,3595,0.0,34,30,2,3,4,88.23529412
2016020418,53,3599,0.0,45,44,8,0,1,97.77777778
2016020419,52,1200,0.0,6,4,0,0,2,66.66666667
2016020419,52,2400,0.0,29,25,4,0,4,86.20689655
2016020419,20,3600,0.0,28,26,3,0,2,92.85714286
2016020420,12,3482,0.0,20,16,0,0,4,80.0
2016020420,28,3600,0.0,33,30,3,0,3,90.90909091
2016020421,9,2386,0.0,19,17,0,0,2,89.47368421
2016020421,9,1200,0.0,13,10,1,0,3,76.92307692
2016020421,24,3600,0.0,22,21,3,0,1,95.45454545
2016020422,4,3764,0.0,28,28,9,1,0,100.0
2016020422,17,3764,0.0,36,35,7,2,1,97.22222222
2016020423,23,3526,0.0,28,26,5,1,2,92.85714286
2016020423,15,3600,0.0,20,20,1,0,0,100.0
2016020424,19,3538,0.0,24,22,2,0,2,91.66666667
2016020424,30,3600,0.0,23,22,3,0,1,95.65217391
2016020425,21,3600,0.0,52,51,9,0,1,98.07692308
2016020425,10,3422,0.0,28,26,2,3,2,92.85714286
2016020426,1,3591,0.0,31,26,8,1,5,83.87096774
2016020426,3,3569,0.0,19,19,5,0,0,100.0
2016020427,25,3510,2.0,27,24,3,0,3,88.88888889
2016020427,16,3600,0.0,24,23,6,0,1,95.83333333
2016020428,52,3533,0.0,30,27,3,3,3,90.0
2016020428,22,3588,0.0,31,29,2,1,2,93.5483871
2016020429,53,1710,0.0,22,18,1,1,4,81.81818182
2016020429,53,1890,0.0,12,9,6,0,3,75.0
2016020429,5,3600,0.0,32,32,2,5,0,100.0
2016020430,6,3800,0.0,31,30,7,0,1,96.77419355
2016020430,8,3800,0.0,29,27,3,3,2,93.10344828
2016020431,26,372,0.0,3,2,0,0,1,66.66666667
2016020431,26,3173,0.0,22,18,2,0,4,81.81818182
2016020431,7,3600,0.0,33,30,0,0,3,90.90909091
2016020432,15,3600,0.0,28,26,5,1,2,92.85714286
2016020432,2,3500,0.0,38,34,5,0,4,89.47368421
2016020433,16,3600,0.0,34,33,0,0,1,97.05882353
2016020433,3,3521,0.0,26,24,4,0,2,92.30769231
2016020434,23,2756,0.0,30,24,4,0,6,80.0
2016020434,23,804,0.0,5,4,0,0,1,80.0
2016020434,12,2076,0.0,16,13,5,0,3,81.25
2016020434,12,1524,0.0,18,15,0,0,3,83.33333333
2016020435,28,3900,0.0,31,29,3,2,2,93.5483871
2016020435,10,3900,0.0,42,40,14,2,2,95.23809524
2016020436,53,3600,0.0,38,37,5,0,1,97.36842105
2016020436,17,3600,0.0,19,15,0,3,4,78.94736842
2016020437,19,508,0.0,2,2,0,0,0,100.0
2016020437,19,3031,0.0,33,28,4,0,5,84.84848485
2016020437,18,3600,0.0,26,23,0,0,3,88.46153846
2016020438,13,2883,0.0,17,12,0,2,5,70.58823529
2016020438,13,694,0.0,5,5,1,0,0,100.0
2016020438,30,3600,0.0,30,29,6,0,1,96.66666667
2016020439,24,3102,0.0,24,19,4,1,5,79.16666667
2016020439,24,446,0.0,2,2,0,0,0,100.0
2016020439,25,3538,0.0,36,34,5,4,2,94.44444444
2016020440,29,3598,0.0,34,33,9,2,1,97.05882353
2016020440,22,3484,0.0,31,28,5,1,3,90.32258065
2016020441,28,3900,0.0,31,28,9,4,3,90.32258065
2016020441,9,3900,0.0,29,26,11,0,3,89.65517241
2016020442,6,3684,0.0,37,33,5,0,4,89.18918919
2016020442,5,3684,0.0,44,41,10,0,3,93.18181818
2016020443,14,3597,2.0,22,19,1,1,3,86.36363636
2016020443,20,2397,0.0,21,17,3,0,4,80.95238095
2016020443,20,1118,0.0,13,12,0,3,1,92.30769231
2016020444,4,3600,0.0,29,26,1,0,3,89.65517241
2016020444,21,3512,0.0,25,21,2,1,4,84.0
2016020445,24,3600,0.0,34,31,6,0,3,91.17647059
2016020445,6,3477,0.0,27,23,5,0,4,85.18518519
2016020446,16,3600,0.0,32,28,2,1,4,87.5
2016020446,2,3537,0.0,32,27,1,3,5,84.375
2016020447,53,3900,0.0,46,44,3,1,2,95.65217391
2016020447,10,3899,0.0,30,28,4,1,2,93.33333333
2016020448,26,3600,0.0,18,17,2,0,1,94.44444444
2016020448,17,3483,0.0,30,27,3,2,3,90.0
2016020449,1,3508,0.0,30,26,3,3,4,86.66666667
2016020449,19,3600,0.0,26,24,4,0,2,92.30769231
2016020450,30,3600,0.0,36,34,7,0,2,94.44444444
2016020450,18,3555,2.0,17,14,0,0,3,82.35294118
2016020451,13,3900,0.0,32,29,4,0,3,90.625
2016020451,52,3900,0.0,44,41,3,0,3,93.18181818
2016020452,3,3260,0.0,27,27,9,1,0,100.0
2016020452,3,331,0.0,0,0,0,0,0,
2016020452,25,3501,0.0,29,28,6,1,1,96.55172414
2016020453,2,3642,0.0,37,34,12,1,3,91.89189189
2016020453,7,3634,0.0,35,33,1,0,2,94.28571429
2016020454,26,3660,0.0,39,39,11,0,0,100.0
2016020454,5,3660,0.0,28,27,1,2,1,96.42857143
2016020455,28,3600,0.0,28,26,5,0,2,92.85714286
2016020455,8,1831,0.0,5,5,1,1,0,100.0
2016020455,8,1604,0.0,18,14,4,0,4,77.77777778
2016020456,15,3900,0.0,30,27,6,0,3,90.0
2016020456,12,3898,0.0,26,23,1,0,3,88.46153846
2016020457,13,3600,0.0,31,30,6,0,1,96.77419355
2016020457,21,3461,0.0,23,20,2,1,3,86.95652174
2016020458,29,3600,0.0,23,22,5,0,1,95.65217391
2016020458,20,3600,0.0,29,25,1,0,4,86.20689655
2016020459,14,3522,0.0,23,20,4,0,3,86.95652174
2016020459,23,3600,0.0,27,25,3,0,2,92.59259259
2016020460,4,3534,0.0,27,25,0,0,2,92.59259259
2016020460,25,3600,0.0,32,31,2,1,1,96.875
2016020461,53,3543,0.0,29,26,3,0,3,89.65517241
2016020461,30,3600,0.0,28,27,2,0,1,96.42857143
2016020462,5,3165,0.0,43,41,6,2,2,95.34883721
2016020462,5,555,0.0,6,6,1,0,0,100.0
2016020462,10,3720,0.0,34,33,2,1,1,97.05882353
2016020463,1,3502,0.0,30,28,1,0,2,93.33333333
2016020463,9,3600,0.0,30,29,1,0,1,96.66666667
2016020464,24,1200,0.0,11,9,1,0,2,81.81818182
2016020464,24,2400,0.0,21,17,4,0,4,80.95238095
2016020464,17,3600,0.0,25,21,1,1,4,84.0
2016020465,8,3600,0.0,21,20,2,1,1,95.23809524
2016020465,15,3476,0.0,25,23,1,2,2,92.0
2016020466,7,3900,0.0,22,21,0,0,1,95.45454545
2016020466,12,3900,0.0,24,23,0,1,1,95.83333333
2016020467,16,3600,0.0,27,23,0,0,4,85.18518519
2016020467,19,3513,0.0,35,30,3,0,5,85.71428571
2016020468,3,3900,0.0,32,31,3,0,1,96.875
2016020468,18,3900,0.0,27,26,2,0,1,96.2962963
2016020469,14,3893,0.0,32,30,7,2,2,93.75
2016020469,22,3900,0.0,33,31,6,1,2,93.93939394
2016020470,26,3540,0.0,30,29,6,1,1,96.66666667
2016020470,6,3600,0.0,18,18,2,3,0,100.0
2016020471,21,3494,0.0,29,26,2,0,3,89.65517241
2016020471,52,3600,0.0,28,27,9,0,1,96.42857143
2016020472,29,3646,0.0,17,14,2,0,3,82.35294118
2016020472,23,3627,0.0,25,21,2,0,4,84.0
2016020473,9,1005,0.0,7,7,1,0,0,100.0
2016020473,9,2594,0.0,24,22,6,0,2,91.66666667
2016020473,2,3467,0.0,32,28,3,0,4,87.5
2016020474,28,3573,0.0,25,22,5,0,3,88.0
2016020474,16,3600,0.0,34,33,2,1,1,97.05882353
2016020475,1,3898,0.0,27,25,0,5,2,92.59259259
2016020475,3,3886,0.0,31,29,6,0,2,93.5483871
2016020476,18,3900,0.0,32,31,7,0,1,96.875
2016020476,4,3894,0.0,31,30,4,0,1,96.77419355
2016020477,17,3719,0.0,42,39,12,0,3,92.85714286
2016020477,12,3648,0.0,27,23,2,1,4,85.18518519
2016020478,24,3600,0.0,35,33,8,3,2,94.28571429
2016020478,10,3386,0.0,28,25,5,0,3,89.28571429
2016020479,22,3772,0.0,27,25,1,1,2,92.59259259
2016020479,19,3775,0.0,35,32,1,1,3,91.42857143
2016020480,20,3600,0.0,27,25,6,0,2,92.59259259
2016020480,53,3533,0.0,27,24,4,1,3,88.88888889
2016020481,2,3600,0.0,50,48,3,0,2,96.0
2016020481,6,1909,0.0,16,15,2,0,1,93.75
2016020481,6,1578,0.0,13,10,1,1,3,76.92307692
2016020482,18,3600,0.0,28,27,3,0,1,96.42857143
2016020482,1,3565,0.0,32,27,0,0,5,84.375
2016020483,3,3600,0.0,47,40,7,0,7,85.10638298
2016020483,5,3600,0.0,28,26,4,4,2,92.85714286
2016020484,26,3900,0.0,27,25,3,1,2,92.59259259
2016020484,29,3900,0.0,46,44,3,0,2,95.65217391
2016020485,24,3600,2.0,34,29,3,1,5,85.29411765
2016020485,8,3600,0.0,13,12,3,0,1,92.30769231
2016020486,17,1539,0.0,16,15,4,0,1,93.75
2016020486,17,2061,0.0,15,12,6,1,3,80.0
2016020486,14,734,0.0,4,4,0,0,0,100.0
2016020486,14,2861,0.0,23,22,5,0,1,95.65217391
2016020487,7,3900,0.0,39,36,8,0,3,92.30769231
2016020487,13,3900,0.0,36,33,3,2,3,91.66666667
2016020488,21,3508,0.0,33,31,4,0,2,93.93939394
2016020488,30,3600,0.0,18,18,2,0,0,100.0
2016020489,9,3594,0.0,26,23,6,2,3,88.46153846
2016020489,16,3422,0.0,30,26,7,1,4,86.66666667
2016020490,19,3715,0.0,38,36,3,1,2,94.73684211
2016020490,25,3715,0.0,22,19,1,0,3,86.36363636
2016020491,52,3575,0.0,23,20,1,0,3,86.95652174
2016020491,23,3598,0.0,32,31,7,0,1,96.875
2016020492,20,3600,0.0,34,30,8,0,4,88.23529412
2016020492,28,3597,0.0,21,20,0,3,1,95.23809524
2016020493,15,3896,0.0,38,36,0,0,2,94.73684211
2016020493,4,3900,0.0,38,36,1,1,2,94.73684211
2016020494,22,3600,0.0,36,34,11,2,2,94.44444444
2016020494,53,3450,0.0,21,18,2,0,3,85.71428571
2016020495,12,3583,0.0,23,22,1,0,1,95.65217391
2016020495,7,3532,0.0,33,31,7,1,2,93.93939394
2016020496,4,2400,0.0,14,12,2,0,2,85.71428571
2016020496,4,1200,0.0,8,6,1,0,2,75.0
2016020496,1,3600,0.0,16,16,0,0,0,100.0
2016020497,5,985,0.0,5,4,1,0,1,80.0
2016020497,5,2615,0.0,23,17,1,2,6,73.91304348
2016020497,29,3600,0.0,26,25,5,1,1,96.15384615
2016020498,30,3600,0.0,34,32,5,2,2,94.11764706
2016020498,8,3521,0.0,26,23,3,0,3,88.46153846
2016020499,24,3841,0.0,18,16,1,2,2,88.88888889
2016020499,9,3843,0.0,25,24,3,0,1,96.0
2016020500,19,66,0.0,0,0,0,0,0,
2016020500,19,3496,0.0,31,27,1,0,4,87.09677419
2016020500,14,3597,0.0,23,21,0,0,2,91.30434783
2016020501,6,3581,0.0,30,29,6,0,1,96.66666667
2016020501,13,3552,0.0,32,30,5,0,2,93.75
2016020502,26,3600,0.0,28,28,3,4,0,100.0
2016020502,18,3600,0.0,26,22,4,1,4,84.61538462
2016020503,10,3600,0.0,38,38,9,1,0,100.0
2016020503,21,1878,0.0,13,12,1,0,1,92.30769231
2016020503,21,1722,0.0,18,13,3,0,5,72.22222222
2016020504,52,3551,0.0,23,22,4,2,1,95.65217391
2016020504,23,3600,0.0,25,21,2,0,4,84.0
2016020505,7,3600,0.0,32,27,7,0,5,84.375
2016020505,2,3600,0.0,29,28,6,1,1,96.55172414
2016020506,30,3600,0.0,35,31,2,0,4,88.57142857
2016020506,3,1495,0.0,13,9,0,0,4,69.23076923
2016020506,3,2024,0.0,7,5,2,0,2,71.42857143
2016020507,1,3589,0.0,39,35,3,1,4,89.74358974
2016020507,5,3600,0.0,24,23,3,0,1,95.83333333
2016020508,14,687,0.0,3,3,0,0,0,100.0
2016020508,14,2905,0.0,24,20,4,1,4,83.33333333
2016020508,15,3600,0.0,23,23,0,0,0,100.0
2016020509,8,3510,0.0,24,22,6,1,2,91.66666667
2016020509,29,3592,0.0,37,36,3,3,1,97.2972973
2016020510,17,3864,0.0,34,31,9,1,3,91.17647059
2016020510,13,3834,0.0,39,36,5,2,3,92.30769231
2016020511,6,3781,0.0,23,20,5,0,3,86.95652174
2016020511,12,3778,0.0,33,31,4,0,2,93.93939394
2016020512,21,3625,0.0,39,38,8,0,1,97.43589744
2016020512,16,3570,0.0,34,32,5,0,2,94.11764706
2016020513,26,3667,0.0,31,28,1,0,3,90.32258065
2016020513,25,3667,0.0,31,29,2,0,2,93.5483871
2016020514,23,3509,0.0,36,33,10,1,3,91.66666667
2016020514,20,3600,0.0,14,13,0,0,1,92.85714286
2016020515,10,3600,0.0,32,31,3,0,1,96.875
2016020515,53,3600,0.0,32,28,0,1,4,87.5
2016020516,22,3802,0.0,31,28,7,2,3,90.32258065
2016020516,28,3802,0.0,18,16,5,0,2,88.88888889
2016020517,5,3600,2.0,23,21,5,0,2,91.30434783
2016020517,1,3540,0.0,28,24,4,0,4,85.71428571
2016020518,15,3474,0.0,31,27,3,0,4,87.09677419
2016020518,2,3593,0.0,34,31,6,0,3,91.17647059
2016020519,9,3494,0.0,25,21,6,5,4,84.0
2016020519,3,3598,0.0,36,33,8,0,3,91.66666667
2016020520,6,3490,0.0,22,18,3,0,4,81.81818182
2016020520,29,3594,0.0,40,37,4,0,3,92.5
2016020521,7,3600,0.0,43,40,1,0,3,93.02325581
2016020521,17,3527,0.0,22,18,2,0,4,81.81818182
2016020522,30,3766,0.0,30,28,1,0,2,93.33333333
2016020522,18,3766,0.0,39,36,8,0,3,92.30769231
2016020523,52,3597,0.0,35,34,4,0,1,97.14285714
2016020523,16,3420,0.0,34,31,4,0,3,91.17647059
2016020524,20,3600,0.0,28,25,8,1,3,89.28571429
2016020524,21,3598,0.0,31,25,2,0,6,80.64516129
2016020525,25,3570,0.0,37,35,7,0,2,94.59459459
2016020525,53,3535,4.0,28,26,2,2,2,92.85714286
2016020526,28,3763,0.0,36,34,2,1,2,94.44444444
2016020526,24,3766,0.0,25,22,4,0,3,88.0
2016020527,10,3900,0.0,47,45,7,0,2,95.74468085
2016020527,13,3898,0.0,40,38,4,1,2,95.0
2016020528,12,3453,0.0,26,23,0,0,3,88.46153846
2016020528,5,1200,0.0,19,19,0,0,0,100.0
2016020528,5,2400,0.0,27,25,0,0,2,92.59259259
2016020529,8,3696,0.0,30,26,3,0,4,86.66666667
2016020529,14,3696,0.0,22,19,2,0,3,86.36363636
2016020530,4,3473,0.0,24,19,2,3,5,79.16666667
2016020530,19,3597,0.0,20,17,2,1,3,85.0
2016020531,26,3528,0.0,20,18,7,1,2,90.0
2016020531,23,3600,0.0,37,36,4,0,1,97.2972973
2016020532,6,3574,0.0,33,31,13,0,2,93.93939394
2016020532,7,3562,0.0,37,34,5,4,3,91.89189189
2016020533,1,3900,0.0,44,43,8,3,1,97.72727273
2016020533,15,3900,0.0,27,26,4,0,1,96.2962963
2016020534,17,3667,0.0,28,26,4,2,2,92.85714286
2016020534,9,3667,0.0,28,25,4,0,3,89.28571429
2016020535,10,3817,0.0,27,25,7,2,2,92.59259259
2016020535,14,3794,0.0,35,32,6,2,3,91.42857143
2016020536,8,3639,0.0,33,31,7,0,2,93.93939394
2016020536,13,3639,0.0,41,38,5,0,3,92.68292683
2016020537,16,3600,0.0,38,36,7,3,2,94.73684211
2016020537,18,3515,0.0,23,20,7,1,3,86.95652174
2016020538,2,2130,0.0,24,20,4,0,4,83.33333333
2016020538,2,1360,0.0,11,10,0,0,1,90.90909091
2016020538,30,3600,2.0,28,24,4,0,4,85.71428571
2016020539,29,3563,0.0,34,31,6,1,3,91.17647059
2016020539,52,3467,0.0,35,30,4,0,5,85.71428571
2016020540,21,3521,0.0,33,30,8,0,3,90.90909091
2016020540,25,904,0.0,5,4,1,0,1,80.0
2016020540,25,2683,0.0,14,13,0,0,1,92.85714286
2016020541,24,3600,0.0,32,31,11,1,1,96.875
2016020541,20,3515,0.0,25,22,5,0,3,88.0
2016020542,26,3559,0.0,34,32,2,0,2,94.11764706
2016020542,22,3598,0.0,29,28,2,0,1,96.55172414
2016020543,3,3599,0.0,21,18,4,0,3,85.71428571
2016020543,53,3537,0.0,31,26,5,1,5,83.87096774
2016020544,16,3488,0.0,28,25,0,1,3,89.28571429
2016020544,12,3600,0.0,29,27,0,0,2,93.10344828
2016020545,18,3600,0.0,25,25,6,2,0,100.0
2016020545,19,1200,0.0,9,8,1,0,1,88.88888889
2016020545,19,2400,0.0,14,11,0,0,3,78.57142857
2016020546,24,3841,0.0,26,23,5,0,3,88.46153846
2016020546,23,3841,0.0,26,24,4,3,2,92.30769231
2016020547,4,2315,0.0,22,21,1,0,1,95.45454545
2016020547,4,1200,0.0,12,11,4,0,1,91.66666667
2016020547,28,3593,0.0,21,21,2,2,0,100.0
2016020548,7,3532,0.0,28,25,5,0,3,89.28571429
2016020548,6,3583,0.0,27,26,5,3,1,96.2962963
2016020549,15,3600,0.0,23,21,6,0,2,91.30434783
2016020549,1,3600,0.0,26,20,0,2,6,76.92307692
2016020550,29,3600,2.0,31,29,4,0,2,93.5483871
2016020550,30,3467,0.0,25,21,3,0,4,84.0
2016020551,12,3443,0.0,25,22,3,1,3,88.0
2016020551,12,8,0.0,0,0,0,0,0,
2016020551,14,3584,0.0,27,26,5,0,1,96.2962963
2016020552,8,3707,0.0,41,37,10,1,4,90.24390244
2016020552,5,3685,0.0,40,37,1,2,3,92.5
2016020553,2,3600,0.0,34,32,2,0,2,94.11764706
2016020553,52,2053,0.0,15,11,0,0,4,73.33333333
2016020553,52,1547,0.0,9,7,1,0,2,77.77777778
2016020554,13,3600,0.0,36,35,5,0,1,97.22222222
2016020554,25,1000,0.0,20,17,1,0,3,85.0
2016020554,25,2421,0.0,18,18,0,0,0,100.0
2016020555,3,3587,0.0,27,25,2,0,2,92.59259259
2016020555,21,3600,0.0,37,31,8,0,6,83.78378378
2016020556,53,3502,0.0,24,20,5,2,4,83.33333333
2016020556,20,3600,0.0,29,27,6,1,2,93.10344828
2016020557,23,3900,0.0,44,42,12,0,2,95.45454545
2016020557,22,3893,0.0,32,30,3,0,2,93.75
2016020558,28,3488,0.0,27,24,5,1,3,88.88888889
2016020558,26,3600,0.0,20,18,1,0,2,90.0
2016020559,17,3673,0.0,28,23,3,0,5,82.14285714
2016020559,10,3820,0.0,37,33,2,0,4,89.18918919
2016020560,9,3504,0.0,28,26,2,1,2,92.85714286
2016020560,15,3599,0.0,24,23,1,0,1,95.83333333
2016020561,4,3900,0.0,25,22,3,2,3,88.0
2016020561,24,3672,0.0,54,51,14,0,3,94.44444444
2016020561,24,228,0.0,1,1,0,0,0,100.0
2016020562,16,3481,0.0,34,31,7,0,3,91.17647059
2016020562,19,3600,0.0,23,22,5,0,1,95.65217391
2016020563,6,3591,0.0,25,23,6,0,2,92.0
2016020563,1,3600,0.0,22,22,2,0,0,100.0
2016020564,21,3508,0.0,24,21,7,0,3,87.5
2016020564,23,3600,0.0,26,24,3,0,2,92.30769231
2016020565,7,3595,0.0,25,24,3,1,1,96.0
2016020565,3,3600,0.0,19,15,4,0,4,78.94736842
2016020566,10,3615,0.0,29,23,1,3,6,79.31034483
2016020566,15,2422,0.0,17,15,4,0,2,88.23529412
2016020566,15,1200,0.0,8,5,4,0,3,62.5
2016020567,1,3588,0.0,30,29,10,1,1,96.66666667
2016020567,12,3454,0.0,17,15,0,0,2,88.23529412
2016020568,22,3489,0.0,35,32,9,1,3,91.42857143
2016020568,29,3600,0.0,22,21,1,0,1,95.45454545
2016020569,52,3600,0.0,36,32,7,0,4,88.88888889
2016020569,14,3416,0.0,33,28,0,1,5,84.84848485
2016020570,8,3870,0.0,23,22,2,0,1,95.65217391
2016020570,18,3870,0.0,43,41,6,0,2,95.34883721
2016020571,26,3651,0.0,27,26,4,0,1,96.2962963
2016020571,28,3657,0.0,35,33,2,5,2,94.28571429
2016020572,52,3600,0.0,32,31,6,0,1,96.875
2016020572,13,3593,0.0,39,35,1,4,4,89.74358974
2016020573,3,3583,0.0,32,30,6,1,2,93.75
2016020573,4,3560,0.0,27,23,2,0,4,85.18518519
2016020574,8,3619,0.0,42,39,3,1,3,92.85714286
2016020574,25,3619,0.0,33,29,2,0,4,87.87878788
2016020575,21,3600,0.0,37,33,13,1,4,89.18918919
2016020575,20,3600,0.0,18,17,4,2,1,94.44444444
2016020576,53,3594,2.0,24,21,2,1,3,87.5
2016020576,23,3600,0.0,22,22,3,1,0,100.0
2016020577,17,3519,0.0,24,22,0,1,2,91.66666667
2016020577,24,3600,0.0,23,23,3,0,0,100.0
2016020578,22,3600,0.0,36,33,5,1,3,91.66666667
2016020578,6,3520,0.0,25,21,1,0,4,84.0
2016020579,29,863,0.0,4,4,2,0,0,100.0
2016020579,29,2736,0.0,23,18,1,3,5,78.26086957
2016020579,15,3600,0.0,29,29,4,0,0,100.0
2016020580,18,3600,0.0,28,27,4,1,1,96.42857143
2016020580,14,3490,0.0,18,13,2,1,5,72.22222222
2016020581,12,3597,0.0,23,21,1,1,2,91.30434783
2016020581,19,3527,0.0,28,25,2,4,3,89.28571429
2016020582,7,3650,0.0,43,39,6,0,4,90.69767442
2016020582,16,3656,0.0,20,17,1,1,3,85.0
2016020583,17,3592,0.0,34,34,0,0,0,100.0
2016020583,26,3600,0.0,22,18,1,0,4,81.81818182
2016020584,30,3592,0.0,34,30,0,1,4,88.23529412
2016020584,28,3542,0.0,26,21,2,0,5,80.76923077
2016020585,18,3520,0.0,34,32,6,3,2,94.11764706
2016020585,13,3600,0.0,29,28,6,1,1,96.55172414
2016020586,10,3577,0.0,32,30,4,0,2,93.75
2016020586,1,880,0.0,5,2,2,0,3,40.0
2016020586,1,2606,0.0,9,8,1,0,1,88.88888889
2016020587,12,3497,0.0,24,22,0,0,2,91.66666667
2016020587,16,3600,0.0,40,39,11,1,1,97.5
2016020588,2,3871,0.0,39,37,7,0,2,94.87179487
2016020588,21,3883,0.0,36,35,5,1,1,97.22222222
2016020589,20,3542,0.0,13,9,1,0,4,69.23076923
2016020589,23,3600,0.0,46,44,8,2,2,95.65217391
2016020590,53,3864,0.0,35,32,3,0,3,91.42857143
2016020590,24,3861,0.0,23,21,3,1,2,91.30434783
2016020591,52,3514,0.0,36,32,7,0,4,88.88888889
2016020591,7,3600,2.0,35,32,7,1,3,91.42857143
2016020592,14,3359,0.0,44,40,8,2,4,90.90909091
2016020592,4,3598,0.0,26,24,0,0,2,92.30769231
2016020593,30,3721,0.0,36,32,3,0,4,88.88888889
2016020593,26,3794,0.0,24,21,1,0,3,87.5
2016020594,8,3600,0.0,36,33,1,3,3,91.66666667
2016020594,10,3418,0.0,31,26,7,0,5,83.87096774
2016020595,15,3600,0.0,30,30,6,1,0,100.0
2016020595,9,3524,0.0,20,19,1,1,1,95.0
2016020596,6,3600,0.0,25,25,2,0,0,100.0
2016020596,13,3600,0.0,37,33,6,0,4,89.18918919
2016020597,22,3826,0.0,20,19,0,1,1,95.0
2016020597,1,3800,0.0,43,41,4,0,2,95.34883721
2016020598,3,3600,0.0,37,33,3,0,4,89.18918919
2016020598,29,3577,0.0,34,29,3,0,5,85.29411765
2016020599,25,1842,0.0,8,7,0,0,1,87.5
2016020599,25,1671,0.0,14,11,2,0,3,78.57142857
2016020599,19,3599,0.0,28,25,5,0,3,89.28571429
2016020600,2,3900,0.0,27,26,4,0,1,96.2962963
2016020600,53,3881,0.0,28,27,1,0,1,96.42857143
2016020601,23,3497,0.0,31,28,4,0,3,90.32258065
2016020601,20,3577,0.0,29,28,4,0,1,96.55172414
2016020602,17,2400,0.0,20,17,0,1,3,85.0
2016020602,17,1200,0.0,15,12,4,0,3,80.0
2016020602,28,3600,0.0,35,32,3,0,3,91.42857143
2016020603,14,3586,0.0,40,34,5,1,6,85.0
2016020603,5,3600,0.0,30,28,7,0,2,93.33333333
2016020604,6,3694,0.0,30,26,2,3,4,86.66666667
2016020604,12,3694,0.0,35,32,2,1,3,91.42857143
2016020605,4,3713,0.0,25,23,2,0,2,92.0
2016020605,29,3753,0.0,26,25,1,1,1,96.15384615
2016020606,22,3595,0.0,17,13,0,0,4,76.47058824
2016020606,9,3589,0.0,38,35,2,1,3,92.10526316
2016020607,18,3548,0.0,29,26,1,0,3,89.65517241
2016020607,16,3600,0.0,27,25,2,0,2,92.59259259
2016020608,30,3595,2.0,24,23,1,0,1,95.83333333
2016020608,24,3496,2.0,36,34,11,2,2,94.44444444
2016020609,13,3600,0.0,28,28,4,1,0,100.0
2016020609,1,3545,0.0,27,26,6,0,1,96.2962963
2016020610,15,3600,0.0,23,22,2,0,1,95.65217391
2016020610,8,3576,0.0,39,35,5,0,4,89.74358974
2016020611,20,3449,0.0,27,25,2,0,2,92.59259259
2016020611,52,3600,0.0,28,28,4,1,0,100.0
2016020612,25,882,0.0,1,1,0,0,0,100.0
2016020612,25,2718,0.0,21,17,0,0,4,80.95238095
2016020612,26,526,0.0,3,3,0,0,0,100.0
2016020612,26,3052,0.0,22,17,0,0,5,77.27272727
2016020613,4,3402,0.0,26,23,1,0,3,88.46153846
2016020613,7,3600,0.0,40,39,7,2,1,97.5
2016020614,29,3515,0.0,27,23,0,0,4,85.18518519
2016020614,12,3583,0.0,27,24,1,0,3,88.88888889
2016020615,6,3600,0.0,17,14,4,2,3,82.35294118
2016020615,19,2338,0.0,27,26,6,2,1,96.2962963
2016020615,19,1200,0.0,11,8,1,0,3,72.72727273
2016020616,23,3827,0.0,26,24,1,1,2,92.30769231
2016020616,18,3898,0.0,30,29,1,0,1,96.66666667
2016020617,17,3638,0.0,43,39,7,0,4,90.69767442
2016020617,16,3614,0.0,36,33,0,1,3,91.66666667
2016020618,28,3600,0.0,36,33,7,0,3,91.66666667
2016020618,22,3436,0.0,28,23,4,0,5,82.14285714
2016020619,25,3479,0.0,38,36,7,2,2,94.73684211
2016020619,24,3599,0.0,34,34,6,1,0,100.0
2016020620,13,3600,2.0,30,29,0,3,1,96.66666667
2016020620,2,3523,0.0,24,22,1,0,2,91.66666667
2016020621,8,3580,0.0,27,23,1,0,4,85.18518519
2016020621,52,841,0.0,7,4,0,0,3,57.14285714
2016020621,52,2572,0.0,23,19,4,0,4,82.60869565
2016020622,5,3517,0.0,29,25,4,0,4,86.20689655
2016020622,15,3600,0.0,32,30,4,2,2,93.75
2016020623,28,3545,0.0,28,25,1,0,3,89.28571429
2016020623,20,3600,0.0,27,25,3,1,2,92.59259259
2016020624,23,3867,0.0,35,31,8,1,4,88.57142857
2016020624,4,1500,0.0,14,14,0,2,0,100.0
2016020624,4,2400,0.0,24,20,6,1,4,83.33333333
2016020625,5,3600,0.0,33,29,2,3,4,87.87878788
2016020625,9,3593,0.0,30,29,8,1,1,96.66666667
2016020626,7,3559,0.0,28,25,9,2,3,89.28571429
2016020626,14,3600,4.0,26,24,4,0,2,92.30769231
2016020627,6,769,0.0,3,3,0,0,0,100.0
2016020627,6,2735,0.0,16,14,1,1,2,87.5
2016020627,18,3600,0.0,36,35,2,1,1,97.22222222
2016020628,8,3600,0.0,24,17,4,0,7,70.83333333
2016020628,30,3600,0.0,21,20,1,1,1,95.23809524
2016020629,17,3457,0.0,20,16,0,0,4,80.0
2016020629,25,3600,0.0,33,31,4,0,2,93.93939394
2016020630,24,3574,0.0,34,33,5,0,1,97.05882353
2016020630,21,3492,0.0,31,28,0,1,3,90.32258065
2016020631,1,3710,0.0,34,31,5,0,3,91.17647059
2016020631,22,3696,0.0,19,17,3,0,2,89.47368421
2016020632,19,2100,0.0,13,11,4,0,2,84.61538462
2016020632,19,1500,0.0,15,12,3,0,3,80.0
2016020632,26,3568,0.0,22,21,5,1,1,95.45454545
2016020633,10,3589,2.0,36,34,5,2,2,94.44444444
2016020633,3,3584,0.0,27,23,4,1,4,85.18518519
2016020634,16,2891,0.0,30,25,0,4,5,83.33333333
2016020634,16,709,0.0,4,3,0,0,1,75.0
2016020634,15,3600,0.0,24,24,2,0,0,100.0
2016020635,29,3600,0.0,32,31,1,0,1,96.875
2016020635,14,3510,0.0,30,28,7,0,2,93.33333333
2016020636,2,3600,0.0,29,27,3,0,2,93.10344828
2016020636,13,3523,0.0,41,37,15,0,4,90.24390244
2016020637,7,3600,0.0,38,33,7,1,5,86.84210526
2016020637,12,3600,0.0,38,36,2,2,2,94.73684211
2016020638,1,3600,0.0,32,31,2,1,1,96.875
2016020638,20,3514,0.0,36,34,3,0,2,94.44444444
2016020639,52,614,0.0,6,3,0,0,3,50.0
2016020639,52,2823,0.0,23,22,5,0,1,95.65217391
2016020639,53,3600,0.0,37,34,2,0,3,91.89189189
2016020640,4,3554,0.0,38,33,10,2,5,86.84210526
2016020640,6,3600,0.0,24,21,0,2,3,87.5
2016020641,18,3600,0.0,30,28,4,0,2,93.33333333
2016020641,21,3461,0.0,32,29,3,0,3,90.625
2016020642,3,2314,0.0,22,17,0,0,5,77.27272727
2016020642,3,1200,0.0,10,10,1,0,0,100.0
2016020642,8,3600,0.0,33,29,5,0,4,87.87878788
2016020643,10,3600,0.0,37,35,2,0,2,94.59459459
2016020643,9,3497,0.0,27,23,1,0,4,85.18518519
2016020644,5,3578,0.0,34,28,2,1,6,82.35294118
2016020644,17,3600,0.0,31,28,3,1,3,90.32258065
2016020645,29,3499,0.0,32,28,3,1,4,87.5
2016020645,13,3597,0.0,33,30,2,2,3,90.90909091
2016020646,2,3233,0.0,43,36,0,0,7,83.72093023
2016020646,2,367,0.0,2,2,0,0,0,100.0
2016020646,12,3600,0.0,32,28,0,0,4,87.5
2016020647,24,3600,0.0,26,26,6,1,0,100.0
2016020647,53,3481,0.0,22,20,3,0,2,90.90909091
2016020648,30,3599,0.0,38,34,8,1,4,89.47368421
2016020648,25,241,0.0,3,0,0,0,3,0.0
2016020648,25,3275,0.0,28,26,5,2,2,92.85714286
2016020649,20,3900,0.0,27,26,5,0,1,96.2962963
2016020649,22,3900,0.0,25,24,2,0,1,96.0
2016020650,52,3673,0.0,38,35,5,1,3,92.10526316
2016020650,26,3678,0.0,28,26,3,1,2,92.85714286
2016020651,19,3600,0.0,23,23,3,1,0,100.0
2016020651,28,3565,0.0,25,22,5,0,3,88.0
2016020652,4,795,0.0,5,5,0,0,0,100.0
2016020652,4,2796,0.0,17,12,2,1,5,70.58823529
2016020652,15,3595,0.0,24,24,9,1,0,100.0
2016020653,30,3600,0.0,35,33,4,0,2,94.28571429
2016020653,16,3519,0.0,32,29,3,0,3,90.625
2016020654,1,3688,0.0,22,21,4,1,1,95.45454545
2016020654,23,3688,0.0,22,20,1,0,2,90.90909091
2016020655,19,3651,0.0,23,22,2,0,1,95.65217391
2016020655,24,3634,0.0,25,23,2,0,2,92.0
2016020656,2,3600,0.0,32,32,4,5,0,100.0
2016020656,6,2400,0.0,15,12,1,0,3,80.0
2016020656,6,1200,0.0,12,11,1,0,1,91.66666667
2016020657,25,3418,0.0,28,25,7,0,3,89.28571429
2016020657,7,3600,0.0,32,31,1,1,1,96.875
2016020658,8,3543,0.0,20,19,2,0,1,95.0
2016020658,17,3600,0.0,18,18,2,0,0,100.0
2016020659,14,3600,0.0,32,31,6,0,1,96.875
2016020659,26,3536,0.0,29,27,4,0,2,93.10344828
2016020660,52,3479,0.0,31,27,3,1,4,87.09677419
2016020660,28,3600,0.0,28,26,3,1,2,92.85714286
2016020661,15,1557,0.0,11,8,0,0,3,72.72727273
2016020661,15,2074,0.0,26,21,0,2,5,80.76923077
2016020661,5,3634,0.0,28,21,4,0,7,75.0
2016020662,53,3470,0.0,27,24,4,1,3,88.88888889
2016020662,22,3597,0.0,22,21,6,2,1,95.45454545
2016020663,25,2846,0.0,28,22,1,0,6,78.57142857
2016020663,25,754,0.0,12,12,4,0,0,100.0
2016020663,3,2400,0.0,27,20,0,0,7,74.07407407
2016020663,3,1112,0.0,4,4,0,1,0,100.0
2016020664,12,1797,2.0,17,17,1,0,0,100.0
2016020664,12,1756,0.0,19,15,0,0,4,78.94736842
2016020664,29,3587,0.0,25,24,1,0,1,96.0
2016020665,7,1785,0.0,16,13,0,0,3,81.25
2016020665,7,1726,0.0,16,15,1,0,1,93.75
2016020665,10,3600,0.0,27,24,3,0,3,88.88888889
2016020666,9,3600,0.0,23,19,0,1,4,82.60869565
2016020666,19,3467,0.0,23,18,1,0,5,78.26086957
2016020667,1,3600,0.0,35,32,3,0,3,91.42857143
2016020667,30,3562,0.0,26,22,0,2,4,84.61538462
2016020668,16,3600,0.0,23,19,1,1,4,82.60869565
2016020668,21,3580,0.0,26,21,1,0,5,80.76923077
2016020669,13,3530,0.0,28,24,3,1,4,85.71428571
2016020669,20,3600,0.0,22,20,9,0,2,90.90909091
2016020670,18,3535,0.0,26,25,1,0,1,96.15384615
2016020670,23,3600,0.0,30,30,3,0,0,100.0
2016020671,14,3654,2.0,21,19,6,0,2,90.47619048
2016020671,24,3654,0.0,28,27,5,1,1,96.42857143
2016020672,5,3600,0.0,20,19,1,0,1,95.0
2016020672,8,3600,0.0,26,22,2,0,4,84.61538462
2016020673,53,2939,0.0,35,29,4,0,6,82.85714286
2016020673,53,661,0.0,4,4,0,1,0,100.0
2016020673,52,3568,0.0,33,30,4,1,3,90.90909091
2016020674,6,3880,0.0,25,20,3,0,5,80.0
2016020674,17,3370,0.0,25,23,1,0,2,92.0
2016020674,17,530,0.0,8,5,2,0,3,62.5
2016020675,13,3897,0.0,31,27,0,0,4,87.09677419
2016020675,22,3897,0.0,31,28,4,0,3,90.32258065
2016020676,28,3597,0.0,24,22,1,1,2,91.66666667
2016020676,26,3526,0.0,27,24,2,3,3,88.88888889
2016020677,25,3392,0.0,35,33,18,1,2,94.28571429
2016020677,2,3600,0.0,23,23,4,1,0,100.0
2016020678,9,3600,2.0,42,42,3,3,0,100.0
2016020678,29,3431,0.0,28,26,4,0,2,92.85714286
2016020679,3,3600,0.0,25,23,2,2,2,92.0
2016020679,10,3575,0.0,40,36,8,2,4,90.0
2016020680,15,3600,0.0,25,22,2,1,3,88.0
2016020680,19,2089,0.0,8,5,2,0,3,62.5
2016020680,19,1511,0.0,10,6,0,0,4,60.0
2016020681,53,3509,0.0,25,21,3,1,4,84.0
2016020681,30,3588,0.0,23,20,0,0,3,86.95652174
2016020682,18,3598,0.0,35,32,6,0,3,91.42857143
2016020682,20,3394,0.0,21,17,1,2,4,80.95238095
2016020683,21,3539,0.0,36,34,10,0,2,94.44444444
2016020683,24,3600,0.0,22,21,3,0,1,95.45454545
2016020684,14,3542,0.0,24,22,3,0,2,91.66666667
2016020684,28,3599,0.0,25,24,3,0,1,96.0
2016020685,16,3597,0.0,30,30,1,2,0,100.0
2016020685,6,3557,0.0,22,21,2,0,1,95.45454545
2016020686,17,3862,0.0,37,34,6,0,3,91.89189189
2016020686,7,3874,0.0,34,32,4,1,2,94.11764706
2016020687,5,3599,0.0,28,27,5,0,1,96.42857143
2016020687,12,3600,2.0,41,34,2,0,7,82.92682927
2016020688,8,3600,0.0,17,16,0,1,1,94.11764706
2016020688,1,3432,0.0,26,23,6,0,3,88.46153846
2016020689,18,3897,0.0,32,30,4,4,2,93.75
2016020689,22,3898,0.0,44,42,7,0,2,95.45454545
2016020690,13,3537,0.0,32,30,1,1,2,93.75
2016020690,23,3600,0.0,35,34,7,0,1,97.14285714
2016020691,19,3536,0.0,29,24,4,2,5,82.75862069
2016020691,52,3581,0.0,37,34,8,1,3,91.89189189
2016020692,12,3438,0.0,20,17,3,0,3,85.0
2016020692,29,3600,0.0,37,35,4,1,2,94.59459459
2016020693,9,3885,0.0,33,31,9,0,2,93.93939394
2016020693,10,3900,0.0,27,25,9,0,2,92.59259259
2016020694,7,3708,0.0,38,36,1,0,2,94.73684211
2016020694,8,3708,0.0,38,35,4,0,3,92.10526316
2016020695,26,3567,0.0,35,32,1,2,3,91.42857143
2016020695,2,3585,0.0,36,34,0,1,2,94.44444444
2016020696,1,3600,0.0,36,35,14,0,1,97.22222222
2016020696,4,2400,0.0,25,22,10,2,3,88.0
2016020696,4,1200,0.0,4,3,2,0,1,75.0
2016020697,15,3619,0.0,35,32,7,1,3,91.42857143
2016020697,25,3619,0.0,22,18,1,0,4,81.81818182
2016020698,14,2400,0.0,17,12,0,2,5,70.58823529
2016020698,14,1097,0.0,6,6,0,1,0,100.0
2016020698,53,3600,0.0,48,45,8,1,3,93.75
2016020699,24,862,0.0,5,4,1,0,1,80.0
2016020699,24,2738,0.0,20,16,2,0,4,80.0
2016020699,30,3600,0.0,29,26,2,0,3,89.65517241
2016020700,22,3599,0.0,41,38,5,2,3,92.68292683
2016020700,20,358,0.0,4,1,0,0,3,25.0
2016020700,20,3072,0.0,26,23,7,1,3,88.46153846
2016020701,21,3678,0.0,30,27,1,0,3,90.0
2016020701,28,3678,0.0,33,31,0,0,2,93.93939394
2016020702,6,1908,0.0,22,20,0,0,2,90.90909091
2016020702,6,1692,0.0,14,11,0,0,3,78.57142857
2016020702,5,3587,0.0,45,44,12,0,1,97.77777778
2016020703,3,3697,0.0,21,21,1,1,0,100.0
2016020703,17,3716,0.0,19,18,7,1,1,94.73684211
2016020704,29,3669,0.0,34,28,7,0,6,82.35294118
2016020704,9,3666,0.0,29,22,2,0,7,75.86206897
2016020705,4,3800,0.0,38,36,5,1,2,94.73684211
2016020705,2,3795,0.0,47,44,7,0,3,93.61702128
2016020706,23,3570,0.0,34,31,1,1,3,91.17647059
2016020706,16,3600,0.0,28,26,4,0,2,92.85714286
2016020707,18,3600,0.0,23,21,1,0,2,91.30434783
2016020707,30,3508,2.0,31,28,2,0,3,90.32258065
2016020708,26,3552,0.0,17,14,0,0,3,82.35294118
2016020708,3,3600,0.0,38,36,4,2,2,94.73684211
2016020709,12,3576,0.0,25,19,1,1,6,76.0
2016020709,15,3593,0.0,26,25,1,0,1,96.15384615
2016020710,20,3587,0.0,28,24,6,3,4,85.71428571
2016020710,10,3600,0.0,26,26,4,2,0,100.0
2016020711,24,3589,0.0,33,31,10,0,2,93.93939394
2016020711,52,3460,0.0,27,24,3,4,3,88.88888889
2016020712,28,3600,0.0,28,26,5,0,2,92.85714286
2016020712,21,3488,0.0,26,21,4,0,5,80.76923077
2016020713,13,3648,2.0,42,39,4,2,3,92.85714286
2016020713,53,3646,0.0,25,23,3,0,2,92.0
2016020714,17,3853,0.0,49,45,6,1,4,91.83673469
2016020714,6,3853,0.0,26,23,0,0,3,88.46153846
2016020715,26,3600,0.0,25,24,3,0,1,96.0
2016020715,1,1200,0.0,12,9,2,0,3,75.0
2016020715,1,2259,0.0,13,13,0,0,0,100.0
2016020716,29,781,0.0,5,5,0,0,0,100.0
2016020716,29,2721,0.0,24,20,5,0,4,83.33333333
2016020716,2,3600,0.0,23,21,0,0,2,91.30434783
2016020717,19,3600,0.0,34,34,11,0,0,100.0
2016020717,5,3600,0.0,28,25,4,1,3,89.28571429
2016020718,20,3600,0.0,20,15,0,1,5,75.0
2016020718,8,3600,0.0,31,30,9,0,1,96.77419355
2016020719,15,3591,0.0,34,31,6,1,3,91.17647059
2016020719,9,3600,0.0,31,31,8,4,0,100.0
2016020720,7,3739,0.0,39,35,6,0,4,89.74358974
2016020720,18,3747,0.0,37,32,1,0,5,86.48648649
2016020721,28,3599,0.0,34,31,1,0,3,91.17647059
2016020721,52,3509,0.0,26,22,0,1,4,84.61538462
2016020722,14,3600,0.0,36,34,4,0,2,94.44444444
2016020722,16,3517,0.0,35,31,0,1,4,88.57142857
2016020723,30,3900,0.0,37,35,6,1,2,94.59459459
2016020723,25,3878,0.0,33,31,1,1,2,93.93939394
2016020724,10,3600,0.0,22,22,1,0,0,100.0
2016020724,17,3600,0.0,28,24,3,1,4,85.71428571
2016020725,4,3591,0.0,34,34,3,1,0,100.0
2016020725,3,3471,0.0,26,24,3,0,2,92.30769231
2016020726,23,3600,0.0,32,30,1,1,2,93.75
2016020726,21,3516,0.0,41,38,0,2,3,92.68292683
2016020727,22,3600,0.0,26,26,2,1,0,100.0
2016020727,24,3600,2.0,23,19,5,0,4,82.60869565
2016020728,5,3522,0.0,37,33,9,0,4,89.18918919
2016020728,6,3600,0.0,22,19,6,0,3,86.36363636
2016020729,15,3600,0.0,29,27,2,0,2,93.10344828
2016020729,1,1715,0.0,18,18,5,1,0,100.0
2016020729,1,1819,0.0,17,13,0,1,4,76.47058824
2016020730,8,3465,0.0,42,39,7,0,3,92.85714286
2016020730,2,3559,0.0,22,21,2,1,1,95.45454545
2016020731,10,3501,0.0,34,32,3,1,2,94.11764706
2016020731,4,3600,0.0,28,27,2,0,1,96.42857143
2016020732,26,3599,0.0,22,22,5,0,0,100.0
2016020732,12,3562,0.0,28,26,0,1,2,92.85714286
2016020733,20,3869,0.0,27,25,4,1,2,92.59259259
2016020733,9,3856,0.0,26,23,0,1,3,88.46153846
2016020734,14,3709,0.0,37,35,8,2,2,94.59459459
2016020734,13,3709,0.0,32,31,3,0,1,96.875
2016020735,29,3488,0.0,32,28,5,0,4,87.5
2016020735,18,3594,0.0,33,30,2,1,3,90.90909091
2016020736,19,2531,2.0,30,25,5,0,5,83.33333333
2016020736,19,1069,0.0,3,3,0,0,0,100.0
2016020736,30,3594,0.0,25,24,4,0,1,96.0
2016020737,52,3600,0.0,41,38,10,1,3,92.68292683
2016020737,16,3541,0.0,32,28,13,1,4,87.5
2016020738,7,3572,0.0,37,33,8,2,4,89.18918919
2016020738,25,1200,0.0,5,3,0,0,2,60.0
2016020738,25,2400,0.0,22,21,1,1,1,95.45454545
2016020739,23,3529,0.0,30,28,5,0,2,93.33333333
2016020739,53,3600,0.0,19,19,0,2,0,100.0
2016020740,22,3600,0.0,33,32,7,0,1,96.96969697
2016020740,28,3545,0.0,20,17,2,1,3,85.0
2016020741,15,3533,0.0,28,26,4,0,2,92.85714286
2016020741,2,3600,0.0,30,28,1,0,2,93.33333333
2016020742,29,3600,0.0,37,33,5,0,4,89.18918919
2016020742,3,1418,0.0,16,13,0,0,3,81.25
2016020742,3,1996,0.0,10,7,0,0,3,70.0
2016020743,18,3455,0.0,38,34,5,0,4,89.47368421
2016020743,5,3600,0.0,39,37,3,0,2,94.87179487
2016020744,4,3597,0.0,28,23,4,0,5,82.14285714
2016020744,12,3586,0.0,16,15,7,0,1,93.75
2016020745,7,3600,0.0,35,30,0,1,5,85.71428571
2016020745,8,3600,0.0,39,37,6,0,2,94.87179487
2016020746,1,3600,0.0,30,27,4,0,3,90.0
2016020746,17,3489,0.0,24,20,3,1,4,83.33333333
2016020747,6,3600,0.0,21,18,1,0,3,85.71428571
2016020747,14,3466,0.0,35,31,0,0,4,88.57142857
2016020748,9,3526,0.0,33,28,4,2,5,84.84848485
2016020748,13,3600,0.0,41,36,7,1,5,87.80487805
2016020749,52,3600,0.0,27,24,1,0,3,88.88888889
2016020749,19,3542,0.0,23,19,0,0,4,82.60869565
2016020750,10,2897,0.0,12,9,0,0,3,75.0
2016020750,10,672,0.0,8,5,0,0,3,62.5
2016020750,25,3600,0.0,43,40,3,0,3,93.02325581
2016020751,30,3600,2.0,43,41,5,1,2,95.34883721
2016020751,22,1636,0.0,16,15,3,0,1,93.75
2016020751,22,1955,0.0,19,15,0,0,4,78.94736842
2016020752,26,3587,0.0,32,30,1,1,2,93.75
2016020752,53,3516,0.0,39,36,8,0,3,92.30769231
2016020753,21,3600,0.0,31,26,0,2,5,83.87096774
2016020753,24,3600,0.0,29,28,5,0,1,96.55172414
2016020754,16,3567,0.0,28,26,2,0,2,92.85714286
2016020754,28,3600,0.0,25,24,7,0,1,96.0
2016020755,6,3518,0.0,22,17,1,1,5,77.27272727
2016020755,15,3600,0.0,33,30,2,0,3,90.90909091
2016020756,30,3600,0.0,36,31,5,1,5,86.11111111
2016020756,20,3589,0.0,29,28,4,1,1,96.55172414
2016020757,21,3600,0.0,40,35,8,2,5,87.5
2016020757,26,3600,0.0,22,22,3,0,0,100.0
2016020758,3,3819,0.0,37,36,10,1,1,97.2972973
2016020758,7,3836,0.0,44,42,4,0,2,95.45454545
2016020759,8,3514,0.0,23,21,5,0,2,91.30434783
2016020759,4,3575,0.0,16,15,0,0,1,93.75
2016020760,9,3594,0.0,21,19,4,0,2,90.47619048
2016020760,14,3542,0.0,29,25,7,0,4,86.20689655
2016020761,10,3600,0.0,31,26,1,2,5,83.87096774
2016020761,19,3600,0.0,27,26,5,0,1,96.2962963
2016020762,22,3479,0.0,27,25,3,1,2,92.59259259
2016020762,18,3593,0.0,31,31,6,1,0,100.0
2016020763,52,3600,0.0,42,39,7,1,3,92.85714286
2016020763,25,3484,0.0,29,25,2,0,4,86.20689655
2016020764,16,3600,0.0,27,24,8,2,3,88.88888889
2016020764,53,3537,0.0,26,22,3,2,4,84.61538462
2016020765,28,3600,0.0,33,32,2,3,1,96.96969697
2016020765,23,3600,0.0,32,28,1,0,4,87.5
2016020766,29,3795,0.0,33,29,1,0,4,87.87878788
2016020766,5,3795,0.0,31,28,0,0,3,90.32258065
2016020767,2,3588,0.0,24,19,4,1,5,79.16666667
2016020767,17,3600,0.0,36,32,7,0,4,88.88888889
2016020768,24,3519,0.0,37,35,10,2,2,94.59459459
2016020768,13,3600,0.0,23,22,4,1,1,95.65217391
2016020769,20,3673,0.0,29,26,7,0,3,89.65517241
2016020769,1,3673,0.0,38,34,4,0,4,89.47368421
2016020770,22,3516,0.0,23,21,1,0,2,91.30434783
2016020770,12,3600,0.0,25,24,7,0,1,96.0
2016020771,15,3600,0.0,22,20,2,2,2,90.90909091
2016020771,8,3512,0.0,30,27,3,1,3,90.0
2016020772,26,3750,0.0,17,17,1,0,0,100.0
2016020772,4,3755,0.0,28,27,4,0,1,96.42857143
2016020773,52,3477,0.0,27,23,4,0,4,85.18518519
2016020773,21,3600,0.0,25,23,8,0,2,92.0
2016020774,10,3600,0.0,41,36,10,1,5,87.80487805
2016020774,6,1815,0.0,14,10,2,0,4,71.42857143
2016020774,6,1726,0.0,12,10,0,1,2,83.33333333
2016020775,9,549,0.0,1,1,0,0,0,100.0
2016020775,9,3001,0.0,25,21,0,0,4,84.0
2016020775,7,3600,0.0,37,37,8,0,0,100.0
2016020776,24,3900,0.0,37,35,8,1,2,94.59459459
2016020776,14,3889,0.0,16,14,2,0,2,87.5
2016020777,12,3772,0.0,37,33,1,0,4,89.18918919
2016020777,2,3769,0.0,25,20,1,1,5,80.0
2016020778,1,3600,0.0,32,31,1,1,1,96.875
2016020778,29,3592,2.0,29,25,5,1,4,86.20689655
2016020779,5,3600,0.0,23,22,4,1,1,95.65217391
2016020779,19,3557,0.0,30,27,8,0,3,90.0
2016020780,17,3600,0.0,42,42,3,1,0,100.0
2016020780,18,3449,0.0,19,18,3,0,1,94.73684211
2016020781,16,3600,0.0,34,31,9,1,3,91.17647059
2016020781,25,3503,0.0,35,31,0,0,4,88.57142857
2016020782,30,3600,0.0,27,24,0,0,3,88.88888889
2016020782,23,3600,0.0,39,33,3,0,6,84.61538462
2016020783,53,3900,2.0,40,38,9,0,2,95.0
2016020783,28,3900,0.0,28,26,5,2,2,92.85714286
2016020784,26,1200,0.0,5,4,0,0,1,80.0
2016020784,26,2361,0.0,15,11,2,0,4,73.33333333
2016020784,15,3600,0.0,38,38,4,1,0,100.0
2016020785,22,3882,0.0,22,22,0,1,0,100.0
2016020785,8,3900,0.0,32,32,5,0,0,100.0
2016020786,20,3510,0.0,32,28,3,0,4,87.5
2016020786,3,3590,0.0,32,29,0,0,3,90.625
2016020787,7,3490,0.0,39,37,12,0,2,94.87179487
2016020787,1,3594,0.0,23,22,1,2,1,95.65217391
2016020788,10,3762,0.0,34,28,0,0,6,82.35294118
2016020788,2,3747,0.0,32,27,2,1,5,84.375
2016020789,19,3600,0.0,26,26,6,0,0,100.0
2016020789,4,3439,0.0,16,14,2,0,2,87.5
2016020790,28,3665,0.0,36,31,7,0,5,86.11111111
2016020790,7,3665,0.0,40,36,2,1,4,90.0
2016020791,24,3509,0.0,19,16,1,1,3,84.21052632
2016020791,3,3600,0.0,44,43,8,0,1,97.72727273
2016020792,20,3900,0.0,33,31,4,0,2,93.93939394
2016020792,5,3900,0.0,30,28,8,0,2,93.33333333
2016020793,12,3589,0.0,28,23,1,0,5,82.14285714
2016020793,15,3600,0.0,23,23,0,1,0,100.0
2016020794,25,3410,0.0,34,31,8,1,3,91.17647059
2016020794,10,3600,0.0,40,39,8,1,1,97.5
2016020795,19,3600,0.0,30,30,7,2,0,100.0
2016020795,9,3599,0.0,30,24,2,1,6,80.0
2016020796,29,3802,0.0,26,24,0,1,2,92.30769231
2016020796,17,3802,0.0,27,24,1,1,3,88.88888889
2016020797,26,3596,0.0,21,16,1,0,5,76.19047619
2016020797,14,3600,0.0,28,28,2,0,0,100.0
2016020798,23,3521,0.0,32,29,6,1,3,90.625
2016020798,18,3600,0.0,33,31,4,1,2,93.93939394
2016020799,30,3600,0.0,40,38,2,0,2,95.0
2016020799,52,1575,0.0,14,11,0,0,3,78.57142857
2016020799,52,1919,0.0,10,10,0,0,0,100.0
2016020800,8,3594,0.0,26,22,1,2,4,84.61538462
2016020800,21,3600,0.0,27,27,5,0,0,100.0
2016020801,16,3789,0.0,38,35,3,0,3,92.10526316
2016020801,30,3789,0.0,32,28,5,1,4,87.5
2016020802,28,1200,0.0,12,9,1,0,3,75.0
2016020802,28,2287,0.0,20,18,2,1,2,90.0
2016020802,6,3592,0.0,26,23,1,2,3,88.46153846
2016020803,24,3238,0.0,24,22,1,0,2,91.66666667
2016020803,24,341,0.0,2,2,0,0,0,100.0
2016020803,7,3575,0.0,43,39,4,0,4,90.69767442
2016020804,18,3435,0.0,30,26,1,0,4,86.66666667
2016020804,3,3600,0.0,37,34,4,0,3,91.89189189
2016020805,2,3600,0.0,35,34,7,0,1,97.14285714
2016020805,4,3442,0.0,30,27,2,0,3,90.0
2016020806,17,3515,0.0,30,25,0,0,5,83.33333333
2016020806,15,3600,0.0,17,14,0,0,3,82.35294118
2016020807,23,3600,0.0,33,33,0,0,0,100.0
2016020807,29,3600,0.0,24,21,2,0,3,87.5
2016020808,19,3620,0.0,32,31,1,0,1,96.875
2016020808,10,3614,0.0,40,38,1,0,2,95.0
2016020809,25,3513,0.0,26,24,5,4,2,92.30769231
2016020809,9,3562,0.0,33,31,6,1,2,93.93939394
2016020810,26,3597,0.0,39,36,8,3,3,92.30769231
2016020810,13,752,0.0,12,9,2,1,3,75.0
2016020810,13,2839,0.0,14,11,0,0,3,78.57142857
2016020811,5,3600,0.0,28,27,4,2,1,96.42857143
2016020811,21,3482,0.0,29,26,3,1,3,89.65517241
2016020812,8,3731,0.0,25,21,2,1,4,84.0
2016020812,53,3733,0.0,40,35,1,0,5,87.5
2016020813,14,3900,0.0,38,37,4,1,1,97.36842105
2016020813,30,3900,0.0,27,26,2,0,1,96.2962963
2016020814,16,3574,0.0,30,28,10,0,2,93.33333333
2016020814,52,3496,0.0,34,31,6,1,3,91.17647059
2016020815,23,3527,0.0,30,26,1,2,4,86.66666667
2016020815,6,3590,0.0,32,29,3,0,3,90.625
2016020816,2,3545,0.0,24,21,5,0,3,87.5
2016020816,9,3600,0.0,33,33,2,2,0,100.0
2016020817,28,3659,0.0,35,33,8,0,2,94.28571429
2016020817,4,3664,0.0,24,23,2,0,1,95.83333333
2016020818,13,3600,0.0,30,26,3,0,4,86.66666667
2016020818,18,1673,0.0,16,12,0,0,4,75.0
2016020818,18,1717,0.0,20,18,8,1,2,90.0
2016020819,12,3600,0.0,27,22,2,0,5,81.48148148
2016020819,25,3595,0.0,24,22,2,0,2,91.66666667
2016020820,17,3475,0.0,39,37,4,1,2,94.87179487
2016020820,29,3600,0.0,36,35,6,0,1,97.22222222
2016020821,7,3600,0.0,44,43,5,0,1,97.72727273
2016020821,10,3382,0.0,23,20,0,0,3,86.95652174
2016020822,19,3600,0.0,30,28,3,0,2,93.33333333
2016020822,8,3541,0.0,21,18,0,1,3,85.71428571
2016020823,21,3529,0.0,29,26,2,0,3,89.65517241
2016020823,3,3597,0.0,34,32,0,1,2,94.11764706
2016020824,24,3499,0.0,38,33,5,2,5,86.84210526
2016020824,15,3580,0.0,22,18,2,1,4,81.81818182
2016020825,14,3600,0.0,33,32,2,1,1,96.96969697
2016020825,52,3519,0.0,29,26,3,0,3,89.65517241
2016020826,5,3820,0.0,25,21,5,0,4,84.0
2016020826,53,3878,0.0,31,28,3,2,3,90.32258065
2016020827,16,3600,0.0,31,30,2,0,1,96.77419355
2016020827,22,1200,0.0,5,4,0,0,1,80.0
2016020827,22,2400,0.0,20,16,4,0,4,80.0
2016020828,28,3600,0.0,22,21,0,2,1,95.45454545
2016020828,1,3535,0.0,37,34,8,0,3,91.89189189
2016020829,17,3600,0.0,30,24,6,0,6,80.0
2016020829,30,3590,0.0,34,31,4,3,3,91.17647059
2016020830,21,3594,0.0,33,28,5,2,5,84.84848485
2016020830,2,3600,0.0,27,26,2,0,1,96.2962963
2016020831,25,3491,0.0,35,31,6,1,4,88.57142857
2016020831,18,3595,0.0,21,18,5,0,3,85.71428571
2016020832,8,3600,0.0,36,32,8,1,4,88.88888889
2016020832,6,3600,0.0,25,25,5,1,0,100.0
2016020833,23,3600,0.0,28,26,7,0,2,92.85714286
2016020833,7,3471,2.0,31,27,10,0,4,87.09677419
2016020834,3,3546,0.0,32,30,4,1,2,93.75
2016020834,29,3477,0.0,23,20,2,1,3,86.95652174
2016020835,53,3600,0.0,36,36,8,1,0,100.0
2016020835,20,2400,0.0,23,19,0,0,4,82.60869565
2016020835,20,1200,0.0,9,8,1,0,1,88.88888889
2016020836,21,3504,0.0,40,37,4,0,3,92.5
2016020836,1,3600,0.0,30,28,4,0,2,93.33333333
2016020837,23,3600,0.0,42,38,8,0,4,90.47619048
2016020837,5,3600,0.0,29,29,1,0,0,100.0
2016020838,2,3089,0.0,34,28,7,1,6,82.35294118
2016020838,2,489,0.0,7,6,0,0,1,85.71428571
2016020838,10,3600,0.0,34,33,10,2,1,97.05882353
2016020839,7,3600,0.0,41,39,3,0,2,95.12195122
2016020839,9,3529,0.0,25,22,0,0,3,88.0
2016020840,24,3600,0.0,37,37,13,0,0,100.0
2016020840,30,3524,0.0,23,22,0,1,1,95.65217391
2016020841,25,3559,0.0,22,19,2,1,3,86.36363636
2016020841,52,3600,0.0,36,34,5,1,2,94.44444444
2016020842,53,3600,0.0,33,28,3,0,5,84.84848485
2016020842,22,3600,0.0,25,23,4,0,2,92.0
2016020843,10,3556,0.0,34,30,6,0,4,88.23529412
2016020843,29,3600,0.0,33,31,4,1,2,93.93939394
2016020844,19,3600,0.0,25,25,4,0,0,100.0
2016020844,17,3507,0.0,28,27,7,0,1,96.42857143
2016020845,4,3538,2.0,22,20,6,0,2,90.90909091
2016020845,20,3600,0.0,34,33,7,0,1,97.05882353
2016020846,13,3562,0.0,34,29,4,0,5,85.29411765
2016020846,13,136,0.0,2,2,0,0,0,100.0
2016020846,28,3652,0.0,22,16,2,0,6,72.72727273
2016020847,21,3487,0.0,32,30,5,0,2,93.75
2016020847,7,3600,0.0,23,23,0,0,0,100.0
2016020848,9,3600,2.0,21,21,1,0,0,100.0
2016020848,1,3540,0.0,34,32,2,1,2,94.11764706
2016020849,3,3528,0.0,22,19,2,2,3,86.36363636
2016020849,2,3600,0.0,27,25,4,0,2,92.59259259
2016020850,52,3878,0.0,39,35,5,2,4,89.74358974
2016020850,5,3871,0.0,47,44,13,0,3,93.61702128
2016020851,23,3488,0.0,21,17,1,0,4,80.95238095
2016020851,19,3600,0.0,21,18,1,2,3,85.71428571
2016020852,25,3497,0.0,26,23,1,1,3,88.46153846
2016020852,30,3600,0.0,35,34,1,0,1,97.14285714
2016020853,4,3600,0.0,25,19,0,1,6,76.0
2016020853,22,3600,0.0,36,33,2,0,3,91.66666667
2016020854,53,3600,2.0,44,41,3,0,3,93.18181818
2016020854,26,3566,0.0,21,17,1,0,4,80.95238095
2016020855,5,3664,0.0,39,37,2,0,2,94.87179487
2016020855,29,3664,0.0,39,38,4,1,1,97.43589744
2016020856,21,3863,0.0,29,28,3,2,1,96.55172414
2016020856,12,3863,0.0,37,35,2,0,2,94.59459459
2016020857,13,3586,0.0,36,35,5,0,1,97.22222222
2016020857,24,3565,0.0,30,27,3,1,3,90.0
2016020858,19,3510,2.0,28,25,11,0,3,89.28571429
2016020858,7,3600,2.0,39,37,4,2,2,94.87179487
2016020859,52,3600,0.0,20,19,2,0,1,95.0
2016020859,8,3537,0.0,32,30,2,0,2,93.75
2016020860,15,3881,0.0,23,21,1,1,2,91.30434783
2016020860,17,3900,0.0,36,34,11,0,2,94.44444444
2016020861,9,3600,0.0,37,34,6,2,3,91.89189189
2016020861,10,3531,0.0,40,36,6,0,4,90.0
2016020862,2,3501,0.0,21,18,2,1,3,85.71428571
2016020862,1,3600,0.0,42,40,5,0,2,95.23809524
2016020863,22,3600,0.0,39,38,3,0,1,97.43589744
2016020863,16,3445,0.0,21,19,1,0,2,90.47619048
2016020864,14,3825,0.0,28,24,1,0,4,85.71428571
2016020864,25,3827,0.0,37,34,1,2,3,91.89189189
2016020865,18,3546,0.0,32,28,5,1,4,87.5
2016020865,30,3575,0.0,39,37,3,4,2,94.87179487
2016020866,28,3596,0.0,37,36,0,0,1,97.2972973
2016020866,53,3600,0.0,33,29,2,0,4,87.87878788
2016020867,20,3569,0.0,19,17,7,0,2,89.47368421
2016020867,23,3634,0.0,36,35,11,2,1,97.22222222
2016020868,13,3583,0.0,35,33,4,0,2,94.28571429
2016020868,26,3531,0.0,25,22,7,1,3,88.0
2016020869,15,3519,0.0,30,28,3,0,2,93.33333333
2016020869,3,3600,0.0,32,31,2,1,1,96.875
2016020870,17,3589,0.0,26,24,3,0,2,92.30769231
2016020870,5,3537,0.0,23,19,4,3,4,82.60869565
2016020871,52,3600,0.0,34,32,3,0,2,94.11764706
2016020871,9,3581,0.0,20,17,1,4,3,85.0
2016020872,16,3554,0.0,26,25,6,2,1,96.15384615
2016020872,7,3598,0.0,37,32,7,1,5,86.48648649
2016020873,1,3507,0.0,32,26,1,0,6,81.25
2016020873,2,3600,0.0,30,26,3,0,4,86.66666667
2016020874,18,3600,0.0,38,35,4,0,3,92.10526316
2016020874,29,3519,0.0,32,28,0,0,4,87.5
2016020875,10,3600,0.0,37,37,8,0,0,100.0
2016020875,12,2942,0.0,24,20,1,0,4,83.33333333
2016020875,12,658,0.0,7,7,0,0,0,100.0
2016020876,14,3747,0.0,29,27,8,0,2,93.10344828
2016020876,21,3686,0.0,40,37,3,2,3,92.5
2016020877,6,3756,0.0,30,29,2,0,1,96.66666667
2016020877,28,3744,0.0,28,26,1,0,2,92.85714286
2016020878,26,3506,0.0,29,28,2,0,1,96.55172414
2016020878,24,3600,0.0,24,24,2,0,0,100.0
2016020879,4,3600,0.0,20,18,2,0,2,90.0
2016020879,23,3472,0.0,28,25,4,1,3,89.28571429
2016020880,13,3600,0.0,27,26,2,0,1,96.2962963
2016020880,19,3595,0.0,33,31,2,1,2,93.93939394
2016020881,24,2307,0.0,14,14,0,0,0,100.0
2016020881,24,1200,0.0,6,3,1,0,3,50.0
2016020881,53,2668,0.0,28,27,2,0,1,96.42857143
2016020881,53,931,0.0,8,7,1,1,1,87.5
2016020882,9,3600,0.0,30,29,2,0,1,96.66666667
2016020882,1,3544,0.0,23,21,0,0,2,91.30434783
2016020883,8,3900,0.0,30,28,4,1,2,93.33333333
2016020883,3,3877,0.0,28,26,0,0,2,92.85714286
2016020884,5,3600,0.0,30,29,6,3,1,96.66666667
2016020884,12,3515,0.0,22,19,1,0,3,86.36363636
2016020885,52,3749,0.0,37,32,2,2,5,86.48648649
2016020885,10,3732,0.0,20,16,3,0,4,80.0
2016020886,2,3600,0.0,27,26,2,1,1,96.2962963
2016020886,17,3450,0.0,22,19,2,0,3,86.36363636
2016020887,22,3497,0.0,27,24,1,0,3,88.88888889
2016020887,14,3600,0.0,21,20,3,0,1,95.23809524
2016020888,20,3643,0.0,28,23,2,0,5,82.14285714
2016020888,18,1512,0.0,13,9,0,0,4,69.23076923
2016020888,18,2058,0.0,17,15,2,0,2,88.23529412
2016020889,16,3600,0.0,32,29,3,0,3,90.625
2016020889,30,3517,0.0,38,34,5,0,4,89.47368421
2016020890,26,3600,0.0,25,24,6,0,1,96.0
2016020890,21,3459,0.0,32,30,3,0,2,93.75
2016020891,22,3600,0.0,34,31,2,0,3,91.17647059
2016020891,13,3494,0.0,35,31,2,0,4,88.57142857
2016020892,15,3581,0.0,34,33,3,1,1,97.05882353
2016020892,4,3600,0.0,29,25,0,0,4,86.20689655
2016020893,6,3570,0.0,24,20,4,1,4,83.33333333
2016020893,24,3600,0.0,29,26,7,0,3,89.65517241
2016020894,3,3900,0.0,33,32,1,1,1,96.96969697
2016020894,10,3900,0.0,38,37,2,4,1,97.36842105
2016020895,2,3600,0.0,24,24,2,0,0,100.0
2016020895,8,3570,0.0,23,21,0,0,2,91.30434783
2016020896,20,3600,0.0,25,23,5,0,2,92.0
2016020896,14,3497,0.0,25,22,6,1,3,88.0
2016020897,21,3507,0.0,28,25,3,0,3,89.28571429
2016020897,18,3597,0.0,22,20,0,0,2,90.90909091
2016020898,53,3600,0.0,29,23,1,2,6,79.31034483
2016020898,16,3600,0.0,37,34,6,0,3,91.89189189
2016020899,6,3600,0.0,28,27,6,0,1,96.42857143
2016020899,26,3581,0.0,23,21,2,1,2,91.30434783
2016020900,22,3480,0.0,25,23,3,0,2,92.0
2016020900,15,3600,0.0,31,30,0,0,1,96.77419355
2016020901,20,3600,0.0,38,36,8,1,2,94.73684211
2016020901,13,3470,0.0,28,24,2,0,4,85.71428571
2016020902,9,3596,0.0,44,41,9,1,3,93.18181818
2016020902,12,3600,0.0,34,34,0,1,0,100.0
2016020903,53,3600,0.0,37,32,6,1,5,86.48648649
2016020903,25,3600,0.0,27,25,5,2,2,92.59259259
2016020904,24,3529,0.0,32,29,7,2,3,90.625
2016020904,26,3600,0.0,33,32,9,1,1,96.96969697
2016020905,3,3676,0.0,38,35,1,0,3,92.10526316
2016020905,1,3676,0.0,40,36,5,0,4,90.0
2016020906,15,3495,0.0,25,21,2,0,4,84.0
2016020906,18,3600,0.0,26,24,1,1,2,92.30769231
2016020907,8,3666,0.0,34,32,8,2,2,94.11764706
2016020907,10,3666,0.0,28,25,4,0,3,89.28571429
2016020908,4,3600,0.0,29,25,3,2,4,86.20689655
2016020908,5,3600,0.0,38,36,8,2,2,94.73684211
2016020909,2,1200,0.0,17,14,2,0,3,82.35294118
2016020909,2,2400,0.0,28,24,0,0,4,85.71428571
2016020909,29,3600,0.0,24,24,0,0,0,100.0
2016020910,7,3504,0.0,29,25,2,2,4,86.20689655
2016020910,21,3600,0.0,37,34,6,1,3,91.89189189
2016020911,28,3600,0.0,36,35,6,0,1,97.22222222
2016020911,23,3600,0.0,26,22,0,1,4,84.61538462
2016020912,6,3600,0.0,36,33,4,1,3,91.66666667
2016020912,25,3600,0.0,28,22,3,0,6,78.57142857
2016020913,20,3600,0.0,35,34,2,0,1,97.14285714
2016020913,12,3479,0.0,24,21,0,0,3,87.5
2016020914,29,3600,2.0,30,28,5,0,2,93.33333333
2016020914,3,3600,0.0,26,21,2,2,5,80.76923077
2016020915,22,3485,0.0,28,23,2,0,5,82.14285714
2016020915,18,3600,0.0,32,28,5,0,4,87.5
2016020916,9,3600,0.0,38,37,12,2,1,97.36842105
2016020916,13,3497,0.0,33,31,1,1,2,93.93939394
2016020917,19,3504,0.0,41,38,0,0,3,92.68292683
2016020917,16,3566,0.0,32,30,0,0,2,93.75
2016020918,7,3581,0.0,29,26,5,0,3,89.65517241
2016020918,53,3600,0.0,33,31,2,1,2,93.93939394
2016020919,8,3725,0.0,37,34,6,0,3,91.89189189
2016020919,1,3774,0.0,33,29,3,0,4,87.87878788
2016020920,9,3600,0.0,34,29,4,0,5,85.29411765
2016020920,14,3600,0.0,40,39,5,1,1,97.5
2016020921,26,3612,0.0,35,30,5,0,5,85.71428571
2016020921,30,3612,0.0,30,26,2,0,4,86.66666667
2016020922,53,2400,0.0,14,10,0,2,4,71.42857143
2016020922,53,1200,0.0,11,11,2,0,0,100.0
2016020922,6,3600,0.0,23,22,4,1,1,95.65217391
2016020923,18,3765,0.0,32,28,6,0,4,87.5
2016020923,7,3765,0.0,41,36,8,0,5,87.80487805
2016020924,15,3600,0.0,30,29,4,1,1,96.66666667
2016020924,3,3563,0.0,38,34,5,1,4,89.47368421
2016020925,21,3598,0.0,26,22,1,1,4,84.61538462
2016020925,4,3600,0.0,33,33,7,0,0,100.0
2016020926,29,3833,0.0,30,29,6,0,1,96.66666667
2016020926,8,3773,0.0,26,26,3,2,0,100.0
2016020927,12,3900,0.0,31,29,1,1,2,93.5483871
2016020927,13,3900,0.0,25,23,2,0,2,92.0
2016020928,22,3600,0.0,26,25,7,0,1,96.15384615
2016020928,19,3527,0.0,25,23,3,0,2,92.0
2016020929,30,523,0.0,7,7,3,0,0,100.0
2016020929,30,3077,0.0,29,24,1,2,5,82.75862069
2016020929,52,1999,0.0,21,16,3,0,5,76.19047619
2016020929,52,1485,0.0,7,6,0,0,1,85.71428571
2016020930,5,3496,0.0,32,29,4,0,3,90.625
2016020930,25,3600,0.0,20,18,0,1,2,90.0
2016020931,26,3707,0.0,30,28,2,0,2,93.33333333
2016020931,20,3707,0.0,29,28,3,0,1,96.55172414
2016020932,17,3714,0.0,27,25,4,0,2,92.59259259
2016020932,23,3751,0.0,28,25,2,2,3,89.28571429
2016020933,10,3521,0.0,36,34,7,2,2,94.44444444
2016020933,28,3600,0.0,21,20,7,1,1,95.23809524
2016020934,12,3646,0.0,16,12,1,0,4,75.0
2016020934,14,3646,0.0,31,28,2,2,3,90.32258065
2016020935,5,3508,0.0,28,25,2,0,3,89.28571429
2016020935,16,3600,0.0,37,36,0,0,1,97.2972973
2016020936,3,3600,0.0,33,32,2,3,1,96.96969697
2016020936,6,3573,0.0,21,19,7,1,2,90.47619048
2016020937,53,3532,0.0,39,35,7,1,4,89.74358974
2016020937,7,3600,0.0,22,19,0,1,3,86.36363636
2016020938,13,1200,0.0,13,13,6,0,0,100.0
2016020938,13,2700,0.0,36,35,0,0,1,97.22222222
2016020938,4,3900,0.0,40,39,6,1,1,97.5
2016020939,1,3534,0.0,24,23,8,1,1,95.83333333
2016020939,15,3587,0.0,15,15,2,2,0,100.0
2016020940,30,3530,0.0,40,39,8,0,1,97.5
2016020940,29,3595,0.0,38,38,6,0,0,100.0
2016020941,18,3539,0.0,26,24,6,0,2,92.30769231
2016020941,8,3597,0.0,25,24,0,0,1,96.0
2016020942,21,3506,0.0,42,40,3,0,2,95.23809524
2016020942,9,3598,0.0,23,22,1,0,1,95.65217391
2016020943,2,3600,0.0,25,21,2,0,4,84.0
2016020943,25,3517,0.0,33,28,4,0,5,84.84848485
2016020944,10,3900,0.0,35,33,1,1,2,94.28571429
2016020944,26,3873,0.0,31,29,1,1,2,93.5483871
2016020945,23,3539,0.0,32,29,0,3,3,90.625
2016020945,28,3600,0.0,18,17,5,1,1,94.44444444
2016020946,14,3505,0.0,34,30,3,2,4,88.23529412
2016020946,5,3589,0.0,29,27,5,0,2,93.10344828
2016020947,53,3600,0.0,34,32,2,1,2,94.11764706
2016020947,12,3508,0.0,21,18,1,0,3,85.71428571
2016020948,19,3521,0.0,38,37,8,0,1,97.36842105
2016020948,52,3592,0.0,29,29,4,1,0,100.0
2016020949,2,3900,0.0,31,30,1,0,1,96.77419355
2016020949,16,3836,0.0,32,31,6,1,1,96.875
2016020950,17,3712,0.0,31,28,9,1,3,90.32258065
2016020950,20,3816,0.0,37,35,4,0,2,94.59459459
2016020951,10,3510,0.0,35,31,3,0,4,88.57142857
2016020951,24,3571,0.0,39,37,5,0,2,94.87179487
2016020952,1,3513,0.0,40,37,5,1,3,92.5
2016020952,6,3551,0.0,17,15,2,1,2,88.23529412
2016020953,14,3900,0.0,32,31,4,0,1,96.875
2016020953,7,3899,0.0,32,31,3,0,1,96.875
2016020954,29,3478,0.0,26,24,2,1,2,92.30769231
2016020954,9,3600,0.0,27,25,3,0,2,92.59259259
2016020955,25,3600,0.0,42,41,3,0,1,97.61904762
2016020955,13,3559,0.0,34,32,5,1,2,94.11764706
2016020956,8,3600,0.0,27,26,0,0,1,96.2962963
2016020956,3,3600,0.0,35,31,1,0,4,88.57142857
2016020957,4,3805,0.0,24,22,1,2,2,91.66666667
2016020957,15,3792,0.0,31,30,7,0,1,96.77419355
2016020958,21,1740,0.0,20,15,4,1,5,75.0
2016020958,21,1830,0.0,11,10,1,0,1,90.90909091
2016020958,52,3600,0.0,23,22,4,0,1,95.65217391
2016020959,16,3600,0.0,35,32,6,0,3,91.42857143
2016020959,18,3583,0.0,32,28,2,0,4,87.5
2016020960,17,3530,0.0,38,34,3,0,4,89.47368421
2016020960,22,3600,0.0,25,22,0,2,3,88.0
2016020961,23,3600,0.0,44,41,8,2,3,93.18181818
2016020961,26,3451,0.0,21,17,0,0,4,80.95238095
2016020962,2,1200,0.0,21,17,2,0,4,80.95238095
2016020962,2,2238,0.0,16,15,0,0,1,93.75
2016020962,20,3592,0.0,35,33,5,0,2,94.28571429
2016020963,29,3600,0.0,20,20,3,0,0,100.0
2016020963,1,3600,0.0,22,19,0,0,3,86.36363636
2016020964,7,3547,0.0,45,41,9,0,4,91.11111111
2016020964,5,2384,0.0,28,28,6,1,0,100.0
2016020964,5,1200,0.0,21,18,9,0,3,85.71428571
2016020965,28,3502,0.0,27,25,1,1,2,92.59259259
2016020965,30,3600,0.0,21,20,6,0,1,95.23809524
2016020966,19,3600,0.0,27,27,1,1,0,100.0
2016020966,21,3560,0.0,25,22,2,1,3,88.0
2016020967,23,3598,0.0,44,43,8,0,1,97.72727273
2016020967,24,3495,0.0,27,25,7,0,2,92.59259259
2016020968,12,3600,0.0,26,25,2,0,1,96.15384615
2016020968,53,3531,0.0,35,33,3,2,2,94.28571429
2016020969,25,3600,0.0,44,42,14,0,2,95.45454545
2016020969,15,1982,0.0,10,10,2,0,0,100.0
2016020969,15,1540,0.0,11,8,0,0,3,72.72727273
2016020970,6,3566,0.0,28,25,0,0,3,89.28571429
2016020970,9,3600,0.0,27,25,1,0,2,92.59259259
2016020971,3,3836,0.0,38,38,9,1,0,100.0
2016020971,14,3836,2.0,34,33,5,0,1,97.05882353
2016020972,28,3600,0.0,33,31,3,0,2,93.93939394
2016020972,52,3471,0.0,29,27,4,2,2,93.10344828
2016020973,4,3600,0.0,34,31,2,2,3,91.17647059
2016020973,7,3578,0.0,30,24,7,1,6,80.0
2016020974,1,3591,0.0,24,23,3,0,1,95.83333333
2016020974,29,3574,0.0,33,33,2,0,0,100.0
2016020975,17,3531,0.0,28,25,2,2,3,89.28571429
2016020975,10,3600,0.0,24,22,3,0,2,91.66666667
2016020976,3,3581,0.0,45,43,11,2,2,95.55555556
2016020976,13,1512,0.0,8,8,4,0,0,100.0
2016020976,13,1994,0.0,19,15,3,1,4,78.94736842
2016020977,19,3600,0.0,33,32,2,1,1,96.96969697
2016020977,30,3523,0.0,20,18,0,0,2,90.0
2016020978,12,3526,0.0,24,22,2,0,2,91.66666667
2016020978,21,3600,0.0,26,25,1,1,1,96.15384615
2016020979,2,3600,0.0,28,27,2,0,1,96.42857143
2016020979,22,3515,0.0,26,23,1,0,3,88.46153846
2016020980,8,3673,0.0,28,27,0,0,1,96.42857143
2016020980,23,3672,0.0,38,36,6,1,2,94.73684211
2016020981,18,3883,0.0,42,39,3,1,3,92.85714286
2016020981,24,3900,0.0,27,24,5,0,3,88.88888889
2016020982,17,2788,0.0,21,18,5,0,3,85.71428571
2016020982,17,812,0.0,8,5,1,0,3,62.5
2016020982,6,3600,0.0,27,26,4,1,1,96.2962963
2016020983,9,3600,0.0,37,35,6,0,2,94.59459459
2016020983,25,2125,0.0,5,3,0,0,2,60.0
2016020983,25,1401,0.0,18,15,1,0,3,83.33333333
2016020984,5,3600,0.0,35,31,8,0,4,88.57142857
2016020984,52,1793,0.0,15,10,3,1,5,66.66666667
2016020984,52,1792,0.0,17,15,2,1,2,88.23529412
2016020985,3,3519,0.0,30,26,2,1,4,86.66666667
2016020985,12,3600,0.0,43,40,8,1,3,93.02325581
2016020986,4,3500,0.0,32,29,0,1,3,90.625
2016020986,10,3600,0.0,38,36,5,0,2,94.73684211
2016020987,30,3508,0.0,28,25,5,2,3,89.28571429
2016020987,14,3582,0.0,33,32,6,2,1,96.96969697
2016020988,24,3600,0.0,43,43,6,0,0,100.0
2016020988,16,3460,0.0,26,25,2,0,1,96.15384615
2016020989,1,3546,0.0,22,19,1,0,3,86.36363636
2016020989,21,3600,0.0,27,25,3,0,2,92.59259259
2016020990,8,3577,0.0,38,33,1,1,5,86.84210526
2016020990,20,3600,0.0,24,24,0,0,0,100.0
2016020991,9,3640,0.0,41,39,9,1,2,95.12195122
2016020991,53,3637,0.0,31,28,3,1,3,90.32258065
2016020992,2,3693,0.0,39,36,5,2,3,92.30769231
2016020992,23,3634,0.0,28,24,5,1,4,85.71428571
2016020993,18,3805,0.0,34,31,6,0,3,91.17647059
2016020993,26,3813,0.0,23,21,2,0,2,91.30434783
2016020994,15,3507,0.0,24,20,5,1,4,83.33333333
2016020994,28,3600,0.0,27,25,7,2,2,92.59259259
2016020995,7,3505,0.0,39,35,8,3,4,89.74358974
2016020995,29,3600,0.0,32,29,3,0,3,90.625
2016020996,16,3505,0.0,29,25,4,1,4,86.20689655
2016020996,17,3596,0.0,26,24,3,0,2,92.30769231
2016020997,30,1200,0.0,12,11,0,0,1,91.66666667
2016020997,30,2400,0.0,28,25,1,0,3,89.28571429
2016020997,13,3531,0.0,44,39,6,0,5,88.63636364
2016020998,24,3580,0.0,35,31,4,0,4,88.57142857
2016020998,19,3584,0.0,26,23,3,0,3,88.46153846
2016020999,5,3900,0.0,42,40,2,1,2,95.23809524
2016020999,22,3900,0.0,30,28,2,0,2,93.33333333
2016021000,4,3594,0.0,27,25,3,0,2,92.59259259
2016021000,6,3600,0.0,27,26,7,0,1,96.2962963
2016021001,18,3600,0.0,26,25,3,0,1,96.15384615
2016021001,28,3568,0.0,24,22,3,0,2,91.66666667
2016021002,29,3545,0.0,30,26,8,0,4,86.66666667
2016021002,7,2370,0.0,24,24,7,0,0,100.0
2016021002,7,1188,0.0,12,9,0,0,3,75.0
2016021003,13,3482,0.0,34,31,4,0,3,91.17647059
2016021003,14,3590,0.0,34,32,3,1,2,94.11764706
2016021004,10,3733,0.0,38,36,3,0,2,94.73684211
2016021004,12,3733,2.0,26,23,4,0,3,88.46153846
2016021005,20,3597,2.0,31,31,3,4,0,100.0
2016021005,52,3600,0.0,29,26,7,1,3,89.65517241
2016021006,9,3600,0.0,16,14,3,0,2,87.5
2016021006,21,3566,0.0,31,27,4,2,4,87.09677419
2016021007,2,2400,0.0,18,14,2,1,4,77.77777778
2016021007,2,1073,0.0,6,6,0,0,0,100.0
2016021007,19,3600,0.0,24,21,4,0,3,87.5
2016021008,1,1453,0.0,10,6,0,0,4,60.0
2016021008,1,2102,0.0,21,20,0,0,1,95.23809524
2016021008,53,3600,2.0,30,26,2,0,4,86.66666667
2016021009,5,3546,0.0,27,27,2,1,0,100.0
2016021009,23,3551,0.0,47,45,9,0,2,95.74468085
2016021010,15,3519,0.0,21,18,6,0,3,85.71428571
2016021010,26,3600,0.0,19,17,0,2,2,89.47368421
2016021011,3,3600,0.0,24,23,5,0,1,95.83333333
2016021011,17,3600,0.0,31,27,2,3,4,87.09677419
2016021012,30,278,0.0,2,0,0,0,2,0.0
2016021012,30,3322,0.0,20,18,3,0,2,90.0
2016021012,16,3557,0.0,44,42,0,1,2,95.45454545
2016021013,8,3600,0.0,25,24,5,0,1,96.0
2016021013,22,3551,0.0,39,37,1,0,2,94.87179487
2016021014,15,3593,0.0,32,27,9,0,5,84.375
2016021014,24,3594,0.0,27,25,8,1,2,92.59259259
2016021015,25,2196,0.0,18,16,6,1,2,88.88888889
2016021015,25,1391,0.0,8,5,1,0,3,62.5
2016021015,28,3600,0.0,30,29,2,2,1,96.66666667
2016021016,12,3600,0.0,27,23,2,1,4,85.18518519
2016021016,2,1918,0.0,20,16,3,1,4,80.0
2016021016,2,1682,0.0,13,9,0,1,4,69.23076923
2016021017,14,3600,0.0,28,26,1,0,2,92.85714286
2016021017,3,3494,0.0,16,13,3,0,3,81.25
2016021018,29,3600,0.0,26,23,10,0,3,88.46153846
2016021018,4,3446,0.0,28,24,0,2,4,85.71428571
2016021019,52,3731,0.0,42,37,3,0,5,88.0952381
2016021019,18,3729,0.0,34,30,2,0,4,88.23529412
2016021020,5,3869,0.0,30,27,4,0,3,90.0
2016021020,20,3900,2.0,35,32,6,0,3,91.42857143
2016021021,6,3600,0.0,29,26,1,0,3,89.65517241
2016021021,23,3505,0.0,42,37,7,0,5,88.0952381
2016021022,21,3540,0.0,35,34,4,0,1,97.14285714
2016021022,53,3600,0.0,22,22,6,0,0,100.0
2016021023,19,3600,0.0,39,38,4,0,1,97.43589744
2016021023,26,3467,0.0,25,23,5,1,2,92.0
2016021024,52,3895,0.0,23,20,4,1,3,86.95652174
2016021024,1,3900,0.0,36,33,3,2,3,91.66666667
2016021025,30,3490,0.0,40,36,6,1,4,90.0
2016021025,15,3585,0.0,32,30,7,1,2,93.75
2016021026,2,3634,0.0,32,30,5,0,2,93.75
2016021026,12,3634,0.0,34,31,1,0,3,91.17647059
2016021027,16,3600,0.0,42,40,5,0,2,95.23809524
2016021027,8,3519,0.0,23,20,1,0,3,86.95652174
2016021028,14,3846,0.0,32,31,4,0,1,96.875
2016021028,9,3846,0.0,37,35,2,0,2,94.59459459
2016021029,10,2400,0.0,24,20,7,0,4,83.33333333
2016021029,10,1200,0.0,8,5,1,0,3,62.5
2016021029,13,3600,0.0,30,28,7,0,2,93.33333333
2016021030,25,1889,0.0,20,15,3,0,5,75.0
2016021030,25,1711,0.0,9,7,0,0,2,77.77777778
2016021030,22,3600,0.0,23,22,1,0,1,95.65217391
2016021031,53,3878,0.0,46,44,9,0,2,95.65217391
2016021031,26,3900,0.0,32,30,3,0,2,93.75
2016021032,7,3600,0.0,41,37,8,0,4,90.24390244
2016021032,28,3600,0.0,23,22,2,0,1,95.65217391
2016021033,5,3600,0.0,28,24,3,3,4,85.71428571
2016021033,4,3600,0.0,23,23,0,2,0,100.0
2016021034,6,3600,0.0,23,21,0,0,2,91.30434783
2016021034,20,3443,0.0,31,27,5,1,4,87.09677419
2016021035,17,3437,0.0,29,26,7,1,3,89.65517241
2016021035,21,3578,0.0,28,27,0,0,1,96.42857143
2016021036,19,3470,0.0,22,20,3,0,2,90.90909091
2016021036,24,3580,0.0,27,26,5,2,1,96.2962963
2016021037,4,1076,0.0,5,4,0,0,1,80.0
2016021037,4,2489,0.0,23,19,4,0,4,82.60869565
2016021037,1,3598,0.0,19,17,4,0,2,89.47368421
2016021038,52,3599,0.0,29,27,4,3,2,93.10344828
2016021038,2,3579,0.0,28,24,6,0,4,85.71428571
2016021039,18,3665,0.0,23,22,0,2,1,95.65217391
2016021039,15,3665,0.0,24,22,1,1,2,91.66666667
2016021040,30,3504,0.0,23,21,7,0,2,91.30434783
2016021040,12,3600,0.0,31,30,1,1,1,96.77419355
2016021041,13,3523,0.0,34,32,4,2,2,94.11764706
2016021041,29,3599,0.0,34,33,3,1,1,97.05882353
2016021042,16,3592,0.0,34,33,5,0,1,97.05882353
2016021042,9,3531,0.0,28,26,6,1,2,92.85714286
2016021043,10,3600,0.0,33,33,11,2,0,100.0
2016021043,14,1574,0.0,15,11,3,0,4,73.33333333
2016021043,14,2026,0.0,6,5,0,0,1,83.33333333
2016021044,6,2093,0.0,19,17,10,0,2,89.47368421
2016021044,6,1326,0.0,17,12,2,0,5,70.58823529
2016021044,22,3600,0.0,36,32,4,0,4,88.88888889
2016021045,25,3600,0.0,28,26,5,0,2,92.85714286
2016021045,23,3424,0.0,36,32,2,0,4,88.88888889
2016021046,17,3893,0.0,26,22,2,1,4,84.61538462
2016021046,53,3900,0.0,33,29,7,1,4,87.87878788
2016021047,7,3503,0.0,36,34,4,1,2,94.44444444
2016021047,26,3600,0.0,26,26,0,0,0,100.0
2016021048,19,3597,0.0,20,19,3,0,1,95.0
2016021048,28,3540,0.0,35,32,1,0,3,91.42857143
2016021049,13,3900,0.0,32,29,0,0,3,90.625
2016021049,3,3880,0.0,37,34,4,0,3,91.89189189
2016021050,1,3549,0.0,42,37,8,0,5,88.0952381
2016021050,5,3566,0.0,36,32,5,1,4,88.88888889
2016021051,25,3520,0.0,24,21,0,0,3,87.5
2016021051,20,3600,0.0,25,24,3,0,1,96.0
2016021052,7,3872,0.0,40,39,0,0,1,97.5
2016021052,24,3900,0.0,31,30,3,0,1,96.77419355
2016021053,21,3600,0.0,23,18,4,0,5,78.26086957
2016021053,17,3600,0.0,24,23,1,0,1,95.83333333
2016021054,29,3679,0.0,22,20,0,0,2,90.90909091
2016021054,2,3679,0.0,38,35,0,1,3,92.10526316
2016021055,16,3883,0.0,26,25,1,0,1,96.15384615
2016021055,10,3883,0.0,39,37,0,0,2,94.87179487
2016021056,8,3900,0.0,31,28,5,0,3,90.32258065
2016021056,9,3871,0.0,32,29,0,0,3,90.625
2016021057,15,3584,0.0,29,26,1,0,3,89.65517241
2016021057,14,3483,0.0,34,30,5,0,4,88.23529412
2016021057,14,22,0.0,0,0,0,0,0,
2016021058,18,3469,0.0,36,33,7,0,3,91.66666667
2016021058,12,3600,0.0,29,27,0,0,2,93.10344828
2016021059,3,3600,0.0,27,25,2,3,2,92.59259259
2016021059,30,3553,0.0,30,27,3,2,3,90.0
2016021060,19,3600,0.0,31,31,0,1,0,100.0
2016021060,53,3517,0.0,40,38,4,1,2,95.0
2016021061,23,3486,0.0,22,20,2,0,2,90.90909091
2016021061,22,3600,0.0,33,33,2,1,0,100.0
2016021062,24,3600,0.0,34,33,0,0,1,97.05882353
2016021062,28,3452,0.0,27,25,6,0,2,92.59259259
2016021063,29,3600,0.0,36,35,2,0,1,97.22222222
2016021063,1,3577,0.0,26,23,1,1,3,88.46153846
2016021064,13,3598,0.0,28,24,5,1,4,85.71428571
2016021064,5,3600,0.0,21,21,5,0,0,100.0
2016021065,30,3446,0.0,21,16,4,1,5,76.19047619
2016021065,52,2400,0.0,35,31,0,3,4,88.57142857
2016021065,52,1200,0.0,13,13,4,0,0,100.0
2016021066,12,3638,0.0,44,40,3,0,4,90.90909091
2016021066,4,3621,0.0,22,19,2,0,3,86.36363636
2016021067,21,3467,0.0,33,28,2,0,5,84.84848485
2016021067,16,3600,0.0,25,22,0,0,3,88.0
2016021068,9,3600,0.0,37,33,2,2,4,89.18918919
2016021068,8,3600,0.0,31,30,1,2,1,96.77419355
2016021069,26,2765,0.0,16,14,2,1,2,87.5
2016021069,26,696,0.0,7,5,0,0,2,71.42857143
2016021069,20,3600,0.0,21,19,3,0,2,90.47619048
2016021070,6,3557,0.0,28,26,5,0,2,92.85714286
2016021070,10,3600,0.0,34,32,3,0,2,94.11764706
2016021071,7,3598,0.0,35,34,6,0,1,97.14285714
2016021071,17,3508,0.0,30,28,0,1,2,93.33333333
2016021072,53,3507,0.0,31,28,0,0,3,90.32258065
2016021072,18,3600,0.0,26,25,0,0,1,96.15384615
2016021073,28,3446,0.0,20,19,2,0,1,95.0
2016021073,25,3570,0.0,30,30,3,1,0,100.0
2016021074,26,3446,0.0,31,29,5,0,2,93.5483871
2016021074,22,3600,0.0,35,35,4,0,0,100.0
2016021075,9,3600,0.0,36,34,7,3,2,94.44444444
2016021075,6,3507,0.0,22,19,3,1,3,86.36363636
2016021076,5,3600,0.0,30,29,0,1,1,96.66666667
2016021076,7,3568,0.0,34,31,5,0,3,91.17647059
2016021077,3,3845,0.0,29,26,1,0,3,89.65517241
2016021077,1,3845,0.0,40,38,4,0,2,95.0
2016021078,20,3500,0.0,40,36,3,0,4,90.0
2016021078,15,3600,0.0,31,29,3,1,2,93.5483871
2016021079,17,3850,0.0,36,35,6,0,1,97.22222222
2016021079,8,3850,0.0,36,34,2,0,2,94.44444444
2016021080,53,3600,0.0,39,36,6,0,3,92.30769231
2016021080,14,3504,0.0,34,30,7,0,4,88.23529412
2016021081,12,3599,0.0,35,32,1,0,3,91.42857143
2016021081,13,3518,0.0,25,21,4,1,4,84.0
2016021082,28,3520,0.0,27,24,6,1,3,88.88888889
2016021082,30,3600,0.0,23,21,3,0,2,91.30434783
2016021083,4,3502,0.0,33,30,5,4,3,90.90909091
2016021083,52,3600,0.0,26,24,8,1,2,92.30769231
2016021084,23,3732,0.0,44,40,9,0,4,90.90909091
2016021084,16,2535,0.0,10,6,0,0,4,60.0
2016021084,16,1134,0.0,5,4,0,0,1,80.0
2016021085,19,3600,0.0,28,26,2,0,2,92.85714286
2016021085,21,3506,0.0,28,25,2,1,3,89.28571429
2016021086,10,3600,0.0,34,32,1,0,2,94.11764706
2016021086,29,3575,0.0,31,27,4,0,4,87.09677419
2016021087,2,3584,0.0,36,34,5,2,2,94.44444444
2016021087,3,3523,0.0,28,25,3,2,3,89.28571429
2016021088,22,1615,0.0,16,16,7,0,0,100.0
2016021088,22,1884,0.0,18,14,3,0,4,77.77777778
2016021088,24,3597,0.0,32,29,3,2,3,90.625
2016021089,14,3600,0.0,31,28,7,1,3,90.32258065
2016021089,6,3538,0.0,28,23,5,0,5,82.14285714
2016021090,29,3888,0.0,45,44,5,0,1,97.77777778
2016021090,15,3900,0.0,30,29,1,1,1,96.66666667
2016021091,1,3582,0.0,29,26,4,1,3,89.65517241
2016021091,10,3600,0.0,32,30,7,0,2,93.75
2016021092,12,3600,0.0,22,21,0,0,1,95.45454545
2016021092,8,3572,0.0,22,19,1,0,3,86.36363636
2016021093,5,3900,0.0,30,29,0,2,1,96.66666667
2016021093,9,3900,0.0,35,34,5,1,1,97.14285714
2016021094,53,3510,0.0,39,36,0,0,3,92.30769231
2016021094,13,3600,0.0,23,22,0,0,1,95.65217391
2016021095,23,3547,0.0,33,30,4,0,3,90.90909091
2016021095,19,3594,0.0,28,27,7,0,1,96.42857143
2016021096,20,3485,0.0,17,14,0,1,3,82.35294118
2016021096,18,3600,0.0,25,24,4,1,1,96.0
2016021097,4,3600,0.0,25,24,2,0,1,96.0
2016021097,30,3511,0.0,26,24,2,0,2,92.30769231
2016021098,25,3900,0.0,26,24,4,0,2,92.30769231
2016021098,16,3900,0.0,44,42,11,2,2,95.45454545
2016021099,22,1200,0.0,6,6,0,0,0,100.0
2016021099,22,2400,0.0,15,11,2,0,4,73.33333333
2016021099,21,3582,0.0,29,23,5,0,6,79.31034483
2016021100,52,3600,0.0,36,31,9,0,5,86.11111111
2016021100,26,3595,2.0,21,19,3,1,2,90.47619048
2016021101,2,3900,0.0,40,37,1,0,3,92.5
2016021101,5,3888,0.0,46,43,4,0,3,93.47826087
2016021102,14,3808,0.0,30,29,10,1,1,96.66666667
2016021102,17,3802,0.0,32,30,6,2,2,93.75
2016021103,28,3600,0.0,29,23,4,0,6,79.31034483
2016021103,25,3600,2.0,21,20,2,1,1,95.23809524
2016021104,52,3585,0.0,34,32,5,1,2,94.11764706
2016021104,24,3600,0.0,18,17,2,0,1,94.44444444
2016021105,4,3533,0.0,21,20,0,1,1,95.23809524
2016021105,29,3600,0.0,36,36,10,0,0,100.0
2016021106,23,3600,0.0,27,25,5,1,2,92.59259259
2016021106,30,3532,0.0,21,17,2,0,4,80.95238095
2016021107,10,2400,0.0,22,19,1,1,3,86.36363636
2016021107,10,1178,0.0,16,14,0,0,2,87.5
2016021107,7,3600,0.0,34,32,7,0,2,94.11764706
2016021108,9,3480,0.0,24,21,3,2,3,87.5
2016021108,8,3587,0.0,32,31,2,4,1,96.875
2016021109,16,2699,0.0,25,21,7,1,4,84.0
2016021109,16,901,0.0,6,3,0,0,3,50.0
2016021109,13,3598,0.0,25,25,3,0,0,100.0
2016021110,12,3597,0.0,27,26,2,0,1,96.2962963
2016021110,1,3482,0.0,28,25,2,1,3,89.28571429
2016021111,6,3600,0.0,19,18,8,1,1,94.73684211
2016021111,2,3491,0.0,18,16,1,0,2,88.88888889
2016021112,53,3591,0.0,32,29,5,1,3,90.625
2016021112,15,3569,0.0,29,28,6,1,1,96.55172414
2016021113,20,3897,0.0,31,29,2,0,2,93.5483871
2016021113,19,3897,0.0,31,28,2,0,3,90.32258065
2016021114,28,3523,0.0,34,27,4,0,7,79.41176471
2016021114,18,3600,0.0,28,26,3,2,2,92.85714286
2016021115,21,3600,0.0,29,25,8,1,4,86.20689655
2016021115,22,3600,0.0,25,24,1,0,1,96.0
2016021116,3,3600,0.0,30,30,1,0,0,100.0
2016021116,26,3413,0.0,19,17,1,0,2,89.47368421
2016021117,4,3600,0.0,27,25,7,1,2,92.59259259
2016021117,5,3566,0.0,32,27,0,1,5,84.375
2016021118,25,3618,0.0,21,20,0,1,1,95.23809524
2016021118,1,3620,0.0,32,30,6,0,2,93.75
2016021119,30,3712,0.0,19,16,0,0,3,84.21052632
2016021119,17,3712,0.0,26,24,5,0,2,92.30769231
2016021120,23,3452,0.0,32,30,1,0,2,93.75
2016021120,52,3600,0.0,29,28,2,1,1,96.55172414
2016021121,3,3517,0.0,33,28,1,1,5,84.84848485
2016021121,24,3600,0.0,28,25,3,1,3,89.28571429
2016021122,13,1407,0.0,10,10,1,0,0,100.0
2016021122,13,2108,0.0,22,18,5,0,4,81.81818182
2016021122,7,3600,0.0,32,30,5,1,2,93.75
2016021123,18,3600,0.0,25,24,1,0,1,96.0
2016021123,2,3526,0.0,30,28,5,2,2,93.33333333
2016021124,16,3865,0.0,30,25,2,2,5,83.33333333
2016021124,14,3486,0.0,29,25,4,0,4,86.20689655
2016021124,14,379,0.0,3,3,0,0,0,100.0
2016021125,53,3600,0.0,28,24,1,0,4,85.71428571
2016021125,19,3600,0.0,22,21,0,1,1,95.45454545
2016021126,21,3503,2.0,26,23,0,2,3,88.46153846
2016021126,20,3598,0.0,26,24,3,0,2,92.30769231
2016021127,18,3550,0.0,30,27,9,0,3,90.0
2016021127,6,3600,0.0,25,24,1,1,1,96.0
2016021128,9,3900,0.0,35,33,7,0,2,94.28571429
2016021128,4,3897,0.0,28,26,5,1,2,92.85714286
2016021129,17,3600,0.0,32,28,5,0,4,87.5
2016021129,12,3600,0.0,22,21,2,0,1,95.45454545
2016021130,7,3486,0.0,28,26,2,0,2,92.85714286
2016021130,29,3600,0.0,42,41,2,1,1,97.61904762
2016021131,13,1657,0.0,11,10,2,2,1,90.90909091
2016021131,13,1867,0.0,14,12,0,0,2,85.71428571
2016021131,10,3570,0.0,27,25,6,2,2,92.59259259
2016021132,25,3598,0.0,36,32,0,0,4,88.88888889
2016021132,8,3600,0.0,28,27,1,0,1,96.42857143
2016021133,15,3712,0.0,30,26,4,2,4,86.66666667
2016021133,30,3650,0.0,20,15,3,1,5,75.0
2016021134,26,3525,0.0,29,27,3,0,2,93.10344828
2016021134,22,3600,0.0,35,34,4,2,1,97.14285714
2016021135,24,3600,0.0,35,34,2,1,1,97.14285714
2016021135,23,3600,0.0,39,35,7,0,4,89.74358974
2016021136,3,3770,0.0,35,30,1,1,5,85.71428571
2016021136,28,3768,0.0,28,24,4,2,4,85.71428571
2016021137,16,3600,0.0,32,31,3,0,1,96.875
2016021137,5,3600,0.0,36,31,4,0,5,86.11111111
2016021138,26,3598,0.0,26,25,8,1,1,96.15384615
2016021138,20,3600,0.0,33,29,11,1,4,87.87878788
2016021139,15,3597,0.0,35,32,3,1,3,91.42857143
2016021139,21,3510,0.0,34,30,1,2,4,88.23529412
2016021140,19,3597,0.0,23,22,3,0,1,95.65217391
2016021140,53,3586,0.0,42,40,10,1,2,95.23809524
2016021141,25,3500,0.0,24,22,3,1,2,91.66666667
2016021141,6,3600,0.0,27,27,4,0,0,100.0
2016021142,2,3061,0.0,21,19,5,0,2,90.47619048
2016021142,2,486,0.0,8,5,0,0,3,62.5
2016021142,4,3600,0.0,41,38,2,0,3,92.68292683
2016021143,29,3736,0.0,31,29,5,0,2,93.5483871
2016021143,12,3736,0.0,24,23,1,0,1,95.83333333
2016021144,13,3600,0.0,33,27,1,1,6,81.81818182
2016021144,8,3600,0.0,31,29,6,2,2,93.5483871
2016021145,17,3452,0.0,31,26,0,0,5,83.87096774
2016021145,14,3600,0.0,34,31,1,0,3,91.17647059
2016021146,10,3554,0.0,30,29,7,0,1,96.66666667
2016021146,18,3503,0.0,16,14,4,0,2,87.5
2016021147,9,3600,0.0,26,21,3,0,5,80.76923077
2016021147,30,3600,0.0,19,18,6,0,1,94.73684211
2016021148,24,3793,0.0,41,37,6,1,4,90.24390244
2016021148,52,3715,0.0,28,25,1,1,3,89.28571429
2016021149,28,3492,0.0,22,19,3,0,3,86.36363636
2016021149,22,3600,0.0,40,38,2,1,2,95.0
2016021150,5,3900,0.0,33,30,1,0,3,90.90909091
2016021150,3,3823,0.0,35,32,6,0,3,91.42857143
2016021151,1,3600,0.0,38,36,15,0,2,94.73684211
2016021151,2,3600,0.0,27,26,5,1,1,96.2962963
2016021152,29,3494,0.0,23,21,2,0,2,91.30434783
2016021152,16,3600,0.0,33,32,9,1,1,96.96969697
2016021153,19,3900,0.0,32,31,2,1,1,96.875
2016021153,21,3900,0.0,28,27,1,1,1,96.42857143
2016021154,28,2400,0.0,22,18,5,1,4,81.81818182
2016021154,28,1094,0.0,12,12,1,0,0,100.0
2016021154,20,3600,0.0,38,36,8,0,2,94.73684211
2016021155,26,3600,0.0,35,35,4,0,0,100.0
2016021155,23,3437,0.0,26,24,1,0,2,92.30769231
2016021156,15,408,0.0,0,0,0,0,0,
2016021156,15,3192,0.0,25,19,0,0,6,76.0
2016021156,53,3600,0.0,48,45,2,1,3,93.75
2016021157,13,3543,0.0,28,24,5,0,4,85.71428571
2016021157,6,3600,0.0,26,24,6,3,2,92.30769231
2016021158,30,3535,0.0,35,33,6,0,2,94.28571429
2016021158,18,3580,0.0,31,31,1,0,0,100.0
2016021159,10,3600,0.0,42,38,4,0,4,90.47619048
2016021159,17,3553,0.0,27,22,0,0,5,81.48148148
2016021160,8,3651,0.0,22,21,0,0,1,95.45454545
2016021160,14,3651,0.0,36,34,8,0,2,94.44444444
2016021161,1,3600,0.0,41,38,5,2,3,92.68292683
2016021161,4,457,0.0,6,6,2,0,0,100.0
2016021161,4,3143,0.0,26,26,3,0,0,100.0
2016021162,25,3600,0.0,25,25,0,0,0,100.0
2016021162,12,3557,0.0,22,21,0,1,1,95.45454545
2016021163,9,3540,0.0,27,24,2,0,3,88.88888889
2016021163,52,3593,0.0,31,29,3,0,2,93.5483871
2016021164,24,3686,0.0,37,34,7,0,3,91.89189189
2016021164,22,3686,0.0,18,16,0,0,2,88.88888889
2016021165,6,3600,0.0,43,41,2,0,2,95.34883721
2016021165,16,3507,0.0,29,26,0,1,3,89.65517241
2016021166,2,3600,0.0,37,35,6,0,2,94.59459459
2016021166,7,3501,0.0,26,22,2,0,4,84.61538462
2016021167,12,3495,0.0,26,23,1,0,3,88.46153846
2016021167,5,3600,0.0,35,33,3,0,2,94.28571429
2016021168,25,3539,0.0,24,19,0,0,5,79.16666667
2016021168,14,3600,0.0,26,23,1,0,3,88.46153846
2016021169,15,3600,0.0,37,35,1,1,2,94.59459459
2016021169,29,3525,0.0,30,27,3,0,3,90.0
2016021170,18,3595,0.0,25,21,2,1,4,84.0
2016021170,19,3600,0.0,36,35,10,1,1,97.22222222
2016021171,21,1411,0.0,16,12,0,0,4,75.0
2016021171,21,2015,0.0,12,11,1,0,1,91.66666667
2016021171,30,3600,0.0,32,30,1,1,2,93.75
2016021172,28,3600,0.0,30,29,1,1,1,96.66666667
2016021172,23,3481,0.0,24,22,1,0,2,91.66666667
2016021173,4,3443,0.0,24,20,1,1,4,83.33333333
2016021173,3,3600,0.0,23,20,5,1,3,86.95652174
2016021174,24,3588,0.0,21,18,3,0,3,85.71428571
2016021174,20,3540,0.0,34,30,4,1,4,88.23529412
2016021175,53,3600,0.0,35,34,7,0,1,97.14285714
2016021175,26,3536,0.0,15,13,1,0,2,86.66666667
2016021176,10,3600,0.0,22,20,2,0,2,90.90909091
2016021176,7,309,0.0,5,2,0,0,3,40.0
2016021176,7,3240,0.0,40,39,5,1,1,97.5
2016021177,9,3898,0.0,33,29,1,1,4,87.87878788
2016021177,17,3898,0.0,45,41,2,0,4,91.11111111
2016021178,8,3600,0.0,32,31,1,4,1,96.875
2016021178,13,3550,0.0,30,27,3,0,3,90.0
2016021179,14,3516,0.0,37,34,2,1,3,91.89189189
2016021179,6,3600,0.0,28,28,2,0,0,100.0
2016021180,4,3618,0.0,27,26,8,0,1,96.2962963
2016021180,1,3651,0.0,35,35,12,1,0,100.0
2016021181,29,3600,0.0,27,23,7,0,4,85.18518519
2016021181,5,3600,0.0,39,38,1,0,1,97.43589744
2016021182,15,3600,0.0,28,27,5,0,1,96.42857143
2016021182,10,3600,0.0,38,34,4,1,4,89.47368421
2016021183,17,3435,0.0,24,22,2,0,2,91.66666667
2016021183,9,3600,0.0,24,24,1,0,0,100.0
2016021184,52,3600,0.0,26,24,1,0,2,92.30769231
2016021184,19,2942,0.0,25,20,2,0,5,80.0
2016021184,19,658,0.0,6,6,0,0,0,100.0
2016021185,2,3685,0.0,23,22,2,0,1,95.65217391
2016021185,18,3685,0.0,32,30,3,1,2,93.75
2016021186,12,3595,0.0,36,31,1,0,5,86.11111111
2016021186,30,3600,0.0,30,27,8,1,3,90.0
2016021187,53,3825,0.0,31,28,4,0,3,90.32258065
2016021187,25,3825,0.0,26,24,2,0,2,92.30769231
2016021188,16,3716,0.0,51,47,8,3,4,92.15686275
2016021188,21,3717,0.0,27,24,3,1,3,88.88888889
2016021189,20,319,0.0,1,1,0,0,0,100.0
2016021189,20,3281,0.0,19,16,2,1,3,84.21052632
2016021189,24,3584,0.0,27,26,6,1,1,96.2962963
2016021190,22,3584,0.0,26,21,7,0,5,80.76923077
2016021190,26,3600,0.0,27,23,2,0,4,85.18518519
2016021191,23,3427,0.0,25,22,0,0,3,88.0
2016021191,28,3600,0.0,34,33,7,0,1,97.05882353
2016021192,8,3528,0.0,30,28,0,1,2,93.33333333
2016021192,7,3600,0.0,32,31,1,0,1,96.875
2016021193,3,3518,0.0,25,23,3,0,2,92.0
2016021193,15,3600,0.0,24,24,0,1,0,100.0
2016021194,9,3895,0.0,29,28,0,0,1,96.55172414
2016021194,6,3895,0.0,26,25,2,0,1,96.15384615
2016021195,5,3600,0.0,38,34,7,1,4,89.47368421
2016021195,1,3596,0.0,28,21,4,0,7,75.0
2016021196,2,3596,0.0,29,29,4,2,0,100.0
2016021196,12,3600,0.0,23,20,2,0,3,86.95652174
2016021197,52,3558,0.0,39,35,0,1,4,89.74358974
2016021197,29,3478,0.0,32,27,2,0,5,84.375
2016021198,14,3600,0.0,27,26,4,0,1,96.2962963
2016021198,10,3585,0.0,30,26,0,1,4,86.66666667
2016021199,19,3600,0.0,32,29,2,0,3,90.625
2016021199,13,3566,0.0,37,32,7,0,5,86.48648649
2016021200,18,3600,0.0,33,30,4,1,3,90.90909091
2016021200,25,782,0.0,8,6,0,0,2,75.0
2016021200,25,2818,0.0,26,21,5,1,5,80.76923077
2016021201,30,3600,0.0,33,30,5,0,3,90.90909091
2016021201,21,3506,0.0,28,24,0,2,4,85.71428571
2016021202,23,3495,0.0,22,18,1,1,4,81.81818182
2016021202,53,3600,0.0,29,26,3,0,3,89.65517241
2016021203,16,3600,0.0,26,22,7,1,4,84.61538462
2016021203,24,3600,0.0,37,37,2,3,0,100.0
2016021204,20,3600,0.0,28,27,3,0,1,96.42857143
2016021204,26,3585,0.0,24,20,2,2,4,83.33333333
2016021205,22,3600,0.0,15,13,2,0,2,86.66666667
2016021205,28,3534,0.0,32,28,8,2,4,87.5
2016021206,14,3600,0.0,29,27,4,0,2,93.10344828
2016021206,8,3461,0.0,22,18,5,1,4,81.81818182
2016021207,3,3600,0.0,33,30,3,0,3,90.90909091
2016021207,9,3600,0.0,19,18,2,0,1,94.73684211
2016021208,29,3447,0.0,24,20,3,0,4,83.33333333
2016021208,4,3600,0.0,22,20,2,0,2,90.90909091
2016021209,15,3600,0.0,22,21,0,2,1,95.45454545
2016021209,6,2400,0.0,24,21,1,4,3,87.5
2016021209,6,1171,0.0,8,8,1,0,0,100.0
2016021210,2,3592,0.0,39,37,7,1,2,94.87179487
2016021210,1,3600,0.0,20,16,1,1,4,80.0
2016021211,5,3523,0.0,29,25,3,0,4,86.20689655
2016021211,10,2247,0.0,14,12,1,0,2,85.71428571
2016021211,10,1321,0.0,4,3,0,0,1,75.0
2016021212,8,3702,0.0,27,25,0,0,2,92.59259259
2016021212,17,3702,0.0,30,27,0,0,3,90.0
2016021213,7,3600,0.0,37,34,10,1,3,91.89189189
2016021213,13,3600,0.0,30,30,3,0,0,100.0
2016021214,19,3889,0.0,38,34,4,0,4,89.47368421
2016021214,12,3900,0.0,39,35,7,1,4,89.74358974
2016021215,18,3553,0.0,36,34,2,0,2,94.44444444
2016021215,52,3576,0.0,34,33,7,0,1,97.05882353
2016021216,21,3900,0.0,45,42,2,0,3,93.33333333
2016021216,25,3900,0.0,24,21,0,0,3,87.5
2016021217,30,3600,0.0,21,20,0,0,1,95.23809524
2016021217,53,3504,0.0,45,42,5,0,3,93.33333333
2016021218,22,3600,0.0,31,29,5,0,2,93.5483871
2016021218,23,3465,0.0,35,32,6,0,3,91.42857143
2016021219,20,2374,0.0,17,15,3,0,2,88.23529412
2016021219,20,1200,0.0,10,9,3,0,1,90.0
2016021219,28,3600,0.0,21,20,3,0,1,95.23809524
2016021220,16,3627,2.0,26,23,2,2,3,88.46153846
2016021220,26,3627,0.0,27,25,5,0,2,92.59259259
2016021221,1,3560,0.0,35,31,2,2,4,88.57142857
2016021221,17,3600,0.0,25,24,3,0,1,96.0
2016021222,7,3524,0.0,36,33,5,2,3,91.66666667
2016021222,14,3600,0.0,28,26,0,0,2,92.85714286
2016021223,9,3573,0.0,20,17,0,0,3,85.0
2016021223,2,3600,0.0,34,32,4,0,2,94.11764706
2016021224,29,3591,0.0,32,30,8,0,2,93.75
2016021224,10,3443,0.0,32,29,5,1,3,90.625
2016021225,21,3462,0.0,27,24,6,0,3,88.88888889
2016021225,19,3600,0.0,34,32,2,1,2,94.11764706
2016021226,5,3525,0.0,25,22,0,0,3,88.0
2016021226,3,3599,0.0,24,22,0,0,2,91.66666667
2016021227,12,3900,0.0,44,41,1,2,3,93.18181818
2016021227,4,3900,0.0,35,32,8,0,3,91.42857143
2016021228,13,3600,0.0,38,38,2,0,0,100.0
2016021228,15,1127,0.0,6,5,1,0,1,83.33333333
2016021228,15,2400,0.0,15,14,0,0,1,93.33333333
2016021229,26,3653,0.0,24,20,2,1,4,83.33333333
2016021229,24,3653,0.0,18,15,2,0,3,83.33333333
2016021230,23,3600,0.0,44,39,3,0,5,88.63636364
2016021230,22,3600,0.0,17,15,0,0,2,88.23529412
2016030111,3,3600,0.0,31,31,4,3,0,100.0
2016030111,8,3512,0.0,30,29,4,0,1,96.66666667
2016030112,3,4714,0.0,58,54,8,2,4,93.10344828
2016030112,8,4642,0.0,38,35,4,2,3,92.10526316
2016030113,8,3600,0.0,21,20,3,0,1,95.23809524
2016030113,3,3342,0.0,29,26,4,1,3,89.65517241
2016030114,8,3511,0.0,32,30,0,1,2,93.75
2016030114,3,3600,0.0,24,23,2,0,1,95.83333333
2016030115,3,4462,0.0,36,34,6,2,2,94.44444444
2016030115,8,4462,0.0,36,33,4,1,3,91.66666667
2016030116,8,3521,0.0,22,20,2,0,2,90.90909091
2016030116,3,3600,0.0,28,27,5,0,1,96.42857143
2016030121,6,3572,0.0,27,26,1,0,1,96.2962963
2016030121,9,3508,0.0,25,23,3,0,2,92.0
2016030122,6,3719,0.0,29,25,3,1,4,86.20689655
2016030122,9,3716,0.0,29,26,1,1,3,89.65517241
2016030123,9,3943,0.0,20,17,0,1,3,85.0
2016030123,6,3943,0.0,32,28,9,0,4,87.5
2016030124,9,3600,0.0,22,22,2,0,0,100.0
2016030124,6,3498,0.0,27,26,3,0,1,96.2962963
2016030125,6,5419,0.0,43,41,5,2,2,95.34883721
2016030125,9,5419,0.0,39,36,4,1,3,92.30769231
2016030126,9,3990,0.0,30,28,2,0,2,93.33333333
2016030126,6,3990,0.0,29,26,0,0,3,89.65517241
2016030131,10,3915,0.0,44,41,2,0,3,93.18181818
2016030131,15,3906,0.0,37,35,0,0,2,94.59459459
2016030132,10,5513,0.0,50,47,5,1,3,94.0
2016030132,15,5513,2.0,51,47,9,2,4,92.15686275
2016030133,15,3697,0.0,28,24,4,1,4,85.71428571
2016030133,10,3682,0.0,26,23,4,1,3,88.46153846
2016030134,15,3600,0.0,34,30,7,0,4,88.23529412
2016030134,10,3407,0.0,27,22,2,0,5,81.48148148
2016030135,10,3658,0.0,28,26,4,0,2,92.85714286
2016030135,15,3664,0.0,25,24,4,0,1,96.0
2016030136,15,3991,0.0,38,37,0,2,1,97.36842105
2016030136,10,3991,0.0,36,34,0,0,2,94.44444444
2016030141,29,3490,0.0,29,26,7,0,3,89.65517241
2016030141,5,3600,0.0,32,31,6,0,1,96.875
2016030142,29,3479,0.0,31,28,2,1,3,90.32258065
2016030142,5,3600,0.0,40,39,6,2,1,97.5
2016030143,5,4385,0.0,37,33,1,0,4,89.18918919
2016030143,29,4390,0.0,47,42,4,0,5,89.36170213
2016030144,5,3426,0.0,34,29,4,1,5,85.29411765
2016030144,29,3600,0.0,31,27,3,3,4,87.09677419
2016030145,29,3597,0.0,32,27,6,1,5,84.375
2016030145,5,3588,0.0,51,49,8,0,2,96.07843137
2016030151,18,3600,0.0,29,29,3,0,0,100.0
2016030151,16,3478,0.0,20,19,1,0,1,95.0
2016030152,18,3600,0.0,30,30,3,0,0,100.0
2016030152,16,3597,0.0,29,24,1,0,5,82.75862069
2016030153,16,4604,0.0,49,46,1,1,3,93.87755102
2016030153,18,4604,0.0,36,34,2,0,2,94.44444444
2016030154,16,3548,0.0,25,22,4,0,3,88.0
2016030154,18,3600,0.0,31,30,1,0,1,96.77419355
2016030161,19,4668,0.0,52,51,2,1,1,98.07692308
2016030161,30,4626,0.0,26,24,4,0,2,92.30769231
2016030162,19,3599,0.0,24,23,2,2,1,95.83333333
2016030162,30,3483,0.0,22,20,4,1,2,90.90909091
2016030163,30,3475,0.0,30,28,7,2,2,93.33333333
2016030163,19,3600,0.0,41,40,8,0,1,97.56097561
2016030164,30,3580,0.0,28,28,7,1,0,100.0
2016030164,19,3486,0.0,28,26,3,0,2,92.85714286
2016030165,19,4182,0.0,37,34,4,0,3,91.89189189
2016030165,30,4171,0.0,27,23,4,1,4,85.18518519
2016030171,20,3523,0.0,41,38,9,0,3,92.68292683
2016030171,24,3600,0.0,32,30,6,1,2,93.75
2016030172,20,3569,0.0,29,26,5,1,3,89.65517241
2016030172,24,3600,0.0,37,35,3,0,2,94.59459459
2016030173,24,1713,0.0,16,12,5,0,4,75.0
2016030173,24,1977,0.0,16,16,1,0,0,100.0
2016030173,20,3690,0.0,27,22,0,1,5,81.48148148
2016030174,24,3585,0.0,37,36,6,1,1,97.2972973
2016030174,20,3110,0.0,21,20,2,0,1,95.23809524
2016030174,20,338,0.0,3,2,0,0,1,66.66666667
2016030181,28,3802,0.0,19,17,2,1,2,89.47368421
2016030181,22,3802,0.0,44,41,12,0,3,93.18181818
2016030182,28,3556,0.0,36,34,8,4,2,94.44444444
2016030182,22,3600,0.0,16,16,5,1,0,100.0
2016030183,22,3600,0.0,23,23,0,0,0,100.0
2016030183,28,3493,0.0,22,21,1,0,1,95.45454545
2016030184,22,1972,0.0,24,19,2,0,5,79.16666667
2016030184,22,1628,0.0,8,6,5,0,2,75.0
2016030184,28,3590,0.0,23,23,6,1,0,100.0
2016030185,28,4682,0.0,48,44,4,1,4,91.66666667
2016030185,22,4693,0.0,30,27,0,0,3,90.0
2016030186,22,3600,0.0,28,27,6,1,1,96.42857143
2016030186,28,3498,0.0,20,18,1,0,2,90.0
2016030211,3,3494,0.0,43,41,11,3,2,95.34883721
2016030211,9,3600,0.0,35,34,6,0,1,97.14285714
2016030212,3,4974,0.0,34,28,0,0,6,82.35294118
2016030212,9,4942,0.0,48,43,8,1,5,89.58333333
2016030213,9,3600,0.0,30,26,4,1,4,86.66666667
2016030213,3,3588,0.0,27,26,2,0,1,96.2962963
2016030214,9,2400,0.0,20,17,1,0,3,85.0
2016030214,9,1189,0.0,10,9,3,0,1,90.0
2016030214,3,3600,0.0,23,22,0,0,1,95.65217391
2016030215,3,3985,0.0,37,32,4,3,5,86.48648649
2016030215,9,3980,0.0,33,29,5,0,4,87.87878788
2016030216,9,3600,0.0,39,37,9,5,2,94.87179487
2016030216,3,3515,0.0,25,22,1,0,3,88.0
2016030221,5,3600,0.0,35,33,0,0,2,94.28571429
2016030221,15,3481,0.0,21,18,2,0,3,85.71428571
2016030222,5,3600,0.0,36,34,8,0,2,94.44444444
2016030222,15,1114,0.0,9,7,3,0,2,77.77777778
2016030222,15,2400,0.0,14,11,2,0,3,78.57142857
2016030223,15,3793,0.0,30,28,10,0,2,93.33333333
2016030223,5,3682,0.0,33,30,7,0,3,90.90909091
2016030224,15,3538,0.0,18,15,2,0,3,83.33333333
2016030224,5,3600,0.0,38,36,5,2,2,94.73684211
2016030225,5,3462,0.0,32,28,7,0,4,87.5
2016030225,15,3600,0.0,22,20,2,0,2,90.90909091
2016030226,15,3573,0.0,18,16,2,1,2,88.88888889
2016030226,5,3600,0.0,26,21,4,1,5,80.76923077
2016030227,5,3600,0.0,29,29,1,3,0,100.0
2016030227,15,3451,0.0,28,26,2,1,2,92.85714286
2016030231,18,3600,0.0,30,27,1,0,3,90.0
2016030231,19,3506,0.0,32,28,11,0,4,87.5
2016030232,18,3502,0.0,20,17,4,0,3,85.0
2016030232,19,3600,0.0,24,22,0,0,2,91.66666667
2016030233,19,3351,0.0,34,31,7,1,3,91.17647059
2016030233,18,3584,0.0,23,22,1,0,1,95.65217391
2016030234,19,3437,0.0,25,23,2,0,2,92.0
2016030234,18,3600,0.0,33,32,7,0,1,96.96969697
2016030235,18,3466,0.0,32,30,3,1,2,93.75
2016030235,19,3600,0.0,22,21,3,1,1,95.45454545
2016030236,19,3467,0.0,17,15,3,0,2,88.23529412
2016030236,18,3591,0.0,24,23,1,0,1,95.83333333
2016030241,22,3585,0.0,36,33,2,0,3,91.66666667
2016030241,24,3530,0.0,31,27,7,0,4,87.09677419
2016030242,22,3600,0.0,40,39,11,1,1,97.5
2016030242,24,3553,0.0,23,21,7,0,2,91.30434783
2016030243,24,3600,0.0,27,24,2,1,3,88.88888889
2016030243,22,3579,0.0,28,22,6,1,6,78.57142857
2016030244,24,3626,0.0,32,29,6,0,3,90.625
2016030244,22,3641,0.0,39,35,8,1,4,89.74358974
2016030245,22,5217,0.0,64,60,8,0,4,93.75
2016030245,24,5124,0.0,38,35,2,1,3,92.10526316
2016030246,24,505,0.0,6,3,0,0,3,50.0
2016030246,24,3095,0.0,29,25,11,0,4,86.20689655
2016030246,22,3600,0.0,35,34,1,0,1,97.14285714
2016030247,22,3474,0.0,30,28,2,0,2,93.33333333
2016030247,24,3589,0.0,24,23,2,0,1,95.83333333
2016030311,9,3899,0.0,28,27,10,1,1,96.42857143
2016030311,5,3876,0.0,35,33,1,2,2,94.28571429
2016030312,9,3534,0.0,29,28,2,0,1,96.55172414
2016030312,5,3600,0.0,23,23,0,1,0,100.0
2016030313,5,772,0.0,9,5,0,0,4,55.55555556
2016030313,5,2817,0.0,20,19,7,0,1,95.0
2016030313,9,3600,0.0,26,25,2,1,1,96.15384615
2016030314,5,3584,0.0,26,24,5,1,2,92.30769231
2016030314,9,3536,0.0,35,32,6,1,3,91.42857143
2016030315,9,1112,0.0,14,10,0,1,4,71.42857143
2016030315,9,2488,0.0,22,19,0,3,3,86.36363636
2016030315,5,3600,0.0,25,25,4,1,0,100.0
2016030316,5,3496,0.0,30,28,7,1,2,93.33333333
2016030316,9,3600,0.0,46,45,5,0,1,97.82608696
2016030317,9,5109,0.0,42,39,0,0,3,92.85714286
2016030317,5,5109,0.0,29,27,2,0,2,93.10344828
2016030321,18,4145,0.0,29,27,4,1,2,93.10344828
2016030321,24,4155,0.0,46,43,11,0,3,93.47826087
2016030322,18,3468,0.0,26,22,1,1,4,84.61538462
2016030322,24,3600,0.0,33,30,2,0,3,90.90909091
2016030323,24,3518,0.0,40,38,6,0,2,95.0
2016030323,18,3600,0.0,20,19,3,0,1,95.0
2016030324,24,4225,0.0,34,32,5,0,2,94.11764706
2016030324,18,4150,0.0,37,34,4,0,3,91.89189189
2016030325,18,3592,0.0,33,32,7,0,1,96.96969697
2016030325,24,1200,0.0,10,10,2,2,0,100.0
2016030325,24,2339,0.0,18,16,0,0,2,88.88888889
2016030326,24,3544,0.0,16,12,0,0,4,75.0
2016030326,18,3600,0.0,41,38,3,2,3,92.68292683
2016030411,18,3528,0.0,11,7,0,0,4,63.63636364
2016030411,5,3586,0.0,26,23,2,0,3,88.46153846
2016030412,18,992,0.0,2,2,0,0,0,100.0
2016030412,18,2608,0.0,25,21,2,0,4,84.0
2016030412,5,3569,0.0,38,37,2,2,1,97.36842105
2016030413,5,3600,0.0,33,28,0,5,5,84.84848485
2016030413,18,3565,0.0,28,27,1,1,1,96.42857143
2016030414,5,3584,0.0,25,22,0,0,3,88.0
2016030414,18,3600,0.0,24,23,3,0,1,95.83333333
2016030415,18,2400,0.0,15,12,4,0,3,80.0
2016030415,18,1200,0.0,9,6,0,0,3,66.66666667
2016030415,5,3590,0.0,24,24,4,3,0,100.0
2016030416,5,3600,0.0,27,27,3,0,0,100.0
2016030416,18,3521,0.0,28,27,0,2,1,96.42857143
2017020001,10,3600,0.0,37,35,18,1,2,94.59459459
2017020001,52,1164,0.0,11,9,6,0,2,81.81818182
2017020001,52,2436,0.0,20,15,3,3,5,75.0
2017020002,19,3675,0.0,33,29,2,0,4,87.87878788
2017020002,5,3675,0.0,34,29,3,1,5,85.29411765
2017020003,20,3537,0.0,44,42,3,0,2,95.45454545
2017020003,22,3600,0.0,27,27,1,1,0,100.0
2017020004,4,3593,0.0,35,32,6,2,3,91.42857143
2017020004,28,3527,0.0,30,26,5,2,4,86.66666667
2017020005,18,3396,0.0,31,28,7,3,3,90.32258065
2017020005,6,3594,0.0,29,26,10,1,3,89.65517241
2017020006,8,3900,0.0,45,43,8,1,2,95.55555556
2017020006,7,3889,0.0,40,38,8,2,2,95.0
2017020007,21,3598,0.0,39,37,13,4,2,94.87179487
2017020007,3,3499,0.0,25,22,6,0,3,88.0
2017020008,15,3900,0.0,32,28,9,0,4,87.5
2017020008,9,3900,0.0,28,24,3,2,4,85.71428571
2017020009,30,3499,0.0,31,27,5,1,4,87.09677419
2017020009,17,3600,0.0,39,37,7,1,2,94.87179487
2017020010,5,3044,0.0,31,25,4,0,6,80.64516129
2017020010,5,556,0.0,13,9,0,0,4,69.23076923
2017020010,16,3596,0.0,29,28,3,1,1,96.55172414
2017020011,53,3497,0.0,41,36,10,0,5,87.80487805
2017020011,24,3593,10.0,30,26,3,4,4,86.66666667
2017020012,4,3512,0.0,27,25,8,0,2,92.59259259
2017020012,26,3599,0.0,35,35,8,3,0,100.0
2017020013,2,1910,0.0,26,21,1,0,5,80.76923077
2017020013,2,1690,0.0,11,11,3,0,0,100.0
2017020013,29,3593,0.0,29,29,2,1,0,100.0
2017020014,13,3500,0.0,24,20,4,0,4,83.33333333
2017020014,14,3600,0.0,36,33,6,0,3,91.66666667
2017020015,54,3569,0.0,46,45,8,1,1,97.82608696
2017020015,25,2638,0.0,19,19,7,0,0,100.0
2017020015,25,900,0.0,11,9,2,0,2,81.81818182
2017020016,3,2314,0.0,24,21,7,0,3,87.5
2017020016,3,1200,0.0,17,12,4,0,5,70.58823529
2017020016,10,3600,0.0,35,30,3,0,5,85.71428571
2017020017,17,3900,0.0,38,37,9,2,1,97.36842105
2017020017,9,3895,0.0,30,29,5,3,1,96.66666667
2017020018,14,3460,0.0,48,43,9,2,5,89.58333333
2017020018,13,3556,0.0,30,26,9,2,4,86.66666667
2017020019,21,3556,0.0,39,35,6,2,4,89.74358974
2017020019,1,3600,0.0,41,40,9,1,1,97.56097561
2017020020,7,1861,0.0,16,15,3,1,1,93.75
2017020020,7,1620,0.0,16,12,0,1,4,75.0
2017020020,2,3600,0.0,29,26,9,3,3,89.65517241
2017020021,18,3600,0.0,34,30,2,1,4,88.23529412
2017020021,5,3600,0.0,26,26,5,1,0,100.0
2017020022,8,2392,0.0,9,7,0,0,2,77.77777778
2017020022,8,1200,0.0,14,10,4,1,4,71.42857143
2017020022,15,3590,0.0,39,38,7,1,1,97.43589744
2017020023,30,3846,0.0,42,38,10,0,4,90.47619048
2017020023,12,3900,0.0,27,23,2,0,4,85.18518519
2017020024,25,3422,0.0,21,17,0,2,4,80.95238095
2017020024,19,3600,0.0,40,38,12,0,2,95.0
2017020025,29,3600,0.0,29,24,4,2,5,82.75862069
2017020025,16,3600,0.0,33,32,2,0,1,96.96969697
2017020026,54,3760,0.0,28,27,3,0,1,96.42857143
2017020026,53,3826,0.0,42,40,9,3,2,95.23809524
2017020027,52,3600,0.0,45,39,10,1,6,86.66666667
2017020027,20,3598,0.0,28,25,7,0,3,89.28571429
2017020028,22,2276,0.0,19,19,6,2,0,100.0
2017020028,22,1232,0.0,7,4,1,2,3,57.14285714
2017020028,23,3574,0.0,35,33,2,2,2,94.28571429
2017020029,4,3624,0.0,23,21,0,1,2,91.30434783
2017020029,24,3644,0.0,37,34,8,1,3,91.89189189
2017020030,26,3600,0.0,25,24,1,1,1,96.0
2017020030,28,2045,0.0,29,25,10,0,4,86.20689655
2017020030,28,1382,0.0,9,9,2,0,0,100.0
2017020031,8,3453,0.0,25,23,7,0,2,92.0
2017020031,3,3587,0.0,34,34,0,1,0,100.0
2017020032,21,3600,0.0,29,29,4,0,0,100.0
2017020032,6,3582,0.0,22,19,1,0,3,86.36363636
2017020033,19,3885,0.0,42,40,11,0,2,95.23809524
2017020033,2,3876,0.0,35,33,6,3,2,94.28571429
2017020034,1,3600,0.0,25,23,4,0,2,92.0
2017020034,7,2400,0.0,22,16,3,1,6,72.72727273
2017020034,7,1200,0.0,9,9,2,0,0,100.0
2017020035,16,3823,0.0,43,39,7,0,4,90.69767442
2017020035,10,3788,0.0,21,18,5,3,3,85.71428571
2017020036,15,3788,0.0,40,36,12,0,4,90.0
2017020036,14,3765,0.0,26,23,8,0,3,88.46153846
2017020037,52,3589,0.0,39,37,9,0,2,94.87179487
2017020037,22,3600,0.0,43,38,5,0,5,88.37209302
2017020038,20,3600,0.0,43,43,10,1,0,100.0
2017020038,24,3381,0.0,29,27,4,1,2,93.10344828
2017020039,19,3600,0.0,33,32,3,1,1,96.96969697
2017020039,3,3501,0.0,22,20,3,1,2,90.90909091
2017020040,29,3859,0.0,38,37,8,1,1,97.36842105
2017020040,12,3815,0.0,27,25,4,1,2,92.59259259
2017020041,16,3600,0.0,42,41,13,1,1,97.61904762
2017020041,8,3451,0.0,25,22,1,2,3,88.0
2017020042,4,3577,0.0,31,25,2,0,6,80.64516129
2017020042,18,3532,0.0,30,25,4,0,5,83.33333333
2017020043,17,3424,0.0,32,29,9,1,3,90.625
2017020043,25,3600,0.0,25,23,5,1,2,92.0
2017020044,9,3900,2.0,28,26,7,0,2,92.85714286
2017020044,23,3866,0.0,42,40,4,2,2,95.23809524
2017020045,53,3225,0.0,23,21,2,0,2,91.30434783
2017020045,53,375,0.0,5,2,0,0,3,40.0
2017020045,54,3600,0.0,33,31,5,1,2,93.93939394
2017020046,1,3600,0.0,50,47,15,2,3,94.0
2017020046,10,3561,0.0,31,25,8,4,6,80.64516129
2017020047,5,3600,0.0,22,20,5,0,2,90.90909091
2017020047,15,3511,2.0,36,33,5,2,3,91.66666667
2017020048,6,1160,0.0,9,9,0,1,0,100.0
2017020048,6,2400,0.0,26,22,9,0,4,84.61538462
2017020048,21,3600,0.0,23,20,6,1,3,86.95652174
2017020049,2,3514,0.0,30,27,8,0,3,90.0
2017020049,24,3600,0.0,41,39,13,0,2,95.12195122
2017020050,20,3662,2.0,45,42,11,1,3,93.33333333
2017020050,26,3662,0.0,37,33,8,2,4,89.18918919
2017020051,5,3532,0.0,34,29,4,0,5,85.29411765
2017020051,14,3600,0.0,40,36,7,2,4,90.0
2017020052,19,3600,0.0,38,33,10,0,5,86.84210526
2017020052,13,3570,0.0,39,37,16,1,2,94.87179487
2017020053,25,3481,0.0,30,27,5,0,3,90.0
2017020053,18,3600,2.0,31,30,3,2,1,96.77419355
2017020054,30,3600,0.0,38,36,5,3,2,94.73684211
2017020054,16,3578,0.0,32,29,4,0,3,90.625
2017020055,52,3581,0.0,32,30,11,0,2,93.75
2017020055,23,3530,0.0,19,16,1,2,3,84.21052632
2017020056,17,3600,2.0,35,33,10,0,2,94.28571429
2017020056,53,2348,0.0,23,20,0,1,3,86.95652174
2017020056,53,1200,0.0,9,9,0,1,0,100.0
2017020057,7,3506,0.0,26,23,2,1,3,88.46153846
2017020057,28,3600,0.0,25,23,6,2,2,92.0
2017020058,15,3600,0.0,23,21,4,0,2,91.30434783
2017020058,1,3600,0.0,28,23,4,0,5,82.14285714
2017020059,3,3507,0.0,42,40,1,5,2,95.23809524
2017020059,29,3596,0.0,38,37,10,2,1,97.36842105
2017020060,24,2338,0.0,20,19,2,0,1,95.0
2017020060,24,1200,0.0,18,17,9,0,1,94.44444444
2017020060,21,3599,0.0,18,17,3,1,1,94.44444444
2017020061,9,3592,0.0,25,25,4,2,0,100.0
2017020061,20,2878,0.0,22,17,9,1,5,77.27272727
2017020061,20,722,0.0,6,5,1,0,1,83.33333333
2017020062,17,3600,0.0,27,24,1,0,3,88.88888889
2017020062,54,3584,0.0,27,21,0,0,6,77.77777778
2017020063,10,3645,0.0,34,31,1,2,3,91.17647059
2017020063,8,3645,0.0,22,18,2,0,4,81.81818182
2017020064,19,3504,0.0,27,25,1,0,2,92.59259259
2017020064,14,3598,0.0,29,28,5,2,1,96.55172414
2017020065,1,3600,0.0,31,29,5,1,2,93.5483871
2017020065,3,3437,0.0,19,16,3,0,3,84.21052632
2017020066,15,3600,0.0,37,29,0,2,8,78.37837838
2017020066,4,3600,0.0,23,21,3,0,2,91.30434783
2017020067,13,3514,0.0,33,29,5,1,4,87.87878788
2017020067,5,3600,0.0,46,43,5,0,3,93.47826087
2017020068,12,3439,0.0,21,19,4,1,2,90.47619048
2017020068,52,3600,0.0,29,28,3,2,1,96.55172414
2017020069,21,3531,0.0,35,33,7,3,2,94.28571429
2017020069,25,3586,0.0,23,22,2,1,1,95.65217391
2017020070,29,3613,0.0,21,17,4,1,4,80.95238095
2017020070,30,3605,0.0,35,30,1,1,5,85.71428571
2017020071,18,3785,0.0,35,33,8,2,2,94.28571429
2017020071,16,3778,0.0,38,37,3,3,1,97.36842105
2017020072,6,3576,0.0,31,29,4,1,2,93.5483871
2017020072,53,3596,0.0,29,23,2,1,6,79.31034483
2017020073,9,3596,0.0,36,35,5,2,1,97.22222222
2017020073,22,1136,0.0,8,6,1,0,2,75.0
2017020073,22,2464,0.0,23,19,4,0,4,82.60869565
2017020074,20,3596,0.0,29,27,3,1,2,93.10344828
2017020074,23,3600,0.0,27,22,6,2,5,81.48148148
2017020075,7,3540,0.0,29,26,3,1,3,89.65517241
2017020075,26,3600,0.0,25,23,7,0,2,92.0
2017020076,2,3600,0.0,41,40,1,3,1,97.56097561
2017020076,28,3447,0.0,22,20,5,0,2,90.90909091
2017020077,6,3531,0.0,25,23,5,1,2,92.0
2017020077,54,3600,0.0,22,21,1,1,1,95.45454545
2017020078,7,3593,0.0,26,25,5,1,1,96.15384615
2017020078,24,3551,0.0,30,28,2,1,2,93.33333333
2017020079,2,3556,0.0,27,24,5,0,3,88.88888889
2017020079,26,3590,0.0,25,23,2,0,2,92.0
2017020080,14,3570,0.0,31,29,9,2,2,93.5483871
2017020080,17,3535,0.0,26,23,7,1,3,88.46153846
2017020081,14,3900,0.0,34,30,3,1,4,88.23529412
2017020081,1,3898,0.0,37,33,10,1,4,89.18918919
2017020082,5,3587,0.0,32,28,8,0,4,87.5
2017020082,3,3656,0.0,33,28,7,1,5,84.84848485
2017020083,13,3502,0.0,38,34,13,5,4,89.47368421
2017020083,4,3600,0.0,41,40,11,1,1,97.56097561
2017020084,10,3600,0.0,30,30,3,1,0,100.0
2017020084,15,3496,0.0,29,28,3,0,1,96.55172414
2017020085,23,3600,0.0,32,32,8,0,0,100.0
2017020085,9,3538,0.0,24,21,1,0,3,87.5
2017020086,21,3600,0.0,34,30,13,2,4,88.23529412
2017020086,18,3576,0.0,21,20,5,1,1,95.23809524
2017020087,29,3600,0.0,26,24,0,1,2,92.30769231
2017020087,52,3600,0.0,39,34,4,0,5,87.17948718
2017020088,53,3505,0.0,33,31,1,0,2,93.93939394
2017020088,25,3600,0.0,28,27,4,0,1,96.42857143
2017020089,12,3586,0.0,51,48,13,4,3,94.11764706
2017020089,22,3469,0.0,21,16,2,1,5,76.19047619
2017020090,7,3627,0.0,31,26,8,0,5,83.87096774
2017020090,54,3832,0.0,34,30,8,1,4,88.23529412
2017020091,8,3565,0.0,34,30,14,0,4,88.23529412
2017020091,28,3600,0.0,30,28,8,2,2,93.33333333
2017020092,17,946,0.0,4,1,0,0,3,25.0
2017020092,17,2633,0.0,21,19,3,0,2,90.47619048
2017020092,10,3600,0.0,33,30,1,0,3,90.90909091
2017020093,16,3418,0.0,32,28,8,1,4,87.5
2017020093,19,3600,0.0,24,22,8,0,2,91.66666667
2017020094,8,3583,0.0,42,37,5,1,5,88.0952381
2017020094,26,3597,0.0,37,36,8,1,1,97.2972973
2017020095,23,640,0.0,17,13,7,0,4,76.47058824
2017020095,23,2941,0.0,18,16,2,1,2,88.88888889
2017020095,6,3596,0.0,29,26,7,0,3,89.65517241
2017020096,2,3900,0.0,41,38,1,0,3,92.68292683
2017020096,3,3893,0.0,38,35,7,0,3,92.10526316
2017020097,18,3600,0.0,28,28,7,0,0,100.0
2017020097,4,3510,0.0,24,23,0,0,1,95.83333333
2017020098,14,3600,0.0,43,43,3,0,0,100.0
2017020098,29,3511,0.0,21,19,3,1,2,90.47619048
2017020099,1,2400,0.0,24,20,2,1,4,83.33333333
2017020099,1,1279,0.0,9,9,2,1,0,100.0
2017020099,9,3667,0.0,46,41,8,4,5,89.13043478
2017020100,22,3863,2.0,31,30,8,0,1,96.77419355
2017020100,16,3884,0.0,42,40,4,1,2,95.23809524
2017020101,19,3592,0.0,41,38,11,2,3,92.68292683
2017020101,21,3499,0.0,28,24,3,0,4,85.71428571
2017020102,12,3599,0.0,26,25,0,1,1,96.15384615
2017020102,20,3521,0.0,33,31,7,0,2,93.93939394
2017020103,25,3600,0.0,31,27,7,0,4,87.09677419
2017020103,53,3496,0.0,30,25,1,1,5,83.33333333
2017020104,23,3600,0.0,22,20,2,3,2,90.90909091
2017020104,7,3513,0.0,40,37,8,3,3,92.5
2017020105,28,3585,0.0,28,28,9,3,0,100.0
2017020105,1,3586,0.0,33,30,4,1,3,90.90909091
2017020106,15,3658,0.0,37,34,11,0,3,91.89189189
2017020106,17,3674,0.0,41,37,9,0,4,90.24390244
2017020107,5,3586,0.0,31,28,5,0,3,90.32258065
2017020107,13,2686,0.0,36,33,5,2,3,91.66666667
2017020107,13,806,0.0,12,11,2,0,1,91.66666667
2017020108,30,3506,0.0,30,26,1,0,4,86.66666667
2017020108,52,3600,0.0,27,24,1,0,3,88.88888889
2017020109,8,3600,0.0,45,39,4,2,6,86.66666667
2017020109,24,3569,0.0,51,49,13,2,2,96.07843137
2017020110,18,3535,0.0,14,11,4,0,3,78.57142857
2017020110,3,3600,0.0,25,23,5,1,2,92.0
2017020111,22,3551,0.0,24,22,2,1,2,91.66666667
2017020111,4,3600,0.0,24,23,3,0,1,95.83333333
2017020112,7,3779,0.0,31,27,4,1,4,87.09677419
2017020112,6,3764,0.0,42,37,1,1,5,88.0952381
2017020113,10,3540,0.0,34,29,2,0,5,85.29411765
2017020113,9,3586,0.0,31,28,0,2,3,90.32258065
2017020114,5,3600,0.0,32,25,4,2,7,78.125
2017020114,14,3600,0.0,29,28,3,0,1,96.55172414
2017020115,28,3533,0.0,22,18,0,1,4,81.81818182
2017020115,2,3600,0.0,31,28,5,0,3,90.32258065
2017020116,13,3600,0.0,42,41,7,1,1,97.61904762
2017020116,15,3441,0.0,22,19,10,1,3,86.36363636
2017020117,26,3600,0.0,36,32,3,1,4,88.88888889
2017020117,29,3486,0.0,31,26,3,0,5,83.87096774
2017020118,12,3486,0.0,26,22,2,0,4,84.61538462
2017020118,25,3600,0.0,39,36,7,2,3,92.30769231
2017020119,16,3600,0.0,29,27,4,0,2,93.10344828
2017020119,53,3555,0.0,28,25,1,0,3,89.28571429
2017020120,30,3595,0.0,37,35,13,1,2,94.59459459
2017020120,20,3556,0.0,31,28,4,1,3,90.32258065
2017020121,19,3876,0.0,22,19,3,0,3,86.36363636
2017020121,54,3050,0.0,38,37,9,1,1,97.36842105
2017020121,54,826,0.0,11,10,0,0,1,90.90909091
2017020122,23,3590,0.0,21,20,1,1,1,95.23809524
2017020122,17,3600,0.0,37,33,4,1,4,89.18918919
2017020123,26,3516,2.0,33,30,10,0,3,90.90909091
2017020123,26,36,0.0,1,1,0,0,0,100.0
2017020123,10,3591,0.0,38,36,6,4,2,94.73684211
2017020124,28,3589,0.0,34,33,10,1,1,97.05882353
2017020124,3,3600,0.0,24,20,2,2,4,83.33333333
2017020125,17,3474,0.0,32,31,5,0,1,96.875
2017020125,7,3598,0.0,32,32,1,3,0,100.0
2017020126,53,3600,0.0,25,20,2,0,5,80.0
2017020126,2,3598,0.0,35,32,6,0,3,91.42857143
2017020127,24,3600,0.0,33,31,10,2,2,93.93939394
2017020127,4,3596,0.0,25,19,3,1,6,76.0
2017020128,22,3642,0.0,44,42,6,1,2,95.45454545
2017020128,5,3637,0.0,30,29,2,1,1,96.66666667
2017020129,14,3600,0.0,32,31,3,0,1,96.875
2017020129,12,3541,0.0,27,24,3,0,3,88.88888889
2017020130,13,3600,0.0,37,32,7,0,5,86.48648649
2017020130,8,3596,0.0,27,26,2,0,1,96.2962963
2017020131,26,3883,0.0,30,28,4,2,2,93.33333333
2017020131,9,3900,0.0,43,41,4,1,2,95.34883721
2017020132,20,3893,0.0,30,28,3,0,2,93.33333333
2017020132,18,3900,0.0,32,30,2,1,2,93.75
2017020133,23,3600,0.0,29,29,4,1,0,100.0
2017020133,30,3504,0.0,25,24,1,1,1,96.0
2017020134,25,1572,0.0,17,14,3,2,3,82.35294118
2017020134,25,2003,0.0,15,14,2,0,1,93.33333333
2017020134,21,3581,0.0,37,34,2,1,3,91.89189189
2017020135,16,3541,0.0,33,29,7,2,4,87.87878788
2017020135,54,3600,0.0,31,29,5,0,2,93.5483871
2017020136,7,3600,0.0,38,33,4,0,5,86.84210526
2017020136,29,3600,0.0,35,34,3,0,1,97.14285714
2017020137,20,3593,0.0,28,24,4,0,4,85.71428571
2017020137,19,3600,0.0,25,23,3,0,2,92.0
2017020138,28,3466,0.0,33,31,5,1,2,93.93939394
2017020138,6,3600,0.0,37,36,9,0,1,97.2972973
2017020139,12,3600,0.0,34,31,0,0,3,91.17647059
2017020139,10,3600,0.0,38,32,0,0,6,84.21052632
2017020140,53,3544,0.0,29,25,1,1,4,86.20689655
2017020140,3,3596,0.0,29,27,4,0,2,93.10344828
2017020141,52,3667,0.0,36,34,9,1,2,94.44444444
2017020141,5,3667,0.0,31,30,2,1,1,96.77419355
2017020142,26,3600,0.0,40,40,11,1,0,100.0
2017020142,8,3600,0.0,28,24,0,0,4,85.71428571
2017020143,4,3478,0.0,28,23,3,0,5,82.14285714
2017020143,9,3600,0.0,40,36,7,1,4,90.0
2017020144,17,3429,0.0,38,35,6,0,3,92.10526316
2017020144,14,3567,0.0,31,29,3,2,2,93.5483871
2017020145,24,1183,0.0,5,3,2,0,2,60.0
2017020145,24,2400,0.0,17,11,3,0,6,64.70588235
2017020145,13,3600,0.0,34,31,8,1,3,91.17647059
2017020146,2,3595,0.0,33,27,8,2,6,81.81818182
2017020146,30,3600,0.0,33,29,6,0,4,87.87878788
2017020147,25,3540,0.0,35,30,3,3,5,85.71428571
2017020147,22,3600,0.0,32,28,11,1,4,87.5
2017020148,15,1500,0.0,8,7,2,0,1,87.5
2017020148,15,2100,0.0,22,17,6,0,5,77.27272727
2017020148,23,3600,0.0,27,25,6,1,2,92.59259259
2017020149,21,3597,0.0,21,14,3,0,7,66.66666667
2017020149,54,3600,0.0,32,32,4,1,0,100.0
2017020150,9,3786,0.0,25,21,4,0,4,84.0
2017020150,1,3900,0.0,27,23,1,0,4,85.18518519
2017020151,52,3748,0.0,37,35,8,1,2,94.59459459
2017020151,29,3758,0.0,30,29,4,0,1,96.66666667
2017020152,19,3600,0.0,27,26,0,0,1,96.2962963
2017020152,12,3512,0.0,34,32,0,0,2,94.11764706
2017020153,18,3574,2.0,44,43,11,6,1,97.72727273
2017020153,16,3495,0.0,30,28,3,2,2,93.33333333
2017020154,25,3600,0.0,30,29,1,1,1,96.66666667
2017020154,20,3532,0.0,24,22,2,0,2,91.66666667
2017020155,28,3592,0.0,33,31,10,2,2,93.93939394
2017020155,7,3451,0.0,31,28,4,1,3,90.32258065
2017020156,26,3899,0.0,30,29,1,0,1,96.66666667
2017020156,6,3899,0.0,30,28,3,4,2,93.33333333
2017020157,4,3600,0.0,30,28,4,0,2,93.33333333
2017020157,10,3405,0.0,30,26,2,3,4,86.66666667
2017020158,3,3511,0.0,43,38,10,1,5,88.37209302
2017020158,8,3600,0.0,26,22,3,2,4,84.61538462
2017020159,24,3600,0.0,32,31,8,0,1,96.875
2017020159,14,3298,0.0,21,17,2,2,4,80.95238095
2017020160,17,3900,0.0,46,44,12,1,2,95.65217391
2017020160,13,3898,0.0,38,36,9,2,2,94.73684211
2017020161,53,3444,0.0,25,21,0,2,4,84.0
2017020161,1,3600,0.0,37,34,7,0,3,91.89189189
2017020162,29,3577,0.0,42,38,5,0,4,90.47619048
2017020162,19,3600,0.0,37,36,2,2,1,97.2972973
2017020163,2,3596,0.0,30,28,6,1,2,93.33333333
2017020163,18,3600,0.0,23,17,2,0,6,73.91304348
2017020164,5,3554,0.0,29,27,5,0,2,93.10344828
2017020164,30,3600,0.0,30,29,3,0,1,96.66666667
2017020165,16,1799,0.0,8,7,1,0,1,87.5
2017020165,16,1602,0.0,20,15,3,0,5,75.0
2017020165,21,3600,0.0,42,39,8,2,3,92.85714286
2017020166,15,3590,0.0,40,38,6,0,2,95.0
2017020166,22,3456,0.0,30,26,0,0,4,86.66666667
2017020167,24,3900,0.0,37,34,4,0,3,91.89189189
2017020167,12,3900,0.0,25,22,0,1,3,88.0
2017020168,5,1087,0.0,9,5,0,0,4,55.55555556
2017020168,5,2513,2.0,15,12,3,0,3,80.0
2017020168,52,3600,0.0,32,31,6,1,1,96.875
2017020169,15,3551,0.0,38,36,4,1,2,94.73684211
2017020169,20,3600,0.0,31,30,6,1,1,96.77419355
2017020170,54,1510,0.0,11,7,2,0,4,63.63636364
2017020170,54,2090,0.0,19,17,4,0,2,89.47368421
2017020170,2,3600,0.0,34,31,5,1,3,91.17647059
2017020171,53,3880,0.0,31,28,1,1,3,90.32258065
2017020171,4,3770,0.0,34,30,5,0,4,88.23529412
2017020172,6,3900,0.0,32,29,4,0,3,90.625
2017020172,29,3895,0.0,30,27,3,1,3,90.0
2017020173,8,3589,0.0,28,25,6,2,3,89.28571429
2017020173,9,2400,0.0,15,9,0,1,6,60.0
2017020173,9,1200,0.0,14,12,7,0,2,85.71428571
2017020174,14,3600,0.0,23,18,3,0,5,78.26086957
2017020174,13,1778,0.0,19,14,1,0,5,73.68421053
2017020174,13,1673,0.0,18,16,1,0,2,88.88888889
2017020175,26,3517,0.0,29,26,4,0,3,89.65517241
2017020175,19,3600,0.0,28,26,3,0,2,92.85714286
2017020176,25,3752,0.0,39,38,7,4,1,97.43589744
2017020176,23,3748,2.0,29,27,5,3,2,93.10344828
2017020177,10,3580,0.0,38,36,5,0,2,94.73684211
2017020177,28,3585,0.0,18,16,0,1,2,88.88888889
2017020178,54,3568,0.0,37,32,12,0,5,86.48648649
2017020178,3,3557,0.0,34,30,3,0,4,88.23529412
2017020179,53,3500,0.0,39,35,0,2,4,89.74358974
2017020179,17,3600,0.0,33,30,2,1,3,90.90909091
2017020180,52,3600,0.0,29,28,8,0,1,96.55172414
2017020180,30,3457,0.0,19,17,6,0,2,89.47368421
2017020181,4,3497,0.0,34,32,4,1,2,94.11764706
2017020181,16,3591,0.0,35,35,8,0,0,100.0
2017020182,5,3600,0.0,37,35,10,2,2,94.59459459
2017020182,22,3518,0.0,30,27,6,1,3,90.0
2017020183,1,3586,0.0,37,37,6,1,0,100.0
2017020183,23,3542,0.0,25,24,3,1,1,96.0
2017020184,10,3600,0.0,29,28,11,1,1,96.55172414
2017020184,24,3521,0.0,29,26,4,1,3,89.65517241
2017020185,18,3600,0.0,23,19,8,2,4,82.60869565
2017020185,28,3599,0.0,20,19,4,4,1,95.0
2017020186,54,3557,0.0,28,26,1,0,2,92.85714286
2017020186,6,3600,0.0,29,28,5,0,1,96.55172414
2017020187,2,3519,0.0,19,15,3,1,4,78.94736842
2017020187,15,3560,0.0,38,35,4,1,3,92.10526316
2017020188,17,3439,0.0,29,27,1,0,2,93.10344828
2017020188,9,3600,0.0,25,24,1,0,1,96.0
2017020189,3,3679,0.0,28,27,3,0,1,96.42857143
2017020189,14,3663,0.0,35,33,2,0,2,94.28571429
2017020190,29,3589,0.0,34,31,3,0,3,91.17647059
2017020190,13,1751,0.0,19,15,2,0,4,78.94736842
2017020190,13,1849,0.0,21,18,1,0,3,85.71428571
2017020191,4,3600,0.0,33,33,3,0,0,100.0
2017020191,19,3498,0.0,22,21,0,0,1,95.45454545
2017020192,8,3585,0.0,26,21,3,0,5,80.76923077
2017020192,30,3600,0.0,31,28,3,0,3,90.32258065
2017020193,25,3515,2.0,26,22,0,0,4,84.61538462
2017020193,52,3600,0.0,23,21,0,2,2,91.30434783
2017020194,12,3503,0.0,27,22,1,0,5,81.48148148
2017020194,21,3584,0.0,60,57,1,1,3,95.0
2017020195,5,3713,0.0,34,32,7,0,2,94.11764706
2017020195,20,3739,0.0,44,43,6,1,1,97.72727273
2017020196,7,3600,0.0,29,25,2,0,4,86.20689655
2017020196,53,3417,0.0,31,26,0,0,5,83.87096774
2017020197,10,3422,0.0,28,23,6,2,5,82.14285714
2017020197,26,3600,0.0,36,33,6,3,3,91.66666667
2017020198,1,3598,0.0,41,36,1,0,5,87.80487805
2017020198,22,3600,0.0,34,31,0,0,3,91.17647059
2017020199,18,3582,0.0,38,35,2,4,3,92.10526316
2017020199,24,3525,0.0,29,25,6,1,4,86.20689655
2017020200,54,3564,0.0,28,24,2,1,4,85.71428571
2017020200,9,3463,0.0,34,29,5,2,5,85.29411765
2017020201,15,3600,0.0,33,31,4,0,2,93.93939394
2017020201,6,3510,0.0,27,24,4,3,3,88.88888889
2017020202,29,3900,0.0,36,32,5,2,4,88.88888889
2017020202,14,3900,0.0,34,30,5,1,4,88.23529412
2017020203,3,3668,0.0,34,30,1,1,4,88.23529412
2017020203,13,3658,0.0,44,39,5,1,5,88.63636364
2017020204,21,3900,0.0,37,33,8,0,4,89.18918919
2017020204,4,3900,0.0,27,23,2,1,4,85.18518519
2017020205,10,3436,0.0,32,26,4,1,6,81.25
2017020205,19,3581,0.0,31,27,4,1,4,87.09677419
2017020206,8,3787,0.0,23,19,3,1,4,82.60869565
2017020206,52,3783,0.0,50,45,11,3,5,90.0
2017020207,7,2973,0.0,15,13,0,1,2,86.66666667
2017020207,7,627,0.0,7,4,0,0,3,57.14285714
2017020207,25,3600,0.0,28,27,9,0,1,96.42857143
2017020208,16,3600,0.0,24,24,3,0,0,100.0
2017020208,30,3509,0.0,34,33,3,1,1,97.05882353
2017020209,12,3887,0.0,24,23,0,1,1,95.83333333
2017020209,53,3871,0.0,37,36,1,1,1,97.2972973
2017020210,5,3411,0.0,21,17,3,2,4,80.95238095
2017020210,23,3600,0.0,39,37,6,1,2,94.87179487
2017020211,18,3880,0.0,39,36,7,0,3,92.30769231
2017020211,26,3880,0.0,31,27,2,1,4,87.09677419
2017020212,24,3900,0.0,45,44,5,1,1,97.77777778
2017020212,28,3890,0.0,26,25,0,3,1,96.15384615
2017020213,17,3600,0.0,36,36,3,0,0,100.0
2017020213,22,3600,0.0,35,31,2,1,4,88.57142857
2017020214,21,3600,0.0,28,22,0,1,6,78.57142857
2017020214,2,3600,0.0,35,31,6,0,4,88.57142857
2017020215,8,3600,0.0,38,38,5,0,0,100.0
2017020215,16,3430,0.0,35,33,5,2,2,94.28571429
2017020216,1,3900,0.0,34,30,1,0,4,88.23529412
2017020216,20,3900,0.0,30,26,4,1,4,86.66666667
2017020217,30,1097,0.0,9,9,3,0,0,100.0
2017020217,30,2400,0.0,24,20,6,0,4,83.33333333
2017020217,6,3599,0.0,27,24,2,0,3,88.88888889
2017020218,54,3897,0.0,25,22,2,1,3,88.0
2017020218,10,3900,0.0,28,25,2,1,3,89.28571429
2017020219,29,3553,0.0,25,21,4,0,4,84.0
2017020219,3,3580,0.0,25,22,2,1,3,88.0
2017020220,53,3833,0.0,40,37,9,2,3,92.5
2017020220,15,3854,0.0,26,24,4,2,2,92.30769231
2017020221,52,3600,0.0,34,33,6,0,1,97.05882353
2017020221,25,3432,0.0,25,22,6,0,3,88.0
2017020222,17,3600,0.0,28,26,3,0,2,92.85714286
2017020222,23,3559,0.0,29,26,1,0,3,89.65517241
2017020223,15,3557,0.0,31,29,5,0,2,93.5483871
2017020223,7,3600,0.0,25,24,1,1,1,96.0
2017020224,19,3600,0.0,22,21,5,1,1,95.45454545
2017020224,1,3560,0.0,39,37,7,2,2,94.87179487
2017020225,22,3638,0.0,37,36,3,0,1,97.2972973
2017020225,2,3638,0.0,25,23,4,0,2,92.0
2017020226,53,3519,0.0,37,34,9,0,3,91.89189189
2017020226,5,3589,0.0,25,24,2,1,1,96.0
2017020227,13,3512,0.0,47,45,11,1,2,95.74468085
2017020227,12,3600,0.0,31,30,3,3,1,96.77419355
2017020228,18,3587,0.0,36,35,6,3,1,97.22222222
2017020228,29,3532,0.0,28,26,6,2,2,92.85714286
2017020229,54,3459,0.0,28,25,5,0,3,89.28571429
2017020229,8,3600,0.0,31,29,2,0,2,93.5483871
2017020230,23,3600,0.0,32,29,2,0,3,90.625
2017020230,20,3452,0.0,21,16,2,0,5,76.19047619
2017020231,26,3811,2.0,36,33,10,2,3,91.66666667
2017020231,24,644,0.0,10,9,4,0,1,90.0
2017020231,24,3187,0.0,33,30,6,5,3,90.90909091
2017020232,30,3525,0.0,18,15,0,0,3,83.33333333
2017020232,10,3600,0.0,37,35,6,1,2,94.59459459
2017020233,6,3521,0.0,32,29,0,1,3,90.625
2017020233,3,3600,0.0,33,31,6,0,2,93.93939394
2017020234,14,3599,0.0,33,32,2,1,1,96.96969697
2017020234,28,2397,2.0,21,17,2,4,4,80.95238095
2017020234,28,1200,0.0,9,8,0,0,1,88.88888889
2017020235,22,3883,0.0,34,32,5,0,2,94.11764706
2017020235,1,3883,0.0,32,29,4,1,3,90.625
2017020236,16,3502,0.0,31,28,6,2,3,90.32258065
2017020236,4,3600,0.0,39,38,2,0,1,97.43589744
2017020237,30,3600,0.0,41,41,6,2,0,100.0
2017020237,8,3490,2.0,34,32,6,1,2,94.11764706
2017020238,53,3881,0.0,38,36,5,2,2,94.73684211
2017020238,19,3900,0.0,29,27,5,1,2,93.10344828
2017020239,17,3585,0.0,33,28,1,0,5,84.84848485
2017020239,20,3600,0.0,42,39,6,1,3,92.85714286
2017020240,23,3600,0.0,35,31,4,3,4,88.57142857
2017020240,24,3084,0.0,14,13,1,1,1,92.85714286
2017020240,24,512,0.0,6,6,4,0,0,100.0
2017020241,14,3600,0.0,24,22,2,1,2,91.66666667
2017020241,26,3555,2.0,43,38,12,1,5,88.37209302
2017020242,13,3600,0.0,25,24,1,1,1,96.0
2017020242,7,3531,0.0,29,27,6,0,2,93.10344828
2017020243,6,3667,0.0,33,30,9,0,3,90.90909091
2017020243,10,3603,0.0,35,33,4,3,2,94.28571429
2017020244,5,3578,0.0,30,27,5,0,3,90.0
2017020244,15,3600,0.0,28,27,5,1,1,96.42857143
2017020245,12,3600,0.0,26,25,3,2,1,96.15384615
2017020245,29,3574,0.0,28,26,0,0,2,92.85714286
2017020246,2,3600,0.0,29,24,2,3,5,82.75862069
2017020246,25,3600,0.0,14,14,1,1,0,100.0
2017020247,9,3634,0.0,19,16,3,0,3,84.21052632
2017020247,21,3659,0.0,32,28,1,0,4,87.5
2017020248,52,2390,0.0,22,17,3,0,5,77.27272727
2017020248,52,1200,0.0,5,5,0,2,0,100.0
2017020248,54,3600,0.0,29,27,12,0,2,93.10344828
2017020249,22,3544,0.0,33,30,3,1,3,90.90909091
2017020249,3,3600,0.0,29,27,5,0,2,93.10344828
2017020250,10,3585,0.0,39,38,6,0,1,97.43589744
2017020250,6,3545,0.0,24,21,3,2,3,87.5
2017020251,7,3788,0.0,29,27,0,2,2,93.10344828
2017020251,8,3788,0.0,35,34,5,0,1,97.14285714
2017020252,21,3511,0.0,40,36,13,0,4,90.0
2017020252,9,1764,0.0,8,8,1,0,0,100.0
2017020252,9,1829,0.0,10,7,2,0,3,70.0
2017020253,29,3893,0.0,33,32,0,1,1,96.96969697
2017020253,17,3900,0.0,32,31,1,0,1,96.875
2017020254,13,3469,0.0,21,19,1,0,2,90.47619048
2017020254,1,3600,0.0,33,32,9,1,1,96.96969697
2017020255,30,3600,0.0,32,32,4,1,0,100.0
2017020255,4,3512,0.0,27,26,6,1,1,96.2962963
2017020256,16,3699,0.0,38,35,1,1,3,92.10526316
2017020256,12,3693,0.0,30,26,4,3,4,86.66666667
2017020257,2,3600,0.0,37,35,8,0,2,94.59459459
2017020257,19,2185,0.0,11,10,2,1,1,90.90909091
2017020257,19,1415,0.0,18,14,0,0,4,77.77777778
2017020258,5,3890,2.0,28,24,1,3,4,85.71428571
2017020258,18,3900,0.0,30,26,7,0,4,86.66666667
2017020259,52,3598,0.0,30,29,9,0,1,96.66666667
2017020259,53,3481,0.0,20,17,3,1,3,85.0
2017020260,23,3547,0.0,29,26,4,3,3,89.65517241
2017020260,28,3576,0.0,41,41,6,2,0,100.0
2017020261,22,3900,0.0,19,18,3,0,1,94.73684211
2017020261,15,3900,0.0,30,29,0,0,1,96.66666667
2017020262,1,3600,0.0,44,39,4,1,5,88.63636364
2017020262,16,2400,0.0,25,19,0,1,6,76.0
2017020262,16,994,0.0,13,12,4,0,1,92.30769231
2017020263,14,3600,0.0,29,28,3,0,1,96.55172414
2017020263,24,3504,0.0,37,35,3,0,2,94.59459459
2017020264,28,3591,0.0,27,26,7,1,1,96.2962963
2017020264,26,3533,0.0,33,31,1,0,2,93.93939394
2017020265,25,3600,0.0,28,23,6,0,5,82.14285714
2017020265,12,3599,0.0,26,25,6,1,1,96.15384615
2017020266,19,3583,0.0,36,30,6,0,6,83.33333333
2017020266,20,1200,0.0,9,7,0,0,2,77.77777778
2017020266,20,2390,0.0,15,13,0,1,2,86.66666667
2017020267,7,3616,0.0,45,40,8,1,5,88.88888889
2017020267,5,3593,0.0,32,28,9,2,4,87.5
2017020268,29,3658,0.0,29,28,1,1,1,96.55172414
2017020268,8,3669,0.0,25,23,2,1,2,92.0
2017020269,25,3894,0.0,29,26,0,1,3,89.65517241
2017020269,13,3896,0.0,43,40,8,3,3,93.02325581
2017020270,15,1200,0.0,6,6,0,0,0,100.0
2017020270,15,2400,0.0,25,19,3,0,6,76.0
2017020270,18,3586,0.0,29,26,2,0,3,89.65517241
2017020271,4,3540,0.0,18,17,2,0,1,94.44444444
2017020271,30,3600,0.0,30,30,2,0,0,100.0
2017020272,53,2092,0.0,17,16,2,1,1,94.11764706
2017020272,53,1508,0.0,13,10,2,0,3,76.92307692
2017020272,52,3600,0.0,34,33,7,1,1,97.05882353
2017020273,54,3027,0.0,29,22,0,0,7,75.86206897
2017020273,54,554,0.0,2,1,0,0,1,50.0
2017020273,22,3598,0.0,24,22,2,0,2,91.66666667
2017020274,23,3596,0.0,32,30,10,2,2,93.75
2017020274,26,3509,0.0,27,24,3,1,3,88.88888889
2017020275,20,2093,2.0,12,9,1,0,3,75.0
2017020275,20,1467,0.0,15,10,2,1,5,66.66666667
2017020275,17,3585,4.0,28,26,5,1,2,92.85714286
2017020276,3,795,0.0,8,7,0,0,1,87.5
2017020276,3,2792,0.0,34,30,7,0,4,88.23529412
2017020276,16,3600,0.0,28,25,5,3,3,89.28571429
2017020277,6,3600,0.0,27,23,0,1,4,85.18518519
2017020277,24,3600,0.0,42,40,1,0,2,95.23809524
2017020278,1,3897,0.0,25,24,5,0,1,96.0
2017020278,10,3875,0.0,42,42,9,2,0,100.0
2017020279,12,3561,0.0,35,30,3,0,5,85.71428571
2017020279,2,3597,0.0,32,28,4,0,4,87.5
2017020280,53,3584,0.0,37,33,6,0,4,89.18918919
2017020280,8,3503,0.0,32,27,7,1,5,84.375
2017020281,5,3596,0.0,22,21,4,0,1,95.45454545
2017020281,9,3539,0.0,28,26,2,0,2,92.85714286
2017020282,25,3600,0.0,28,22,1,0,6,78.57142857
2017020282,14,3600,0.0,28,27,2,0,1,96.42857143
2017020283,18,3557,2.0,35,30,5,1,5,85.71428571
2017020283,30,3586,0.0,30,26,3,1,4,86.66666667
2017020284,4,3892,0.0,33,31,5,0,2,93.93939394
2017020284,52,3871,0.0,32,30,8,1,2,93.75
2017020285,15,3591,0.0,28,22,6,2,6,78.57142857
2017020285,21,3600,0.0,30,28,8,0,2,93.33333333
2017020286,19,3600,0.0,30,29,3,0,1,96.66666667
2017020286,22,3597,0.0,39,35,4,2,4,89.74358974
2017020287,54,3600,0.0,21,19,1,0,2,90.47619048
2017020287,23,3572,0.0,29,25,0,1,4,86.20689655
2017020288,6,3596,0.0,28,27,2,0,1,96.42857143
2017020288,26,3492,0.0,30,28,1,3,2,93.33333333
2017020289,13,3600,0.0,35,35,6,1,0,100.0
2017020289,28,3443,0.0,28,26,1,1,2,92.85714286
2017020290,3,3404,0.0,42,40,3,2,2,95.23809524
2017020290,29,3600,0.0,36,36,2,0,0,100.0
2017020291,7,3600,0.0,33,30,9,0,3,90.90909091
2017020291,17,3575,0.0,20,19,1,2,1,95.0
2017020292,20,3678,0.0,39,35,6,2,4,89.74358974
2017020292,4,3662,0.0,31,26,7,0,5,83.87096774
2017020293,53,3665,0.0,32,30,6,1,2,93.75
2017020293,9,3683,0.0,28,25,6,1,3,89.28571429
2017020294,22,3600,0.0,21,15,5,1,6,71.42857143
2017020294,25,2354,0.0,18,18,5,0,0,100.0
2017020294,25,1242,0.0,12,9,0,3,3,75.0
2017020295,1,2400,0.0,22,17,0,0,5,77.27272727
2017020295,1,1200,0.0,12,12,0,0,0,100.0
2017020295,52,3600,0.0,36,34,7,0,2,94.44444444
2017020296,13,3500,0.0,19,16,0,0,3,84.21052632
2017020296,26,3593,0.0,24,24,1,0,0,100.0
2017020297,12,3587,0.0,25,24,4,1,1,96.0
2017020297,7,3537,0.0,32,30,7,0,2,93.75
2017020298,10,3600,0.0,33,33,1,0,0,100.0
2017020298,8,661,0.0,4,3,0,0,1,75.0
2017020298,8,2939,0.0,27,22,5,0,5,81.48148148
2017020299,2,3600,0.0,39,36,4,1,3,92.30769231
2017020299,14,3542,0.0,31,27,3,0,4,87.09677419
2017020300,16,3428,0.0,36,35,6,1,1,97.22222222
2017020300,16,172,0.0,0,0,0,0,0,
2017020300,5,3507,2.0,38,36,11,0,2,94.73684211
2017020301,30,3503,0.0,43,40,7,0,3,93.02325581
2017020301,15,3597,0.0,31,30,5,2,1,96.77419355
2017020302,21,3600,0.0,24,19,6,3,5,79.16666667
2017020302,18,3597,0.0,31,29,11,1,2,93.5483871
2017020303,19,3761,0.0,23,20,3,0,3,86.95652174
2017020303,23,3759,0.0,31,27,2,3,4,87.09677419
2017020304,6,3600,2.0,37,36,11,1,1,97.2972973
2017020304,28,3451,0.0,20,17,0,0,3,85.0
2017020305,2,3600,0.0,32,28,8,0,4,87.5
2017020305,12,3600,0.0,29,27,7,3,2,93.10344828
2017020306,21,3715,0.0,24,21,7,2,3,87.5
2017020306,17,3775,0.0,37,33,6,0,4,89.18918919
2017020307,9,3581,0.0,26,24,5,2,2,92.30769231
2017020307,3,3577,0.0,20,20,3,1,0,100.0
2017020308,26,682,0.0,9,6,0,0,3,66.66666667
2017020308,26,2843,0.0,30,30,2,2,0,100.0
2017020308,54,3600,0.0,29,27,2,0,2,93.10344828
2017020309,13,3450,0.0,28,25,6,3,3,89.28571429
2017020309,24,3598,2.0,52,50,11,1,2,96.15384615
2017020310,29,3600,0.0,32,30,7,0,2,93.75
2017020310,7,3527,0.0,29,26,0,1,3,89.65517241
2017020311,53,3585,0.0,28,27,2,1,1,96.42857143
2017020311,10,3508,0.0,29,27,6,0,2,93.10344828
2017020312,20,3585,0.0,30,29,7,1,1,96.66666667
2017020312,15,3482,0.0,39,35,9,2,4,89.74358974
2017020313,52,3470,0.0,29,24,6,1,5,82.75862069
2017020313,18,3583,0.0,35,32,4,0,3,91.42857143
2017020314,1,3650,0.0,36,33,6,1,3,91.66666667
2017020314,30,3596,0.0,25,21,4,2,4,84.0
2017020315,24,3897,0.0,42,40,9,0,2,95.23809524
2017020315,28,3900,0.0,30,28,8,0,2,93.33333333
2017020316,23,3581,0.0,38,36,4,1,2,94.73684211
2017020316,4,2066,0.0,22,18,2,2,4,81.81818182
2017020316,4,1400,0.0,13,13,0,0,0,100.0
2017020317,22,3145,0.0,37,31,5,1,6,83.78378378
2017020317,22,455,0.0,3,1,0,0,2,33.33333333
2017020317,19,3600,0.0,29,26,2,1,3,89.65517241
2017020318,8,3553,0.0,28,26,6,0,2,92.85714286
2017020318,25,3600,0.0,30,29,6,0,1,96.66666667
2017020319,30,3600,0.0,34,30,3,0,4,88.23529412
2017020319,7,1200,0.0,13,10,0,0,3,76.92307692
2017020319,7,2328,0.0,19,17,2,1,2,89.47368421
2017020320,22,3600,0.0,22,20,0,1,2,90.90909091
2017020320,17,2062,0.0,19,15,0,0,4,78.94736842
2017020320,17,1538,0.0,9,7,2,0,2,77.77777778
2017020321,10,3900,0.0,43,42,5,1,1,97.6744186
2017020321,13,3900,0.0,44,43,5,0,1,97.72727273
2017020322,6,3900,0.0,42,40,6,3,2,95.23809524
2017020322,1,3900,0.0,29,27,5,1,2,93.10344828
2017020323,4,3632,0.0,39,35,5,1,4,89.74358974
2017020323,2,3632,0.0,38,35,4,2,3,92.10526316
2017020324,23,3600,0.0,45,43,6,1,2,95.55555556
2017020324,5,3531,0.0,36,32,2,3,4,88.88888889
2017020325,9,3524,0.0,24,20,2,1,4,83.33333333
2017020325,15,3600,0.0,31,29,4,0,2,93.5483871
2017020326,3,3600,0.0,33,32,11,0,1,96.96969697
2017020326,12,3592,0.0,27,21,3,0,6,77.77777778
2017020327,20,3722,0.0,41,40,2,0,1,97.56097561
2017020327,29,3692,0.0,22,22,0,0,0,100.0
2017020328,16,3793,0.0,38,35,9,0,3,92.10526316
2017020328,14,3805,0.0,31,29,8,0,2,93.5483871
2017020329,8,3846,0.0,33,31,4,0,2,93.93939394
2017020329,18,3900,0.0,29,27,7,1,2,93.10344828
2017020330,25,3600,0.0,32,29,8,0,3,90.625
2017020330,21,3588,0.0,28,28,4,1,0,100.0
2017020331,28,3600,0.0,27,26,4,1,1,96.2962963
2017020331,53,2660,0.0,16,14,0,1,2,87.5
2017020331,53,877,0.0,9,9,0,2,0,100.0
2017020332,54,3600,0.0,19,17,4,1,2,89.47368421
2017020332,24,3600,0.0,49,45,5,0,4,91.83673469
2017020333,52,3600,0.0,39,38,10,0,1,97.43589744
2017020333,26,3525,0.0,27,25,2,3,2,92.59259259
2017020334,5,3504,0.0,33,29,3,1,4,87.87878788
2017020334,6,3600,0.0,20,17,1,1,3,85.0
2017020335,2,3764,0.0,30,26,1,1,4,86.66666667
2017020335,4,3764,0.0,37,32,4,1,5,86.48648649
2017020336,21,3900,0.0,27,25,0,1,2,92.59259259
2017020336,30,3863,0.0,30,28,6,3,2,93.33333333
2017020337,52,3600,0.0,31,30,6,3,1,96.77419355
2017020337,24,3591,0.0,35,32,3,0,3,91.42857143
2017020338,14,3454,0.0,37,35,6,0,2,94.59459459
2017020338,15,3600,0.0,26,25,3,1,1,96.15384615
2017020339,22,3483,0.0,30,28,3,2,2,93.33333333
2017020339,7,3600,0.0,30,29,4,1,1,96.66666667
2017020340,23,3504,0.0,26,23,1,1,3,88.46153846
2017020340,1,3600,0.0,25,23,4,1,2,92.0
2017020341,17,3637,0.0,31,29,1,0,2,93.5483871
2017020341,3,3637,0.0,41,40,6,1,1,97.56097561
2017020342,9,3494,0.0,31,27,1,1,4,87.09677419
2017020342,29,3600,0.0,26,24,5,1,2,92.30769231
2017020343,10,3600,0.0,47,43,5,0,4,91.4893617
2017020343,12,2400,0.0,16,12,1,2,4,75.0
2017020343,12,1060,0.0,9,8,3,0,1,88.88888889
2017020344,18,3600,0.0,34,34,2,0,0,100.0
2017020344,19,3492,0.0,27,26,0,2,1,96.2962963
2017020345,20,3561,0.0,40,35,10,0,5,87.5
2017020345,25,3594,0.0,38,34,3,0,4,89.47368421
2017020346,26,3736,0.0,33,30,5,1,3,90.90909091
2017020346,53,3763,2.0,25,23,1,0,2,92.0
2017020347,28,1210,0.0,14,11,3,0,3,78.57142857
2017020347,28,2465,0.0,19,17,4,0,2,89.47368421
2017020347,54,2400,0.0,23,19,2,2,4,82.60869565
2017020347,54,1281,0.0,3,3,0,0,0,100.0
2017020348,15,3600,0.0,29,27,2,0,2,93.10344828
2017020348,10,3483,0.0,20,17,4,1,3,85.0
2017020349,7,3278,0.0,26,23,2,0,3,88.46153846
2017020349,8,3600,0.0,36,36,1,0,0,100.0
2017020350,2,3598,0.0,32,31,12,1,1,96.875
2017020350,9,3524,0.0,24,22,5,1,2,91.66666667
2017020351,1,3752,0.0,34,31,1,2,3,91.17647059
2017020351,17,980,0.0,8,7,2,0,1,87.5
2017020351,17,2772,0.0,24,21,1,0,3,87.5
2017020352,16,3600,0.0,38,37,8,0,1,97.36842105
2017020352,13,3600,0.0,39,35,0,0,4,89.74358974
2017020353,14,3600,0.0,34,29,5,1,5,85.29411765
2017020353,5,3600,0.0,35,33,6,1,2,94.28571429
2017020354,30,3600,0.0,40,34,8,1,6,85.0
2017020354,19,3581,0.0,25,22,1,1,3,88.0
2017020355,54,3600,0.0,26,24,1,0,2,92.30769231
2017020355,53,1729,0.0,17,14,3,2,3,82.35294118
2017020355,53,1733,0.0,10,10,3,0,0,100.0
2017020356,20,3543,0.0,26,24,8,0,2,92.30769231
2017020356,21,3526,0.0,28,25,4,0,3,89.28571429
2017020357,52,2337,0.0,20,19,2,0,1,95.0
2017020357,52,1200,0.0,13,11,1,0,2,84.61538462
2017020357,28,3600,0.0,38,38,4,0,0,100.0
2017020358,24,3900,0.0,34,33,3,2,1,97.05882353
2017020358,26,3890,0.0,26,25,1,1,1,96.15384615
2017020359,18,3844,0.0,36,33,5,0,3,91.66666667
2017020359,12,3900,0.0,35,32,2,0,3,91.42857143
2017020360,23,3898,0.0,20,17,1,0,3,85.0
2017020360,3,3898,0.0,32,29,1,0,3,90.625
2017020361,22,3592,0.0,25,23,0,0,2,92.0
2017020361,6,3515,0.0,35,32,4,0,3,91.42857143
2017020362,13,3600,0.0,25,23,1,1,2,92.0
2017020362,1,3493,0.0,38,35,5,2,3,92.10526316
2017020363,4,3704,0.0,52,47,7,0,5,90.38461538
2017020363,5,2139,0.0,22,20,5,1,2,90.90909091
2017020363,5,1524,0.0,10,8,1,1,2,80.0
2017020364,29,3516,0.0,27,25,6,0,2,92.59259259
2017020364,8,3600,0.0,38,37,13,0,1,97.36842105
2017020365,30,3600,0.0,28,21,3,1,7,75.0
2017020365,52,3600,0.0,19,17,1,0,2,89.47368421
2017020366,24,2009,0.0,13,10,0,0,3,76.92307692
2017020366,24,1591,2.0,22,18,3,0,4,81.81818182
2017020366,16,3600,0.0,29,26,4,0,3,89.65517241
2017020367,14,3590,0.0,34,34,11,0,0,100.0
2017020367,7,3341,0.0,26,24,4,0,2,92.30769231
2017020368,23,3600,0.0,36,31,2,1,5,86.11111111
2017020368,2,3596,0.0,25,23,1,2,2,92.0
2017020369,13,3600,2.0,37,33,3,0,4,89.18918919
2017020369,3,2542,0.0,21,19,0,0,2,90.47619048
2017020369,3,1007,0.0,6,3,0,0,3,50.0
2017020370,28,3600,0.0,23,22,2,3,1,95.65217391
2017020370,4,3434,0.0,34,31,3,0,3,91.17647059
2017020371,12,3900,0.0,38,36,0,0,2,94.73684211
2017020371,29,3896,0.0,31,29,0,1,2,93.5483871
2017020372,26,3591,0.0,24,23,3,2,1,95.83333333
2017020372,17,3600,0.0,36,32,8,0,4,88.88888889
2017020373,16,3474,0.0,31,28,6,1,3,90.32258065
2017020373,18,3600,0.0,39,37,6,1,2,94.87179487
2017020374,10,3600,0.0,20,19,0,0,1,95.0
2017020374,20,3454,0.0,29,26,4,1,3,89.65517241
2017020375,53,3860,0.0,27,24,4,0,3,88.88888889
2017020375,22,3860,0.0,31,29,0,0,2,93.5483871
2017020376,25,3597,0.0,34,34,2,1,0,100.0
2017020376,54,3600,0.0,30,27,2,0,3,90.0
2017020377,14,3517,0.0,36,33,4,0,3,91.66666667
2017020377,6,3600,0.0,21,19,0,0,2,90.47619048
2017020378,9,3516,0.0,31,29,2,2,2,93.5483871
2017020378,8,3600,0.0,28,27,3,0,1,96.42857143
2017020379,24,3590,0.0,39,37,13,7,2,94.87179487
2017020379,19,3468,0.0,30,27,5,1,3,90.0
2017020380,52,3648,0.0,26,23,2,3,3,88.46153846
2017020380,21,3644,0.0,33,31,4,1,2,93.93939394
2017020381,26,3600,0.0,29,27,5,0,2,93.10344828
2017020381,15,3528,0.0,25,22,2,0,3,88.0
2017020382,8,3596,0.0,31,28,3,2,3,90.32258065
2017020382,17,3600,0.0,25,19,3,0,6,76.0
2017020383,23,3600,0.0,32,29,2,1,3,90.625
2017020383,18,3526,0.0,31,27,4,2,4,87.09677419
2017020384,54,3519,0.0,31,28,2,1,3,90.32258065
2017020384,30,3600,0.0,31,29,5,0,2,93.5483871
2017020385,25,3651,0.0,22,19,5,0,3,86.36363636
2017020385,16,3651,0.0,35,31,5,2,4,88.57142857
2017020386,53,3600,0.0,44,41,4,0,3,93.18181818
2017020386,20,3600,0.0,28,28,3,1,0,100.0
2017020387,10,3600,0.0,45,41,3,1,4,91.11111111
2017020387,22,3561,0.0,35,30,0,0,5,85.71428571
2017020388,5,3600,0.0,34,34,1,2,0,100.0
2017020388,7,3600,0.0,25,21,1,3,4,84.0
2017020389,9,1720,0.0,18,13,4,0,5,72.22222222
2017020389,9,1821,0.0,19,19,0,3,0,100.0
2017020389,2,1909,0.0,20,15,3,1,5,75.0
2017020389,2,1602,0.0,15,14,3,0,1,93.33333333
2017020390,12,3576,0.0,24,21,6,0,3,87.5
2017020390,3,3600,0.0,33,32,1,1,1,96.96969697
2017020391,24,3504,2.0,30,27,4,1,3,90.0
2017020391,29,3600,0.0,27,25,3,4,2,92.59259259
2017020392,28,3600,0.0,40,39,7,0,1,97.5
2017020392,13,3504,0.0,32,30,0,0,2,93.75
2017020393,26,3600,0.0,40,39,6,2,1,97.5
2017020393,19,2400,0.0,21,18,5,0,3,85.71428571
2017020393,19,1200,0.0,7,6,0,0,1,85.71428571
2017020394,54,3581,0.0,37,31,6,1,6,83.78378378
2017020394,52,3589,0.0,31,27,4,1,4,87.09677419
2017020395,1,3596,0.0,23,22,2,0,1,95.65217391
2017020395,21,3470,0.0,21,19,5,1,2,90.47619048
2017020396,6,3600,0.0,28,28,9,0,0,100.0
2017020396,4,3403,0.0,27,24,1,2,3,88.88888889
2017020397,19,3639,0.0,25,23,4,2,2,92.0
2017020397,30,3639,0.0,42,41,9,0,1,97.61904762
2017020398,17,1577,0.0,9,4,0,0,5,44.44444444
2017020398,17,2023,0.0,25,20,2,0,5,80.0
2017020398,8,3600,0.0,23,22,0,0,1,95.65217391
2017020399,28,3600,0.0,43,38,2,0,5,88.37209302
2017020399,14,3600,0.0,27,25,1,0,2,92.59259259
2017020400,7,3543,0.0,28,24,7,0,4,85.71428571
2017020400,5,3589,0.0,33,32,6,2,1,96.96969697
2017020401,29,3519,0.0,23,19,1,0,4,82.60869565
2017020401,15,3588,0.0,35,32,0,1,3,91.42857143
2017020402,10,3468,0.0,26,24,2,0,2,92.30769231
2017020402,23,3577,0.0,36,35,4,0,1,97.22222222
2017020403,13,3893,0.0,47,44,11,1,3,93.61702128
2017020403,12,3882,0.0,39,37,3,1,2,94.87179487
2017020404,24,3900,0.0,35,33,4,0,2,94.28571429
2017020404,18,3900,0.0,35,33,1,0,2,94.28571429
2017020405,1,3600,0.0,27,22,5,0,5,81.48148148
2017020405,53,3583,0.0,27,27,4,1,0,100.0
2017020406,16,3900,0.0,35,33,6,2,2,94.28571429
2017020406,25,3894,0.0,34,32,5,2,2,94.11764706
2017020407,22,3600,0.0,34,29,7,1,5,85.29411765
2017020407,20,2400,0.0,27,22,5,1,5,81.48148148
2017020407,20,1200,0.0,6,4,0,0,2,66.66666667
2017020408,26,3600,0.0,25,24,3,0,1,96.0
2017020408,16,3524,0.0,22,21,3,1,1,95.45454545
2017020409,9,1990,0.0,27,27,2,1,0,100.0
2017020409,9,1610,0.0,22,17,5,0,5,77.27272727
2017020409,52,3600,0.0,21,21,1,0,0,100.0
2017020410,25,3599,0.0,27,25,5,1,2,92.59259259
2017020410,21,1807,0.0,18,16,7,0,2,88.88888889
2017020410,21,1672,0.0,9,5,0,0,4,55.55555556
2017020411,53,3831,0.0,45,42,0,0,3,93.33333333
2017020411,54,3831,0.0,33,31,4,0,2,93.93939394
2017020412,28,3600,0.0,29,25,8,2,4,86.20689655
2017020412,15,3600,0.0,25,24,1,1,1,96.0
2017020413,2,3898,2.0,43,39,8,1,4,90.69767442
2017020413,13,1351,0.0,13,12,2,0,1,92.30769231
2017020413,13,2549,0.0,19,16,2,0,3,84.21052632
2017020414,6,1450,0.0,14,10,0,0,4,71.42857143
2017020414,6,1960,0.0,11,10,3,1,1,90.90909091
2017020414,18,3600,0.0,40,37,6,0,3,92.5
2017020415,4,3600,0.0,45,43,5,4,2,95.55555556
2017020415,20,3600,0.0,21,16,2,0,5,76.19047619
2017020416,3,3600,0.0,44,41,5,0,3,93.18181818
2017020416,5,3514,0.0,29,25,2,0,4,86.20689655
2017020417,1,3600,0.0,42,41,7,0,1,97.61904762
2017020417,29,3585,0.0,36,32,2,2,4,88.88888889
2017020418,19,207,0.0,0,0,0,0,0,
2017020418,19,3393,0.0,25,22,3,1,3,88.0
2017020418,8,3541,0.0,30,26,3,1,4,86.66666667
2017020419,52,3600,0.0,32,27,5,3,5,84.375
2017020419,17,3600,2.0,26,25,7,1,1,96.15384615
2017020420,2,3578,0.0,34,28,4,1,6,82.35294118
2017020420,14,3577,0.0,31,29,3,2,2,93.5483871
2017020421,18,3600,0.0,45,43,4,0,2,95.55555556
2017020421,25,1466,0.0,15,12,1,1,3,80.0
2017020421,25,2134,0.0,17,15,2,3,2,88.23529412
2017020422,7,3600,0.0,37,35,10,2,2,94.59459459
2017020422,21,3482,0.0,34,31,9,0,3,91.17647059
2017020423,12,3595,0.0,22,19,0,0,3,86.36363636
2017020423,23,3600,0.0,30,30,2,0,0,100.0
2017020424,24,3900,0.0,43,40,9,0,3,93.02325581
2017020424,54,3891,0.0,29,26,2,4,3,89.65517241
2017020425,30,3561,0.0,27,23,6,0,4,85.18518519
2017020425,26,3600,0.0,21,19,0,2,2,90.47619048
2017020426,20,3900,0.0,29,28,6,0,1,96.55172414
2017020426,10,3900,0.0,48,47,3,2,1,97.91666667
2017020427,16,2654,0.0,14,12,5,1,2,85.71428571
2017020427,16,922,0.0,10,7,0,0,3,70.0
2017020427,15,3600,0.0,39,37,5,1,2,94.87179487
2017020428,4,3598,0.0,26,24,1,2,2,92.30769231
2017020428,22,3546,0.0,32,29,8,0,3,90.625
2017020429,9,3526,0.0,21,19,5,1,2,90.47619048
2017020429,24,3598,0.0,29,29,4,0,0,100.0
2017020430,53,3600,0.0,32,26,2,0,6,81.25
2017020430,6,3596,0.0,21,20,0,1,1,95.23809524
2017020431,2,3667,0.0,32,28,1,0,4,87.5
2017020431,5,3689,0.0,26,23,7,0,3,88.46153846
2017020432,20,3674,0.0,37,35,4,0,2,94.59459459
2017020432,8,3674,0.0,37,34,4,0,3,91.89189189
2017020433,21,3524,2.0,31,27,4,0,4,87.09677419
2017020433,14,3600,0.0,30,28,6,1,2,93.33333333
2017020434,52,3529,0.0,35,30,3,2,5,85.71428571
2017020434,13,3600,0.0,39,35,13,0,4,89.74358974
2017020435,25,3512,0.0,26,24,11,0,2,92.30769231
2017020435,19,3564,0.0,29,29,5,1,0,100.0
2017020436,4,3592,0.0,37,36,10,2,1,97.2972973
2017020436,23,3540,0.0,25,22,6,0,3,88.0
2017020437,9,3540,0.0,38,34,0,1,4,89.47368421
2017020437,26,3632,0.0,40,37,6,2,3,92.5
2017020438,12,3622,0.0,33,28,4,0,5,84.84848485
2017020438,28,3622,0.0,25,21,3,0,4,84.0
2017020439,29,3600,0.0,24,21,2,0,3,87.5
2017020439,1,3547,0.0,28,23,2,5,5,82.14285714
2017020440,3,3548,0.0,40,36,6,1,4,90.0
2017020440,15,3579,0.0,29,27,2,2,2,93.10344828
2017020441,54,3842,0.0,44,41,6,1,3,93.18181818
2017020441,18,3897,0.0,39,36,5,0,3,92.30769231
2017020442,7,3892,0.0,51,48,4,2,3,94.11764706
2017020442,16,3895,0.0,28,26,3,0,2,92.85714286
2017020443,30,3823,0.0,28,26,5,0,2,92.85714286
2017020443,24,3823,0.0,31,28,4,0,3,90.32258065
2017020444,2,3551,0.0,32,30,0,4,2,93.75
2017020444,6,3600,0.0,31,30,3,0,1,96.77419355
2017020445,22,3599,0.0,24,22,2,0,2,91.66666667
2017020445,8,1344,0.0,14,10,2,0,4,71.42857143
2017020445,8,2248,0.0,26,24,4,0,2,92.30769231
2017020446,19,3599,0.0,29,28,3,3,1,96.55172414
2017020446,17,2400,0.0,10,6,0,0,4,60.0
2017020446,17,1200,0.0,12,10,2,0,2,83.33333333
2017020447,52,3634,0.0,28,24,4,0,4,85.71428571
2017020447,14,3636,0.0,20,17,0,1,3,85.0
2017020448,21,3600,0.0,42,39,8,0,3,92.85714286
2017020448,13,3399,0.0,28,23,7,0,5,82.14285714
2017020449,1,3600,0.0,39,34,5,2,5,87.17948718
2017020449,3,3576,0.0,28,26,4,2,2,92.85714286
2017020450,10,3600,0.0,36,33,7,0,3,91.66666667
2017020450,5,1200,0.0,16,13,0,1,3,81.25
2017020450,5,2292,0.0,9,8,1,0,1,88.88888889
2017020451,53,3535,0.0,34,33,3,2,1,97.05882353
2017020451,29,3600,0.0,35,35,7,1,0,100.0
2017020452,54,3600,0.0,39,36,7,1,3,92.30769231
2017020452,25,3511,0.0,38,34,3,3,4,89.47368421
2017020453,23,3573,0.0,34,31,1,1,3,91.17647059
2017020453,20,3591,2.0,24,22,0,5,2,91.66666667
2017020454,9,3585,0.0,50,45,20,1,5,90.0
2017020454,28,3597,0.0,25,25,8,5,0,100.0
2017020455,12,3836,0.0,21,18,0,1,3,85.71428571
2017020455,26,3880,0.0,34,32,1,0,2,94.11764706
2017020456,22,3555,0.0,23,22,1,1,1,95.65217391
2017020456,10,3598,0.0,41,41,11,1,0,100.0
2017020457,53,3497,0.0,37,34,1,0,3,91.89189189
2017020457,16,3600,0.0,32,31,1,0,1,96.875
2017020458,7,3846,0.0,45,42,6,1,3,93.33333333
2017020458,19,3864,0.0,24,22,5,1,2,91.66666667
2017020459,30,3806,0.0,34,31,8,1,3,91.17647059
2017020459,28,3806,0.0,24,20,1,1,4,83.33333333
2017020460,15,2113,0.0,17,17,5,0,0,100.0
2017020460,15,1294,0.0,12,9,0,0,3,75.0
2017020460,2,3600,0.0,32,31,3,2,1,96.875
2017020461,25,3900,0.0,25,24,0,2,1,96.0
2017020461,3,3900,2.0,45,44,4,0,1,97.77777778
2017020462,21,3600,0.0,40,39,2,1,1,97.5
2017020462,5,3522,0.0,27,26,7,1,1,96.2962963
2017020463,13,3722,0.0,35,34,9,1,1,97.14285714
2017020463,17,3722,0.0,29,27,6,0,2,93.10344828
2017020464,23,3600,0.0,24,19,4,0,5,79.16666667
2017020464,52,3595,0.0,26,25,3,0,1,96.15384615
2017020465,12,3511,0.0,23,20,2,0,3,86.95652174
2017020465,24,3600,0.0,30,28,7,0,2,93.33333333
2017020466,9,3479,0.0,25,22,0,2,3,88.0
2017020466,7,3584,0.0,26,24,3,0,2,92.30769231
2017020467,26,3587,0.0,26,21,0,1,5,80.76923077
2017020467,1,3600,0.0,17,16,1,1,1,94.11764706
2017020468,10,3514,0.0,38,35,1,0,3,92.10526316
2017020468,4,3600,0.0,22,20,0,0,2,90.90909091
2017020469,21,3588,0.0,26,22,0,2,4,84.61538462
2017020469,15,3577,0.0,24,22,0,1,2,91.66666667
2017020470,22,3579,0.0,29,27,0,3,2,93.10344828
2017020470,29,1200,0.0,12,10,3,0,2,83.33333333
2017020470,29,2400,0.0,26,21,4,0,5,80.76923077
2017020471,14,3600,0.0,32,32,0,0,0,100.0
2017020471,19,3491,0.0,24,22,4,0,2,91.66666667
2017020472,20,3900,0.0,22,21,3,0,1,95.45454545
2017020472,30,2700,0.0,17,16,1,1,1,94.11764706
2017020472,30,1200,0.0,10,10,1,0,0,100.0
2017020473,13,3741,2.0,28,25,4,0,3,89.28571429
2017020473,16,3742,0.0,37,35,4,2,2,94.59459459
2017020474,12,3900,0.0,24,22,3,1,2,91.66666667
2017020474,54,3900,0.0,37,35,6,0,2,94.59459459
2017020475,3,3523,0.0,30,27,2,0,3,90.0
2017020475,9,3600,0.0,29,27,0,1,2,93.10344828
2017020476,25,3583,2.0,34,32,2,0,2,94.11764706
2017020476,2,1839,0.0,7,6,0,0,1,85.71428571
2017020476,2,1761,0.0,20,16,3,0,4,80.0
2017020477,6,3569,0.0,33,31,5,1,2,93.93939394
2017020477,17,3610,0.0,32,29,4,0,3,90.625
2017020478,18,3600,0.0,26,25,2,0,1,96.15384615
2017020478,23,3600,0.0,48,41,0,2,7,85.41666667
2017020479,15,3582,0.0,37,34,6,0,3,91.89189189
2017020479,6,3533,0.0,21,17,3,1,4,80.95238095
2017020480,7,3478,0.0,27,25,6,0,2,92.59259259
2017020480,4,3600,0.0,20,19,1,1,1,95.0
2017020481,2,3513,0.0,34,29,4,0,5,85.29411765
2017020481,29,3594,0.0,25,21,3,0,4,84.0
2017020482,1,3690,0.0,36,34,0,0,2,94.44444444
2017020482,8,3709,0.0,32,31,5,3,1,96.875
2017020483,24,3600,0.0,30,29,6,0,1,96.66666667
2017020483,19,3492,0.0,18,15,0,2,3,83.33333333
2017020484,10,3364,0.0,26,24,3,0,2,92.30769231
2017020484,30,3595,0.0,28,28,5,0,0,100.0
2017020485,16,3600,0.0,28,27,1,1,1,96.42857143
2017020485,52,3600,0.0,30,25,5,0,5,83.33333333
2017020486,13,3508,0.0,30,28,8,0,2,93.33333333
2017020486,21,3597,0.0,33,32,0,0,1,96.96969697
2017020487,28,3592,0.0,34,32,3,0,2,94.11764706
2017020487,20,3515,2.0,29,26,2,3,3,89.65517241
2017020488,18,3600,0.0,46,46,12,2,0,100.0
2017020488,22,3578,0.0,23,19,0,1,4,82.60869565
2017020489,14,3600,0.0,33,32,4,0,1,96.96969697
2017020489,53,3593,0.0,48,44,5,3,4,91.66666667
2017020490,5,3491,0.0,26,24,3,3,2,92.30769231
2017020490,54,3600,0.0,25,24,4,0,1,96.0
2017020491,12,3733,0.0,41,37,3,0,4,90.24390244
2017020491,7,3735,0.0,34,29,3,0,5,85.29411765
2017020492,25,3490,0.0,25,21,10,0,4,84.0
2017020492,1,3600,0.0,30,28,7,0,2,93.33333333
2017020493,26,3537,0.0,27,24,8,0,3,88.88888889
2017020493,3,3600,0.0,35,33,2,1,2,94.28571429
2017020494,10,3473,0.0,29,26,4,0,3,89.65517241
2017020494,17,3600,0.0,26,25,1,0,1,96.15384615
2017020495,28,3874,0.0,40,36,3,1,4,90.0
2017020495,23,3874,0.0,37,34,6,2,3,91.89189189
2017020496,22,3600,0.0,31,29,5,1,2,93.5483871
2017020496,30,3531,0.0,29,26,9,1,3,89.65517241
2017020497,3,3716,0.0,35,33,5,2,2,94.28571429
2017020497,6,3704,0.0,28,25,3,2,3,89.28571429
2017020498,8,3448,0.0,37,35,9,2,2,94.59459459
2017020498,9,3600,0.0,28,28,4,1,0,100.0
2017020499,26,3642,0.0,33,29,7,2,4,87.87878788
2017020499,2,3711,0.0,29,26,4,2,3,89.65517241
2017020500,25,3830,0.0,30,28,10,0,2,93.33333333
2017020500,4,3830,0.0,28,27,2,2,1,96.42857143
2017020501,52,3531,0.0,30,28,7,3,2,93.33333333
2017020501,19,3600,0.0,48,48,10,3,0,100.0
2017020502,24,3718,0.0,27,24,0,0,3,88.88888889
2017020502,15,3718,0.0,30,28,0,0,2,93.33333333
2017020503,29,3500,0.0,24,22,2,0,2,91.66666667
2017020503,12,3578,0.0,36,35,5,1,1,97.22222222
2017020504,5,3600,0.0,17,15,0,0,2,88.23529412
2017020504,53,3586,0.0,32,29,4,0,3,90.625
2017020505,14,3600,0.0,37,32,4,0,5,86.48648649
2017020505,21,3437,0.0,31,25,2,0,6,80.64516129
2017020506,18,3591,0.0,32,32,9,0,0,100.0
2017020506,20,3431,0.0,28,26,4,0,2,92.85714286
2017020507,19,3600,0.0,46,42,4,2,4,91.30434783
2017020507,52,3596,0.0,24,24,6,0,0,100.0
2017020508,30,3546,0.0,45,42,14,1,3,93.33333333
2017020508,16,3571,0.0,28,27,2,2,1,96.42857143
2017020509,20,3600,2.0,17,16,2,2,1,94.11764706
2017020509,23,1200,0.0,19,18,10,0,1,94.73684211
2017020509,23,2400,0.0,19,14,3,1,5,73.68421053
2017020510,13,3563,0.0,38,35,5,2,3,92.10526316
2017020510,54,3600,0.0,18,16,1,0,2,88.88888889
2017020511,29,3600,0.0,45,38,1,1,7,84.44444444
2017020511,6,3600,0.0,18,16,2,0,2,88.88888889
2017020512,24,3489,0.0,33,29,2,1,4,87.87878788
2017020512,1,3600,0.0,24,21,1,1,3,87.5
2017020513,26,3600,0.0,37,36,12,1,1,97.2972973
2017020513,4,3600,0.0,25,21,0,3,4,84.0
2017020514,5,3504,0.0,36,33,4,1,3,91.66666667
2017020514,21,3600,0.0,32,30,2,0,2,93.75
2017020515,28,3530,0.0,28,24,2,1,4,85.71428571
2017020515,22,3600,0.0,21,18,2,1,3,85.71428571
2017020516,12,3593,0.0,36,28,5,0,8,77.77777778
2017020516,10,3600,0.0,33,32,4,0,1,96.96969697
2017020517,6,3598,0.0,36,36,3,2,0,100.0
2017020517,7,3506,0.0,31,30,4,0,1,96.77419355
2017020518,17,3600,0.0,37,34,4,0,3,91.89189189
2017020518,2,3548,0.0,21,16,1,1,5,76.19047619
2017020519,24,3600,0.0,32,28,2,0,4,87.5
2017020519,3,3600,0.0,40,39,1,0,1,97.5
2017020520,30,3600,0.0,32,28,2,4,4,87.5
2017020520,9,3465,0.0,40,34,8,1,6,85.0
2017020521,52,3600,0.0,34,30,3,1,4,88.23529412
2017020521,18,3525,0.0,35,30,5,1,5,85.71428571
2017020522,15,3711,0.0,36,33,8,0,3,91.66666667
2017020522,25,3711,0.0,28,24,6,2,4,85.71428571
2017020523,13,3600,0.0,41,39,13,0,2,95.12195122
2017020523,53,3498,0.0,26,23,0,1,3,88.46153846
2017020524,8,3600,0.0,39,34,5,0,5,87.17948718
2017020524,23,3489,0.0,31,25,2,1,6,80.64516129
2017020525,14,3600,0.0,36,32,3,0,4,88.88888889
2017020525,54,3600,0.0,38,35,7,0,3,92.10526316
2017020526,10,3440,0.0,37,33,8,0,4,89.18918919
2017020526,29,3600,0.0,41,39,3,0,2,95.12195122
2017020527,17,3474,0.0,31,27,0,0,4,87.09677419
2017020527,4,3600,0.0,28,25,3,0,3,89.28571429
2017020528,19,3553,0.0,33,31,10,4,2,93.93939394
2017020528,20,3593,0.0,22,21,4,0,1,95.45454545
2017020529,52,3896,0.0,33,32,7,1,1,96.96969697
2017020529,6,3900,0.0,38,37,7,0,1,97.36842105
2017020530,3,3900,0.0,48,45,5,1,3,93.75
2017020530,1,3900,0.0,28,25,0,1,3,89.28571429
2017020531,24,3821,0.0,26,22,3,0,4,84.61538462
2017020531,2,3843,2.0,40,35,3,1,5,87.5
2017020532,29,3900,0.0,41,39,8,1,2,95.12195122
2017020532,5,3900,0.0,32,30,2,2,2,93.75
2017020533,9,3900,0.0,38,35,8,0,3,92.10526316
2017020533,14,3876,0.0,21,18,2,0,3,85.71428571
2017020534,12,3600,0.0,29,28,5,0,1,96.55172414
2017020534,18,389,0.0,6,2,1,0,4,33.33333333
2017020534,18,3211,0.0,26,26,8,1,0,100.0
2017020535,16,3600,0.0,22,18,1,1,4,81.81818182
2017020535,25,3564,0.0,24,24,0,2,0,100.0
2017020536,19,3600,0.0,35,32,4,0,3,91.42857143
2017020536,22,3600,0.0,36,34,3,2,2,94.44444444
2017020537,21,3644,0.0,27,25,4,1,2,92.59259259
2017020537,26,3644,0.0,32,31,6,0,1,96.875
2017020538,23,3708,0.0,32,27,1,1,5,84.375
2017020538,28,3707,0.0,40,36,7,2,4,90.0
2017020539,4,3448,0.0,35,33,3,1,2,94.28571429
2017020539,7,3600,0.0,35,33,6,2,2,94.28571429
2017020540,30,3439,0.0,33,30,5,3,3,90.90909091
2017020540,13,3600,0.0,31,29,5,3,2,93.5483871
2017020541,8,3600,0.0,23,21,2,0,2,91.30434783
2017020541,20,3449,0.0,35,32,2,0,3,91.42857143
2017020542,15,3873,0.0,27,24,1,2,3,88.88888889
2017020542,53,3856,0.0,17,15,1,0,2,88.23529412
2017020543,17,3547,0.0,25,23,0,1,2,92.0
2017020543,6,3600,0.0,31,30,1,0,1,96.77419355
2017020544,52,3600,0.0,29,24,3,1,5,82.75862069
2017020544,2,3590,0.0,40,38,3,0,2,95.0
2017020545,30,3567,0.0,30,28,6,1,2,93.33333333
2017020545,14,3517,0.0,22,22,10,0,0,100.0
2017020546,9,3511,0.0,38,37,8,2,1,97.36842105
2017020546,13,3599,0.0,38,38,1,2,0,100.0
2017020547,16,802,0.0,7,4,0,0,3,57.14285714
2017020547,16,2798,0.0,22,21,0,1,1,95.45454545
2017020547,1,3600,0.0,40,39,3,0,1,97.5
2017020548,10,3600,0.0,32,30,3,3,2,93.75
2017020548,3,3530,0.0,37,34,8,0,3,91.89189189
2017020549,24,3600,0.0,29,29,4,1,0,100.0
2017020549,5,1422,0.0,13,10,0,0,3,76.92307692
2017020549,5,2178,0.0,10,9,0,1,1,90.0
2017020550,7,3525,0.0,38,34,8,0,4,89.47368421
2017020550,12,3598,0.0,22,20,3,0,2,90.90909091
2017020551,4,3900,0.0,36,35,1,3,1,97.22222222
2017020551,29,3900,0.0,31,30,1,1,1,96.77419355
2017020552,8,3563,0.0,34,31,5,1,3,91.17647059
2017020552,22,3600,0.0,30,29,4,0,1,96.66666667
2017020553,18,3900,0.0,28,25,5,0,3,89.28571429
2017020553,25,3896,0.0,32,29,6,2,3,90.625
2017020554,21,3600,0.0,34,32,7,1,2,94.11764706
2017020554,53,1594,0.0,9,6,0,0,3,66.66666667
2017020554,53,2006,0.0,19,16,0,0,3,84.21052632
2017020555,15,3594,0.0,28,25,3,0,3,89.28571429
2017020555,54,3600,0.0,26,26,2,0,0,100.0
2017020556,19,3600,0.0,31,30,2,2,1,96.77419355
2017020556,23,3522,0.0,33,31,5,0,2,93.93939394
2017020557,26,3479,0.0,31,29,7,0,2,93.5483871
2017020557,28,3564,0.0,28,28,7,0,0,100.0
2017020558,9,3600,0.0,23,18,1,0,5,78.26086957
2017020558,6,3600,0.0,26,25,1,2,1,96.15384615
2017020559,17,3540,0.0,31,29,4,2,2,93.5483871
2017020559,1,3600,0.0,32,31,11,1,1,96.875
2017020560,7,3657,0.0,34,31,6,3,3,91.17647059
2017020560,2,3657,0.0,37,35,10,0,2,94.59459459
2017020561,15,3900,0.0,37,37,2,1,0,100.0
2017020561,3,3900,0.0,30,30,3,1,0,100.0
2017020562,29,3900,0.0,37,33,4,0,4,89.18918919
2017020562,5,3900,0.0,33,29,4,3,4,87.87878788
2017020563,8,3584,0.0,35,33,6,0,2,94.28571429
2017020563,12,3598,0.0,24,23,3,1,1,95.83333333
2017020564,18,3584,0.0,30,29,1,2,1,96.66666667
2017020564,19,3487,0.0,26,24,6,0,2,92.30769231
2017020565,25,3535,2.0,30,27,4,2,3,90.0
2017020565,30,3597,0.0,26,24,3,0,2,92.30769231
2017020566,22,3457,0.0,39,35,7,0,4,89.74358974
2017020566,52,3584,0.0,25,22,1,1,3,88.0
2017020567,53,3592,0.0,26,25,4,0,1,96.15384615
2017020567,21,3475,0.0,27,24,5,0,3,88.88888889
2017020568,54,3600,0.0,28,27,4,1,1,96.42857143
2017020568,24,3462,0.0,27,24,6,0,3,88.88888889
2017020569,6,3900,0.0,34,31,8,2,3,91.17647059
2017020569,15,3900,0.0,34,31,12,0,3,91.17647059
2017020570,8,3446,0.0,34,31,9,0,3,91.17647059
2017020570,14,3600,0.0,32,31,6,2,1,96.875
2017020571,4,3459,2.0,27,24,7,0,3,88.88888889
2017020571,13,3600,0.0,31,29,6,0,2,93.5483871
2017020572,10,3600,0.0,34,30,3,0,4,88.23529412
2017020572,53,3585,0.0,32,26,1,1,6,81.25
2017020573,16,3600,0.0,31,26,4,4,5,83.87096774
2017020573,23,3572,0.0,32,30,6,0,2,93.75
2017020574,54,3810,0.0,28,26,5,1,2,92.85714286
2017020574,26,3810,2.0,39,36,6,0,3,92.30769231
2017020575,20,3884,0.0,32,30,4,0,2,93.75
2017020575,28,3900,0.0,34,32,2,1,2,94.11764706
2017020576,7,3752,0.0,38,35,0,0,3,92.10526316
2017020576,1,3757,0.0,29,25,4,0,4,86.20689655
2017020577,29,3500,0.0,28,23,0,2,5,82.14285714
2017020577,9,3588,0.0,25,21,2,1,4,84.0
2017020578,3,3896,0.0,35,33,5,2,2,94.28571429
2017020578,17,3900,2.0,39,37,8,2,2,94.87179487
2017020579,4,3600,0.0,27,24,1,0,3,88.88888889
2017020579,14,489,0.0,4,4,2,0,0,100.0
2017020579,14,3026,0.0,33,29,9,0,4,87.87878788
2017020580,5,3517,0.0,33,31,5,0,2,93.93939394
2017020580,12,3600,0.0,28,27,4,0,1,96.42857143
2017020581,18,3490,0.0,37,34,7,0,3,91.89189189
2017020581,30,3581,2.0,43,41,9,2,2,95.34883721
2017020582,2,3519,0.0,37,33,3,1,4,89.18918919
2017020582,52,3600,0.0,44,42,8,0,2,95.45454545
2017020583,19,574,0.0,2,2,1,0,0,100.0
2017020583,19,2901,0.0,28,25,4,0,3,89.28571429
2017020583,25,3600,0.0,37,35,6,2,2,94.59459459
2017020584,10,3755,0.0,28,24,6,0,4,85.71428571
2017020584,21,3805,0.0,34,31,7,0,3,91.17647059
2017020585,16,3650,0.0,45,42,4,0,3,93.33333333
2017020585,22,3640,0.0,36,32,5,0,4,88.88888889
2017020586,20,3458,0.0,41,39,8,0,2,95.12195122
2017020586,24,3590,0.0,23,22,4,1,1,95.65217391
2017020587,6,3592,0.0,25,25,3,1,0,100.0
2017020587,9,3600,0.0,34,29,10,0,5,85.29411765
2017020588,8,3456,0.0,33,31,3,0,2,93.93939394
2017020588,13,3590,0.0,38,38,0,2,0,100.0
2017020589,1,3552,0.0,34,30,3,0,4,88.23529412
2017020589,15,3600,0.0,27,25,2,0,2,92.59259259
2017020590,12,3490,0.0,29,26,4,0,3,89.65517241
2017020590,19,3600,0.0,25,23,4,0,2,92.0
2017020591,30,3542,0.0,28,26,6,0,2,92.85714286
2017020591,18,3600,0.0,29,29,5,1,0,100.0
2017020592,26,3600,0.0,25,22,2,0,3,88.0
2017020592,23,3521,0.0,36,32,3,0,4,88.88888889
2017020593,10,3547,0.0,30,25,2,2,5,83.33333333
2017020593,54,3594,0.0,23,20,4,0,3,86.95652174
2017020594,14,3600,0.0,21,21,4,1,0,100.0
2017020594,29,3600,0.0,35,30,4,1,5,85.71428571
2017020595,5,3600,0.0,23,19,2,0,4,82.60869565
2017020595,17,3600,0.0,38,37,2,0,1,97.36842105
2017020596,28,2400,0.0,22,18,3,0,4,81.81818182
2017020596,28,1200,0.0,10,8,0,0,2,80.0
2017020596,25,3597,0.0,26,26,6,1,0,100.0
2017020597,2,1200,0.0,13,12,0,2,1,92.30769231
2017020597,2,2398,0.0,35,30,3,1,5,85.71428571
2017020597,21,3600,0.0,28,27,5,1,1,96.42857143
2017020598,53,3531,0.0,25,21,2,0,4,84.0
2017020598,24,3600,0.0,25,23,3,0,2,92.0
2017020599,16,3625,0.0,39,35,1,0,4,89.74358974
2017020599,20,3652,0.0,37,34,3,0,3,91.89189189
2017020600,52,3600,0.0,35,35,1,1,0,100.0
2017020600,22,3595,0.0,38,33,4,3,5,86.84210526
2017020601,3,3763,0.0,33,31,11,2,2,93.93939394
2017020601,7,3763,0.0,42,39,7,1,3,92.85714286
2017020602,14,3600,0.0,29,29,4,2,0,100.0
2017020602,10,3430,0.0,36,34,2,3,2,94.44444444
2017020603,6,3600,0.0,26,25,6,0,1,96.15384615
2017020603,2,3550,0.0,37,33,4,0,4,89.18918919
2017020604,5,1526,0.0,11,11,4,0,0,100.0
2017020604,5,2074,0.0,17,16,1,0,1,94.11764706
2017020604,4,1200,0.0,11,10,3,0,1,90.90909091
2017020604,4,2400,0.0,14,10,0,1,4,71.42857143
2017020605,15,3717,0.0,38,34,14,0,4,89.47368421
2017020605,12,3707,0.0,26,21,4,0,5,80.76923077
2017020606,28,3600,0.0,31,30,4,1,1,96.77419355
2017020606,8,3600,0.0,33,29,4,2,4,87.87878788
2017020607,1,3900,0.0,29,27,8,0,2,93.10344828
2017020607,19,3900,0.0,26,24,2,3,2,92.30769231
2017020608,13,2194,0.0,26,23,2,0,3,88.46153846
2017020608,13,1387,0.0,14,13,0,0,1,92.85714286
2017020608,30,3600,0.0,26,25,4,0,1,96.15384615
2017020609,29,3593,0.0,22,21,0,1,1,95.45454545
2017020609,25,3506,0.0,26,24,1,0,2,92.30769231
2017020610,52,3853,0.0,26,23,3,0,3,88.46153846
2017020610,21,2055,0.0,21,21,3,0,0,100.0
2017020610,21,1835,0.0,23,21,4,0,2,91.30434783
2017020611,26,3600,0.0,32,32,3,3,0,100.0
2017020611,22,3600,0.0,33,28,8,0,5,84.84848485
2017020612,24,3600,0.0,31,31,8,1,0,100.0
2017020612,23,2420,0.0,19,15,2,1,4,78.94736842
2017020612,23,1173,0.0,8,7,0,0,1,87.5
2017020613,18,3484,0.0,30,28,1,0,2,93.33333333
2017020613,54,3592,0.0,29,29,4,0,0,100.0
2017020614,9,3515,0.0,35,33,0,1,2,94.28571429
2017020614,17,3606,0.0,34,33,1,1,1,97.05882353
2017020615,16,3600,2.0,25,23,8,0,2,92.0
2017020615,3,3513,0.0,33,30,1,3,3,90.90909091
2017020616,13,487,0.0,8,8,0,0,0,100.0
2017020616,13,3113,0.0,35,33,10,0,2,94.28571429
2017020616,6,3490,0.0,26,22,8,0,4,84.61538462
2017020617,28,3900,0.0,28,26,8,1,2,92.85714286
2017020617,10,3900,0.0,35,33,6,0,2,94.28571429
2017020618,2,3521,0.0,31,26,3,0,5,83.87096774
2017020618,4,3536,0.0,31,27,0,2,4,87.09677419
2017020619,12,3600,0.0,21,21,0,0,0,100.0
2017020619,5,3600,0.0,33,29,1,1,4,87.87878788
2017020620,14,3900,0.0,38,37,1,1,1,97.36842105
2017020620,8,3898,0.0,45,44,0,1,1,97.77777778
2017020621,54,3481,0.0,39,37,6,0,2,94.87179487
2017020621,19,3600,0.0,33,32,2,0,1,96.96969697
2017020622,7,1200,0.0,10,10,0,2,0,100.0
2017020622,7,2400,0.0,17,11,3,0,6,64.70588235
2017020622,30,3600,0.0,31,29,3,1,2,93.5483871
2017020623,1,3509,0.0,33,29,5,5,4,87.87878788
2017020623,25,3600,0.0,42,39,8,0,3,92.85714286
2017020624,29,3571,0.0,32,30,8,0,2,93.75
2017020624,21,3589,0.0,34,34,6,0,0,100.0
2017020625,26,3473,0.0,41,37,4,0,4,90.24390244
2017020625,20,3594,0.0,31,28,2,0,3,90.32258065
2017020626,24,3900,0.0,34,33,8,0,1,97.05882353
2017020626,22,3869,0.0,34,33,2,1,1,97.05882353
2017020627,18,3739,0.0,25,22,1,0,3,88.0
2017020627,53,3739,0.0,39,37,2,0,2,94.87179487
2017020628,5,3600,0.0,31,31,7,1,0,100.0
2017020628,2,3600,0.0,38,34,2,0,4,89.47368421
2017020629,28,3604,0.0,43,37,3,1,6,86.04651163
2017020629,9,3607,0.0,35,30,4,1,5,85.71428571
2017020630,13,3471,0.0,19,15,2,0,4,78.94736842
2017020630,17,3598,0.0,40,38,5,1,2,95.0
2017020631,7,3476,0.0,29,25,3,1,4,86.20689655
2017020631,52,3571,0.0,29,26,6,0,3,89.65517241
2017020632,54,3597,0.0,32,28,4,3,4,87.5
2017020632,16,3488,0.0,43,38,4,1,5,88.37209302
2017020633,19,3411,0.0,38,33,6,0,5,86.84210526
2017020633,4,3600,0.0,31,28,0,3,3,90.32258065
2017020634,22,2115,0.0,14,13,4,0,1,92.85714286
2017020634,22,1485,0.0,19,15,0,1,4,78.94736842
2017020634,25,3600,0.0,38,37,6,0,1,97.36842105
2017020635,30,763,0.0,6,5,0,0,1,83.33333333
2017020635,30,2837,4.0,32,26,3,0,6,81.25
2017020635,21,3600,0.0,36,34,5,0,2,94.44444444
2017020636,12,343,0.0,2,0,0,0,2,0.0
2017020636,12,3257,0.0,28,23,1,1,5,82.14285714
2017020636,6,3597,0.0,28,27,6,0,1,96.42857143
2017020637,23,3900,0.0,36,34,6,0,2,94.44444444
2017020637,10,3896,2.0,36,34,2,0,2,94.44444444
2017020638,14,3469,0.0,33,27,1,0,6,81.81818182
2017020638,9,3600,0.0,48,45,5,2,3,93.75
2017020639,3,3900,0.0,39,38,3,0,1,97.43589744
2017020639,53,3900,0.0,25,24,0,0,1,96.0
2017020640,24,3578,0.0,31,28,5,0,3,90.32258065
2017020640,20,3595,0.0,29,27,6,2,2,93.10344828
2017020641,18,3600,0.0,29,26,5,2,3,89.65517241
2017020641,26,3544,0.0,20,16,4,1,4,80.0
2017020642,1,3878,0.0,38,34,3,0,4,89.47368421
2017020642,2,3900,0.0,46,42,11,2,4,91.30434783
2017020643,7,3520,0.0,27,25,3,0,2,92.59259259
2017020643,4,3600,0.0,31,30,6,0,1,96.77419355
2017020644,19,3857,0.0,33,29,4,0,4,87.87878788
2017020644,15,3829,0.0,34,31,1,0,3,91.17647059
2017020645,22,3600,0.0,29,25,5,0,4,86.20689655
2017020645,16,3594,0.0,33,32,1,2,1,96.96969697
2017020646,28,3564,0.0,29,26,4,0,3,89.65517241
2017020646,52,3600,0.0,32,31,7,2,1,96.875
2017020647,13,3861,0.0,48,46,8,2,2,95.83333333
2017020647,29,3869,0.0,44,42,12,0,2,95.45454545
2017020648,23,3576,0.0,44,40,4,2,4,90.90909091
2017020648,8,3600,0.0,36,34,5,0,2,94.44444444
2017020649,14,3600,0.0,36,34,8,0,2,94.44444444
2017020649,17,3600,0.0,24,19,0,0,5,79.16666667
2017020650,6,3771,0.0,35,29,6,0,6,82.85714286
2017020650,5,1535,0.0,6,6,0,0,0,100.0
2017020650,5,2228,0.0,19,14,3,0,5,73.68421053
2017020651,3,3481,0.0,34,32,1,0,2,94.11764706
2017020651,54,3591,0.0,29,28,2,0,1,96.55172414
2017020652,29,3791,0.0,37,35,3,0,2,94.59459459
2017020652,10,3791,0.0,33,30,4,0,3,90.90909091
2017020653,52,3600,0.0,34,30,5,0,4,88.23529412
2017020653,7,2242,0.0,19,16,2,0,3,84.21052632
2017020653,7,1267,0.0,17,14,1,0,3,82.35294118
2017020654,23,3428,0.0,36,33,1,2,3,91.66666667
2017020654,15,3600,0.0,38,37,4,0,1,97.36842105
2017020655,16,3588,0.0,27,25,9,2,2,92.59259259
2017020655,9,1793,0.0,26,22,3,0,4,84.61538462
2017020655,9,1807,0.0,17,13,1,2,4,76.47058824
2017020656,12,3448,0.0,34,29,0,0,5,85.29411765
2017020656,14,3600,0.0,32,28,3,0,4,87.5
2017020657,13,3600,0.0,30,26,2,2,4,86.66666667
2017020657,19,1368,0.0,12,11,0,2,1,91.66666667
2017020657,19,2197,0.0,23,18,3,0,5,78.26086957
2017020658,22,3484,0.0,24,22,2,1,2,91.66666667
2017020658,18,3549,0.0,26,25,0,0,1,96.15384615
2017020659,20,3731,0.0,35,33,6,4,2,94.28571429
2017020659,30,3749,0.0,29,26,5,1,3,89.65517241
2017020660,9,3600,0.0,48,45,6,0,3,93.75
2017020660,10,3460,0.0,32,28,1,2,4,87.5
2017020661,30,3600,0.0,35,34,3,1,1,97.14285714
2017020661,16,3564,0.0,27,25,4,4,2,92.59259259
2017020662,29,3512,0.0,28,26,0,0,2,92.85714286
2017020662,7,3600,0.0,45,44,2,0,1,97.77777778
2017020663,12,3588,0.0,28,27,4,1,1,96.42857143
2017020663,15,3451,0.0,32,30,4,1,2,93.75
2017020664,20,3600,0.0,34,33,5,0,1,97.05882353
2017020664,14,3594,0.0,24,19,3,2,5,79.16666667
2017020665,23,3582,0.0,29,27,3,1,2,93.10344828
2017020665,29,3471,0.0,28,24,6,0,4,85.71428571
2017020666,20,3598,2.0,43,41,6,1,2,95.34883721
2017020666,13,3528,0.0,28,25,2,0,3,89.28571429
2017020667,15,3600,0.0,39,36,8,0,3,92.30769231
2017020667,12,3587,0.0,27,23,5,0,4,85.18518519
2017020668,52,3499,0.0,27,25,3,1,2,92.59259259
2017020668,16,3551,0.0,32,31,3,1,1,96.875
2017020669,22,3393,0.0,19,19,0,0,0,100.0
2017020669,22,197,0.0,3,1,0,0,2,33.33333333
2017020669,53,3526,0.0,26,23,4,0,3,88.46153846
2017020670,2,3600,0.0,39,37,7,1,2,94.87179487
2017020670,3,1611,0.0,19,14,5,0,5,73.68421053
2017020670,3,1987,0.0,18,16,0,0,2,88.88888889
2017020671,17,3595,0.0,36,32,2,4,4,88.88888889
2017020671,5,3600,0.0,30,29,6,1,1,96.66666667
2017020672,6,3883,0.0,30,27,1,0,3,90.0
2017020672,8,3900,0.0,32,29,0,0,3,90.625
2017020673,4,3600,0.0,29,26,5,0,3,89.65517241
2017020673,1,3600,0.0,25,20,2,1,5,80.0
2017020674,52,3600,0.0,41,37,7,0,4,90.24390244
2017020674,30,3600,0.0,33,32,4,1,1,96.96969697
2017020675,21,3600,0.0,28,27,11,0,1,96.42857143
2017020675,25,3530,0.0,22,19,1,1,3,86.36363636
2017020676,22,3653,0.0,36,34,9,1,2,94.44444444
2017020676,54,3653,0.0,30,27,3,5,3,90.0
2017020677,24,3600,0.0,25,23,3,1,2,92.0
2017020677,26,3555,0.0,21,18,2,0,3,85.71428571
2017020678,53,3762,0.0,44,38,0,0,6,86.36363636
2017020678,28,828,0.0,6,3,0,0,3,50.0
2017020678,28,2800,0.0,15,13,1,0,2,86.66666667
2017020679,3,3597,0.0,46,42,9,0,4,91.30434783
2017020679,5,3595,0.0,28,26,2,2,2,92.85714286
2017020680,20,3586,0.0,39,38,9,0,1,97.43589744
2017020680,12,3586,0.0,30,26,1,2,4,86.66666667
2017020681,17,3600,0.0,27,27,3,1,0,100.0
2017020681,16,3590,0.0,26,22,5,0,4,84.61538462
2017020682,23,3770,0.0,23,21,0,0,2,91.30434783
2017020682,30,3741,0.0,25,22,3,0,3,88.0
2017020683,25,3721,0.0,32,30,6,0,2,93.75
2017020683,6,3774,0.0,32,29,5,3,3,90.625
2017020684,24,3429,0.0,29,26,9,0,3,89.65517241
2017020684,21,3600,0.0,34,33,2,1,1,97.05882353
2017020685,28,3598,0.0,36,35,3,1,1,97.22222222
2017020685,26,3431,0.0,32,29,2,0,3,90.625
2017020686,2,3711,0.0,56,52,8,1,4,92.85714286
2017020686,8,3675,0.0,24,19,1,1,5,79.16666667
2017020687,19,3669,0.0,31,30,1,0,1,96.77419355
2017020687,10,3703,0.0,42,40,0,1,2,95.23809524
2017020688,1,3600,0.0,26,25,1,2,1,96.15384615
2017020688,2,3585,0.0,42,38,4,1,4,90.47619048
2017020689,4,1200,0.0,8,8,0,0,0,100.0
2017020689,4,2400,0.0,21,16,3,1,5,76.19047619
2017020689,3,3600,0.0,26,25,3,1,1,96.15384615
2017020690,25,3600,0.0,15,13,0,0,2,86.66666667
2017020690,17,3309,0.0,26,22,5,0,4,84.61538462
2017020691,54,3478,0.0,27,26,8,0,1,96.2962963
2017020691,18,3584,0.0,43,43,15,0,0,100.0
2017020692,28,3900,0.0,32,30,2,0,2,93.75
2017020692,53,3900,0.0,22,20,3,0,2,90.90909091
2017020693,8,3581,0.0,31,28,3,1,3,90.32258065
2017020693,6,3600,0.0,22,21,4,0,1,95.45454545
2017020694,5,3480,0.0,32,28,7,3,4,87.5
2017020694,24,3600,0.0,33,30,2,0,3,90.90909091
2017020695,15,3634,0.0,32,28,3,1,4,87.5
2017020695,1,3627,0.0,19,16,5,1,3,84.21052632
2017020696,6,3599,0.0,24,22,3,0,2,91.66666667
2017020696,2,3531,0.0,33,29,0,2,4,87.87878788
2017020697,7,3483,0.0,34,30,2,1,4,88.23529412
2017020697,3,3600,0.0,37,34,4,0,3,91.89189189
2017020698,10,3610,0.0,37,34,4,2,3,91.89189189
2017020698,4,3618,0.0,31,29,2,2,2,93.5483871
2017020699,25,3871,0.0,26,25,2,1,1,96.15384615
2017020699,29,3900,0.0,36,35,5,2,1,97.22222222
2017020700,19,3599,0.0,21,20,3,0,1,95.23809524
2017020700,9,3561,0.0,36,33,2,2,3,91.66666667
2017020701,54,3600,0.0,29,28,4,1,1,96.55172414
2017020701,14,3600,0.0,30,26,1,0,4,86.66666667
2017020702,53,3900,0.0,39,37,5,1,2,94.87179487
2017020702,18,3900,0.0,29,27,0,0,2,93.10344828
2017020703,28,3375,0.0,22,17,4,1,5,77.27272727
2017020703,21,3600,0.0,48,45,25,0,3,93.75
2017020704,5,3600,0.0,29,28,3,4,1,96.55172414
2017020704,26,3574,0.0,31,28,6,1,3,90.32258065
2017020705,54,3637,0.0,26,22,0,2,4,84.61538462
2017020705,13,3640,0.0,36,33,5,0,3,91.66666667
2017020706,8,3597,0.0,26,24,5,2,2,92.30769231
2017020706,15,3453,0.0,25,23,6,1,2,92.0
2017020707,26,3480,0.0,31,29,6,2,2,93.5483871
2017020707,24,3544,0.0,24,23,0,0,1,95.83333333
2017020708,25,3600,0.0,27,26,10,1,1,96.2962963
2017020708,7,1828,0.0,13,10,0,0,3,76.92307692
2017020708,7,1768,0.0,19,15,1,1,4,78.94736842
2017020709,1,2764,0.0,24,24,6,1,0,100.0
2017020709,1,735,0.0,7,4,0,0,3,57.14285714
2017020709,4,3583,0.0,29,28,3,1,1,96.55172414
2017020710,3,3535,0.0,36,34,0,0,2,94.44444444
2017020710,21,3600,0.0,28,27,2,0,1,96.42857143
2017020711,52,3900,0.0,31,30,6,2,1,96.77419355
2017020711,20,3900,0.0,35,34,1,1,1,97.14285714
2017020712,6,3600,0.0,25,24,3,1,1,96.0
2017020712,8,3536,0.0,30,27,5,0,3,90.0
2017020713,10,3600,0.0,18,15,2,1,3,83.33333333
2017020713,9,3504,0.0,33,29,5,0,4,87.87878788
2017020714,12,3578,0.0,24,23,3,0,1,95.83333333
2017020714,17,3495,0.0,30,27,4,0,3,90.0
2017020715,53,3600,0.0,27,25,4,0,2,92.59259259
2017020715,19,426,0.0,12,9,0,0,3,75.0
2017020715,19,3159,0.0,32,30,5,1,2,93.75
2017020716,13,3465,0.0,29,25,1,0,4,86.20689655
2017020716,18,3593,0.0,40,37,2,0,3,92.5
2017020717,5,3466,0.0,36,34,3,4,2,94.44444444
2017020717,28,3600,0.0,32,31,7,0,1,96.875
2017020718,2,3600,0.0,39,36,1,2,3,92.30769231
2017020718,16,1088,0.0,11,9,0,0,2,81.81818182
2017020718,16,2512,0.0,35,30,8,0,5,85.71428571
2017020719,14,3563,0.0,34,30,2,2,4,88.23529412
2017020719,30,3600,0.0,23,21,4,0,2,91.30434783
2017020720,23,3584,0.0,34,30,4,2,4,88.23529412
2017020720,22,3583,0.0,27,25,2,1,2,92.59259259
2017020721,4,3627,0.0,28,27,2,0,1,96.42857143
2017020721,15,3627,0.0,23,21,5,0,2,91.30434783
2017020722,54,3600,0.0,28,27,6,0,1,96.42857143
2017020722,12,2816,0.0,25,23,4,0,2,92.0
2017020722,12,779,0.0,8,5,1,0,3,62.5
2017020723,23,3510,0.0,36,35,5,1,1,97.22222222
2017020723,52,3600,0.0,29,29,4,0,0,100.0
2017020724,28,3600,0.0,35,33,5,2,2,94.28571429
2017020724,24,472,0.0,4,3,0,0,1,75.0
2017020724,24,3128,0.0,22,17,5,0,5,77.27272727
2017020725,3,3469,0.0,29,26,3,0,3,89.65517241
2017020725,26,3588,0.0,23,21,4,0,2,91.30434783
2017020726,21,3600,0.0,31,29,3,0,2,93.5483871
2017020726,10,3479,0.0,26,23,0,1,3,88.46153846
2017020727,17,3600,0.0,37,37,11,1,0,100.0
2017020727,1,3598,0.0,30,27,4,0,3,90.0
2017020728,9,3467,0.0,36,33,2,1,3,91.66666667
2017020728,30,3600,0.0,38,37,6,1,1,97.36842105
2017020729,14,3600,0.0,40,40,10,0,0,100.0
2017020729,16,3521,0.0,31,29,4,1,2,93.5483871
2017020730,7,3690,0.0,33,32,3,1,1,96.96969697
2017020730,20,3677,0.0,33,31,5,1,2,93.93939394
2017020731,2,3738,0.0,33,30,6,0,3,90.90909091
2017020731,53,3741,0.0,34,32,5,1,2,94.11764706
2017020732,1,2400,0.0,20,17,3,1,3,85.0
2017020732,1,1112,0.0,4,4,0,1,0,100.0
2017020732,6,3600,0.0,39,37,5,1,2,94.87179487
2017020733,12,3444,2.0,33,30,2,0,3,90.90909091
2017020733,5,3600,0.0,35,34,2,1,1,97.14285714
2017020734,21,3583,0.0,39,36,14,0,3,92.30769231
2017020734,8,3594,0.0,22,20,2,4,2,90.90909091
2017020735,4,3601,0.0,21,19,3,1,2,90.47619048
2017020735,17,3627,0.0,31,28,4,1,3,90.32258065
2017020736,9,3577,0.0,40,38,7,0,2,95.0
2017020736,19,3600,0.0,25,25,6,2,0,100.0
2017020737,14,3705,0.0,33,30,4,1,3,90.90909091
2017020737,18,3705,0.0,31,27,3,1,4,87.09677419
2017020738,13,228,0.0,3,3,0,0,0,100.0
2017020738,13,3372,0.0,36,30,7,1,6,83.33333333
2017020738,25,3600,0.0,34,33,6,1,1,97.05882353
2017020739,7,3600,0.0,33,33,5,0,0,100.0
2017020739,22,1701,0.0,12,11,2,0,1,91.66666667
2017020739,22,1892,0.0,22,18,1,0,4,81.81818182
2017020740,26,1461,0.0,19,14,6,0,5,73.68421053
2017020740,26,2139,0.0,16,15,1,3,1,93.75
2017020740,23,3600,0.0,32,30,4,4,2,93.75
2017020741,29,3524,0.0,37,32,2,1,5,86.48648649
2017020741,54,3600,0.0,32,29,3,2,3,90.625
2017020742,3,2569,0.0,23,21,4,0,2,91.30434783
2017020742,3,981,0.0,7,4,0,0,3,57.14285714
2017020742,24,3585,0.0,44,41,4,2,3,93.18181818
2017020743,52,3618,0.0,33,29,6,1,4,87.87878788
2017020743,28,3618,0.0,23,18,0,0,5,78.26086957
2017020744,10,3606,0.0,36,34,4,0,2,94.44444444
2017020744,16,3602,0.0,36,33,4,0,3,91.66666667
2017020745,26,3837,0.0,31,30,11,2,1,96.77419355
2017020745,20,3873,0.0,27,25,6,2,2,92.59259259
2017020746,18,3599,0.0,27,27,1,0,0,100.0
2017020746,1,3584,0.0,27,24,1,0,3,88.88888889
2017020747,14,3600,0.0,37,36,11,0,1,97.2972973
2017020747,4,3557,0.0,22,17,0,1,5,77.27272727
2017020748,30,1745,0.0,18,16,0,1,2,88.88888889
2017020748,30,1855,0.0,21,17,0,0,4,80.95238095
2017020748,5,3588,0.0,26,23,6,0,3,88.46153846
2017020749,12,3600,2.0,31,26,3,0,5,83.87096774
2017020749,8,3483,0.0,29,23,3,1,6,79.31034483
2017020750,6,3595,0.0,23,21,2,0,2,91.30434783
2017020750,9,3533,0.0,44,41,0,0,3,93.18181818
2017020751,16,3600,0.0,24,23,2,1,1,95.83333333
2017020751,17,527,0.0,9,6,0,0,3,66.66666667
2017020751,17,2936,0.0,18,17,2,0,1,94.44444444
2017020752,15,3576,0.0,34,32,6,4,2,94.11764706
2017020752,13,3524,0.0,46,42,17,0,4,91.30434783
2017020753,21,3525,0.0,34,31,4,2,3,91.17647059
2017020753,19,3600,0.0,37,36,2,0,1,97.2972973
2017020754,10,3600,0.0,40,39,5,0,1,97.5
2017020754,25,3574,0.0,29,25,5,1,4,86.20689655
2017020755,20,3893,10.0,37,34,9,1,3,91.89189189
2017020755,22,3900,2.0,37,34,4,1,3,91.89189189
2017020756,29,3600,0.0,39,38,2,1,1,97.43589744
2017020756,53,3514,0.0,27,25,1,0,2,92.59259259
2017020757,7,3566,0.0,30,30,5,1,0,100.0
2017020757,23,3515,0.0,25,22,1,0,3,88.0
2017020758,2,3600,0.0,39,38,5,0,1,97.43589744
2017020758,54,3525,0.0,25,23,0,0,2,92.0
2017020759,52,3900,0.0,39,36,7,0,3,92.30769231
2017020759,24,700,0.0,0,0,0,0,0,
2017020759,24,3200,0.0,27,24,8,1,3,88.88888889
2017020760,3,3600,0.0,28,23,1,0,5,82.14285714
2017020760,28,3501,0.0,29,23,2,1,6,79.31034483
2017020761,24,445,0.0,6,5,2,0,1,83.33333333
2017020761,24,3155,0.0,25,25,4,0,0,100.0
2017020761,6,3540,0.0,26,24,3,2,2,92.30769231
2017020762,1,3600,0.0,28,27,9,0,1,96.42857143
2017020762,7,3509,0.0,27,25,0,0,2,92.59259259
2017020763,13,3600,0.0,33,32,1,0,1,96.96969697
2017020763,2,3483,0.0,39,36,0,2,3,92.30769231
2017020764,28,3498,0.0,30,26,1,2,4,86.66666667
2017020764,5,3600,0.0,42,40,9,1,2,95.23809524
2017020765,9,3595,0.0,39,37,7,0,2,94.87179487
2017020765,12,3599,0.0,30,29,0,3,1,96.66666667
2017020766,30,3900,0.0,30,28,0,0,2,93.33333333
2017020766,29,3900,0.0,43,41,4,1,2,95.34883721
2017020767,8,3468,0.0,30,28,6,1,2,93.33333333
2017020767,19,3600,0.0,34,33,3,1,1,97.05882353
2017020768,16,3600,0.0,43,42,4,1,1,97.6744186
2017020768,18,3515,0.0,31,29,1,0,2,93.5483871
2017020769,14,3481,2.0,37,34,7,0,3,91.89189189
2017020769,52,3600,0.0,24,23,6,0,1,95.83333333
2017020770,26,3600,0.0,28,28,7,0,0,100.0
2017020770,25,3600,0.0,42,39,7,1,3,92.85714286
2017020771,54,3600,0.0,33,31,7,0,2,93.93939394
2017020771,20,3594,0.0,34,31,5,3,3,91.17647059
2017020772,21,3637,0.0,26,22,6,0,4,84.61538462
2017020772,23,3667,0.0,30,27,3,1,3,90.0
2017020773,2,3600,0.0,50,45,4,0,5,90.0
2017020773,10,3600,0.0,28,28,2,1,0,100.0
2017020774,28,3900,0.0,44,43,7,1,1,97.72727273
2017020774,17,3900,0.0,31,30,2,2,1,96.77419355
2017020775,4,2946,0.0,20,15,1,0,5,75.0
2017020775,4,482,0.0,5,5,0,0,0,100.0
2017020775,15,3600,0.0,30,27,2,0,3,90.0
2017020776,19,3476,0.0,45,43,0,0,2,95.55555556
2017020776,6,3600,0.0,33,32,2,0,1,96.96969697
2017020777,13,3600,0.0,32,30,4,3,2,93.75
2017020777,7,3580,0.0,32,28,5,1,4,87.5
2017020778,4,3524,0.0,22,18,2,0,4,81.81818182
2017020778,1,3600,0.0,25,22,4,1,3,88.0
2017020779,10,3600,0.0,25,25,3,1,0,100.0
2017020779,3,2215,0.0,19,19,0,1,0,100.0
2017020779,3,1385,0.0,13,9,0,1,4,69.23076923
2017020780,8,3600,0.0,30,28,4,1,2,93.33333333
2017020780,12,3600,0.0,27,27,4,0,0,100.0
2017020781,24,3559,0.0,32,30,9,1,2,93.75
2017020781,9,3619,0.0,31,30,4,0,1,96.77419355
2017020782,26,3600,0.0,36,31,2,2,5,86.11111111
2017020782,18,3600,0.0,19,19,1,0,0,100.0
2017020783,54,3819,0.0,28,26,4,0,2,92.85714286
2017020783,52,3837,0.0,31,28,3,0,3,90.32258065
2017020784,14,3600,0.0,46,42,5,0,4,91.30434783
2017020784,20,2782,0.0,27,21,2,0,6,77.77777778
2017020784,20,818,0.0,4,3,0,0,1,75.0
2017020785,21,3735,0.0,32,29,2,0,3,90.625
2017020785,22,3691,0.0,31,27,0,0,4,87.09677419
2017020786,25,3600,0.0,18,17,6,1,1,94.44444444
2017020786,53,3553,0.0,24,21,2,1,3,87.5
2017020787,16,3436,0.0,21,17,3,0,4,80.95238095
2017020787,23,3600,0.0,28,26,6,2,2,92.85714286
2017020788,15,721,0.0,6,5,2,1,1,83.33333333
2017020788,15,2879,0.0,33,27,2,0,6,81.81818182
2017020788,5,3600,0.0,33,29,7,0,4,87.87878788
2017020789,17,3600,0.0,37,36,3,2,1,97.2972973
2017020789,12,3591,0.0,38,34,5,0,4,89.47368421
2017020790,28,3600,0.0,29,28,3,0,1,96.55172414
2017020790,29,3477,0.0,28,25,0,0,3,89.28571429
2017020791,54,3499,0.0,35,31,5,0,4,88.57142857
2017020791,30,3596,0.0,24,22,5,0,2,91.66666667
2017020792,24,613,0.0,7,4,3,0,3,57.14285714
2017020792,24,2987,0.0,22,20,8,0,2,90.90909091
2017020792,8,3598,0.0,45,43,9,1,2,95.55555556
2017020793,9,3892,0.0,36,33,2,0,3,91.66666667
2017020793,4,1420,0.0,6,6,0,0,0,100.0
2017020793,4,2400,0.0,23,20,2,0,3,86.95652174
2017020794,10,3516,0.0,29,26,4,1,3,89.65517241
2017020794,6,3600,0.0,24,23,6,1,1,95.83333333
2017020795,19,3600,0.0,27,27,9,1,0,100.0
2017020795,7,3486,0.0,33,32,3,0,1,96.96969697
2017020796,17,3598,0.0,33,30,4,0,3,90.90909091
2017020796,13,3600,0.0,28,26,2,1,2,92.85714286
2017020797,5,3484,0.0,38,35,7,2,3,92.10526316
2017020797,1,3600,0.0,16,15,1,1,1,93.75
2017020798,29,3499,0.0,38,34,4,0,4,89.47368421
2017020798,2,3598,0.0,49,46,12,0,3,93.87755102
2017020799,21,3514,0.0,31,29,3,0,2,93.5483871
2017020799,52,3600,0.0,25,25,2,0,0,100.0
2017020800,3,3548,0.0,27,23,7,0,4,85.18518519
2017020800,18,3600,0.0,22,20,3,1,2,90.90909091
2017020801,30,2400,0.0,29,25,4,2,4,86.20689655
2017020801,30,1200,0.0,9,7,0,0,2,77.77777778
2017020801,25,3600,0.0,31,30,1,0,1,96.77419355
2017020802,16,3659,0.0,39,35,2,1,4,89.74358974
2017020802,20,3659,0.0,28,25,0,1,3,89.28571429
2017020803,14,3600,0.0,33,31,4,1,2,93.93939394
2017020803,23,3580,0.0,28,24,5,0,4,85.71428571
2017020804,53,3584,0.0,35,29,0,1,6,82.85714286
2017020804,26,3600,0.0,27,27,1,0,0,100.0
2017020805,54,3600,0.0,23,20,6,0,3,86.95652174
2017020805,15,3513,0.0,31,27,3,1,4,87.09677419
2017020806,9,3600,0.0,35,31,1,0,4,88.57142857
2017020806,8,3598,0.0,26,25,2,0,1,96.15384615
2017020807,28,3600,0.0,30,29,3,0,1,96.66666667
2017020807,12,3471,0.0,26,23,0,1,3,88.46153846
2017020808,24,3514,0.0,39,33,9,1,6,84.61538462
2017020808,10,1558,0.0,16,15,0,0,1,93.75
2017020808,10,2025,0.0,28,25,8,1,3,89.28571429
2017020809,18,3715,0.0,28,24,4,0,4,85.71428571
2017020809,2,3822,0.0,47,42,8,2,5,89.36170213
2017020810,3,3532,0.0,41,39,4,0,2,95.12195122
2017020810,25,3584,0.0,32,31,5,0,1,96.875
2017020811,14,1200,0.0,9,7,0,1,2,77.77777778
2017020811,14,2400,0.0,26,22,2,0,4,84.61538462
2017020811,22,3600,0.0,34,32,4,0,2,94.11764706
2017020812,24,3696,0.0,33,30,1,2,3,90.90909091
2017020812,7,3539,0.0,33,29,4,1,4,87.87878788
2017020813,54,3534,0.0,38,33,3,1,5,86.84210526
2017020813,5,3600,0.0,25,21,1,1,4,84.0
2017020814,4,3896,0.0,28,27,3,1,1,96.42857143
2017020814,12,3896,0.0,30,28,4,0,2,93.33333333
2017020815,15,3578,0.0,39,37,4,0,2,94.87179487
2017020815,29,3567,0.0,25,22,2,0,3,88.0
2017020816,1,1720,0.0,20,16,2,0,4,80.0
2017020816,1,1771,0.0,12,11,0,1,1,91.66666667
2017020816,9,3600,0.0,33,30,8,1,3,90.90909091
2017020817,6,3600,0.0,28,26,1,3,2,92.85714286
2017020817,17,3450,0.0,31,28,4,0,3,90.32258065
2017020818,23,3528,0.0,39,37,8,1,2,94.87179487
2017020818,13,3600,0.0,27,26,4,2,1,96.2962963
2017020819,30,3600,0.0,37,35,3,2,2,94.59459459
2017020819,19,1200,0.0,8,5,0,0,3,62.5
2017020819,19,2400,0.0,12,9,0,0,3,75.0
2017020820,53,3463,0.0,23,19,7,1,4,82.60869565
2017020820,52,3561,0.0,24,21,4,4,3,87.5
2017020821,20,3600,0.0,36,34,5,1,2,94.44444444
2017020821,16,3494,0.0,22,20,5,2,2,90.90909091
2017020822,28,3512,0.0,19,17,1,0,2,89.47368421
2017020822,21,3600,0.0,39,38,6,0,1,97.43589744
2017020823,18,3900,0.0,32,30,5,0,2,93.75
2017020823,10,3900,0.0,46,44,8,0,2,95.65217391
2017020824,6,3575,0.0,22,21,1,0,1,95.45454545
2017020824,3,1955,0.0,18,16,4,1,2,88.88888889
2017020824,3,1645,0.0,16,12,0,0,4,75.0
2017020825,22,3560,0.0,26,23,5,0,3,88.46153846
2017020825,26,3600,0.0,27,25,8,0,2,92.59259259
2017020826,2,3515,0.0,22,18,3,1,4,81.81818182
2017020826,7,3600,0.0,29,26,3,0,3,89.65517241
2017020827,20,3600,0.0,32,30,1,0,2,93.75
2017020827,1,3527,0.0,25,22,0,0,3,88.0
2017020828,8,3524,0.0,27,23,6,0,4,85.18518519
2017020828,4,3600,0.0,28,25,2,1,3,89.28571429
2017020829,18,3781,0.0,36,32,3,0,4,88.88888889
2017020829,9,3781,0.0,38,35,3,1,3,92.10526316
2017020830,23,3596,0.0,36,31,6,1,5,86.11111111
2017020830,14,3597,0.0,29,27,4,1,2,93.10344828
2017020831,21,2060,0.0,11,8,0,1,3,72.72727273
2017020831,21,1505,0.0,20,17,1,0,3,85.0
2017020831,19,3600,0.0,24,23,1,0,1,95.83333333
2017020832,53,3767,0.0,28,25,1,0,3,89.28571429
2017020832,30,3835,0.0,40,36,2,0,4,90.0
2017020833,25,3600,0.0,39,37,6,0,2,94.87179487
2017020833,16,3496,0.0,29,26,0,2,3,89.65517241
2017020834,54,3589,0.0,38,35,7,1,3,92.10526316
2017020834,28,3552,0.0,32,28,6,0,4,87.5
2017020835,17,3752,0.0,29,22,6,0,7,75.86206897
2017020835,2,2994,0.0,32,27,2,1,5,84.375
2017020835,2,801,0.0,7,6,0,2,1,85.71428571
2017020836,20,3494,0.0,36,32,8,0,4,88.88888889
2017020836,3,1190,0.0,8,7,2,1,1,87.5
2017020836,3,2400,0.0,30,28,11,1,2,93.33333333
2017020837,29,3517,0.0,17,13,4,0,4,76.47058824
2017020837,15,3600,0.0,37,35,7,1,2,94.59459459
2017020838,26,3600,0.0,36,35,2,0,1,97.22222222
2017020838,13,3408,0.0,26,23,0,2,3,88.46153846
2017020839,23,3600,0.0,33,29,5,0,4,87.87878788
2017020839,12,3600,0.0,22,21,0,0,1,95.45454545
2017020840,19,3596,0.0,22,20,3,0,2,90.90909091
2017020840,52,3491,0.0,26,22,3,2,4,84.61538462
2017020841,5,3833,0.0,36,33,2,0,3,91.66666667
2017020841,25,3900,0.0,37,34,5,1,3,91.89189189
2017020842,22,3567,0.0,34,31,1,3,3,91.17647059
2017020842,24,3541,0.0,32,30,6,1,2,93.75
2017020843,7,3600,0.0,27,25,4,0,2,92.59259259
2017020843,6,3545,0.0,27,24,0,2,3,88.88888889
2017020844,9,690,0.0,10,7,0,0,3,70.0
2017020844,9,2888,0.0,30,28,1,0,2,93.33333333
2017020844,10,3600,0.0,25,22,1,0,3,88.0
2017020845,18,3889,0.0,49,47,3,2,2,95.91836735
2017020845,8,3857,0.0,32,30,1,1,2,93.75
2017020846,26,2106,2.0,14,13,5,0,1,92.85714286
2017020846,26,1392,0.0,14,11,0,0,3,78.57142857
2017020846,14,3600,0.0,47,44,9,1,3,93.61702128
2017020847,21,3465,0.0,35,32,3,2,3,91.42857143
2017020847,12,3592,0.0,30,29,7,1,1,96.66666667
2017020848,1,3600,0.0,50,44,11,1,6,88.0
2017020848,29,3582,0.0,35,34,0,0,1,97.14285714
2017020849,16,3333,0.0,19,16,5,0,3,84.21052632
2017020849,30,3600,0.0,44,44,7,1,0,100.0
2017020850,4,0,0.0,0,0,0,0,0,
2017020850,4,3900,0.0,27,24,2,0,3,88.88888889
2017020850,53,3900,0.0,43,40,4,1,3,93.02325581
2017020851,22,3590,0.0,29,24,0,1,5,82.75862069
2017020851,28,3600,0.0,31,27,6,0,4,87.09677419
2017020852,17,3751,0.0,27,23,1,0,4,85.18518519
2017020852,15,3643,0.0,29,24,3,0,5,82.75862069
2017020853,5,3597,0.0,34,33,6,0,1,97.05882353
2017020853,19,3577,0.0,22,19,1,3,3,86.36363636
2017020854,3,3600,0.0,38,37,7,4,1,97.36842105
2017020854,52,3516,0.0,27,25,9,0,2,92.59259259
2017020855,23,3592,0.0,30,30,0,4,0,100.0
2017020855,25,1478,0.0,20,16,3,0,4,80.0
2017020855,25,2119,0.0,21,19,3,0,2,90.47619048
2017020856,21,3579,0.0,32,28,4,2,4,87.5
2017020856,7,3389,0.0,27,22,7,2,5,81.48148148
2017020857,6,3600,0.0,38,35,8,4,3,92.10526316
2017020857,1,3512,0.0,26,22,6,2,4,84.61538462
2017020858,20,3598,0.0,25,23,5,1,2,92.0
2017020858,20,2,0.0,0,0,0,0,0,
2017020858,2,3542,0.0,42,39,6,0,3,92.85714286
2017020859,4,3600,0.0,39,38,1,0,1,97.43589744
2017020859,54,3588,0.0,17,14,0,1,3,82.35294118
2017020860,28,3827,0.0,27,25,1,0,2,92.59259259
2017020860,24,3900,0.0,39,37,3,1,2,94.87179487
2017020861,14,3493,0.0,23,19,1,0,4,82.60869565
2017020861,10,3600,0.0,34,31,6,2,3,91.17647059
2017020862,13,3580,0.0,32,27,0,0,5,84.375
2017020862,22,3572,0.0,39,33,2,0,6,84.61538462
2017020863,16,1965,0.0,9,6,4,1,3,66.66666667
2017020863,16,1626,0.0,13,10,2,1,3,76.92307692
2017020863,53,3584,0.0,38,37,13,1,1,97.36842105
2017020864,20,3561,0.0,39,35,7,4,4,89.74358974
2017020864,6,3600,0.0,30,28,7,0,2,93.33333333
2017020865,14,3511,0.0,32,28,5,2,4,87.5
2017020865,7,3600,0.0,29,26,7,0,3,89.65517241
2017020866,29,3600,0.0,30,29,2,2,1,96.66666667
2017020866,2,3600,0.0,51,47,5,3,4,92.15686275
2017020867,1,3892,0.0,35,31,3,3,4,88.57142857
2017020867,4,3900,0.0,36,32,3,3,4,88.88888889
2017020868,9,1644,0.0,18,17,0,0,1,94.44444444
2017020868,9,1882,0.0,9,5,0,0,4,55.55555556
2017020868,5,3600,0.0,33,30,1,0,3,90.90909091
2017020869,26,1277,0.0,20,16,3,0,4,80.0
2017020869,26,2323,0.0,21,18,3,0,3,85.71428571
2017020869,12,3582,0.0,30,27,2,1,3,90.0
2017020870,24,3510,0.0,16,14,0,1,2,87.5
2017020870,17,3600,0.0,33,32,12,0,1,96.96969697
2017020871,19,3679,0.0,33,29,3,1,4,87.87878788
2017020871,18,3653,0.0,31,28,7,1,3,90.32258065
2017020872,3,3530,0.0,29,26,2,0,3,89.65517241
2017020872,30,3596,0.0,34,32,10,0,2,94.11764706
2017020873,15,3752,0.0,44,40,7,1,4,90.90909091
2017020873,52,3701,0.0,27,24,3,1,3,88.88888889
2017020874,16,3488,0.0,36,32,6,0,4,88.88888889
2017020874,54,3600,0.0,31,29,2,1,2,93.5483871
2017020875,53,2428,0.0,29,28,7,0,1,96.55172414
2017020875,53,1172,0.0,12,12,2,0,0,100.0
2017020875,28,3454,0.0,26,24,0,4,2,92.30769231
2017020876,29,3527,0.0,27,22,6,1,5,81.48148148
2017020876,10,3600,0.0,57,54,2,0,3,94.73684211
2017020877,8,3445,0.0,25,23,2,0,2,92.0
2017020877,21,3595,0.0,44,44,5,0,0,100.0
2017020878,13,3600,0.0,37,34,10,0,3,91.89189189
2017020878,23,2367,0.0,20,20,6,1,0,100.0
2017020878,23,1200,0.0,14,10,1,0,4,71.42857143
2017020879,12,3600,0.0,22,17,0,0,5,77.27272727
2017020879,1,3600,0.0,29,27,4,1,2,93.10344828
2017020880,3,3598,0.0,35,32,3,1,3,91.42857143
2017020880,2,3600,0.0,50,50,8,0,0,100.0
2017020881,26,3518,0.0,38,36,5,1,2,94.73684211
2017020881,5,3600,0.0,35,34,5,2,1,97.14285714
2017020882,7,3673,0.0,36,33,6,2,3,91.66666667
2017020882,9,3596,0.0,25,23,4,1,2,92.0
2017020883,17,3600,0.0,32,28,5,1,4,87.5
2017020883,14,3593,0.0,39,38,4,1,1,97.43589744
2017020884,20,3597,0.0,32,29,7,0,3,90.625
2017020884,18,3420,0.0,31,27,3,0,4,87.09677419
2017020885,15,3600,0.0,34,32,4,1,2,94.11764706
2017020885,30,3538,0.0,26,22,3,1,4,84.61538462
2017020886,24,3600,0.0,44,42,8,1,2,95.45454545
2017020886,16,3406,0.0,32,29,1,1,3,90.625
2017020887,8,3600,0.0,21,16,2,1,5,76.19047619
2017020887,53,3600,0.0,36,34,4,0,2,94.44444444
2017020888,22,3600,0.0,28,24,0,0,4,85.71428571
2017020888,54,3600,0.0,29,28,1,1,1,96.55172414
2017020889,23,3600,0.0,30,26,3,1,4,86.66666667
2017020889,28,3600,0.0,44,43,2,0,1,97.72727273
2017020890,4,3712,0.0,36,35,0,0,1,97.22222222
2017020890,29,3712,0.0,25,23,2,0,2,92.0
2017020891,2,3600,0.0,45,45,10,0,0,100.0
2017020891,12,3486,0.0,22,20,0,0,2,90.90909091
2017020892,21,1200,0.0,8,6,2,1,2,75.0
2017020892,21,2397,0.0,20,16,3,0,4,80.0
2017020892,52,3600,0.0,31,30,10,1,1,96.77419355
2017020893,19,3504,0.0,16,14,3,2,2,87.5
2017020893,25,3592,0.0,29,28,5,1,1,96.55172414
2017020894,26,3600,0.0,35,33,2,2,2,94.28571429
2017020894,7,1050,0.0,6,6,0,0,0,100.0
2017020894,7,2384,0.0,30,26,3,1,4,86.66666667
2017020895,3,2845,0.0,27,22,2,0,5,81.48148148
2017020895,3,753,0.0,6,5,0,0,1,83.33333333
2017020895,9,3600,0.0,38,35,3,0,3,92.10526316
2017020896,24,3897,0.0,38,36,5,0,2,94.73684211
2017020896,30,3899,0.0,31,29,2,1,2,93.5483871
2017020897,22,3516,0.0,32,31,8,0,1,96.875
2017020897,53,3574,0.0,40,40,3,1,0,100.0
2017020898,1,3600,0.0,51,48,13,2,3,94.11764706
2017020898,14,3471,0.0,28,24,4,3,4,85.71428571
2017020899,10,3458,0.0,39,34,1,0,5,87.17948718
2017020899,5,3600,0.0,32,29,0,0,3,90.625
2017020900,8,3009,0.0,28,25,1,4,3,89.28571429
2017020900,8,591,0.0,6,3,1,0,3,50.0
2017020900,54,3600,2.0,33,30,0,0,3,90.90909091
2017020901,17,3577,0.0,32,31,1,2,1,96.875
2017020901,18,3530,0.0,33,31,3,0,2,93.93939394
2017020902,15,1200,0.0,11,10,0,0,1,90.90909091
2017020902,15,2400,0.0,33,27,2,2,6,81.81818182
2017020902,16,3596,0.0,20,19,0,0,1,95.0
2017020903,13,3600,0.0,33,30,8,2,3,90.90909091
2017020903,20,2037,0.0,15,13,0,2,2,86.66666667
2017020903,20,1563,0.0,15,11,2,0,4,73.33333333
2017020904,6,2400,0.0,15,13,0,4,2,86.66666667
2017020904,6,1200,0.0,8,4,0,1,4,50.0
2017020904,23,3600,0.0,45,44,10,0,1,97.77777778
2017020905,4,1200,0.0,14,11,0,1,3,78.57142857
2017020905,4,2400,0.0,26,25,0,0,1,96.15384615
2017020905,3,3600,0.0,37,30,0,0,7,81.08108108
2017020906,22,3600,0.0,26,24,1,0,2,92.30769231
2017020906,21,3503,0.0,39,36,4,1,3,92.30769231
2017020907,1,3840,0.0,42,40,7,1,2,95.23809524
2017020907,12,3803,0.0,21,18,1,0,3,85.71428571
2017020908,5,3600,2.0,37,35,7,0,2,94.59459459
2017020908,29,3600,0.0,23,18,0,1,5,78.26086957
2017020909,10,3600,0.0,29,27,2,0,2,93.10344828
2017020909,17,3572,0.0,34,31,3,1,3,91.17647059
2017020910,13,3600,0.0,34,27,6,1,7,79.41176471
2017020910,52,3600,0.0,27,25,11,0,2,92.59259259
2017020911,25,1043,0.0,5,1,1,0,4,20.0
2017020911,25,2515,0.0,23,22,0,0,1,95.65217391
2017020911,28,3600,0.0,28,26,0,0,2,92.85714286
2017020912,30,3600,0.0,35,32,9,0,3,91.42857143
2017020912,2,3487,0.0,32,27,3,0,5,84.375
2017020913,15,3600,0.0,34,32,2,0,2,94.11764706
2017020913,7,3491,0.0,29,27,1,0,2,93.10344828
2017020914,6,3816,0.0,29,28,1,1,1,96.55172414
2017020914,20,3816,0.0,32,30,3,0,2,93.75
2017020915,9,3596,0.0,41,36,5,0,5,87.80487805
2017020915,18,3568,0.0,38,36,4,0,2,94.73684211
2017020916,26,3600,0.0,28,27,1,2,1,96.42857143
2017020916,16,3427,0.0,32,29,4,1,3,90.625
2017020917,24,1200,0.0,20,20,2,0,0,100.0
2017020917,24,2400,0.0,13,13,1,0,0,100.0
2017020917,54,3429,0.0,20,18,0,1,2,90.0
2017020918,13,3535,0.0,31,30,4,0,1,96.77419355
2017020918,10,3533,0.0,40,40,6,1,0,100.0
2017020919,29,3600,0.0,31,30,2,0,1,96.77419355
2017020919,1,3512,0.0,19,17,1,3,2,89.47368421
2017020920,8,3686,0.0,33,30,1,0,3,90.90909091
2017020920,4,3685,0.0,27,25,0,1,2,92.59259259
2017020921,14,3600,0.0,37,35,2,1,2,94.59459459
2017020921,15,3469,0.0,19,15,0,0,4,78.94736842
2017020922,18,3590,0.0,36,34,2,0,2,94.44444444
2017020922,17,3472,0.0,29,26,0,0,3,89.65517241
2017020923,28,3594,0.0,33,31,1,0,2,93.93939394
2017020923,19,3457,0.0,23,20,3,0,3,86.95652174
2017020924,26,3596,0.0,33,30,0,0,3,90.90909091
2017020924,52,3492,0.0,32,28,8,1,4,87.5
2017020925,6,3596,0.0,20,18,0,0,2,90.0
2017020925,22,3555,2.0,45,42,11,0,3,93.33333333
2017020926,21,3816,0.0,28,24,2,2,4,85.71428571
2017020926,23,3816,0.0,34,29,1,1,5,85.29411765
2017020927,9,3896,0.0,38,36,1,0,2,94.73684211
2017020927,16,3900,0.0,34,32,0,1,2,94.11764706
2017020928,25,3384,0.0,17,15,3,1,2,88.23529412
2017020928,24,3600,0.0,41,41,13,0,0,100.0
2017020929,20,3588,0.0,26,19,2,0,7,73.07692308
2017020929,54,3600,2.0,31,28,1,0,3,90.32258065
2017020930,2,3900,0.0,31,28,5,0,3,90.32258065
2017020930,10,3895,0.0,35,32,1,1,3,91.42857143
2017020931,30,3600,0.0,40,38,6,1,2,95.0
2017020931,1,3562,0.0,24,21,3,0,3,87.5
2017020932,29,3518,0.0,20,18,5,1,2,90.0
2017020932,4,3600,0.0,20,19,1,4,1,95.0
2017020933,3,3505,0.0,40,38,10,0,2,95.0
2017020933,8,3600,0.0,32,31,8,1,1,96.875
2017020934,14,3600,0.0,36,33,4,1,3,91.66666667
2017020934,9,3452,0.0,24,20,0,4,4,83.33333333
2017020935,7,3874,0.0,37,35,7,0,2,94.59459459
2017020935,17,3835,0.0,30,27,5,0,3,90.0
2017020936,15,3571,0.0,33,30,4,1,3,90.90909091
2017020936,13,3600,0.0,35,33,4,0,2,94.28571429
2017020937,28,3600,0.0,46,39,5,5,7,84.7826087
2017020937,18,3591,0.0,34,33,12,0,1,97.05882353
2017020938,21,3739,0.0,46,43,3,0,3,93.47826087
2017020938,22,3739,0.0,30,28,2,0,2,93.33333333
2017020939,20,3599,0.0,37,35,6,4,2,94.59459459
2017020939,53,3590,0.0,38,33,6,2,5,86.84210526
2017020940,25,3600,0.0,18,18,3,0,0,100.0
2017020940,26,3524,0.0,27,26,0,0,1,96.2962963
2017020941,30,3600,0.0,23,22,4,1,1,95.65217391
2017020941,3,3600,0.0,37,33,3,0,4,89.18918919
2017020942,5,3600,0.0,28,27,1,0,1,96.42857143
2017020942,12,3600,10.0,39,33,1,0,6,84.61538462
2017020943,52,3600,0.0,34,34,12,2,0,100.0
2017020943,19,3592,0.0,23,19,5,0,4,82.60869565
2017020944,28,3521,0.0,35,33,0,0,2,94.28571429
2017020944,16,3600,0.0,43,42,1,0,1,97.6744186
2017020945,23,2400,0.0,25,20,0,1,5,80.0
2017020945,23,1177,0.0,8,8,1,0,0,100.0
2017020945,54,3600,2.0,33,30,2,0,3,90.90909091
2017020946,4,3562,0.0,28,25,2,2,3,89.28571429
2017020946,9,3560,0.0,39,34,4,1,5,87.17948718
2017020947,21,3583,0.0,29,24,4,0,5,82.75862069
2017020947,20,3600,0.0,29,28,4,0,1,96.55172414
2017020948,6,3567,0.0,36,32,2,1,4,88.88888889
2017020948,10,3600,0.0,23,20,5,0,3,86.95652174
2017020949,14,3876,0.0,32,29,4,0,3,90.625
2017020949,8,3878,0.0,39,36,9,2,3,92.30769231
2017020950,12,3520,0.0,22,19,5,2,3,86.36363636
2017020950,17,3600,0.0,29,28,7,0,1,96.55172414
2017020951,5,1827,0.0,14,12,3,0,2,85.71428571
2017020951,5,1692,0.0,16,12,0,0,4,75.0
2017020951,13,3600,0.0,37,32,1,0,5,86.48648649
2017020952,2,3499,0.0,33,31,4,0,2,93.93939394
2017020952,1,3600,0.0,31,30,2,1,1,96.77419355
2017020953,7,3592,0.0,35,31,2,0,4,88.57142857
2017020953,15,3600,0.0,29,28,1,0,1,96.55172414
2017020954,16,3509,0.0,29,26,1,1,3,89.65517241
2017020954,29,3600,0.0,33,31,5,0,2,93.93939394
2017020955,52,3600,0.0,36,33,7,0,3,91.66666667
2017020955,25,1649,0.0,6,5,0,1,1,83.33333333
2017020955,25,1919,0.0,21,17,1,2,4,80.95238095
2017020956,24,3539,0.0,37,36,7,1,1,97.2972973
2017020956,53,3600,0.0,26,26,2,1,0,100.0
2017020957,22,3596,0.0,33,30,5,0,3,90.90909091
2017020957,26,3565,0.0,24,21,2,1,3,87.5
2017020958,6,3488,0.0,24,20,6,0,4,83.33333333
2017020958,7,3600,0.0,35,34,3,0,1,97.14285714
2017020959,19,3595,0.0,39,35,3,2,4,89.74358974
2017020959,18,3600,0.0,27,27,8,1,0,100.0
2017020960,17,3894,0.0,38,36,0,0,2,94.73684211
2017020960,3,3891,0.0,34,31,2,0,3,91.17647059
2017020961,28,3888,0.0,41,38,2,0,3,92.68292683
2017020961,30,3872,0.0,28,26,0,1,2,92.85714286
2017020962,22,3785,0.0,46,41,1,1,5,89.13043478
2017020962,24,3785,0.0,42,37,4,3,5,88.0952381
2017020963,23,3600,0.0,42,41,4,0,1,97.61904762
2017020963,53,3501,0.0,27,24,3,5,3,88.88888889
2017020964,15,2332,0.0,18,18,1,0,0,100.0
2017020964,15,1168,0.0,16,12,1,0,4,75.0
2017020964,29,3600,0.0,26,25,3,0,1,96.15384615
2017020965,4,3900,0.0,28,28,3,0,0,100.0
2017020965,8,3900,0.0,33,33,1,0,0,100.0
2017020966,10,3900,0.0,42,39,7,0,3,92.85714286
2017020966,14,3899,0.0,30,27,8,1,3,90.0
2017020967,23,3499,0.0,27,25,6,1,2,92.59259259
2017020967,21,3593,0.0,32,31,4,3,1,96.875
2017020968,54,3794,0.0,44,41,6,0,3,93.18181818
2017020968,26,3720,0.0,39,37,5,2,2,94.87179487
2017020969,12,3665,0.0,32,28,1,1,4,87.5
2017020969,6,3668,0.0,32,29,0,0,3,90.625
2017020970,1,3600,0.0,38,36,1,0,2,94.73684211
2017020970,5,3495,0.0,38,35,1,1,3,92.10526316
2017020971,9,3499,0.0,22,19,2,0,3,86.36363636
2017020971,15,3600,0.0,30,28,4,0,2,93.33333333
2017020972,10,3818,0.0,31,28,6,0,3,90.32258065
2017020972,13,3827,0.0,39,37,2,5,2,94.87179487
2017020973,19,2400,0.0,25,20,6,1,5,80.0
2017020973,19,1200,0.0,8,5,1,0,3,62.5
2017020973,30,3597,0.0,25,22,4,1,3,88.0
2017020974,18,3600,0.0,39,34,2,1,5,87.17948718
2017020974,52,3541,0.0,32,26,0,0,6,81.25
2017020975,20,3491,0.0,26,24,6,2,2,92.30769231
2017020975,25,3600,0.0,38,38,12,6,0,100.0
2017020976,26,3600,0.0,42,41,11,5,1,97.61904762
2017020976,54,3599,0.0,30,26,9,1,4,86.66666667
2017020977,22,3537,0.0,36,32,3,0,4,88.88888889
2017020977,28,3600,0.0,26,24,2,0,2,92.30769231
2017020978,2,3454,0.0,26,23,3,0,3,88.46153846
2017020978,8,3596,0.0,28,27,4,2,1,96.42857143
2017020979,7,3683,0.0,22,21,4,0,1,95.45454545
2017020979,14,3686,10.0,34,32,8,1,2,94.11764706
2017020980,17,3405,0.0,25,23,2,2,2,92.0
2017020980,19,3570,2.0,36,35,3,0,1,97.22222222
2017020981,20,3483,0.0,33,29,6,2,4,87.87878788
2017020981,21,3600,0.0,32,30,6,1,2,93.75
2017020982,3,3682,0.0,55,50,6,1,5,90.90909091
2017020982,23,2883,0.0,22,19,3,0,3,86.36363636
2017020982,23,749,0.0,5,2,0,0,3,40.0
2017020983,5,3273,0.0,33,28,6,1,5,84.84848485
2017020983,5,327,0.0,5,2,0,0,3,40.0
2017020983,6,3600,0.0,26,22,9,1,4,84.61538462
2017020984,12,3600,0.0,22,21,3,0,1,95.45454545
2017020984,4,3600,0.0,35,31,1,0,4,88.57142857
2017020985,1,3443,0.0,29,26,0,0,3,89.65517241
2017020985,13,3600,0.0,31,29,3,0,2,93.5483871
2017020986,14,3859,0.0,35,31,2,0,4,88.57142857
2017020986,25,3750,0.0,25,20,2,1,5,80.0
2017020987,18,3600,0.0,36,34,0,2,2,94.44444444
2017020987,22,3600,0.0,42,38,5,0,4,90.47619048
2017020988,30,3455,0.0,24,20,2,0,4,83.33333333
2017020988,53,3600,0.0,35,32,9,0,3,91.42857143
2017020989,29,3600,0.0,34,29,1,1,5,85.29411765
2017020989,26,3600,0.0,32,30,2,0,2,93.75
2017020990,16,2400,0.0,28,22,2,0,6,78.57142857
2017020990,16,1200,0.0,6,5,0,0,1,83.33333333
2017020990,28,3578,0.0,34,32,2,0,2,94.11764706
2017020991,8,3598,0.0,35,32,8,0,3,91.42857143
2017020991,2,3513,0.0,24,19,1,0,5,79.16666667
2017020992,7,3595,0.0,30,26,4,3,4,86.66666667
2017020992,13,3565,0.0,25,24,3,0,1,96.0
2017020993,1,3506,0.0,29,27,1,0,2,93.10344828
2017020993,12,3571,0.0,26,25,2,1,1,96.15384615
2017020994,17,3561,0.0,42,38,6,0,4,90.47619048
2017020994,52,3600,0.0,33,30,1,1,3,90.90909091
2017020995,30,1706,0.0,9,7,0,0,2,77.77777778
2017020995,30,1839,0.0,17,12,3,0,5,70.58823529
2017020995,21,3600,0.0,32,31,2,0,1,96.875
2017020996,3,3600,0.0,51,50,10,1,1,98.03921569
2017020996,20,3409,0.0,27,24,4,0,3,88.88888889
2017020997,18,3642,0.0,27,24,5,0,3,88.88888889
2017020997,23,3643,0.0,43,39,2,1,4,90.69767442
2017020998,9,3600,0.0,29,25,3,0,4,86.20689655
2017020998,54,3491,0.0,38,33,3,0,5,86.84210526
2017020999,29,3481,0.0,35,31,4,1,4,88.57142857
2017020999,24,3600,0.0,36,34,8,1,2,94.44444444
2017021000,4,3900,0.0,35,29,0,0,6,82.85714286
2017021000,14,3900,2.0,43,37,10,0,6,86.04651163
2017021001,19,3775,0.0,34,31,0,0,3,91.17647059
2017021001,25,3754,0.0,37,35,3,0,2,94.59459459
2017021002,16,3597,0.0,32,29,5,1,3,90.625
2017021002,26,3518,0.0,24,20,4,1,4,83.33333333
2017021003,8,3726,0.0,50,48,20,0,2,96.0
2017021003,6,3715,0.0,28,27,6,3,1,96.42857143
2017021004,2,3828,0.0,50,47,6,0,3,94.0
2017021004,5,3828,0.0,27,25,3,0,2,92.59259259
2017021005,10,1729,0.0,9,9,0,0,0,100.0
2017021005,10,1870,0.0,25,20,1,0,5,80.0
2017021005,15,3596,0.0,29,27,2,0,2,93.10344828
2017021006,9,3543,0.0,27,25,5,0,2,92.59259259
2017021006,53,3589,0.0,24,23,3,0,1,95.83333333
2017021007,3,3600,0.0,37,35,3,0,2,94.59459459
2017021007,22,3561,2.0,34,31,5,0,3,91.17647059
2017021008,4,3600,0.0,26,22,5,1,4,84.61538462
2017021008,13,3592,0.0,40,39,6,1,1,97.5
2017021009,18,3610,0.0,25,22,3,0,3,88.0
2017021009,21,3634,0.0,31,27,3,1,4,87.09677419
2017021010,16,1640,0.0,10,8,0,0,2,80.0
2017021010,16,1823,0.0,21,17,0,1,4,80.95238095
2017021010,24,3589,0.0,40,37,3,2,3,92.5
2017021011,54,3600,0.0,35,33,3,0,2,94.28571429
2017021011,1,3490,0.0,27,24,4,2,3,88.88888889
2017021012,52,3596,0.0,35,33,5,0,2,94.28571429
2017021012,12,3433,0.0,23,20,0,0,3,86.95652174
2017021013,17,3565,0.0,26,23,3,0,3,88.46153846
2017021013,30,3583,0.0,29,28,4,0,1,96.55172414
2017021014,29,3599,0.0,35,33,8,0,2,94.28571429
2017021014,28,1532,0.0,13,10,0,0,3,76.92307692
2017021014,28,2001,0.0,14,14,0,0,0,100.0
2017021015,10,3452,0.0,24,19,1,0,5,79.16666667
2017021015,7,3600,0.0,41,38,2,0,3,92.68292683
2017021016,20,3756,0.0,32,28,3,2,4,87.5
2017021016,5,3756,0.0,38,35,2,0,3,92.10526316
2017021017,9,3761,0.0,33,31,8,0,2,93.93939394
2017021017,25,1200,0.0,12,12,0,0,0,100.0
2017021017,25,2477,0.0,18,15,3,0,3,83.33333333
2017021018,53,3650,0.0,36,32,9,3,4,88.88888889
2017021018,22,3650,0.0,35,32,2,2,3,91.42857143
2017021019,2,3747,0.0,23,19,1,0,4,82.60869565
2017021019,23,3763,0.0,34,31,8,0,3,91.17647059
2017021020,17,2227,0.0,21,19,1,1,2,90.47619048
2017021020,17,1407,0.0,16,12,3,0,4,75.0
2017021020,6,3634,0.0,35,30,6,3,5,85.71428571
2017021021,8,3544,0.0,33,27,5,1,6,81.81818182
2017021021,1,3588,0.0,33,29,3,0,4,87.87878788
2017021022,52,3600,0.0,31,31,0,0,0,100.0
2017021022,3,3454,0.0,33,31,0,0,2,93.93939394
2017021023,54,3539,0.0,20,17,2,1,3,85.0
2017021023,29,3597,0.0,38,37,3,1,1,97.36842105
2017021024,13,3769,0.0,33,28,0,1,5,84.84848485
2017021024,14,3769,0.0,49,45,7,0,4,91.83673469
2017021025,25,3545,0.0,33,32,12,0,1,96.96969697
2017021025,18,3600,0.0,26,26,5,2,0,100.0
2017021026,12,1416,0.0,13,9,1,0,4,69.23076923
2017021026,12,2174,0.0,18,16,0,0,2,88.88888889
2017021026,30,3600,0.0,31,29,7,0,2,93.5483871
2017021027,21,3609,0.0,27,25,1,0,2,92.59259259
2017021027,16,3609,0.0,34,33,5,0,1,97.05882353
2017021028,15,1987,0.0,8,8,0,0,0,100.0
2017021028,15,1537,0.0,9,6,0,0,3,66.66666667
2017021028,24,3600,0.0,36,36,4,0,0,100.0
2017021029,20,3598,0.0,26,25,4,0,1,96.15384615
2017021029,7,1561,0.0,22,18,0,1,4,81.81818182
2017021029,7,2039,2.0,19,18,1,0,1,94.73684211
2017021030,5,3600,0.0,28,26,4,0,2,92.85714286
2017021030,4,3577,0.0,27,23,5,1,4,85.18518519
2017021031,53,3598,0.0,17,16,0,0,1,94.11764706
2017021031,23,3523,0.0,34,32,3,0,2,94.11764706
2017021032,4,3582,0.0,27,24,3,1,3,88.88888889
2017021032,6,3600,0.0,33,31,9,2,2,93.93939394
2017021033,52,3600,0.0,43,41,9,1,2,95.34883721
2017021033,1,3479,0.0,24,21,2,0,3,87.5
2017021034,21,3626,0.0,44,39,5,0,5,88.63636364
2017021034,29,3634,0.0,27,23,4,0,4,85.18518519
2017021035,7,3868,0.0,40,37,12,2,3,92.5
2017021035,9,3900,0.0,34,31,1,2,3,91.17647059
2017021036,54,3600,0.0,28,28,2,1,0,100.0
2017021036,17,3600,0.0,32,28,6,0,4,87.5
2017021037,3,1955,0.0,31,27,7,0,4,87.09677419
2017021037,3,1529,0.0,14,13,0,0,1,92.85714286
2017021037,14,3600,0.0,30,27,3,0,3,90.0
2017021038,8,3594,0.0,32,27,2,3,5,84.375
2017021038,13,3600,0.0,40,40,9,0,0,100.0
2017021039,24,3527,0.0,28,24,0,1,4,85.71428571
2017021039,18,3595,0.0,33,31,5,2,2,93.93939394
2017021040,12,3543,0.0,24,22,1,0,2,91.66666667
2017021040,16,3447,0.0,40,37,3,1,3,92.5
2017021041,2,3900,0.0,36,35,0,0,1,97.22222222
2017021041,22,3900,0.0,31,30,0,0,1,96.77419355
2017021042,15,3481,0.0,28,26,0,2,2,92.85714286
2017021042,26,3600,0.0,26,25,2,0,1,96.15384615
2017021043,19,3523,0.0,35,34,3,0,1,97.14285714
2017021043,28,3600,0.0,16,16,0,1,0,100.0
2017021044,17,3479,0.0,36,33,3,0,3,91.66666667
2017021044,29,3600,0.0,24,22,1,1,2,91.66666667
2017021045,20,3600,0.0,30,29,2,1,1,96.66666667
2017021045,9,3497,0.0,37,35,1,0,2,94.59459459
2017021046,24,3510,0.0,37,35,1,2,2,94.59459459
2017021046,25,3579,0.0,27,26,3,0,1,96.2962963
2017021047,30,3569,0.0,32,30,0,0,2,93.75
2017021047,23,3531,0.0,35,31,3,0,4,88.57142857
2017021048,16,3535,0.0,39,33,8,1,6,84.61538462
2017021048,6,3591,0.0,27,23,2,3,4,85.18518519
2017021049,54,3900,0.0,32,31,3,2,1,96.875
2017021049,7,3900,0.0,34,33,6,1,1,97.05882353
2017021050,8,3881,0.0,34,32,7,0,2,94.11764706
2017021050,14,3852,0.0,29,27,4,1,2,93.10344828
2017021051,52,3489,0.0,35,33,2,1,2,94.28571429
2017021051,4,3586,0.0,28,27,1,2,1,96.42857143
2017021052,53,3600,0.0,31,26,4,1,5,83.87096774
2017021052,21,753,0.0,4,4,0,0,0,100.0
2017021052,21,2807,0.0,24,22,4,1,2,91.66666667
2017021053,19,3600,0.0,40,38,4,0,2,95.0
2017021053,26,2400,0.0,29,25,4,0,4,86.20689655
2017021053,26,1200,0.0,14,11,0,1,3,78.57142857
2017021054,15,3600,0.0,24,24,1,0,0,100.0
2017021054,28,3511,0.0,25,24,0,0,1,96.0
2017021055,5,2374,0.0,16,12,1,1,4,75.0
2017021055,5,1071,0.0,9,9,0,0,0,100.0
2017021055,10,3600,0.0,40,38,3,0,2,95.0
2017021056,3,3900,0.0,35,32,3,0,3,91.42857143
2017021056,13,3900,0.0,37,34,1,2,3,91.89189189
2017021057,1,3879,0.0,36,34,4,0,2,94.44444444
2017021057,18,3837,0.0,27,25,4,1,2,92.59259259
2017021058,30,3584,0.0,27,24,0,1,3,88.88888889
2017021058,22,3597,0.0,33,32,5,0,1,96.96969697
2017021059,6,3560,0.0,39,36,9,0,3,92.30769231
2017021059,16,3600,0.0,32,31,1,0,1,96.875
2017021060,2,3600,0.0,52,50,14,0,2,96.15384615
2017021060,20,3442,0.0,26,22,1,1,4,84.61538462
2017021061,25,3503,0.0,29,27,7,0,2,93.10344828
2017021061,5,3600,0.0,18,17,3,2,1,94.44444444
2017021062,23,3504,0.0,24,23,3,0,1,95.83333333
2017021062,53,3600,0.0,27,27,1,0,0,100.0
2017021063,12,3504,0.0,21,17,1,0,4,80.95238095
2017021063,3,3600,0.0,44,41,9,0,3,93.18181818
2017021064,54,3600,0.0,40,38,5,3,2,95.0
2017021064,4,3505,0.0,29,26,7,1,3,89.65517241
2017021065,52,3851,0.0,43,40,11,0,3,93.02325581
2017021065,15,3851,0.0,28,26,3,0,2,92.85714286
2017021066,8,3600,0.0,25,20,0,0,5,80.0
2017021066,29,3600,0.0,40,38,8,1,2,95.0
2017021067,9,3600,0.0,38,35,1,2,3,92.10526316
2017021067,13,3497,0.0,25,20,2,0,5,80.0
2017021068,19,3600,0.0,22,20,1,0,2,90.90909091
2017021068,24,3442,0.0,23,19,1,1,4,82.60869565
2017021069,23,3577,0.0,33,30,3,3,3,90.90909091
2017021069,26,3600,0.0,35,35,5,2,0,100.0
2017021070,17,3591,0.0,33,29,3,4,4,87.87878788
2017021070,28,3567,0.0,26,23,1,1,3,88.46153846
2017021071,6,3597,0.0,33,29,2,1,4,87.87878788
2017021071,12,3582,0.0,33,28,4,1,5,84.84848485
2017021072,25,3478,0.0,26,22,4,0,4,84.61538462
2017021072,8,3600,0.0,38,36,6,0,2,94.73684211
2017021073,9,3600,0.0,46,42,7,0,4,91.30434783
2017021073,14,2400,0.0,29,23,0,0,6,79.31034483
2017021073,14,1200,0.0,4,3,0,0,1,75.0
2017021074,52,2976,0.0,30,30,2,2,0,100.0
2017021074,52,525,0.0,15,12,5,0,3,80.0
2017021074,18,3600,0.0,33,32,5,0,1,96.96969697
2017021075,21,3600,0.0,34,33,6,0,1,97.05882353
2017021075,30,3593,0.0,22,17,2,1,5,77.27272727
2017021076,22,3491,0.0,32,31,2,2,1,96.875
2017021076,20,3598,0.0,28,28,2,1,0,100.0
2017021077,26,3900,0.0,29,26,1,4,3,89.65517241
2017021077,53,3900,0.0,37,34,4,0,3,91.89189189
2017021078,25,3900,0.0,33,28,2,1,5,84.84848485
2017021078,10,1974,0.0,15,13,4,0,2,86.66666667
2017021078,10,1825,0.0,20,17,0,0,3,85.0
2017021079,5,3773,0.0,33,29,4,2,4,87.87878788
2017021079,3,3764,0.0,40,37,3,0,3,92.5
2017021080,28,3760,0.0,28,25,1,3,3,89.28571429
2017021080,22,3760,0.0,40,36,3,1,4,90.0
2017021081,1,3593,0.0,42,39,9,2,3,92.85714286
2017021081,54,2249,0.0,17,13,1,1,4,76.47058824
2017021081,54,1351,0.0,11,7,0,0,4,63.63636364
2017021082,23,3532,2.0,37,34,6,0,3,91.89189189
2017021082,24,3600,0.0,32,32,1,1,0,100.0
2017021083,10,3580,0.0,40,38,10,2,2,95.0
2017021083,7,3435,0.0,38,34,2,0,4,89.47368421
2017021084,15,3600,0.0,38,35,10,1,3,92.10526316
2017021084,2,1749,0.0,9,8,0,0,1,88.88888889
2017021084,2,1822,0.0,12,7,1,0,5,58.33333333
2017021085,29,3600,0.0,30,27,5,0,3,90.0
2017021085,4,1403,0.0,10,6,0,0,4,60.0
2017021085,4,2085,0.0,18,18,6,1,0,100.0
2017021086,5,3600,0.0,20,17,1,0,3,85.0
2017021086,8,3484,0.0,38,34,2,0,4,89.47368421
2017021087,6,3415,0.0,28,25,1,4,3,89.28571429
2017021087,13,3600,0.0,46,46,7,0,0,100.0
2017021088,21,3600,0.0,45,44,3,1,1,97.77777778
2017021088,19,3454,0.0,22,19,0,1,3,86.36363636
2017021089,16,2960,0.0,32,30,10,0,2,93.75
2017021089,16,566,0.0,6,3,0,0,3,50.0
2017021089,52,3592,0.0,27,25,4,1,2,92.59259259
2017021090,18,3593,0.0,34,32,12,1,2,94.11764706
2017021090,53,3505,0.0,29,26,4,0,3,89.65517241
2017021091,17,3594,0.0,21,18,3,1,3,85.71428571
2017021091,26,3598,0.0,21,20,1,1,1,95.23809524
2017021092,2,3515,0.0,30,25,5,1,5,83.33333333
2017021092,15,3599,0.0,25,22,6,3,3,88.0
2017021093,25,3768,0.0,25,22,1,0,3,88.0
2017021093,9,3806,0.0,25,23,0,0,2,92.0
2017021094,18,3600,0.0,35,33,6,0,2,94.28571429
2017021094,21,3521,0.0,27,24,9,0,3,88.88888889
2017021095,28,3600,0.0,34,30,4,1,4,88.23529412
2017021095,20,2462,0.0,20,14,2,0,6,70.0
2017021095,20,1076,0.0,7,7,0,0,0,100.0
2017021096,17,3389,0.0,36,32,5,1,4,88.88888889
2017021096,24,3600,0.0,30,28,9,0,2,93.33333333
2017021097,30,3600,0.0,28,26,5,0,2,92.85714286
2017021097,54,3455,0.0,29,26,6,0,3,89.65517241
2017021098,16,3513,0.0,31,27,5,0,4,87.09677419
2017021098,7,3590,0.0,37,34,1,1,3,91.89189189
2017021099,22,3600,0.0,42,40,11,2,2,95.23809524
2017021099,13,3554,0.0,35,32,1,2,3,91.42857143
2017021100,1,3600,0.0,38,38,11,1,0,100.0
2017021100,26,3498,0.0,28,25,6,1,3,89.28571429
2017021101,8,3600,0.0,49,45,7,0,4,91.83673469
2017021101,10,3589,0.0,33,33,0,0,0,100.0
2017021102,6,3600,0.0,23,23,3,0,0,100.0
2017021102,14,3477,0.0,27,24,3,1,3,88.88888889
2017021103,4,3597,0.0,25,23,2,2,2,92.0
2017021103,12,3586,0.0,26,23,2,0,3,88.46153846
2017021104,9,3533,0.0,35,33,2,0,2,94.28571429
2017021104,29,3600,0.0,24,23,0,1,1,95.83333333
2017021105,3,3662,0.0,33,29,0,1,4,87.87878788
2017021105,19,3647,0.0,20,17,1,0,3,85.0
2017021106,30,3590,0.0,31,30,0,0,1,96.77419355
2017021106,53,3504,0.0,32,30,7,1,2,93.75
2017021107,28,3600,0.0,31,28,4,0,3,90.32258065
2017021107,23,3525,0.0,29,25,3,0,4,86.20689655
2017021108,17,3600,0.0,31,26,5,0,5,83.87096774
2017021108,21,3600,0.0,38,37,6,4,1,97.36842105
2017021109,20,3600,0.0,31,27,2,0,4,87.09677419
2017021109,54,3600,0.0,42,42,9,0,0,100.0
2017021110,22,3524,0.0,40,37,4,1,3,92.5
2017021110,14,3600,0.0,30,29,15,2,1,96.66666667
2017021111,12,3600,0.0,29,26,2,3,3,89.65517241
2017021111,2,3477,0.0,39,35,7,2,4,89.74358974
2017021112,15,3480,0.0,34,29,3,1,5,85.29411765
2017021112,4,3600,0.0,28,25,0,0,3,89.28571429
2017021113,19,3770,0.0,30,26,1,1,4,86.66666667
2017021113,16,3811,0.0,41,36,5,0,5,87.80487805
2017021114,25,611,0.0,3,3,0,0,0,100.0
2017021114,25,2870,0.0,20,17,4,0,3,85.0
2017021114,52,3600,0.0,30,28,8,2,2,93.33333333
2017021115,1,3554,0.0,36,32,2,0,4,88.88888889
2017021115,24,3595,0.0,17,15,2,0,2,88.23529412
2017021116,29,3760,0.0,38,34,13,0,4,89.47368421
2017021116,6,3775,0.0,25,20,2,3,5,80.0
2017021117,18,3600,0.0,35,35,3,0,0,100.0
2017021117,7,3576,0.0,32,28,0,0,4,87.5
2017021118,13,3585,0.0,28,28,12,2,0,100.0
2017021118,8,3462,0.0,40,38,3,5,2,95.0
2017021119,26,3816,0.0,27,24,1,1,3,88.88888889
2017021119,30,3853,0.0,30,26,0,0,4,86.66666667
2017021120,20,3514,0.0,28,25,0,3,3,89.28571429
2017021120,53,3600,0.0,44,42,7,0,2,95.45454545
2017021121,5,3566,0.0,39,36,10,1,3,92.30769231
2017021121,2,3592,0.0,37,36,1,2,1,97.2972973
2017021122,29,3593,0.0,32,29,2,2,3,90.625
2017021122,3,3475,0.0,30,26,2,0,4,86.66666667
2017021123,25,3579,0.0,32,28,3,2,4,87.5
2017021123,15,3600,0.0,27,24,7,1,3,88.88888889
2017021124,22,3600,0.0,33,30,5,0,3,90.90909091
2017021124,12,3600,0.0,30,23,0,1,7,76.66666667
2017021125,13,3598,0.0,35,33,4,1,2,94.28571429
2017021125,9,1639,0.0,17,13,0,0,4,76.47058824
2017021125,9,1961,0.0,22,19,0,0,3,86.36363636
2017021126,4,1797,0.0,19,16,2,1,3,84.21052632
2017021126,4,2076,0.0,12,11,0,0,1,91.66666667
2017021126,17,3900,0.0,31,27,2,0,4,87.09677419
2017021127,10,3456,0.0,25,21,1,0,4,84.0
2017021127,14,3600,0.0,30,27,7,0,3,90.0
2017021128,26,3697,0.0,38,36,7,0,2,94.73684211
2017021128,52,3697,0.0,17,16,2,0,1,94.11764706
2017021129,21,3600,0.0,45,44,7,1,1,97.77777778
2017021129,16,3535,0.0,39,35,5,1,4,89.74358974
2017021130,23,3600,0.0,28,24,5,0,4,85.71428571
2017021130,54,1200,0.0,7,7,0,0,0,100.0
2017021130,54,2400,0.0,23,22,1,1,1,95.65217391
2017021131,1,1831,0.0,14,10,0,1,4,71.42857143
2017021131,1,1762,0.0,11,9,0,0,2,81.81818182
2017021131,28,3600,0.0,28,26,6,1,2,92.85714286
2017021132,53,3600,0.0,30,29,6,0,1,96.66666667
2017021132,7,1564,0.0,15,13,3,0,2,86.66666667
2017021132,7,1838,0.0,13,12,2,1,1,92.30769231
2017021133,8,3600,0.0,39,34,1,1,5,87.17948718
2017021133,5,3600,0.0,30,27,4,0,3,90.0
2017021134,6,3630,0.0,20,18,2,0,2,90.0
2017021134,19,3630,0.0,22,21,2,0,1,95.45454545
2017021135,24,3600,0.0,29,29,0,0,0,100.0
2017021135,20,2400,0.0,11,8,1,0,3,72.72727273
2017021135,20,1200,0.0,5,4,0,0,1,80.0
2017021136,14,3588,0.0,41,35,8,0,6,85.36585366
2017021136,2,1659,0.0,12,11,0,0,1,91.66666667
2017021136,2,1882,0.0,24,18,4,0,6,75.0
2017021137,3,3495,0.0,36,32,2,1,4,88.88888889
2017021137,4,3600,0.0,36,33,3,1,3,91.66666667
2017021138,53,3491,0.0,30,24,1,0,6,80.0
2017021138,12,3600,0.0,33,28,5,0,5,84.84848485
2017021139,13,3576,0.0,32,29,3,0,3,90.625
2017021139,29,3600,0.0,33,33,2,2,0,100.0
2017021140,22,3600,0.0,35,33,0,4,2,94.28571429
2017021140,9,3590,0.0,38,32,6,0,6,84.21052632
2017021141,15,3539,0.0,39,39,9,0,0,100.0
2017021141,17,3531,0.0,26,25,7,0,1,96.15384615
2017021142,10,3600,0.0,25,23,4,0,2,92.0
2017021142,18,3585,0.0,28,23,4,0,5,82.14285714
2017021143,23,3600,0.0,41,39,5,0,2,95.12195122
2017021143,16,1778,0.0,18,14,2,2,4,77.77777778
2017021143,16,1822,0.0,9,8,0,1,1,88.88888889
2017021144,26,3600,0.0,30,29,5,2,1,96.66666667
2017021144,21,1947,0.0,20,15,1,0,5,75.0
2017021144,21,1653,0.0,15,13,1,2,2,86.66666667
2017021145,54,3639,0.0,44,42,13,0,2,95.45454545
2017021145,28,3639,0.0,25,24,0,1,1,96.0
2017021146,8,3600,0.0,35,35,5,1,0,100.0
2017021146,7,3529,0.0,22,21,2,0,1,95.45454545
2017021147,1,3627,0.0,43,40,2,1,3,93.02325581
2017021147,5,3624,0.0,34,30,3,0,4,88.23529412
2017021148,23,3590,0.0,25,21,1,1,4,84.0
2017021148,19,3583,0.0,20,19,0,1,1,95.0
2017021149,24,3796,0.0,42,39,2,1,3,92.85714286
2017021149,52,3796,0.0,18,16,3,0,2,88.88888889
2017021150,6,3600,0.0,42,40,14,2,2,95.23809524
2017021150,25,3578,0.0,36,33,7,2,3,91.66666667
2017021151,54,3900,0.0,30,29,4,0,1,96.66666667
2017021151,21,3900,0.0,40,39,3,3,1,97.5
2017021152,20,3600,0.0,33,28,7,1,5,84.84848485
2017021152,28,3600,0.0,38,37,7,0,1,97.36842105
2017021153,17,3514,0.0,29,25,8,0,4,86.20689655
2017021153,10,3580,0.0,41,38,3,0,3,92.68292683
2017021154,15,3600,0.0,21,17,4,0,4,80.95238095
2017021154,8,3495,0.0,30,24,2,1,6,80.0
2017021155,12,3600,0.0,36,34,1,0,2,94.44444444
2017021155,9,3506,0.0,23,19,1,2,4,82.60869565
2017021156,53,3571,0.0,46,43,9,0,3,93.47826087
2017021156,13,3600,0.0,28,26,0,1,2,92.85714286
2017021157,14,3492,0.0,31,29,0,0,2,93.5483871
2017021157,1,3600,0.0,36,35,2,0,1,97.22222222
2017021158,16,3600,0.0,32,31,5,3,1,96.875
2017021158,2,3533,0.0,24,22,2,0,2,91.66666667
2017021159,7,1725,0.0,12,8,0,0,4,66.66666667
2017021159,7,1875,0.0,11,10,0,0,1,90.90909091
2017021159,3,3597,0.0,44,43,7,1,1,97.72727273
2017021160,19,3600,0.0,34,33,3,1,1,97.05882353
2017021160,29,3498,0.0,28,26,0,2,2,92.85714286
2017021161,18,3560,0.0,29,26,5,2,3,89.65517241
2017021161,30,3600,2.0,20,19,0,1,1,95.0
2017021162,26,3526,0.0,27,24,1,1,3,88.88888889
2017021162,22,3600,0.0,29,27,0,2,2,93.10344828
2017021163,4,2314,0.0,21,19,0,0,2,90.47619048
2017021163,4,1357,0.0,11,8,1,0,3,72.72727273
2017021163,5,3706,0.0,45,41,8,0,4,91.11111111
2017021164,23,3600,0.0,31,30,2,0,1,96.77419355
2017021164,25,3474,0.0,26,23,7,1,3,88.46153846
2017021165,18,3888,0.0,47,43,5,0,4,91.4893617
2017021165,52,3890,0.0,36,32,7,1,4,88.88888889
2017021166,6,3628,0.0,25,24,5,1,1,96.0
2017021166,30,3628,0.0,28,26,3,0,2,92.85714286
2017021167,24,3672,0.0,32,28,3,0,4,87.5
2017021167,22,3681,0.0,38,33,2,0,5,86.84210526
2017021168,7,3600,0.0,41,39,2,0,2,95.12195122
2017021168,10,3464,0.0,27,24,0,0,3,88.88888889
2017021169,13,3600,0.0,32,32,11,0,0,100.0
2017021169,2,3490,0.0,41,38,13,0,3,92.68292683
2017021170,15,3574,0.0,30,28,4,0,2,93.33333333
2017021170,3,2922,0.0,27,26,6,0,1,96.2962963
2017021170,3,534,0.0,6,3,0,1,3,50.0
2017021171,9,3581,0.0,29,26,1,0,3,89.65517241
2017021171,12,3600,0.0,20,19,4,0,1,95.0
2017021172,17,3432,0.0,31,27,5,0,4,87.09677419
2017021172,8,3535,0.0,28,26,2,0,2,92.85714286
2017021173,53,3600,0.0,20,19,1,0,1,95.0
2017021173,14,3504,0.0,34,31,6,0,3,91.17647059
2017021174,28,3900,0.0,31,28,4,2,3,90.32258065
2017021174,16,3898,0.0,38,35,3,0,3,92.10526316
2017021175,21,3453,0.0,29,26,6,1,3,89.65517241
2017021175,54,3600,0.0,29,28,5,0,1,96.55172414
2017021176,20,3584,0.0,29,26,9,1,3,89.65517241
2017021176,26,3584,0.0,23,23,2,1,0,100.0
2017021177,12,3515,0.0,45,41,7,2,4,91.11111111
2017021177,1,3595,0.0,34,31,2,0,3,91.17647059
2017021178,2,3592,0.0,36,33,2,3,3,91.66666667
2017021178,9,3511,0.0,31,27,2,1,4,87.09677419
2017021179,5,3452,0.0,25,21,1,2,4,84.0
2017021179,17,3575,0.0,24,22,0,1,2,91.66666667
2017021180,28,3737,0.0,32,29,0,1,3,90.625
2017021180,19,3753,0.0,24,22,0,0,2,91.66666667
2017021181,30,3900,2.0,29,28,4,0,1,96.55172414
2017021181,18,3874,0.0,23,22,0,3,1,95.65217391
2017021182,6,3869,0.0,32,28,3,0,4,87.5
2017021182,52,3900,0.0,32,28,7,0,4,87.5
2017021183,4,3640,0.0,23,20,1,0,3,86.95652174
2017021183,25,3640,2.0,33,31,2,0,2,93.93939394
2017021184,29,3600,0.0,25,22,2,1,3,88.0
2017021184,22,1584,0.0,18,13,2,0,5,72.22222222
2017021184,22,1987,0.0,9,7,2,1,2,77.77777778
2017021185,24,3428,0.0,29,26,1,1,3,89.65517241
2017021185,23,3579,0.0,24,23,1,1,1,95.83333333
2017021186,13,3499,0.0,35,31,2,1,4,88.57142857
2017021186,10,3598,0.0,33,30,4,0,3,90.90909091
2017021187,3,3636,0.0,33,30,5,1,3,90.90909091
2017021187,15,3609,0.0,37,35,13,0,2,94.59459459
2017021188,4,1891,0.0,17,17,3,0,0,100.0
2017021188,4,1687,0.0,11,10,0,0,1,90.90909091
2017021188,21,3502,0.0,33,31,5,1,2,93.93939394
2017021189,53,3600,0.0,29,27,5,0,2,93.10344828
2017021189,54,3472,0.0,32,29,0,0,3,90.625
2017021190,14,3513,2.0,29,26,5,0,3,89.65517241
2017021190,6,3600,4.0,28,26,5,0,2,92.85714286
2017021191,17,3585,0.0,32,29,9,3,3,90.625
2017021191,7,1183,0.0,12,9,5,0,3,75.0
2017021191,7,2400,0.0,20,17,6,2,3,85.0
2017021192,5,3619,0.0,31,28,4,0,3,90.32258065
2017021192,1,3606,0.0,35,31,5,1,4,88.57142857
2017021193,13,3882,0.0,30,27,0,0,3,90.0
2017021193,9,3884,0.0,26,24,1,0,2,92.30769231
2017021194,28,3484,0.0,31,27,5,2,4,87.09677419
2017021194,18,3595,0.0,42,39,19,1,3,92.85714286
2017021195,25,3467,0.0,21,17,2,0,4,80.95238095
2017021195,30,3600,0.0,31,29,5,1,2,93.5483871
2017021196,52,3600,0.0,42,36,1,0,6,85.71428571
2017021196,16,2759,0.0,27,25,0,1,2,92.59259259
2017021196,16,841,0.0,7,7,1,0,0,100.0
2017021197,29,3600,0.0,38,37,2,0,1,97.36842105
2017021197,20,3600,0.0,28,23,3,0,5,82.14285714
2017021198,22,3513,0.0,30,28,0,2,2,93.33333333
2017021198,23,3589,0.0,36,35,3,2,1,97.22222222
2017021199,53,3531,0.0,34,31,6,0,3,91.17647059
2017021199,26,3600,0.0,22,20,4,2,2,90.90909091
2017021200,10,3596,0.0,33,29,3,1,4,87.87878788
2017021200,2,3498,0.0,32,27,4,0,5,84.375
2017021201,14,3600,0.0,31,28,4,0,3,90.32258065
2017021201,3,3569,0.0,49,43,3,0,6,87.75510204
2017021202,12,3600,0.0,21,20,1,2,1,95.23809524
2017021202,15,3572,0.0,29,26,0,2,3,89.65517241
2017021203,16,3600,2.0,36,31,1,0,5,86.11111111
2017021203,21,3211,0.0,30,30,0,0,0,100.0
2017021203,21,385,0.0,3,3,0,0,0,100.0
2017021204,26,3881,0.0,33,31,1,0,2,93.93939394
2017021204,24,3881,0.0,29,28,0,0,1,96.55172414
2017021205,19,3622,0.0,26,22,0,0,4,84.61538462
2017021205,54,3607,2.0,24,21,2,0,3,87.5
2017021206,13,1408,0.0,9,9,0,0,0,100.0
2017021206,13,2192,0.0,24,19,1,0,5,79.16666667
2017021206,6,3600,0.0,31,30,2,0,1,96.77419355
2017021207,9,3584,0.0,27,25,5,0,2,92.59259259
2017021207,17,3600,0.0,31,31,8,2,0,100.0
2017021208,29,3621,0.0,29,24,1,2,5,82.75862069
2017021208,23,3681,0.0,30,26,0,0,4,86.66666667
2017021209,52,3597,0.0,29,28,3,2,1,96.55172414
2017021209,10,3498,0.0,29,26,3,1,3,89.65517241
2017021210,2,3508,0.0,35,31,2,1,4,88.57142857
2017021210,1,3600,0.0,30,27,2,0,3,90.0
2017021211,8,3600,0.0,33,28,6,0,5,84.84848485
2017021211,5,3600,0.0,26,24,1,2,2,92.30769231
2017021212,3,3600,0.0,41,40,7,0,1,97.56097561
2017021212,12,3438,0.0,20,18,4,0,2,90.0
2017021213,7,3600,0.0,36,32,9,1,4,88.88888889
2017021213,18,1024,0.0,7,6,1,0,1,85.71428571
2017021213,18,2400,0.0,29,23,8,1,6,79.31034483
2017021214,30,3518,2.0,35,32,5,1,3,91.42857143
2017021214,25,3561,0.0,34,33,2,1,1,97.05882353
2017021215,19,1431,0.0,14,12,3,0,2,85.71428571
2017021215,19,2169,0.0,19,15,0,1,4,78.94736842
2017021215,53,3600,0.0,34,34,2,0,0,100.0
2017021216,22,2594,0.0,13,13,2,0,0,100.0
2017021216,22,928,0.0,7,4,0,1,3,57.14285714
2017021216,20,3600,2.0,36,34,5,2,2,94.44444444
2017021217,28,3521,0.0,38,35,7,0,3,92.10526316
2017021217,54,3600,0.0,31,29,1,0,2,93.5483871
2017021218,6,3720,0.0,24,20,1,2,4,83.33333333
2017021218,4,3816,0.0,39,36,7,0,3,92.30769231
2017021219,18,3600,0.0,30,29,6,0,1,96.66666667
2017021219,14,3558,0.0,25,21,1,1,4,84.0
2017021220,1,3595,2.0,26,25,7,1,1,96.15384615
2017021220,8,3553,0.0,32,30,11,0,2,93.75
2017021221,15,3580,0.0,37,36,12,1,1,97.2972973
2017021221,5,3571,0.0,34,31,8,3,3,91.17647059
2017021222,21,3694,0.0,42,38,8,0,4,90.47619048
2017021222,24,1199,0.0,10,9,1,0,1,90.0
2017021222,24,2494,0.0,21,19,2,0,2,90.47619048
2017021223,7,3591,0.0,36,31,4,0,5,86.11111111
2017021223,10,3600,0.0,34,32,5,1,2,94.11764706
2017021224,52,3600,0.0,37,32,4,3,5,86.48648649
2017021224,9,3521,0.0,40,34,5,2,6,85.0
2017021225,12,3455,2.0,35,32,1,1,3,91.42857143
2017021225,13,3600,0.0,29,27,0,0,2,93.10344828
2017021226,15,3552,0.0,36,34,4,0,2,94.44444444
2017021226,19,3509,0.0,33,30,1,1,3,90.90909091
2017021227,22,3528,0.0,39,37,2,1,2,94.87179487
2017021227,30,3600,0.0,22,22,2,1,0,100.0
2017021228,21,3448,0.0,25,22,3,0,3,88.0
2017021228,26,3600,0.0,28,27,6,0,1,96.42857143
2017021229,3,3598,0.0,44,39,1,2,5,88.63636364
2017021229,1,3579,0.0,24,22,1,1,2,91.66666667
2017021230,4,3500,0.0,37,32,3,0,5,86.48648649
2017021230,2,3547,0.0,31,27,2,0,4,87.09677419
2017021231,17,3775,0.0,41,36,3,0,5,87.80487805
2017021231,29,3769,0.0,27,23,2,2,4,85.18518519
2017021232,52,3780,0.0,40,36,7,0,4,90.0
2017021232,8,3766,0.0,32,27,2,2,5,84.375
2017021233,6,3600,0.0,36,32,5,0,4,88.88888889
2017021233,14,3581,0.0,33,33,0,3,0,100.0
2017021234,18,3492,0.0,33,31,1,0,2,93.93939394
2017021234,13,3600,0.0,46,45,0,0,1,97.82608696
2017021235,53,3570,0.0,43,42,8,2,1,97.6744186
2017021235,20,3600,0.0,21,17,3,0,4,80.95238095
2017021236,54,3900,0.0,25,21,2,1,4,84.0
2017021236,23,3900,0.0,39,35,3,0,4,89.74358974
2017021237,25,2646,0.0,17,17,0,0,0,100.0
2017021237,25,954,0.0,14,12,1,1,2,85.71428571
2017021237,28,3532,0.0,22,19,1,1,3,86.36363636
2017021238,9,3600,0.0,34,32,2,0,2,94.11764706
2017021238,7,3514,0.0,31,28,3,1,3,90.32258065
2017021239,16,3600,0.0,34,31,5,1,3,91.17647059
2017021239,19,3591,0.0,26,22,1,0,4,84.61538462
2017021240,30,3590,0.0,29,27,2,0,2,93.10344828
2017021240,24,3600,0.0,27,26,2,0,1,96.2962963
2017021241,10,3443,0.0,39,37,2,1,2,94.87179487
2017021241,1,3600,0.0,32,31,0,2,1,96.875
2017021242,3,3515,0.0,22,20,0,3,2,90.90909091
2017021242,2,3600,0.0,35,34,9,1,1,97.14285714
2017021243,12,3492,0.0,34,30,0,0,4,88.23529412
2017021243,4,3600,0.0,22,19,1,0,3,86.36363636
2017021244,18,3600,0.0,32,29,2,0,3,90.625
2017021244,15,3463,0.0,29,25,3,1,4,86.20689655
2017021245,5,3620,0.0,30,26,4,0,4,86.66666667
2017021245,29,3666,0.0,43,38,1,0,5,88.37209302
2017021246,8,3600,0.0,26,23,7,0,3,88.46153846
2017021246,17,3530,0.0,28,24,0,0,4,85.71428571
2017021247,6,3542,0.0,35,32,5,0,3,91.42857143
2017021247,13,3600,0.0,28,26,0,0,2,92.85714286
2017021248,20,3540,0.0,26,24,6,3,2,92.30769231
2017021248,52,3593,0.0,32,31,6,2,1,96.875
2017021249,54,3492,0.0,33,29,4,0,4,87.87878788
2017021249,22,3585,0.0,33,30,5,1,3,90.90909091
2017021250,53,3753,0.0,40,36,3,1,4,90.0
2017021250,23,3753,0.0,19,16,2,0,3,84.21052632
2017021251,30,3586,0.0,28,23,7,0,5,82.14285714
2017021251,26,3589,0.0,27,23,3,0,4,85.18518519
2017021252,21,3523,0.0,35,32,4,0,3,91.42857143
2017021252,28,3586,0.0,25,23,2,1,2,92.0
2017021253,9,3600,0.0,23,19,3,1,4,82.60869565
2017021253,5,3600,0.0,35,35,3,7,0,100.0
2017021254,7,3474,0.0,33,27,3,0,6,81.81818182
2017021254,14,3567,0.0,32,27,6,1,5,84.375
2017021255,19,3600,0.0,20,19,2,0,1,95.0
2017021255,16,3496,0.0,34,31,4,0,3,91.17647059
2017021256,25,3434,0.0,33,28,8,0,5,84.84848485
2017021256,24,3595,0.0,26,23,4,1,3,88.46153846
2017021257,3,3600,0.0,40,35,2,1,5,87.5
2017021257,4,3567,0.0,17,17,1,0,0,100.0
2017021258,9,3509,0.0,34,30,2,0,4,88.23529412
2017021258,6,3591,0.0,28,26,4,2,2,92.85714286
2017021259,8,3526,0.0,30,26,5,2,4,86.66666667
2017021259,10,3600,0.0,33,31,6,0,2,93.93939394
2017021260,2,3714,0.0,39,36,0,0,3,92.30769231
2017021260,17,3784,0.0,40,36,1,0,4,90.0
2017021261,7,1200,0.0,12,9,2,0,3,75.0
2017021261,7,2319,0.0,14,14,4,0,0,100.0
2017021261,13,3597,0.0,41,38,2,0,3,92.68292683
2017021262,1,3600,0.0,26,21,2,0,5,80.76923077
2017021262,15,3600,0.0,26,23,2,2,3,88.46153846
2017021263,14,3649,0.0,42,39,1,0,3,92.85714286
2017021263,12,3648,0.0,34,32,2,0,2,94.11764706
2017021264,16,3600,0.0,39,35,5,0,4,89.74358974
2017021264,52,3600,0.0,31,30,1,1,1,96.77419355
2017021265,29,3586,0.0,26,23,2,0,3,88.46153846
2017021265,18,1200,0.0,8,7,0,0,1,87.5
2017021265,18,2400,0.0,23,22,2,1,1,95.65217391
2017021266,19,3341,0.0,37,34,3,0,3,91.89189189
2017021266,21,3585,0.0,34,32,3,1,2,94.11764706
2017021267,24,3600,0.0,31,31,3,0,0,100.0
2017021267,53,3484,0.0,26,24,3,1,2,92.30769231
2017021268,54,2400,0.0,18,12,1,1,6,66.66666667
2017021268,54,1200,0.0,13,12,3,0,1,92.30769231
2017021268,20,3571,0.0,27,26,6,1,1,96.2962963
2017021269,23,3898,0.0,33,31,0,0,2,93.93939394
2017021269,22,3898,0.0,38,36,4,0,2,94.73684211
2017021270,25,3600,0.0,36,34,1,0,2,94.44444444
2017021270,26,3515,0.0,18,14,2,0,4,77.77777778
2017021271,30,3600,0.0,30,27,3,1,3,90.0
2017021271,28,2400,0.0,19,14,0,0,5,73.68421053
2017021271,28,1022,0.0,4,4,0,0,0,100.0
2017030111,1,3518,0.0,31,27,3,0,4,87.09677419
2017030111,14,3600,0.0,31,29,6,0,2,93.5483871
2017030112,1,1471,0.0,10,10,0,0,0,100.0
2017030112,1,1992,0.0,15,10,2,0,5,66.66666667
2017030112,14,3600,0.0,44,41,6,0,3,93.18181818
2017030113,14,3574,0.0,39,36,12,5,3,92.30769231
2017030113,1,3595,0.0,36,34,6,3,2,94.44444444
2017030114,14,3591,0.0,28,27,5,0,1,96.42857143
2017030114,1,3565,0.0,36,34,8,1,2,94.44444444
2017030115,1,3471,0.0,37,35,13,0,2,94.59459459
2017030115,14,3557,0.0,27,26,3,1,1,96.2962963
2017030121,10,3600,0.0,40,35,6,0,5,87.5
2017030121,6,3586,0.0,27,26,6,2,1,96.2962963
2017030122,10,2842,0.0,23,19,2,1,4,82.60869565
2017030122,10,733,0.0,5,2,1,0,3,40.0
2017030122,6,3600,0.0,33,30,5,0,3,90.90909091
2017030123,6,3459,0.0,30,26,1,0,4,86.66666667
2017030123,10,3600,0.0,42,40,2,0,2,95.23809524
2017030124,6,3600,0.0,32,31,1,0,1,96.875
2017030124,10,3428,0.0,21,18,0,1,3,85.71428571
2017030125,10,3600,0.0,45,42,11,0,3,93.33333333
2017030125,6,1597,0.0,8,8,0,1,0,100.0
2017030125,6,1915,0.0,13,9,0,0,4,69.23076923
2017030126,6,3529,0.0,29,27,4,1,2,93.10344828
2017030126,10,3600,0.0,33,32,1,0,1,96.96969697
2017030127,10,3475,0.0,35,29,4,2,6,82.85714286
2017030127,6,3600,0.0,24,20,2,0,4,83.33333333
2017030131,29,3956,0.0,30,27,10,0,3,90.0
2017030131,15,3933,0.0,27,23,3,1,4,85.18518519
2017030132,29,4342,0.0,58,54,10,5,4,93.10344828
2017030132,15,2390,0.0,22,18,3,0,4,81.81818182
2017030132,15,1935,0.0,8,7,1,1,1,87.5
2017030133,15,5340,0.0,35,33,2,2,2,94.28571429
2017030133,29,5340,0.0,45,42,8,1,3,93.33333333
2017030134,15,3595,0.0,24,23,0,0,1,95.83333333
2017030134,29,3530,0.0,32,29,4,0,3,90.625
2017030135,29,4313,0.0,29,25,6,0,4,86.20689655
2017030135,15,4313,0.0,42,39,7,0,3,92.85714286
2017030136,15,3600,0.0,38,35,9,0,3,92.10526316
2017030136,29,3446,0.0,27,22,5,0,5,81.48148148
2017030141,4,1741,0.0,19,14,0,2,5,73.68421053
2017030141,4,1859,0.0,14,12,1,0,2,85.71428571
2017030141,5,3600,0.0,24,24,0,2,0,100.0
2017030142,4,3600,0.0,35,34,3,1,1,97.14285714
2017030142,5,3360,0.0,19,15,2,2,4,78.94736842
2017030143,5,3595,0.0,27,26,11,1,1,96.2962963
2017030143,4,3600,0.0,26,21,6,0,5,80.76923077
2017030144,5,3600,0.0,26,26,3,2,0,100.0
2017030144,4,1684,0.0,17,14,0,1,3,82.35294118
2017030144,4,1916,0.0,13,11,3,0,2,84.61538462
2017030145,4,3600,0.0,32,30,4,0,2,93.75
2017030145,5,3558,0.0,24,21,2,3,3,87.5
2017030146,5,3549,0.0,26,21,2,0,5,80.76923077
2017030146,4,3474,0.0,27,20,1,0,7,74.07407407
2017030151,21,3554,0.0,30,26,1,0,4,86.66666667
2017030151,18,3600,0.0,27,25,4,2,2,92.59259259
2017030152,21,3499,0.0,32,28,8,0,4,87.5
2017030152,18,3600,0.0,30,26,3,1,4,86.66666667
2017030153,18,2014,0.0,18,18,7,0,0,100.0
2017030153,18,1465,0.0,15,11,1,1,4,73.33333333
2017030153,21,3596,0.0,32,29,3,7,3,90.625
2017030154,18,3600,0.0,33,31,7,0,2,93.93939394
2017030154,21,1052,0.0,8,8,3,1,0,100.0
2017030154,21,2375,0.0,26,23,2,1,3,88.46153846
2017030155,21,3597,0.0,45,44,3,2,1,97.77777778
2017030155,18,3507,0.0,27,25,2,1,2,92.59259259
2017030156,18,3600,0.0,22,22,0,0,0,100.0
2017030156,21,3600,0.0,37,32,3,0,5,86.48648649
2017030161,30,3459,0.0,40,37,2,0,3,92.5
2017030161,52,3569,0.0,20,18,2,1,2,90.0
2017030162,30,3600,0.0,44,40,6,0,4,90.90909091
2017030162,52,3600,0.0,17,16,4,1,1,94.11764706
2017030163,52,2400,0.0,22,16,5,0,6,72.72727273
2017030163,52,1200,0.0,7,7,0,0,0,100.0
2017030163,30,3600,0.0,31,29,3,0,2,93.5483871
2017030164,52,3600,2.0,30,30,3,0,0,100.0
2017030164,30,3498,0.0,27,26,1,0,1,96.2962963
2017030165,30,2881,0.0,16,15,2,0,1,93.75
2017030165,30,719,0.0,10,6,0,0,4,60.0
2017030165,52,3600,0.0,30,30,3,0,0,100.0
2017030171,26,3529,0.0,28,27,5,2,1,96.42857143
2017030171,54,3588,0.0,30,30,6,0,0,100.0
2017030172,26,5723,0.0,56,54,8,1,2,96.42857143
2017030172,54,5718,0.0,30,29,4,0,1,96.66666667
2017030173,54,3600,0.0,39,37,9,2,2,94.87179487
2017030173,26,3516,0.0,26,23,3,2,3,88.46153846
2017030174,54,3595,0.0,31,31,1,0,0,100.0
2017030174,26,3518,0.0,21,20,2,0,1,95.23809524
2017030181,28,3579,0.0,25,25,3,8,0,100.0
2017030181,24,3599,0.0,34,31,9,1,3,91.17647059
2017030182,28,3600,0.0,30,28,3,1,2,93.33333333
2017030182,24,3508,0.0,35,32,7,2,3,91.42857143
2017030183,24,2383,0.0,24,19,7,0,5,79.16666667
2017030183,24,1200,0.0,12,9,4,0,3,75.0
2017030183,28,3600,0.0,46,45,7,5,1,97.82608696
2017030184,24,3501,0.0,24,22,3,1,2,91.66666667
2017030184,28,3600,0.0,31,30,6,0,1,96.77419355
2017030211,6,3585,0.0,36,34,3,0,2,94.44444444
2017030211,14,3558,0.0,23,18,0,0,5,78.26086957
2017030212,6,3514,0.0,30,27,5,0,3,90.0
2017030212,14,3600,0.0,20,18,6,1,2,90.0
2017030213,14,3600,0.0,29,28,1,2,1,96.55172414
2017030213,6,3497,0.0,36,33,7,0,3,91.66666667
2017030214,14,3764,0.0,32,29,8,2,3,90.625
2017030214,6,3798,0.0,28,24,4,0,4,85.71428571
2017030215,6,3527,0.0,21,19,2,0,2,90.47619048
2017030215,14,3600,0.0,28,27,5,0,1,96.42857143
2017030221,5,3600,0.0,34,32,1,1,2,94.11764706
2017030221,15,3491,0.0,25,22,2,0,3,88.0
2017030222,5,3468,0.0,31,28,3,4,3,90.32258065
2017030222,15,3600,0.0,33,32,5,0,1,96.96969697
2017030223,15,3600,0.0,22,19,6,1,3,86.36363636
2017030223,5,3562,0.0,22,18,4,0,4,81.81818182
2017030224,15,3529,0.0,23,21,3,1,2,91.30434783
2017030224,5,3600,0.0,21,20,4,1,1,95.23809524
2017030225,5,3516,0.0,30,26,1,2,4,86.66666667
2017030225,15,3600,0.0,39,36,8,1,3,92.30769231
2017030226,15,3927,0.0,22,21,1,1,1,95.45454545
2017030226,5,3927,0.0,30,28,0,1,2,93.33333333
2017030231,52,3600,0.0,48,47,5,0,1,97.91666667
2017030231,18,1080,0.0,2,2,0,0,0,100.0
2017030231,18,2395,0.0,16,13,0,0,3,81.25
2017030232,52,5090,0.0,41,36,2,3,5,87.80487805
2017030232,18,5137,0.0,50,46,2,0,4,92.0
2017030233,18,3542,2.0,43,38,6,1,5,88.37209302
2017030233,52,3583,0.0,30,26,3,3,4,86.66666667
2017030234,18,3584,0.0,33,32,3,0,1,96.96969697
2017030234,52,3489,0.0,29,27,4,0,2,93.10344828
2017030235,52,3600,0.0,40,38,4,1,2,95.0
2017030235,18,817,0.0,6,6,3,0,0,100.0
2017030235,18,2783,0.0,26,20,1,0,6,76.92307692
2017030236,18,3600,0.0,34,34,4,2,0,100.0
2017030236,52,3565,0.0,28,25,0,4,3,89.28571429
2017030237,52,3600,0.0,37,36,6,0,1,97.2972973
2017030237,18,2909,0.0,16,14,1,0,2,87.5
2017030237,18,631,0.0,7,5,0,0,2,71.42857143
2017030241,28,1406,0.0,13,8,1,0,5,61.53846154
2017030241,28,2178,0.0,21,19,10,0,2,90.47619048
2017030241,54,3592,0.0,33,33,15,4,0,100.0
2017030242,28,5112,0.0,29,26,1,2,3,89.65517241
2017030242,54,5113,0.0,47,43,7,1,4,91.4893617
2017030243,54,4095,2.0,42,39,10,1,3,92.85714286
2017030243,28,4097,0.0,33,29,7,0,4,87.87878788
2017030244,54,3576,0.0,34,30,9,1,4,88.23529412
2017030244,28,3600,0.0,34,34,10,0,0,100.0
2017030245,28,2913,0.0,31,27,3,2,4,87.09677419
2017030245,28,624,0.0,7,7,1,0,0,100.0
2017030245,54,3600,0.0,30,27,1,3,3,90.0
2017030246,54,3600,0.0,28,28,4,1,0,100.0
2017030246,28,3573,0.0,32,30,3,2,2,93.75
2017030311,15,3600,0.0,21,19,2,1,2,90.47619048
2017030311,14,1105,0.0,7,7,1,0,0,100.0
2017030311,14,2400,0.0,25,21,3,0,4,84.0
2017030312,15,3600,0.0,35,33,6,1,2,94.28571429
2017030312,14,3600,2.0,37,31,3,0,6,83.78378378
2017030313,14,3600,0.0,38,36,7,0,2,94.73684211
2017030313,15,3413,2.0,23,19,4,0,4,82.60869565
2017030314,14,3597,0.0,38,36,9,0,2,94.73684211
2017030314,15,3447,0.0,19,16,1,0,3,84.21052632
2017030315,15,3466,0.0,22,19,2,0,3,86.36363636
2017030315,14,3600,0.0,30,28,0,0,2,93.33333333
2017030316,14,3536,0.0,33,31,3,2,2,93.93939394
2017030316,15,3600,0.0,24,24,1,1,0,100.0
2017030317,15,3600,0.0,29,29,0,0,0,100.0
2017030317,14,3572,0.0,22,19,1,0,3,86.36363636
2017030321,54,3441,0.0,26,22,4,1,4,84.61538462
2017030321,52,3592,0.0,21,19,1,2,2,90.47619048
2017030322,54,3600,0.0,31,30,3,0,1,96.77419355
2017030322,52,3464,0.0,28,25,6,1,3,89.28571429
2017030323,52,3538,0.0,29,26,4,1,3,89.65517241
2017030323,54,3600,0.0,35,33,2,1,2,94.28571429
2017030324,52,3509,0.0,29,26,4,0,3,89.65517241
2017030324,54,3600,0.0,37,35,11,0,2,94.59459459
2017030325,54,3597,0.0,32,31,6,0,1,96.875
2017030325,52,3508,0.0,32,30,1,2,2,93.75
2017030411,15,3492,0.0,33,28,0,0,5,84.84848485
2017030411,54,3600,0.0,28,24,0,0,4,85.71428571
2017030412,15,3600,0.0,39,37,10,0,2,94.87179487
2017030412,54,3481,0.0,26,23,2,0,3,88.46153846
2017030413,54,3443,2.0,26,23,4,0,3,88.46153846
2017030413,15,3600,0.0,22,21,4,1,1,95.45454545
2017030414,54,3600,0.0,23,17,3,0,6,73.91304348
2017030414,15,3600,0.0,30,28,6,2,2,93.33333333
2017030415,15,3597,0.0,31,28,3,1,3,90.32258065
2017030415,54,3476,0.0,33,29,4,0,4,87.87878788
2018020001,8,3661,0.0,26,23,3,0,3,88.46153846
2018020001,10,3661,0.0,36,34,5,0,2,94.44444444
2018020002,6,1952,0.0,18,16,5,4,2,88.88888889
2018020002,6,1648,0.0,19,14,1,0,5,73.68421053
2018020002,15,3596,0.0,25,25,2,3,0,100.0
2018020003,20,3517,0.0,22,18,3,2,4,81.81818182
2018020003,23,3600,0.0,35,33,6,2,2,94.28571429
2018020004,24,3600,0.0,33,31,1,0,2,93.93939394
2018020004,28,3534,0.0,14,10,0,0,4,71.42857143
2018020005,6,3600,0.0,32,32,2,0,0,100.0
2018020005,7,3309,0.0,25,22,0,1,3,88.0
2018020006,18,3600,0.0,36,34,1,0,2,94.44444444
2018020006,3,3532,0.0,32,30,2,0,2,93.75
2018020007,15,3680,0.0,41,34,2,2,7,82.92682927
2018020007,5,3680,0.0,36,30,2,4,6,83.33333333
2018020008,2,3643,0.0,46,45,3,2,1,97.82608696
2018020008,12,3556,0.0,20,18,2,1,2,90.0
2018020009,16,3638,0.0,25,22,2,2,3,88.0
2018020009,9,3638,0.0,43,39,5,0,4,90.69767442
2018020010,29,3731,0.0,20,18,2,0,2,90.0
2018020010,17,3731,0.0,39,36,11,0,3,92.30769231
2018020011,52,3593,0.0,42,41,12,0,1,97.61904762
2018020011,19,3600,0.0,25,20,3,0,5,80.0
2018020012,53,3600,0.0,25,22,2,1,3,88.0
2018020012,25,3597,0.0,30,30,3,0,0,100.0
2018020013,30,3561,0.0,38,36,6,3,2,94.73684211
2018020013,21,3600,0.0,21,20,7,1,1,95.23809524
2018020014,4,3561,0.0,25,23,4,2,2,92.0
2018020014,54,1811,0.0,16,11,3,0,5,68.75
2018020014,54,1789,0.0,9,9,2,0,0,100.0
2018020015,12,3600,0.0,32,31,1,1,1,96.875
2018020015,29,3522,0.0,35,32,0,2,3,91.42857143
2018020016,28,3774,0.0,21,19,6,0,2,90.47619048
2018020016,26,3774,0.0,33,30,1,3,3,90.90909091
2018020017,3,3463,0.0,28,26,6,1,2,92.85714286
2018020017,7,3577,0.0,44,43,10,0,1,97.72727273
2018020018,9,3600,0.0,37,34,0,0,3,91.89189189
2018020018,10,3406,0.0,23,19,0,0,4,82.60869565
2018020019,13,1941,0.0,13,13,3,0,0,100.0
2018020019,13,1950,0.0,16,15,1,2,1,93.75
2018020019,14,3900,0.0,43,42,12,2,1,97.6744186
2018020020,22,3555,0.0,26,22,0,0,4,84.61538462
2018020020,1,3600,0.0,19,17,0,0,2,89.47368421
2018020021,18,3600,0.0,29,26,8,2,3,89.65517241
2018020021,2,3487,0.0,23,19,1,0,4,82.60869565
2018020022,8,3600,0.0,22,21,3,1,1,95.45454545
2018020022,5,3558,0.0,29,24,2,0,5,82.75862069
2018020023,52,3595,0.0,35,30,12,2,5,85.71428571
2018020023,25,3600,0.0,33,32,5,1,1,96.96969697
2018020024,16,3729,0.0,30,26,6,1,4,86.66666667
2018020024,19,3730,0.0,30,25,2,0,5,83.33333333
2018020025,54,3871,0.0,30,29,3,0,1,96.66666667
2018020025,30,3900,0.0,42,41,3,1,1,97.61904762
2018020026,4,3569,0.0,34,30,6,1,4,88.23529412
2018020026,21,3600,0.0,37,35,6,1,2,94.59459459
2018020027,24,3600,0.0,41,41,6,1,0,100.0
2018020027,53,3545,0.0,20,19,1,0,1,95.0
2018020028,23,3549,0.0,35,30,6,2,5,85.71428571
2018020028,20,3594,0.0,20,16,3,1,4,80.0
2018020029,3,3505,2.0,39,32,9,0,7,82.05128205
2018020029,12,3600,0.0,24,19,5,2,5,79.16666667
2018020030,10,3619,0.0,31,25,1,0,6,80.64516129
2018020030,16,3523,0.0,34,27,2,1,7,79.41176471
2018020031,17,3498,0.0,24,21,3,0,3,87.5
2018020031,26,3600,0.0,38,36,6,0,2,94.73684211
2018020032,9,3585,0.0,29,24,2,2,5,82.75862069
2018020032,6,3600,0.0,31,28,2,3,3,90.32258065
2018020033,28,3381,0.0,29,26,9,1,3,89.65517241
2018020033,2,3581,0.0,35,35,9,0,0,100.0
2018020034,54,3489,0.0,17,13,1,0,4,76.47058824
2018020034,7,3600,0.0,37,35,4,3,2,94.59459459
2018020035,17,3900,0.0,27,25,2,1,2,92.59259259
2018020035,24,3900,0.0,21,19,1,1,2,90.47619048
2018020036,28,3598,0.0,33,31,7,0,2,93.93939394
2018020036,4,3585,0.0,48,40,7,2,8,83.33333333
2018020037,23,3565,0.0,33,28,1,3,5,84.84848485
2018020037,12,3600,0.0,25,22,3,1,3,88.0
2018020038,21,3543,0.0,34,30,7,1,4,88.23529412
2018020038,29,3591,0.0,27,25,5,2,2,92.59259259
2018020039,20,3600,0.0,43,43,9,0,0,100.0
2018020039,18,3600,0.0,27,24,5,0,3,88.88888889
2018020040,26,3501,0.0,39,37,8,0,2,94.87179487
2018020040,52,3600,0.0,17,16,4,1,1,94.11764706
2018020041,10,3600,0.0,34,30,0,0,4,88.23529412
2018020041,25,3554,0.0,29,23,1,0,6,79.31034483
2018020042,4,3573,0.0,35,31,10,1,4,88.57142857
2018020042,9,3516,0.0,44,38,18,4,6,86.36363636
2018020043,54,3587,0.0,28,24,3,1,4,85.71428571
2018020043,15,3600,0.0,31,29,4,1,2,93.5483871
2018020044,53,3881,0.0,25,23,2,0,2,92.0
2018020044,24,3900,0.0,39,37,6,1,2,94.87179487
2018020045,22,3496,0.0,31,28,2,0,3,90.32258065
2018020045,6,3600,0.0,26,25,5,2,1,96.15384615
2018020046,21,3593,0.0,31,30,13,0,1,96.77419355
2018020046,7,3600,2.0,30,24,5,2,6,80.0
2018020047,29,3600,0.0,41,37,3,0,4,90.24390244
2018020047,13,3496,0.0,32,27,5,0,5,84.375
2018020048,15,3585,0.0,36,30,1,1,6,83.33333333
2018020048,1,3596,0.0,21,21,2,1,0,100.0
2018020049,28,3631,0.0,27,24,1,2,3,88.88888889
2018020049,3,3637,0.0,43,41,4,3,2,95.34883721
2018020050,54,3533,0.0,22,18,0,0,4,81.81818182
2018020050,5,3600,0.0,37,35,4,0,2,94.59459459
2018020051,26,3600,0.0,40,40,4,3,0,100.0
2018020051,8,3584,0.0,29,26,2,1,3,89.65517241
2018020052,10,3592,0.0,29,26,3,1,3,89.65517241
2018020052,17,3517,0.0,34,30,5,4,4,88.23529412
2018020053,23,3600,0.0,34,33,7,0,1,97.05882353
2018020053,14,3486,0.0,26,24,9,1,2,92.30769231
2018020054,20,2400,0.0,24,19,3,2,5,79.16666667
2018020054,20,1042,0.0,8,8,2,0,0,100.0
2018020054,19,3600,0.0,34,31,5,1,3,91.17647059
2018020055,52,3586,0.0,30,27,11,0,3,90.0
2018020055,18,3599,0.0,29,29,5,3,0,100.0
2018020056,16,3805,0.0,46,42,1,1,4,91.30434783
2018020056,30,3774,0.0,30,27,5,1,3,90.0
2018020057,22,3595,0.0,24,23,3,0,1,95.83333333
2018020057,3,3530,0.0,27,25,2,0,2,92.59259259
2018020058,54,3600,0.0,26,26,2,1,0,100.0
2018020058,4,3508,0.0,21,20,4,0,1,95.23809524
2018020059,26,1801,0.0,11,7,1,1,4,63.63636364
2018020059,26,1799,0.0,11,10,0,0,1,90.90909091
2018020059,9,3546,0.0,37,36,9,0,1,97.2972973
2018020060,12,3717,0.0,23,19,4,3,4,82.60869565
2018020060,30,3777,0.0,57,52,21,0,5,91.22807018
2018020061,17,3600,0.0,39,31,2,0,8,79.48717949
2018020061,6,3600,0.0,34,32,6,2,2,94.11764706
2018020062,5,3900,0.0,40,37,5,1,3,92.5
2018020062,8,3900,0.0,28,25,3,1,3,89.28571429
2018020063,29,3550,0.0,31,23,7,3,8,74.19354839
2018020063,14,3600,0.0,32,30,10,1,2,93.75
2018020064,23,3560,0.0,26,24,5,1,2,92.30769231
2018020064,13,3510,0.0,30,27,2,1,3,90.0
2018020065,10,3600,0.0,27,25,3,1,2,92.59259259
2018020065,15,3500,0.0,28,24,4,1,4,85.71428571
2018020066,2,3556,0.0,28,24,2,0,4,85.71428571
2018020066,18,3597,0.0,22,20,2,1,2,90.90909091
2018020067,24,1156,0.0,6,6,0,0,0,100.0
2018020067,24,2400,2.0,44,40,9,0,4,90.90909091
2018020067,25,3571,0.0,25,22,2,1,3,88.0
2018020068,19,3887,0.0,50,46,7,1,4,92.0
2018020068,16,3886,0.0,38,35,7,2,3,92.10526316
2018020069,7,3588,0.0,36,36,7,0,0,100.0
2018020069,53,3600,0.0,23,20,3,0,3,86.95652174
2018020070,20,3640,0.0,26,24,5,0,2,92.30769231
2018020070,21,3621,0.0,41,38,12,1,3,92.68292683
2018020071,28,3496,0.0,36,33,9,3,3,91.66666667
2018020071,1,3574,0.0,39,37,11,2,2,94.87179487
2018020072,24,3597,0.0,31,29,4,0,2,93.5483871
2018020072,19,3456,0.0,31,28,2,0,3,90.32258065
2018020073,12,3482,0.0,25,23,0,1,2,92.0
2018020073,52,3600,0.0,43,42,7,1,1,97.6744186
2018020074,26,3585,0.0,25,21,4,0,4,84.0
2018020074,10,3600,0.0,34,33,3,0,1,97.05882353
2018020075,17,1475,0.0,20,15,4,2,5,75.0
2018020075,17,2125,0.0,15,13,2,0,2,86.66666667
2018020075,8,3600,0.0,28,25,1,0,3,89.28571429
2018020076,25,3328,0.0,23,20,3,1,3,86.95652174
2018020076,9,3600,0.0,38,37,5,1,1,97.36842105
2018020077,30,3474,0.0,27,24,8,0,3,88.88888889
2018020077,18,3600,0.0,31,29,3,1,2,93.5483871
2018020078,25,3587,0.0,34,31,8,1,3,91.17647059
2018020078,1,3581,0.0,24,24,3,5,0,100.0
2018020079,21,3899,0.0,43,41,13,0,2,95.34883721
2018020079,3,3899,0.0,33,31,3,2,2,93.93939394
2018020080,13,3886,0.0,26,21,2,1,5,80.76923077
2018020080,4,1194,0.0,3,2,0,0,1,66.66666667
2018020080,4,2706,0.0,23,19,2,0,4,82.60869565
2018020081,23,3634,0.0,28,26,1,0,2,92.85714286
2018020081,5,3634,0.0,26,23,0,0,3,88.46153846
2018020082,12,3453,0.0,26,23,1,1,3,88.46153846
2018020082,14,3600,0.0,40,38,12,0,2,95.0
2018020083,53,3510,0.0,28,26,1,1,2,92.85714286
2018020083,30,3600,0.0,32,31,0,4,1,96.875
2018020084,22,3666,0.0,33,29,7,0,4,87.87878788
2018020084,52,3685,0.0,35,30,2,0,5,85.71428571
2018020085,7,3335,0.0,28,25,3,0,3,89.28571429
2018020085,54,3599,0.0,27,26,8,2,1,96.2962963
2018020086,19,3586,0.0,23,20,3,2,3,86.95652174
2018020086,8,3592,0.0,25,23,2,1,2,92.0
2018020087,3,3738,0.0,38,34,6,1,4,89.47368421
2018020087,15,3736,0.0,32,29,3,1,3,90.625
2018020088,6,3520,0.0,28,24,2,1,4,85.71428571
2018020088,20,3600,0.0,26,24,2,0,2,92.30769231
2018020089,2,3538,0.0,24,21,3,0,3,87.5
2018020089,24,3600,0.0,35,34,13,1,1,97.14285714
2018020090,5,3600,2.0,38,38,1,0,0,100.0
2018020090,10,3495,0.0,37,36,1,0,1,97.2972973
2018020091,21,3597,0.0,30,27,2,3,3,90.0
2018020091,1,3529,0.0,33,29,4,0,4,87.87878788
2018020092,4,3600,0.0,28,22,2,0,6,78.57142857
2018020092,29,3600,0.0,35,32,5,1,3,91.42857143
2018020093,17,3506,0.0,30,28,9,3,2,93.33333333
2018020093,14,3583,0.0,30,29,6,2,1,96.66666667
2018020094,23,3574,0.0,32,28,0,1,4,87.5
2018020094,52,3600,0.0,27,26,2,0,1,96.2962963
2018020095,53,3600,0.0,34,33,3,0,1,97.05882353
2018020095,16,3429,0.0,30,27,0,2,3,90.0
2018020096,6,3636,0.0,22,19,3,0,3,86.36363636
2018020096,22,3637,0.0,29,27,4,0,2,93.10344828
2018020097,2,424,0.0,5,5,0,0,0,100.0
2018020097,2,3162,0.0,30,28,5,2,2,93.33333333
2018020097,26,2950,2.0,29,23,4,0,6,79.31034483
2018020097,26,640,0.0,3,2,0,0,1,66.66666667
2018020098,7,3506,0.0,38,34,9,2,4,89.47368421
2018020098,28,3600,0.0,25,24,7,1,1,96.0
2018020099,13,1905,0.0,11,10,1,1,1,90.90909091
2018020099,13,1995,0.0,20,16,1,0,4,80.0
2018020099,15,2655,0.0,19,18,5,0,1,94.73684211
2018020099,15,1200,0.0,11,7,0,0,4,63.63636364
2018020100,30,3597,0.0,34,33,9,2,1,97.05882353
2018020100,25,3471,0.0,35,33,2,1,2,94.28571429
2018020101,18,2709,0.0,18,15,1,0,3,83.33333333
2018020101,18,891,0.0,9,9,2,0,0,100.0
2018020101,20,3501,0.0,30,26,3,1,4,86.66666667
2018020102,1,3551,0.0,19,16,2,1,3,84.21052632
2018020102,4,3578,0.0,21,19,2,1,2,90.47619048
2018020103,21,3592,0.0,43,42,9,4,1,97.6744186
2018020103,12,3437,0.0,22,19,7,4,3,86.36363636
2018020104,53,3521,0.0,31,27,10,0,4,87.09677419
2018020104,52,3579,0.0,45,42,9,0,3,93.33333333
2018020105,7,3600,0.0,20,19,2,0,1,95.0
2018020105,26,3319,0.0,25,21,2,0,4,84.0
2018020106,19,3562,0.0,23,22,6,1,1,95.65217391
2018020106,10,3509,0.0,24,21,6,0,3,87.5
2018020107,8,3750,0.0,34,30,6,1,4,88.23529412
2018020107,9,3732,0.0,27,24,3,3,3,88.88888889
2018020108,17,3799,0.0,37,34,6,1,3,91.89189189
2018020108,13,3796,0.0,31,27,0,2,4,87.09677419
2018020109,16,3596,0.0,38,37,11,2,1,97.36842105
2018020109,29,3553,0.0,25,22,3,0,3,88.0
2018020110,14,3807,0.0,34,29,1,3,5,85.29411765
2018020110,30,3823,0.0,31,27,7,0,4,87.09677419
2018020111,18,3600,0.0,31,31,5,0,0,100.0
2018020111,22,3441,0.0,27,25,6,0,2,92.59259259
2018020112,6,3787,0.0,22,20,0,0,2,90.90909091
2018020112,23,3792,0.0,31,30,7,0,1,96.77419355
2018020113,24,3527,0.0,44,42,10,1,2,95.45454545
2018020113,54,3600,2.0,18,17,1,1,1,94.44444444
2018020114,2,3600,0.0,41,37,3,1,4,90.24390244
2018020114,28,3563,0.0,25,24,1,3,1,96.0
2018020115,20,3600,0.0,45,44,0,1,1,97.77777778
2018020115,3,3600,0.0,26,22,2,0,4,84.61538462
2018020116,14,3600,2.0,36,33,9,1,3,91.66666667
2018020116,16,3541,2.0,54,49,4,0,5,90.74074074
2018020117,7,3577,0.0,28,26,5,1,2,92.85714286
2018020117,24,3523,0.0,44,41,9,0,3,93.18181818
2018020118,21,3600,0.0,38,37,7,1,1,97.36842105
2018020118,4,3554,0.0,32,29,5,2,3,90.625
2018020119,12,3600,0.0,21,20,5,0,1,95.23809524
2018020119,17,3500,0.0,38,36,2,0,2,94.73684211
2018020120,19,3747,0.0,36,31,6,0,5,86.11111111
2018020120,52,3739,0.0,34,30,8,2,4,88.23529412
2018020121,15,3587,0.0,24,22,3,1,2,91.66666667
2018020121,23,3576,0.0,32,28,5,1,4,87.5
2018020122,13,2487,0.0,19,15,6,1,4,78.94736842
2018020122,13,1010,0.0,2,2,0,0,0,100.0
2018020122,3,3600,0.0,38,36,5,2,2,94.73684211
2018020123,53,3600,0.0,36,35,2,2,1,97.22222222
2018020123,29,3600,0.0,26,22,1,0,4,84.61538462
2018020124,20,3534,0.0,40,37,8,2,3,92.5
2018020124,8,3600,0.0,23,21,4,1,2,91.30434783
2018020125,6,3600,0.0,39,38,15,0,1,97.43589744
2018020125,9,3600,0.0,32,28,3,0,4,87.5
2018020126,28,3600,0.0,29,25,5,2,4,86.20689655
2018020126,18,3485,0.0,32,27,9,0,5,84.375
2018020127,24,3503,0.0,37,35,8,2,2,94.59459459
2018020127,16,3600,0.0,25,24,8,0,1,96.0
2018020128,26,3414,0.0,23,19,2,0,4,82.60869565
2018020128,25,3600,0.0,33,31,3,1,2,93.93939394
2018020129,5,3732,0.0,46,41,5,0,5,89.13043478
2018020129,22,3722,0.0,31,25,3,2,6,80.64516129
2018020130,13,3633,0.0,22,20,1,0,2,90.90909091
2018020130,2,3626,0.0,41,38,10,1,3,92.68292683
2018020131,10,3600,0.0,40,38,4,0,2,95.0
2018020131,52,3457,0.0,39,35,3,2,4,89.74358974
2018020132,14,3600,0.0,22,22,9,0,0,100.0
2018020132,21,3507,0.0,24,23,7,1,1,95.83333333
2018020133,23,3900,0.0,35,33,3,0,2,94.28571429
2018020133,54,3894,0.0,26,24,1,1,2,92.30769231
2018020134,4,3554,0.0,24,22,6,1,2,91.66666667
2018020134,6,3600,0.0,26,26,6,1,0,100.0
2018020135,8,3546,0.0,42,38,7,0,4,90.47619048
2018020135,7,3600,0.0,22,19,4,0,3,86.36363636
2018020136,18,3812,0.0,36,33,4,1,3,91.66666667
2018020136,1,3815,0.0,36,32,5,0,4,88.88888889
2018020137,29,3596,0.0,37,33,2,1,4,89.18918919
2018020137,19,1862,0.0,11,8,0,0,3,72.72727273
2018020137,19,1738,0.0,21,17,3,0,4,80.95238095
2018020138,26,3501,0.0,24,22,4,0,2,91.66666667
2018020138,30,3586,0.0,24,23,5,1,1,95.83333333
2018020139,3,3526,0.0,36,33,9,2,3,91.66666667
2018020139,16,3585,0.0,19,18,3,0,1,94.73684211
2018020140,24,3600,0.0,41,36,4,0,5,87.80487805
2018020140,25,3600,2.0,25,23,4,1,2,92.0
2018020141,5,3600,0.0,39,38,12,0,1,97.43589744
2018020141,20,1759,0.0,21,15,0,1,6,71.42857143
2018020141,20,1841,0.0,15,12,1,2,3,80.0
2018020142,15,3505,0.0,31,28,3,0,3,90.32258065
2018020142,22,3600,0.0,32,31,0,5,1,96.875
2018020143,23,3593,0.0,29,26,3,2,3,89.65517241
2018020143,53,3600,0.0,28,27,2,1,1,96.42857143
2018020144,14,3600,0.0,31,29,5,1,2,93.5483871
2018020144,54,3435,0.0,23,20,6,1,3,86.95652174
2018020145,52,3584,0.0,28,27,3,2,1,96.42857143
2018020145,17,3517,0.0,40,38,9,0,2,95.0
2018020146,28,3896,0.0,41,38,2,2,3,92.68292683
2018020146,12,3900,0.0,23,20,0,0,3,86.95652174
2018020147,9,3600,0.0,37,31,6,1,6,83.78378378
2018020147,21,3600,0.0,24,21,1,1,3,87.5
2018020148,13,3427,0.0,26,23,3,0,3,88.46153846
2018020148,1,3600,0.0,37,35,7,2,2,94.59459459
2018020149,2,3579,0.0,23,22,0,1,1,95.65217391
2018020149,4,3600,0.0,22,16,5,1,6,72.72727273
2018020150,22,3539,0.0,27,24,6,1,3,88.88888889
2018020150,18,3400,0.0,34,30,8,0,4,88.23529412
2018020151,15,3900,0.0,30,27,3,0,3,90.0
2018020151,20,3836,0.0,27,24,2,0,3,88.88888889
2018020152,8,3593,0.0,33,33,6,0,0,100.0
2018020152,6,3450,2.0,22,20,2,1,2,90.90909091
2018020153,52,3522,0.0,31,28,3,0,3,90.32258065
2018020153,10,3600,0.0,24,22,3,0,2,91.66666667
2018020154,7,3627,0.0,37,32,4,3,5,86.48648649
2018020154,29,3631,0.0,38,34,7,0,4,89.47368421
2018020155,16,3502,0.0,36,30,7,0,6,83.33333333
2018020155,19,1261,0.0,5,5,0,0,0,100.0
2018020155,19,2339,0.0,19,16,1,0,3,84.21052632
2018020156,21,3464,0.0,27,25,8,0,2,92.59259259
2018020156,30,3595,0.0,32,30,10,3,2,93.75
2018020157,14,3600,0.0,30,23,5,4,7,76.66666667
2018020157,53,3600,0.0,31,30,0,3,1,96.77419355
2018020158,5,3600,2.0,29,29,4,2,0,100.0
2018020158,23,3600,0.0,35,30,2,2,5,85.71428571
2018020159,3,3560,0.0,40,36,6,0,4,90.0
2018020159,26,3600,0.0,25,22,3,0,3,88.0
2018020160,25,3534,0.0,22,19,3,0,3,86.36363636
2018020160,17,3600,0.0,30,28,0,0,2,93.33333333
2018020161,2,3600,0.0,39,38,9,2,1,97.43589744
2018020161,12,3489,0.0,20,18,1,1,2,90.0
2018020162,22,3644,0.0,32,31,1,0,1,96.875
2018020162,16,3644,0.0,26,24,3,1,2,92.30769231
2018020163,9,3739,0.0,53,49,13,0,4,92.45283019
2018020163,54,3744,0.0,22,19,0,3,3,86.36363636
2018020164,28,3732,0.0,30,27,3,1,3,90.0
2018020164,24,3732,0.0,49,45,5,1,4,91.83673469
2018020165,20,3594,0.0,25,24,5,0,1,96.0
2018020165,10,3507,0.0,33,31,5,0,2,93.93939394
2018020166,30,3488,0.0,30,26,4,0,4,86.66666667
2018020166,23,3600,0.0,39,37,9,1,2,94.87179487
2018020167,20,3667,0.0,29,28,6,0,1,96.55172414
2018020167,7,3760,0.0,38,36,7,0,2,94.73684211
2018020168,2,1200,0.0,13,12,4,0,1,92.30769231
2018020168,2,2400,0.0,25,23,3,2,2,92.0
2018020168,5,1916,0.0,9,5,2,0,4,55.55555556
2018020168,5,1445,0.0,16,14,2,0,2,87.5
2018020169,6,3600,0.0,44,42,5,3,2,95.45454545
2018020169,12,3459,0.0,31,28,5,4,3,90.32258065
2018020170,17,3600,0.0,37,34,4,1,3,91.89189189
2018020170,29,782,0.0,7,4,0,0,3,57.14285714
2018020170,29,2724,0.0,24,23,0,2,1,95.83333333
2018020171,25,3593,0.0,35,34,1,4,1,97.14285714
2018020171,8,3578,0.0,21,18,3,0,3,85.71428571
2018020172,1,898,0.0,6,5,0,0,1,83.33333333
2018020172,1,2702,0.0,38,31,3,0,7,81.57894737
2018020172,14,3586,0.0,30,27,4,0,3,90.0
2018020173,54,3583,0.0,28,25,4,4,3,89.28571429
2018020173,18,3568,0.0,24,23,5,0,1,95.83333333
2018020174,30,3600,0.0,37,34,7,0,3,91.89189189
2018020174,22,3494,0.0,28,24,4,0,4,85.71428571
2018020175,9,2668,0.0,24,22,0,1,2,91.66666667
2018020175,9,930,0.0,11,8,0,0,3,72.72727273
2018020175,53,3559,0.0,26,25,4,1,1,96.15384615
2018020176,4,3600,0.0,25,23,4,3,2,92.0
2018020176,24,3549,0.0,36,33,6,1,3,91.66666667
2018020177,3,3900,0.0,34,31,1,0,3,91.17647059
2018020177,28,3781,0.0,37,34,3,1,3,91.89189189
2018020178,16,3456,0.0,28,24,8,0,4,85.71428571
2018020178,23,3600,0.0,26,24,1,1,2,92.30769231
2018020179,25,3600,0.0,32,31,11,1,1,96.875
2018020179,10,3440,0.0,19,17,3,1,2,89.47368421
2018020180,52,3597,0.0,38,36,11,0,2,94.73684211
2018020180,13,3455,0.0,35,32,10,2,3,91.42857143
2018020181,5,3895,0.0,26,24,1,0,2,92.30769231
2018020181,2,3899,0.0,31,29,4,0,2,93.5483871
2018020182,15,3598,0.0,43,38,2,2,5,88.37209302
2018020182,8,3600,0.0,31,27,0,4,4,87.09677419
2018020183,7,3522,0.0,31,28,10,0,3,90.32258065
2018020183,9,3577,0.0,48,46,12,1,2,95.83333333
2018020184,1,3548,0.0,30,27,3,1,3,90.0
2018020184,17,3600,0.0,28,25,6,0,3,89.28571429
2018020185,18,3600,0.0,43,42,4,0,1,97.6744186
2018020185,14,3584,0.0,23,20,1,0,3,86.95652174
2018020186,54,3419,0.0,26,21,2,1,5,80.76923077
2018020186,19,3600,0.0,34,31,5,2,3,91.17647059
2018020187,21,3431,0.0,37,31,5,0,6,83.78378378
2018020187,20,3596,0.0,26,21,1,0,5,80.76923077
2018020188,16,3595,0.0,29,25,3,1,4,86.20689655
2018020188,22,3600,0.0,40,40,6,3,0,100.0
2018020189,3,3900,0.0,30,28,2,1,2,93.33333333
2018020189,24,3787,0.0,24,22,3,0,2,91.66666667
2018020190,4,3600,0.0,27,25,4,1,2,92.59259259
2018020190,26,3581,0.0,30,26,2,1,4,86.66666667
2018020191,29,3600,0.0,45,44,4,0,1,97.77777778
2018020191,28,3500,0.0,26,23,1,0,3,88.46153846
2018020192,13,3555,0.0,34,32,1,1,2,94.11764706
2018020192,52,3496,0.0,26,22,5,0,4,84.61538462
2018020193,21,3878,0.0,37,30,6,1,7,81.08108108
2018020193,23,3851,0.0,29,23,4,0,6,79.31034483
2018020194,12,3675,0.0,25,21,0,4,4,84.0
2018020194,53,3677,0.0,51,48,9,0,3,94.11764706
2018020195,9,865,0.0,10,7,0,0,3,70.0
2018020195,9,2735,0.0,31,25,11,0,6,80.64516129
2018020195,7,3600,0.0,29,27,2,0,2,93.10344828
2018020196,14,3600,0.0,35,34,5,0,1,97.14285714
2018020196,8,3600,0.0,36,32,4,1,4,88.88888889
2018020197,22,3574,0.0,26,23,2,0,3,88.46153846
2018020197,17,3463,0.0,42,38,3,2,4,90.47619048
2018020198,1,3444,0.0,32,30,6,0,2,93.75
2018020198,2,3600,0.0,35,35,7,2,0,100.0
2018020199,10,3596,0.0,31,31,5,2,0,100.0
2018020199,5,3407,0.0,31,26,5,4,5,83.87096774
2018020199,5,193,0.0,2,2,0,0,0,100.0
2018020200,25,3779,0.0,32,29,2,1,3,90.625
2018020200,15,3792,2.0,37,33,1,1,4,89.18918919
2018020201,30,3600,0.0,16,15,0,0,1,93.75
2018020201,19,3600,0.0,45,40,13,0,5,88.88888889
2018020202,6,3463,0.0,40,39,6,1,1,97.5
2018020202,18,3598,0.0,26,26,5,1,0,100.0
2018020203,16,3489,0.0,40,36,8,0,4,90.0
2018020203,20,3600,2.0,15,12,0,0,3,80.0
2018020204,12,3411,0.0,25,22,3,0,3,88.0
2018020204,54,3600,0.0,34,34,3,3,0,100.0
2018020205,29,3583,0.0,29,25,2,2,4,86.20689655
2018020205,26,3571,0.0,27,26,2,2,1,96.2962963
2018020206,4,3613,0.0,35,31,7,2,4,88.57142857
2018020206,28,3613,0.0,25,22,5,0,3,88.0
2018020207,14,3534,0.0,25,22,2,4,3,88.0
2018020207,9,3576,0.0,45,41,3,0,4,91.11111111
2018020208,7,3486,0.0,21,19,1,0,2,90.47619048
2018020208,3,3600,0.0,40,39,14,0,1,97.5
2018020209,29,3597,0.0,30,27,6,2,3,90.0
2018020209,24,3633,0.0,26,24,8,2,2,92.30769231
2018020210,25,3869,0.0,35,33,5,0,2,94.28571429
2018020210,6,3869,0.0,25,24,3,0,1,96.0
2018020211,8,3891,0.0,24,21,4,0,3,87.5
2018020211,2,3900,0.0,35,32,3,0,3,91.42857143
2018020212,1,3600,0.0,36,35,5,1,1,97.22222222
2018020212,5,2400,0.0,27,23,1,1,4,85.18518519
2018020212,5,1200,0.0,12,11,0,0,1,91.66666667
2018020213,22,3465,0.0,23,19,0,0,4,82.60869565
2018020213,15,3600,0.0,33,31,5,0,2,93.93939394
2018020214,4,3548,0.0,36,34,4,0,2,94.44444444
2018020214,53,3560,0.0,33,29,5,4,4,87.87878788
2018020215,54,3478,0.0,20,18,3,0,2,90.0
2018020215,10,3600,0.0,37,36,7,0,1,97.2972973
2018020216,8,3502,0.0,32,27,7,2,5,84.375
2018020216,3,3600,0.0,34,31,8,0,3,91.17647059
2018020217,25,3385,0.0,33,30,6,0,3,90.90909091
2018020217,29,3600,0.0,28,27,3,0,1,96.42857143
2018020218,1,1655,0.0,22,18,2,0,4,81.81818182
2018020218,1,1815,0.0,19,17,1,1,2,89.47368421
2018020218,9,3297,0.0,33,30,0,1,3,90.90909091
2018020218,9,303,0.0,6,6,3,0,0,100.0
2018020219,23,3900,0.0,30,28,1,1,2,93.33333333
2018020219,17,3900,0.0,42,40,2,0,2,95.23809524
2018020220,22,3600,0.0,35,30,7,1,5,85.71428571
2018020220,14,3600,0.0,35,33,8,3,2,94.28571429
2018020221,12,3585,0.0,19,16,0,2,3,84.21052632
2018020221,19,3594,0.0,39,38,3,1,1,97.43589744
2018020222,24,3569,0.0,26,23,1,0,3,88.46153846
2018020222,26,3600,0.0,31,30,5,0,1,96.77419355
2018020223,30,3523,0.0,22,18,0,1,4,81.81818182
2018020223,28,3600,0.0,26,23,3,0,3,88.46153846
2018020224,5,3543,0.0,22,20,7,0,2,90.90909091
2018020224,15,3600,0.0,42,41,0,3,1,97.61904762
2018020225,18,3586,0.0,25,24,0,1,1,96.0
2018020225,21,3576,0.0,33,30,3,0,3,90.90909091
2018020226,20,3434,0.0,24,21,2,0,3,87.5
2018020226,24,3597,0.0,39,37,4,1,2,94.87179487
2018020227,23,3600,0.0,28,23,5,0,5,82.14285714
2018020227,6,2093,0.0,19,14,3,0,5,73.68421053
2018020227,6,1507,0.0,14,11,2,2,3,78.57142857
2018020228,22,3496,0.0,32,29,1,0,3,90.625
2018020228,13,3600,0.0,27,26,2,1,1,96.2962963
2018020229,53,3661,0.0,31,26,2,0,5,83.87096774
2018020229,4,1598,0.0,18,14,2,0,4,77.77777778
2018020229,4,2063,0.0,16,16,0,0,0,100.0
2018020230,7,1298,0.0,5,5,1,1,0,100.0
2018020230,7,2379,0.0,32,27,6,1,5,84.375
2018020230,8,3690,0.0,31,25,3,1,6,80.64516129
2018020231,54,3600,0.0,30,27,3,0,3,90.0
2018020231,9,3415,0.0,42,37,1,0,5,88.0952381
2018020232,2,3550,0.0,26,23,5,3,3,88.46153846
2018020232,14,3599,0.0,37,35,9,0,2,94.59459459
2018020233,12,3600,0.0,38,35,1,1,3,92.10526316
2018020233,16,3483,0.0,34,30,4,1,4,88.23529412
2018020234,28,3486,0.0,22,18,1,2,4,81.81818182
2018020234,25,3600,0.0,36,33,6,0,3,91.66666667
2018020235,30,3600,0.0,28,27,4,1,1,96.42857143
2018020235,26,3509,0.0,23,21,3,0,2,91.30434783
2018020236,1,3600,0.0,32,26,4,0,6,81.25
2018020236,10,3600,0.0,39,38,5,2,1,97.43589744
2018020237,29,3558,0.0,34,33,5,1,1,97.05882353
2018020237,15,3511,0.0,36,34,2,2,2,94.44444444
2018020238,3,3894,0.0,31,28,2,1,3,90.32258065
2018020238,17,3890,0.0,30,28,6,1,2,93.33333333
2018020239,28,3600,0.0,31,27,4,1,4,87.09677419
2018020239,19,3600,0.0,33,33,7,4,0,100.0
2018020240,21,3493,0.0,23,19,3,2,4,82.60869565
2018020240,52,3600,0.0,30,28,4,3,2,93.33333333
2018020241,30,3596,0.0,21,20,2,2,1,95.23809524
2018020241,24,3600,0.0,43,38,6,0,5,88.37209302
2018020242,23,3898,0.0,37,34,4,1,3,91.89189189
2018020242,7,3856,0.0,39,36,4,0,3,92.30769231
2018020243,16,3509,0.0,24,21,5,0,3,87.5
2018020243,4,3600,0.0,33,33,4,0,0,100.0
2018020244,18,3660,0.0,24,20,5,0,4,83.33333333
2018020244,25,3747,0.0,34,29,5,0,5,85.29411765
2018020245,10,3592,0.0,34,29,6,1,5,85.29411765
2018020245,6,3588,0.0,41,40,17,2,1,97.56097561
2018020246,54,3548,0.0,27,22,3,0,5,81.48148148
2018020246,8,3600,0.0,38,34,6,1,4,89.47368421
2018020247,9,3600,0.0,28,24,4,0,4,85.71428571
2018020247,14,3517,0.0,34,28,3,2,6,82.35294118
2018020248,2,3474,0.0,30,27,5,1,3,90.0
2018020248,13,3592,0.0,31,29,6,0,2,93.5483871
2018020249,53,3600,0.0,32,28,2,0,4,87.5
2018020249,5,3600,0.0,39,39,4,0,0,100.0
2018020250,17,3900,0.0,52,49,6,0,3,94.23076923
2018020250,12,3900,0.0,32,29,4,0,3,90.625
2018020251,3,3900,0.0,38,34,4,0,4,89.47368421
2018020251,29,3900,0.0,19,15,2,0,4,78.94736842
2018020252,20,3600,0.0,21,21,3,0,0,100.0
2018020252,26,3541,0.0,36,35,3,2,1,97.22222222
2018020253,30,3600,0.0,31,29,6,1,2,93.5483871
2018020253,19,3560,0.0,18,15,1,1,3,83.33333333
2018020254,9,3591,0.0,40,35,7,6,5,87.5
2018020254,13,3600,0.0,35,34,4,0,1,97.14285714
2018020255,53,3595,0.0,39,38,4,4,1,97.43589744
2018020255,15,3556,0.0,21,18,5,0,3,85.71428571
2018020256,54,3600,2.0,37,33,6,1,4,89.18918919
2018020256,6,3599,0.0,38,37,9,2,1,97.36842105
2018020257,1,3600,0.0,28,23,1,0,5,82.14285714
2018020257,52,3581,0.0,36,34,4,0,2,94.44444444
2018020258,20,3551,0.0,28,26,3,0,2,92.85714286
2018020258,28,3600,0.0,30,29,0,0,1,96.66666667
2018020259,21,3580,0.0,27,26,2,0,1,96.2962963
2018020259,22,2093,0.0,13,12,1,2,1,92.30769231
2018020259,22,1506,0.0,15,12,2,2,3,80.0
2018020260,23,3461,0.0,27,25,7,1,2,92.59259259
2018020260,3,3600,0.0,26,25,4,0,1,96.15384615
2018020261,16,3676,0.0,40,37,1,0,3,92.5
2018020261,12,3670,0.0,35,33,0,1,2,94.28571429
2018020262,29,3588,0.0,27,26,1,0,1,96.2962963
2018020262,25,3500,0.0,28,26,0,3,2,92.85714286
2018020263,18,3896,0.0,30,29,3,2,1,96.66666667
2018020263,24,3900,0.0,35,34,16,0,1,97.14285714
2018020264,14,3509,0.0,19,17,1,0,2,89.47368421
2018020264,7,3600,0.0,30,29,2,0,1,96.66666667
2018020265,5,3518,0.0,34,31,2,2,3,91.17647059
2018020265,1,3600,0.0,31,29,2,2,2,93.5483871
2018020266,23,3600,0.0,34,29,6,0,5,85.29411765
2018020266,2,3583,0.0,24,22,6,1,2,91.66666667
2018020267,13,3597,0.0,31,30,1,1,1,96.77419355
2018020267,4,3532,0.0,30,28,2,1,2,93.33333333
2018020268,53,2504,0.0,17,12,3,0,5,70.58823529
2018020268,53,1096,0.0,9,8,0,0,1,88.88888889
2018020268,17,3600,0.0,25,24,10,0,1,96.0
2018020269,15,3599,0.0,28,26,11,0,2,92.85714286
2018020269,30,3600,0.0,33,28,5,3,5,84.84848485
2018020270,8,3600,0.0,43,37,5,3,6,86.04651163
2018020270,22,3600,0.0,29,27,3,1,2,93.10344828
2018020271,10,3600,0.0,23,22,4,2,1,95.65217391
2018020271,26,2127,0.0,16,15,6,0,1,93.75
2018020271,26,1473,0.0,19,15,7,1,4,78.94736842
2018020272,18,3457,0.0,37,32,1,0,5,86.48648649
2018020272,28,3591,0.0,34,30,3,5,4,88.23529412
2018020273,19,3515,0.0,19,18,2,0,1,94.73684211
2018020273,16,3600,0.0,28,28,1,1,0,100.0
2018020274,15,3534,0.0,23,21,5,0,2,91.30434783
2018020274,52,3600,0.0,28,27,7,0,1,96.42857143
2018020275,6,3440,0.0,25,19,2,2,6,76.0
2018020275,21,3597,0.0,23,20,5,0,3,86.95652174
2018020276,24,1957,0.0,13,11,2,0,2,84.61538462
2018020276,24,1639,0.0,12,9,5,1,3,75.0
2018020276,54,3600,0.0,29,29,7,1,0,100.0
2018020277,3,2398,0.0,17,12,3,1,5,70.58823529
2018020277,3,1076,0.0,6,5,0,0,1,83.33333333
2018020277,2,3600,0.0,41,36,11,1,5,87.80487805
2018020278,1,3600,0.0,29,29,6,0,0,100.0
2018020278,4,329,0.0,1,1,0,0,0,100.0
2018020278,4,3228,0.0,25,23,3,1,2,92.0
2018020279,14,3596,0.0,31,28,6,2,3,90.32258065
2018020279,5,3440,0.0,26,22,5,0,4,84.61538462
2018020280,13,3568,0.0,36,30,1,2,6,83.33333333
2018020280,29,3600,0.0,43,40,4,0,3,93.02325581
2018020281,17,3481,0.0,36,34,13,1,2,94.44444444
2018020281,9,3600,0.0,35,34,3,3,1,97.14285714
2018020282,23,3600,0.0,29,23,1,1,6,79.31034483
2018020282,30,3600,0.0,27,25,5,2,2,92.59259259
2018020283,8,3600,0.0,45,43,2,1,2,95.55555556
2018020283,20,3441,0.0,22,19,0,0,3,86.36363636
2018020284,18,3513,2.0,23,21,1,0,2,91.30434783
2018020284,53,3548,2.0,46,45,12,1,1,97.82608696
2018020285,10,3600,0.0,45,42,2,1,3,93.33333333
2018020285,28,3442,0.0,34,29,6,0,5,85.29411765
2018020286,6,3694,0.0,37,36,6,3,1,97.2972973
2018020286,25,3694,0.0,23,23,1,2,0,100.0
2018020287,7,3896,0.0,26,25,0,0,1,96.15384615
2018020287,52,3900,0.0,32,31,5,0,1,96.875
2018020288,26,3900,0.0,35,34,6,0,1,97.14285714
2018020288,16,3900,0.0,32,31,3,2,1,96.875
2018020289,15,3622,0.0,26,24,1,0,2,92.30769231
2018020289,21,3622,0.0,29,26,5,0,3,89.65517241
2018020290,19,3600,0.0,33,32,8,1,1,96.96969697
2018020290,54,3595,0.0,35,31,7,0,4,88.57142857
2018020291,10,3797,0.0,39,38,6,1,1,97.43589744
2018020291,24,3797,0.0,35,33,2,0,2,94.28571429
2018020292,17,3849,0.0,40,38,0,0,2,95.0
2018020292,1,3849,0.0,30,27,3,0,3,90.0
2018020293,14,3707,0.0,45,40,8,3,5,88.88888889
2018020293,4,3693,0.0,26,20,2,0,6,76.92307692
2018020294,7,3600,0.0,39,37,0,0,2,94.87179487
2018020294,30,3521,0.0,29,26,0,0,3,89.65517241
2018020295,5,1200,0.0,10,7,0,1,3,70.0
2018020295,5,2209,0.0,15,12,3,0,3,80.0
2018020295,9,3597,0.0,35,31,9,1,4,88.57142857
2018020296,13,3374,0.0,24,20,2,1,4,83.33333333
2018020296,3,3600,0.0,41,39,6,0,2,95.12195122
2018020297,29,3600,0.0,31,30,5,3,1,96.77419355
2018020297,12,3600,0.0,24,20,4,1,4,83.33333333
2018020298,8,3600,0.0,38,36,8,1,2,94.73684211
2018020298,23,3485,0.0,31,28,3,1,3,90.32258065
2018020299,26,3506,0.0,42,38,4,2,4,90.47619048
2018020299,18,3598,0.0,28,25,4,3,3,89.28571429
2018020300,6,3600,0.0,33,32,9,2,1,96.96969697
2018020300,53,3512,0.0,23,21,0,2,2,91.30434783
2018020301,22,3548,0.0,36,33,3,1,3,91.66666667
2018020301,20,3597,0.0,26,24,2,2,2,92.30769231
2018020302,19,3598,0.0,29,25,4,0,4,86.20689655
2018020302,28,3600,0.0,30,30,1,0,0,100.0
2018020303,25,3600,0.0,39,37,5,1,2,94.87179487
2018020303,2,1628,0.0,19,16,2,0,3,84.21052632
2018020303,2,1963,0.0,14,11,2,0,3,78.57142857
2018020304,1,3535,0.0,25,23,2,1,2,92.0
2018020304,12,3600,0.0,34,33,5,1,1,97.05882353
2018020305,30,3529,0.0,27,25,4,1,2,92.59259259
2018020305,16,3600,0.0,40,39,4,1,1,97.5
2018020306,54,3600,0.0,32,29,4,0,3,90.625
2018020306,22,3594,0.0,31,25,1,0,6,80.64516129
2018020307,21,3898,0.0,33,30,5,0,3,90.90909091
2018020307,24,3898,0.0,42,38,0,0,4,90.47619048
2018020308,29,3515,0.0,25,22,0,0,3,88.0
2018020308,10,3600,0.0,39,37,0,0,2,94.87179487
2018020309,25,1063,0.0,10,9,0,0,1,90.0
2018020309,25,2400,0.0,13,12,1,1,1,92.30769231
2018020309,3,3600,0.0,17,16,0,2,1,94.11764706
2018020310,7,3645,0.0,40,36,8,2,4,90.0
2018020310,5,3645,0.0,40,35,6,1,5,87.5
2018020311,15,1295,0.0,22,18,3,0,4,81.81818182
2018020311,15,2519,0.0,22,22,4,0,0,100.0
2018020311,8,3814,0.0,34,29,3,0,5,85.29411765
2018020312,13,3600,0.0,38,33,4,0,5,86.84210526
2018020312,9,2189,0.0,22,16,1,2,6,72.72727273
2018020312,9,1352,0.0,10,9,1,1,1,90.0
2018020313,26,3600,0.0,29,29,5,0,0,100.0
2018020313,19,3509,0.0,26,25,0,0,1,96.15384615
2018020314,14,3528,0.0,34,31,5,0,3,91.17647059
2018020314,18,3600,0.0,31,29,0,2,2,93.5483871
2018020315,54,3600,0.0,32,25,3,1,7,78.125
2018020315,20,3600,0.0,22,20,0,2,2,90.90909091
2018020316,52,3587,0.0,25,22,1,0,3,88.0
2018020316,23,3527,0.0,48,43,11,0,5,89.58333333
2018020317,22,3651,0.0,25,22,5,0,3,88.0
2018020317,28,3627,0.0,23,19,0,1,4,82.60869565
2018020318,4,2362,2.0,8,8,1,0,0,100.0
2018020318,4,1200,0.0,12,8,3,0,4,66.66666667
2018020318,7,3600,0.0,25,23,2,1,2,92.0
2018020319,8,3600,0.0,28,23,2,2,5,82.14285714
2018020319,1,3600,0.0,26,24,2,0,2,92.30769231
2018020320,2,3597,0.0,27,22,5,0,5,81.48148148
2018020320,3,3600,0.0,29,29,1,0,0,100.0
2018020321,25,1732,0.0,16,11,0,0,5,68.75
2018020321,25,1868,0.0,14,14,0,0,0,100.0
2018020321,5,3596,0.0,19,18,1,0,1,94.73684211
2018020322,16,3431,0.0,27,23,6,0,4,85.18518519
2018020322,15,3597,0.0,39,37,3,1,2,94.87179487
2018020323,10,3538,0.0,43,40,3,0,3,93.02325581
2018020323,12,3600,0.0,32,30,1,0,2,93.75
2018020324,6,3649,0.0,27,24,0,1,3,88.88888889
2018020324,17,3649,0.0,36,34,1,0,2,94.44444444
2018020325,13,2601,0.0,28,22,2,0,6,78.57142857
2018020325,13,980,0.0,5,4,0,0,1,80.0
2018020325,14,3600,0.0,43,40,7,1,3,93.02325581
2018020326,19,3503,0.0,33,30,2,0,3,90.90909091
2018020326,18,3600,0.0,29,28,6,1,1,96.55172414
2018020327,9,3534,0.0,33,28,4,1,5,84.84848485
2018020327,30,425,0.0,1,1,0,0,0,100.0
2018020327,30,3159,0.0,26,22,5,0,4,84.61538462
2018020328,54,3810,0.0,21,19,2,1,2,90.47619048
2018020328,53,3815,0.0,25,22,0,2,3,88.0
2018020329,52,695,0.0,9,6,0,0,3,66.66666667
2018020329,52,2827,0.0,16,14,0,0,2,87.5
2018020329,20,3600,0.0,40,37,7,0,3,92.5
2018020330,23,3492,0.0,37,33,7,1,4,89.18918919
2018020330,24,3600,0.0,28,25,0,2,3,89.28571429
2018020331,21,3578,0.0,36,33,5,0,3,91.66666667
2018020331,26,2567,0.0,31,25,3,1,6,80.64516129
2018020331,26,1033,0.0,3,2,0,0,1,66.66666667
2018020332,3,3589,0.0,45,42,0,3,3,93.33333333
2018020332,4,3600,0.0,31,31,3,1,0,100.0
2018020333,8,3786,0.0,40,37,9,0,3,92.5
2018020333,7,3786,0.0,33,31,0,3,2,93.93939394
2018020334,2,3820,2.0,42,39,8,1,3,92.85714286
2018020334,1,3725,0.0,35,31,5,0,4,88.57142857
2018020335,17,3389,0.0,20,17,5,1,3,85.0
2018020335,15,3600,0.0,32,31,5,1,1,96.875
2018020336,52,3588,0.0,38,35,7,0,3,92.10526316
2018020336,30,3579,0.0,28,26,4,2,2,92.85714286
2018020337,22,3614,0.0,25,23,6,0,2,92.0
2018020337,24,3569,0.0,28,27,3,0,1,96.42857143
2018020338,20,3468,0.0,28,26,4,0,2,92.85714286
2018020338,54,3600,0.0,29,29,1,1,0,100.0
2018020339,10,3458,0.0,24,20,0,1,4,83.33333333
2018020339,29,3600,0.0,34,32,7,1,2,94.11764706
2018020340,5,3702,0.0,37,35,0,0,2,94.59459459
2018020340,6,3717,0.0,37,36,3,0,1,97.2972973
2018020341,16,3430,0.0,29,25,4,0,4,86.20689655
2018020341,14,3600,0.0,32,30,5,1,2,93.75
2018020342,13,1162,0.0,10,9,0,0,1,90.0
2018020342,13,2357,0.0,28,26,3,1,2,92.85714286
2018020342,12,3600,0.0,35,34,1,2,1,97.14285714
2018020343,18,1687,0.0,19,18,7,1,1,94.73684211
2018020343,18,1913,0.0,15,10,0,0,5,66.66666667
2018020343,19,3600,0.0,28,26,3,1,2,92.85714286
2018020344,9,3475,0.0,53,48,7,1,5,90.56603774
2018020344,25,3600,0.0,33,29,5,2,4,87.87878788
2018020345,21,3586,0.0,38,37,8,2,1,97.36842105
2018020345,53,3600,0.0,39,34,9,0,5,87.17948718
2018020346,23,3600,0.0,24,20,5,0,4,83.33333333
2018020346,28,3600,0.0,19,19,4,1,0,100.0
2018020347,15,3600,0.0,30,27,3,1,3,90.0
2018020347,3,3539,0.0,27,23,1,1,4,85.18518519
2018020348,4,740,0.0,6,2,0,0,4,33.33333333
2018020348,4,2860,0.0,35,33,0,0,2,94.28571429
2018020348,10,3600,0.0,34,34,0,0,0,100.0
2018020349,6,3600,0.0,33,31,6,1,2,93.93939394
2018020349,8,3447,0.0,35,32,7,1,3,91.42857143
2018020350,7,3900,0.0,37,35,2,0,2,94.59459459
2018020350,17,3900,0.0,35,33,5,1,2,94.28571429
2018020351,16,3643,0.0,38,34,3,0,4,89.47368421
2018020351,13,3745,0.0,41,36,5,3,5,87.80487805
2018020352,12,3596,0.0,19,15,0,0,4,78.94736842
2018020352,2,3600,0.0,27,26,3,0,1,96.2962963
2018020353,29,3468,0.0,36,32,2,0,4,88.88888889
2018020353,5,3600,0.0,39,37,2,1,2,94.87179487
2018020354,52,3597,0.0,27,23,2,2,4,85.18518519
2018020354,19,2162,0.0,25,19,3,0,6,76.0
2018020354,19,1438,0.0,11,9,0,0,2,81.81818182
2018020355,25,3511,0.0,36,33,2,0,3,91.66666667
2018020355,21,3600,0.0,29,27,0,2,2,93.10344828
2018020356,28,3600,0.0,36,30,3,1,6,83.33333333
2018020356,54,3597,0.0,33,33,5,4,0,100.0
2018020357,23,3600,0.0,22,20,3,0,2,90.90909091
2018020357,26,3509,0.0,28,25,1,1,3,89.28571429
2018020358,20,3593,0.0,29,28,0,3,1,96.55172414
2018020358,53,957,0.0,1,1,0,0,0,100.0
2018020358,53,2643,0.0,26,20,4,1,6,76.92307692
2018020359,1,3600,0.0,35,30,3,1,5,85.71428571
2018020359,14,3593,0.0,35,33,4,0,2,94.28571429
2018020360,24,3559,0.0,32,28,10,1,4,87.5
2018020360,18,3600,0.0,19,17,3,0,2,89.47368421
2018020361,22,3551,0.0,30,27,2,1,3,90.0
2018020361,26,3529,0.0,34,32,3,2,2,94.11764706
2018020362,6,3497,0.0,30,27,1,0,3,90.0
2018020362,10,3600,0.0,40,38,5,1,2,95.0
2018020363,1,3688,0.0,34,30,3,3,4,88.23529412
2018020363,13,3638,0.0,32,29,3,3,3,90.625
2018020364,15,3600,0.0,33,32,6,0,1,96.96969697
2018020364,2,3469,0.0,23,20,4,0,3,86.95652174
2018020365,9,3465,0.0,32,29,6,2,3,90.625
2018020365,3,3600,0.0,31,29,1,3,2,93.5483871
2018020366,29,3600,0.0,32,27,2,4,5,84.375
2018020366,17,1200,0.0,16,13,1,1,3,81.25
2018020366,17,2356,0.0,15,12,1,1,3,80.0
2018020367,28,3701,0.0,31,28,1,3,3,90.32258065
2018020367,7,3701,0.0,38,36,5,0,2,94.73684211
2018020368,9,3600,0.0,37,34,0,4,3,91.89189189
2018020368,4,3523,0.0,24,20,2,0,4,83.33333333
2018020369,12,3600,0.0,49,48,4,0,1,97.95918367
2018020369,8,3427,0.0,22,20,2,0,2,90.90909091
2018020370,24,3600,0.0,35,34,7,2,1,97.14285714
2018020370,14,3433,0.0,22,19,0,1,3,86.36363636
2018020371,21,3600,0.0,38,36,2,1,2,94.73684211
2018020371,18,3452,0.0,25,22,2,1,3,88.0
2018020372,53,1200,0.0,5,5,0,0,0,100.0
2018020372,53,2400,0.0,20,17,1,0,3,85.0
2018020372,30,3477,0.0,14,10,3,0,4,71.42857143
2018020373,5,3600,0.0,27,24,3,0,3,88.88888889
2018020373,52,3472,0.0,30,26,2,1,4,86.66666667
2018020374,54,3600,0.0,24,21,1,0,3,87.5
2018020374,16,1200,0.0,13,11,1,0,2,84.61538462
2018020374,16,2400,0.0,30,24,1,0,6,80.0
2018020375,25,3762,0.0,31,30,3,0,1,96.77419355
2018020375,22,3762,0.0,28,28,2,0,0,100.0
2018020376,26,3621,0.0,33,32,4,5,1,96.96969697
2018020376,23,3651,0.0,25,23,0,0,2,92.0
2018020377,19,3490,0.0,31,27,1,1,4,87.09677419
2018020377,17,3600,0.0,36,33,5,0,3,91.66666667
2018020378,24,3600,0.0,44,42,4,1,2,95.45454545
2018020378,13,3519,0.0,25,22,2,0,3,88.0
2018020379,28,3492,0.0,29,24,4,1,5,82.75862069
2018020379,10,3600,0.0,41,38,7,0,3,92.68292683
2018020380,25,3593,0.0,33,30,5,1,3,90.90909091
2018020380,20,3610,0.0,28,24,1,0,4,85.71428571
2018020381,5,3501,0.0,25,20,0,0,5,80.0
2018020381,21,3600,0.0,25,22,0,0,3,88.0
2018020382,2,3878,0.0,36,35,0,0,1,97.22222222
2018020382,6,3900,0.0,29,28,1,0,1,96.55172414
2018020383,30,3478,0.0,29,25,1,1,4,86.20689655
2018020383,29,3600,0.0,25,23,0,0,2,92.0
2018020384,3,3600,0.0,34,31,2,0,3,91.17647059
2018020384,9,3600,0.0,27,27,0,0,0,100.0
2018020385,7,3497,0.0,37,32,2,0,5,86.48648649
2018020385,14,3600,0.0,22,18,0,1,4,81.81818182
2018020386,53,3600,0.0,29,29,1,3,0,100.0
2018020386,18,3600,0.0,25,22,1,1,3,88.0
2018020387,16,3495,0.0,33,27,3,0,6,81.81818182
2018020387,52,3600,0.0,31,26,1,1,5,83.87096774
2018020388,26,3544,0.0,34,31,6,0,3,91.17647059
2018020388,22,3600,0.0,32,30,3,0,2,93.75
2018020389,54,3600,0.0,36,33,7,0,3,91.66666667
2018020389,23,3531,0.0,31,27,0,0,4,87.09677419
2018020390,7,3743,0.0,43,40,4,2,3,93.02325581
2018020390,13,3735,0.0,24,22,4,0,2,91.66666667
2018020391,1,3554,0.0,29,25,6,0,4,86.20689655
2018020391,15,3600,0.0,36,33,4,1,3,91.66666667
2018020392,24,3675,0.0,34,33,15,3,1,97.05882353
2018020392,12,3675,0.0,29,27,2,1,2,93.10344828
2018020393,19,3694,0.0,29,27,6,0,2,93.10344828
2018020393,21,3680,0.0,37,34,3,1,3,91.89189189
2018020394,26,3547,0.0,35,33,2,1,2,94.28571429
2018020394,20,3600,0.0,14,13,0,0,1,92.85714286
2018020395,28,3587,0.0,26,21,3,1,5,80.76923077
2018020395,9,3578,0.0,38,36,3,1,2,94.73684211
2018020396,25,3600,0.0,25,24,4,1,1,96.0
2018020396,23,3495,0.0,27,25,1,0,2,92.59259259
2018020397,17,3550,2.0,40,38,3,2,2,95.0
2018020397,6,3486,2.0,26,23,4,4,3,88.46153846
2018020398,3,3590,0.0,41,36,7,1,5,87.80487805
2018020398,8,3598,0.0,22,20,3,0,2,90.90909091
2018020399,14,3792,0.0,27,23,9,2,4,85.18518519
2018020399,13,3782,0.0,39,34,0,3,5,87.17948718
2018020400,52,3883,0.0,39,36,2,0,3,92.30769231
2018020400,1,3873,0.0,38,34,0,2,4,89.47368421
2018020401,29,3482,0.0,29,26,2,0,3,89.65517241
2018020401,2,3594,0.0,30,28,3,1,2,93.33333333
2018020402,4,3600,0.0,32,30,0,2,2,93.75
2018020402,5,3534,0.0,25,22,4,0,3,88.0
2018020403,10,3600,0.0,41,38,2,0,3,92.68292683
2018020403,30,3518,0.0,22,18,0,3,4,81.81818182
2018020404,16,3597,0.0,29,25,2,1,4,86.20689655
2018020404,18,3600,0.0,21,19,0,0,2,90.47619048
2018020405,19,3600,0.0,44,38,12,1,6,86.36363636
2018020405,53,3589,0.0,26,25,1,1,1,96.15384615
2018020406,54,3479,0.0,34,32,7,2,2,94.11764706
2018020406,22,3586,0.0,32,31,3,3,1,96.875
2018020407,24,2801,0.0,21,19,4,0,2,90.47619048
2018020407,24,799,0.0,11,8,0,0,3,72.72727273
2018020407,15,3507,0.0,25,19,1,1,6,76.0
2018020408,52,3900,0.0,19,16,0,1,3,84.21052632
2018020408,3,3900,0.0,42,39,5,0,3,92.85714286
2018020409,28,3597,0.0,41,40,3,0,1,97.56097561
2018020409,8,3452,0.0,29,26,3,0,3,89.65517241
2018020410,21,3600,0.0,24,24,5,0,0,100.0
2018020410,17,3505,0.0,28,27,0,1,1,96.42857143
2018020411,20,3595,0.0,24,22,3,3,2,91.66666667
2018020411,16,3517,0.0,41,38,9,0,3,92.68292683
2018020412,12,3535,0.0,34,33,8,0,1,97.05882353
2018020412,26,3600,0.0,34,34,6,0,0,100.0
2018020413,14,3600,0.0,27,26,7,1,1,96.2962963
2018020413,1,1196,0.0,6,5,0,0,1,83.33333333
2018020413,1,2397,0.0,20,16,1,0,4,80.0
2018020414,7,3504,0.0,25,23,4,0,2,92.0
2018020414,18,3600,0.0,22,21,3,1,1,95.45454545
2018020415,22,3493,0.0,24,21,3,0,3,87.5
2018020415,25,3588,2.0,29,28,4,0,1,96.55172414
2018020416,10,3897,0.0,41,38,1,0,3,92.68292683
2018020416,7,3897,0.0,30,26,1,1,4,86.66666667
2018020417,6,3600,0.0,44,39,10,1,5,88.63636364
2018020417,13,3590,0.0,33,33,3,0,0,100.0
2018020418,52,3600,0.0,28,27,2,0,1,96.42857143
2018020418,2,3511,0.0,23,21,2,0,2,91.30434783
2018020419,21,3467,0.0,32,26,1,0,6,81.25
2018020419,5,3600,0.0,45,42,2,0,3,93.33333333
2018020420,20,2400,0.0,16,13,1,0,3,81.25
2018020420,20,1200,0.0,14,11,2,0,3,78.57142857
2018020420,29,811,0.0,2,1,0,0,1,50.0
2018020420,29,2789,0.0,26,18,2,2,8,69.23076923
2018020421,9,3600,0.0,41,36,5,0,5,87.80487805
2018020421,8,3577,0.0,30,28,5,1,2,93.33333333
2018020422,14,3900,0.0,24,19,1,0,5,79.16666667
2018020422,17,3900,0.0,35,30,1,0,5,85.71428571
2018020423,30,3600,0.0,31,29,6,0,2,93.5483871
2018020423,23,3559,0.0,28,25,1,0,3,89.28571429
2018020424,15,3537,0.0,27,23,10,3,4,85.18518519
2018020424,54,3600,0.0,26,23,3,1,3,88.46153846
2018020425,53,3600,0.0,26,25,2,2,1,96.15384615
2018020425,26,3498,2.0,20,18,4,1,2,90.0
2018020426,22,3839,0.0,30,28,5,2,2,93.33333333
2018020426,19,3878,0.0,36,34,5,1,2,94.44444444
2018020427,16,3556,0.0,31,28,2,1,3,90.32258065
2018020427,24,3600,0.0,27,25,5,1,2,92.59259259
2018020428,12,3600,0.0,23,18,1,0,5,78.26086957
2018020428,28,3600,0.0,40,39,2,1,1,97.5
2018020429,17,3752,0.0,31,27,4,0,4,87.09677419
2018020429,10,3768,0.0,32,27,2,1,5,84.375
2018020430,21,3600,0.0,35,33,7,1,2,94.28571429
2018020430,13,3500,0.0,36,32,4,2,4,88.88888889
2018020431,29,3610,0.0,26,23,5,0,3,88.46153846
2018020431,4,3583,0.0,30,26,5,3,4,86.66666667
2018020432,2,2383,0.0,21,16,3,0,5,76.19047619
2018020432,2,1200,0.0,7,6,0,0,1,85.71428571
2018020432,5,3600,0.0,24,22,3,1,2,91.66666667
2018020433,8,3597,0.0,21,19,2,2,2,90.47619048
2018020433,9,3595,0.0,42,38,6,0,4,90.47619048
2018020434,6,3512,0.0,30,27,2,0,3,90.0
2018020434,14,3596,2.0,35,33,4,0,2,94.28571429
2018020435,30,3400,0.0,20,18,4,1,2,90.0
2018020435,20,3600,0.0,31,31,9,1,0,100.0
2018020436,15,3600,0.0,29,27,0,1,2,93.10344828
2018020436,53,3496,0.0,28,25,0,0,3,89.28571429
2018020437,18,2400,0.0,25,21,3,0,4,84.0
2018020437,18,1133,0.0,5,4,2,0,1,80.0
2018020437,23,3600,0.0,29,26,1,0,3,89.65517241
2018020438,16,3435,0.0,36,32,1,3,4,88.88888889
2018020438,54,3583,0.0,35,32,3,0,3,91.42857143
2018020439,1,3600,0.0,32,29,0,1,3,90.625
2018020439,26,3483,2.0,34,29,4,0,5,85.29411765
2018020440,28,3481,0.0,30,27,2,0,3,90.0
2018020440,25,3600,0.0,43,41,4,0,2,95.34883721
2018020441,19,3600,0.0,26,26,4,0,0,100.0
2018020441,52,3470,0.0,27,26,2,2,1,96.2962963
2018020442,30,3078,0.0,26,22,3,0,4,84.61538462
2018020442,30,522,0.0,6,3,0,0,3,50.0
2018020442,22,3600,0.0,33,31,3,0,2,93.93939394
2018020443,12,3600,2.0,19,18,4,2,1,94.73684211
2018020443,24,3539,0.0,35,32,6,0,3,91.42857143
2018020444,4,3600,0.0,30,28,0,1,2,93.33333333
2018020444,7,3600,0.0,41,35,7,2,6,85.36585366
2018020445,54,3600,0.0,25,20,1,0,5,80.0
2018020445,26,3600,0.0,30,29,4,0,1,96.66666667
2018020446,10,827,0.0,4,4,0,0,0,100.0
2018020446,10,2770,0.0,28,22,4,1,6,78.57142857
2018020446,6,3591,0.0,32,29,3,1,3,90.625
2018020447,5,3680,0.0,29,27,7,2,2,93.10344828
2018020447,9,3680,0.0,36,35,6,0,1,97.22222222
2018020448,2,3592,0.0,25,23,3,2,2,92.0
2018020448,17,3476,0.0,19,16,3,0,3,84.21052632
2018020449,21,1679,0.0,23,18,2,0,5,78.26086957
2018020449,21,1921,0.0,15,13,0,0,2,86.66666667
2018020449,14,3600,0.0,30,29,1,1,1,96.66666667
2018020450,3,3900,0.0,31,27,5,1,4,87.09677419
2018020450,13,3900,0.0,26,22,1,1,4,84.61538462
2018020451,15,3580,0.0,28,28,9,1,0,100.0
2018020451,29,2400,0.0,15,14,2,1,1,93.33333333
2018020451,29,1200,0.0,13,10,0,0,3,76.92307692
2018020452,28,3600,0.0,20,17,0,0,3,85.0
2018020452,53,3550,0.0,32,28,2,0,4,87.5
2018020453,18,3567,0.0,24,20,1,0,4,83.33333333
2018020453,20,3600,0.0,27,25,0,2,2,92.59259259
2018020454,23,3600,0.0,23,22,2,1,1,95.65217391
2018020454,19,2754,0.0,15,12,2,0,3,80.0
2018020454,19,846,0.0,6,3,0,0,3,50.0
2018020455,4,1651,0.0,10,7,1,0,3,70.0
2018020455,4,1949,0.0,25,21,4,0,4,84.0
2018020455,52,3578,0.0,37,36,8,4,1,97.2972973
2018020456,6,3787,0.0,28,27,5,1,1,96.42857143
2018020456,9,3787,0.0,44,42,5,3,2,95.45454545
2018020457,8,3600,0.0,39,37,14,1,2,94.87179487
2018020457,16,3551,0.0,28,25,6,1,3,89.28571429
2018020458,1,3791,0.0,37,32,0,0,5,86.48648649
2018020458,24,2830,0.0,27,23,3,0,4,85.18518519
2018020458,24,1067,0.0,8,7,0,0,1,87.5
2018020459,20,3528,0.0,30,29,10,1,1,96.66666667
2018020459,22,3600,0.0,24,24,2,3,0,100.0
2018020460,25,3567,0.0,27,24,6,0,3,88.88888889
2018020460,54,3591,0.0,24,22,4,3,2,91.66666667
2018020461,5,3900,0.0,26,25,5,1,1,96.15384615
2018020461,2,3875,0.0,24,23,5,0,1,95.83333333
2018020462,26,3444,0.0,21,18,2,0,3,85.71428571
2018020462,17,3600,0.0,43,42,1,1,1,97.6744186
2018020463,3,3507,0.0,35,30,6,0,5,85.71428571
2018020463,14,3600,0.0,26,23,0,1,3,88.46153846
2018020464,1,3600,0.0,34,29,1,0,5,85.29411765
2018020464,28,3600,0.0,24,22,2,0,2,91.66666667
2018020465,53,3526,0.0,26,22,2,1,4,84.61538462
2018020465,6,3600,0.0,33,30,2,0,3,90.90909091
2018020466,26,3696,0.0,47,43,12,1,4,91.4893617
2018020466,7,3703,0.0,29,26,6,0,3,89.65517241
2018020467,17,1794,0.0,10,9,0,0,1,90.0
2018020467,17,1806,0.0,15,10,2,0,5,66.66666667
2018020467,15,3600,0.0,37,35,1,1,2,94.59459459
2018020468,10,3600,0.0,30,29,8,0,1,96.66666667
2018020468,12,3567,0.0,29,25,3,1,4,86.20689655
2018020469,23,3600,0.0,36,34,1,2,2,94.44444444
2018020469,29,3489,0.0,25,22,2,1,3,88.0
2018020470,13,3531,0.0,33,29,3,0,4,87.87878788
2018020470,19,3600,0.0,25,22,1,0,3,88.0
2018020471,9,3493,0.0,36,33,3,1,3,91.66666667
2018020471,18,3600,0.0,26,25,1,0,1,96.15384615
2018020472,8,830,0.0,9,9,0,0,0,100.0
2018020472,8,2770,0.0,23,16,1,0,7,69.56521739
2018020472,30,3600,0.0,30,29,2,2,1,96.66666667
2018020473,16,3489,0.0,33,28,7,0,5,84.84848485
2018020473,52,3593,0.0,35,32,5,1,3,91.42857143
2018020474,22,3600,0.0,43,39,11,0,4,90.69767442
2018020474,21,2017,0.0,18,15,3,0,3,83.33333333
2018020474,21,1395,0.0,8,5,0,1,3,62.5
2018020475,54,3600,0.0,25,23,2,0,2,92.0
2018020475,2,3521,0.0,17,14,0,0,3,82.35294118
2018020476,5,3491,0.0,27,23,0,1,4,85.18518519
2018020476,16,3600,0.0,43,40,4,0,3,93.02325581
2018020477,4,3635,0.0,41,35,12,0,6,85.36585366
2018020477,20,2400,0.0,14,10,3,0,4,71.42857143
2018020477,20,1119,0.0,5,4,0,1,1,80.0
2018020478,25,3379,0.0,35,30,1,0,5,85.71428571
2018020478,24,3600,0.0,29,26,7,0,3,89.65517241
2018020479,53,3427,0.0,33,30,0,0,3,90.90909091
2018020479,7,3600,0.0,26,25,0,0,1,96.15384615
2018020480,26,3597,0.0,41,37,2,1,4,90.24390244
2018020480,29,3600,0.0,30,29,1,1,1,96.66666667
2018020481,12,3473,0.0,39,34,4,0,5,87.17948718
2018020481,8,3574,0.0,31,27,2,3,4,87.09677419
2018020482,10,3580,0.0,21,17,2,0,4,80.95238095
2018020482,14,3599,0.0,49,48,15,3,1,97.95918367
2018020483,23,3714,0.0,34,30,3,2,4,88.23529412
2018020483,18,3744,2.0,22,19,4,1,3,86.36363636
2018020484,13,3593,0.0,26,21,0,2,5,80.76923077
2018020484,30,3600,0.0,31,30,6,0,1,96.77419355
2018020485,22,3637,0.0,40,35,2,0,5,87.5
2018020485,52,3640,0.0,26,22,2,3,4,84.61538462
2018020486,25,3502,0.0,24,21,3,0,3,87.5
2018020486,28,3600,0.0,22,20,0,0,2,90.90909091
2018020487,54,3641,0.0,42,37,6,0,5,88.0952381
2018020487,1,576,0.0,7,4,0,0,3,57.14285714
2018020487,1,3060,0.0,15,14,2,0,1,93.33333333
2018020488,53,3868,0.0,30,27,12,1,3,90.0
2018020488,3,3863,0.0,34,30,8,3,4,88.23529412
2018020489,6,3515,0.0,27,23,3,0,4,85.18518519
2018020489,5,3600,0.0,51,48,7,0,3,94.11764706
2018020490,9,3600,0.0,28,26,3,0,2,92.85714286
2018020490,17,3514,0.0,31,28,3,0,3,90.32258065
2018020491,15,3900,0.0,27,22,5,0,5,81.48148148
2018020491,12,3898,0.0,29,24,1,1,5,82.75862069
2018020492,21,3704,0.0,28,24,4,1,4,85.71428571
2018020492,19,3725,0.0,42,39,9,1,3,92.85714286
2018020493,52,3619,0.0,37,34,3,0,3,91.89189189
2018020493,16,3630,0.0,42,38,4,0,4,90.47619048
2018020494,4,3539,0.0,21,18,3,2,3,85.71428571
2018020494,22,3600,0.0,32,31,5,1,1,96.875
2018020495,20,3600,0.0,35,34,3,1,1,97.14285714
2018020495,30,3475,0.0,26,24,5,0,2,92.30769231
2018020496,9,3593,0.0,46,42,6,0,4,91.30434783
2018020496,8,3583,0.0,18,16,3,0,2,88.88888889
2018020497,10,3749,0.0,33,29,0,4,4,87.87878788
2018020497,13,3804,0.0,32,29,4,0,3,90.625
2018020498,17,3872,0.0,48,45,13,0,3,93.75
2018020498,2,3893,0.0,21,18,0,1,3,85.71428571
2018020499,26,3839,0.0,36,32,6,2,4,88.88888889
2018020499,5,3835,0.0,41,38,5,0,3,92.68292683
2018020500,7,3900,0.0,38,35,7,2,3,92.10526316
2018020500,15,3900,0.0,29,26,4,0,3,89.65517241
2018020501,24,3679,0.0,37,36,6,0,1,97.2972973
2018020501,29,3633,0.0,22,20,0,0,2,90.90909091
2018020502,1,3837,0.0,28,27,0,1,1,96.42857143
2018020502,18,3898,0.0,34,33,4,1,1,97.05882353
2018020503,25,1200,0.0,20,17,6,2,3,85.0
2018020503,25,2283,0.0,16,14,3,0,2,87.5
2018020503,21,3600,0.0,42,38,2,1,4,90.47619048
2018020504,4,494,0.0,4,2,0,0,2,50.0
2018020504,4,3049,0.0,19,17,1,3,2,89.47368421
2018020504,23,3595,0.0,32,31,7,2,1,96.875
2018020505,54,3731,0.0,30,27,6,1,3,90.0
2018020505,3,3731,0.0,41,37,2,0,4,90.24390244
2018020506,53,3600,0.0,27,24,3,1,3,88.88888889
2018020506,12,3537,0.0,23,23,0,3,0,100.0
2018020507,20,3564,0.0,28,26,1,0,2,92.85714286
2018020507,19,1196,0.0,16,12,1,0,4,75.0
2018020507,19,2265,0.0,12,10,1,0,2,83.33333333
2018020508,7,3600,0.0,37,35,4,0,2,94.59459459
2018020508,6,3501,0.0,26,23,2,0,3,88.46153846
2018020509,28,833,0.0,4,1,0,0,3,25.0
2018020509,28,2767,0.0,16,16,3,0,0,100.0
2018020509,16,2490,0.0,35,30,9,1,5,85.71428571
2018020509,16,1110,0.0,8,6,0,0,2,75.0
2018020510,14,3858,0.0,42,37,0,0,5,88.0952381
2018020510,52,3858,0.0,47,43,5,1,4,91.4893617
2018020511,22,3497,0.0,29,26,3,0,3,89.65517241
2018020511,23,3600,0.0,22,20,0,0,2,90.90909091
2018020512,24,3600,0.0,30,28,8,0,2,93.33333333
2018020512,5,3553,0.0,35,32,7,1,3,91.42857143
2018020513,54,3540,0.0,31,30,2,0,1,96.77419355
2018020513,29,3600,0.0,28,28,0,0,0,100.0
2018020514,6,3600,0.0,22,22,4,0,0,100.0
2018020514,8,3600,0.0,35,31,1,3,4,88.57142857
2018020515,18,1182,0.0,11,8,1,1,3,72.72727273
2018020515,18,2421,0.0,12,11,0,0,1,91.66666667
2018020515,9,3610,0.0,34,31,5,1,3,91.17647059
2018020516,2,3600,0.0,31,30,8,0,1,96.77419355
2018020516,21,3467,0.0,20,17,1,1,3,85.0
2018020517,13,3579,0.0,32,30,5,3,2,93.75
2018020517,7,3544,0.0,35,31,3,0,4,88.57142857
2018020518,10,3600,0.0,29,27,0,0,2,93.10344828
2018020518,1,1200,0.0,10,8,0,0,2,80.0
2018020518,1,2400,0.0,21,16,1,1,5,76.19047619
2018020519,24,3584,0.0,23,21,2,3,2,91.30434783
2018020519,3,3593,0.0,15,14,3,1,1,93.33333333
2018020520,17,3490,0.0,33,30,3,0,3,90.90909091
2018020520,4,3600,0.0,22,20,1,0,2,90.90909091
2018020521,28,3600,0.0,26,26,0,0,0,100.0
2018020521,30,3573,0.0,24,21,1,0,3,87.5
2018020522,18,3431,0.0,36,34,4,1,2,94.44444444
2018020522,16,3589,2.0,31,30,2,0,1,96.77419355
2018020523,20,3500,0.0,28,26,0,5,2,92.85714286
2018020523,25,383,0.0,3,3,1,0,0,100.0
2018020523,25,3217,0.0,21,21,4,0,0,100.0
2018020524,19,3600,0.0,23,22,3,0,1,95.65217391
2018020524,22,3593,0.0,29,26,5,1,3,89.65517241
2018020525,2,3600,0.0,37,36,4,2,1,97.2972973
2018020525,53,3446,0.0,32,29,4,1,3,90.625
2018020526,14,3600,0.0,38,36,7,2,2,94.73684211
2018020526,23,3571,0.0,36,32,6,0,4,88.88888889
2018020527,52,3446,2.0,30,27,3,1,3,90.0
2018020527,26,3575,0.0,28,27,3,0,1,96.42857143
2018020528,5,3600,0.0,32,31,6,0,1,96.875
2018020528,15,3463,0.0,30,28,1,5,2,93.33333333
2018020529,8,3553,0.0,26,24,2,0,2,92.30769231
2018020529,21,3600,0.0,36,35,0,3,1,97.22222222
2018020530,24,3523,0.0,31,28,6,2,3,90.32258065
2018020530,6,3582,0.0,25,24,3,0,1,96.0
2018020531,13,2741,0.0,22,17,1,0,5,77.27272727
2018020531,13,859,0.0,4,3,0,1,1,75.0
2018020531,10,3600,0.0,26,25,4,0,1,96.15384615
2018020532,18,3361,0.0,31,29,11,1,2,93.5483871
2018020532,4,3600,0.0,32,31,8,0,1,96.875
2018020533,30,3572,0.0,37,35,6,1,2,94.59459459
2018020533,5,3589,0.0,41,40,4,2,1,97.56097561
2018020534,17,3600,0.0,39,38,4,0,1,97.43589744
2018020534,12,3428,0.0,23,20,0,0,3,86.95652174
2018020535,1,3480,0.0,38,36,10,2,2,94.73684211
2018020535,29,3586,0.0,30,29,5,3,1,96.66666667
2018020536,16,3600,0.0,28,26,2,0,2,92.85714286
2018020536,25,3560,0.0,27,24,1,2,3,88.88888889
2018020537,14,3900,0.0,37,33,1,2,4,89.18918919
2018020537,20,3900,0.0,36,32,3,1,4,88.88888889
2018020538,8,3581,0.0,37,36,7,1,1,97.2972973
2018020538,53,3522,0.0,28,26,3,0,2,92.85714286
2018020539,19,3577,0.0,28,24,3,3,4,85.71428571
2018020539,23,3573,0.0,30,29,3,0,1,96.66666667
2018020540,2,3551,0.0,46,43,4,1,3,93.47826087
2018020540,54,3600,0.0,21,19,1,1,2,90.47619048
2018020541,52,3600,0.0,44,41,6,1,3,93.18181818
2018020541,28,3568,0.0,24,20,5,2,4,83.33333333
2018020542,9,2384,0.0,25,20,1,2,5,80.0
2018020542,9,1200,0.0,7,7,2,1,0,100.0
2018020542,1,3600,0.0,27,25,1,0,2,92.59259259
2018020543,7,3472,0.0,24,22,3,1,2,91.66666667
2018020543,15,3594,0.0,37,36,6,2,1,97.2972973
2018020544,16,3581,0.0,36,35,6,0,1,97.22222222
2018020544,21,3560,0.0,28,26,6,1,2,92.85714286
2018020545,18,3542,0.0,31,27,4,1,4,87.09677419
2018020545,6,3600,0.0,30,28,1,0,2,93.33333333
2018020546,29,3600,0.0,37,34,9,2,3,91.89189189
2018020546,4,3473,0.0,19,15,2,1,4,78.94736842
2018020547,13,3600,0.0,34,33,3,3,1,97.05882353
2018020547,17,3529,0.0,23,21,1,0,2,91.30434783
2018020548,19,3600,0.0,29,28,2,0,1,96.55172414
2018020548,20,3500,0.0,27,24,3,2,3,88.88888889
2018020549,8,3673,0.0,26,23,1,0,3,88.46153846
2018020549,54,3719,0.0,47,43,3,0,4,91.4893617
2018020550,26,3749,0.0,31,29,1,0,2,93.5483871
2018020550,28,3669,0.0,31,28,3,1,3,90.32258065
2018020551,24,3582,0.0,32,30,9,0,2,93.75
2018020551,7,3581,0.0,40,40,3,1,0,100.0
2018020552,3,3465,0.0,35,31,5,1,4,88.57142857
2018020552,10,3553,0.0,28,25,1,0,3,89.28571429
2018020553,15,3586,0.0,35,35,1,0,0,100.0
2018020553,9,3600,0.0,33,29,5,0,4,87.87878788
2018020554,5,3600,0.0,39,39,2,1,0,100.0
2018020554,12,3600,0.0,32,29,1,1,3,90.625
2018020555,21,1708,0.0,16,12,0,1,4,75.0
2018020555,21,1755,0.0,22,21,4,1,1,95.45454545
2018020555,53,3600,0.0,28,24,0,1,4,85.71428571
2018020556,25,3887,0.0,31,30,3,1,1,96.77419355
2018020556,30,3890,0.0,27,25,8,0,2,92.59259259
2018020557,14,3600,0.0,28,25,1,1,3,89.28571429
2018020557,22,3560,0.0,44,39,1,0,5,88.63636364
2018020558,52,3600,0.0,40,40,7,0,0,100.0
2018020558,23,3532,0.0,24,23,2,0,1,95.83333333
2018020559,29,3551,2.0,39,39,6,1,0,100.0
2018020559,1,1753,0.0,9,9,1,1,0,100.0
2018020559,1,1847,0.0,11,8,0,0,3,72.72727273
2018020560,6,3440,0.0,37,32,6,3,5,86.48648649
2018020560,12,3591,0.0,30,27,5,0,3,90.0
2018020561,4,3886,0.0,34,32,4,1,2,94.11764706
2018020561,3,3898,0.0,31,29,2,1,2,93.5483871
2018020562,13,3600,0.0,29,26,4,0,3,89.65517241
2018020562,16,3540,0.0,26,21,3,0,5,80.76923077
2018020563,17,3699,0.0,24,19,4,0,5,79.16666667
2018020563,10,3561,0.0,30,26,3,0,4,86.66666667
2018020564,2,3600,0.0,20,19,0,0,1,95.0
2018020564,25,3589,0.0,27,25,2,0,2,92.59259259
2018020565,26,3700,0.0,25,22,0,0,3,88.0
2018020565,54,3700,0.0,32,28,3,0,4,87.5
2018020566,53,3900,0.0,38,35,8,3,3,92.10526316
2018020566,28,3900,0.0,26,23,1,3,3,88.46153846
2018020567,1,3597,0.0,42,40,3,3,2,95.23809524
2018020567,6,3513,0.0,32,28,2,3,4,87.5
2018020568,29,3631,0.0,22,19,0,1,3,86.36363636
2018020568,3,3631,0.0,29,25,2,0,4,86.20689655
2018020569,17,3533,0.0,39,35,4,1,4,89.74358974
2018020569,5,3600,0.0,29,27,2,0,2,93.10344828
2018020570,12,3503,0.0,32,30,6,1,2,93.75
2018020570,15,3589,0.0,29,28,3,1,1,96.55172414
2018020571,4,3618,0.0,37,31,4,3,6,83.78378378
2018020571,14,3587,0.0,33,28,5,0,5,84.84848485
2018020572,7,3600,0.0,32,28,0,0,4,87.5
2018020572,19,3600,0.0,31,30,2,0,1,96.77419355
2018020573,25,3600,0.0,49,49,4,1,0,100.0
2018020573,18,3456,0.0,30,28,3,0,2,93.33333333
2018020574,20,3600,0.0,36,35,3,3,1,97.22222222
2018020574,52,3487,0.0,28,25,6,0,3,89.28571429
2018020575,30,1978,2.0,9,8,2,1,1,88.88888889
2018020575,30,1432,0.0,10,7,1,0,3,70.0
2018020575,16,3600,0.0,48,46,9,1,2,95.83333333
2018020576,23,3600,0.0,32,30,2,0,2,93.75
2018020576,22,1198,0.0,6,2,0,0,4,33.33333333
2018020576,22,2235,0.0,14,14,1,0,0,100.0
2018020577,21,3488,0.0,43,41,7,1,2,95.34883721
2018020577,54,3583,0.0,32,31,5,1,1,96.875
2018020578,53,3487,0.0,26,24,4,0,2,92.30769231
2018020578,26,3592,0.0,27,26,3,0,1,96.2962963
2018020579,24,2355,0.0,22,20,4,1,2,90.90909091
2018020579,24,1200,0.0,16,15,1,2,1,93.75
2018020579,28,3600,0.0,27,25,5,1,2,92.59259259
2018020580,8,3599,0.0,26,23,4,1,3,88.46153846
2018020580,13,3465,0.0,27,23,2,0,4,85.18518519
2018020581,9,3502,0.0,38,33,0,0,5,86.84210526
2018020581,2,1571,0.0,17,14,1,1,3,82.35294118
2018020581,2,2029,0.0,10,10,0,0,0,100.0
2018020582,10,3600,0.0,29,27,2,1,2,93.10344828
2018020582,29,3554,0.0,29,25,1,1,4,86.20689655
2018020583,12,3499,0.0,29,28,7,2,1,96.55172414
2018020583,1,3600,0.0,37,37,5,2,0,100.0
2018020584,30,3600,0.0,27,26,1,0,1,96.2962963
2018020584,52,3546,0.0,24,22,0,1,2,91.66666667
2018020585,28,3600,0.0,26,22,0,1,4,84.61538462
2018020585,22,3600,0.0,40,33,3,0,7,82.5
2018020586,54,3600,0.0,31,30,0,0,1,96.77419355
2018020586,26,3592,0.0,31,28,1,1,3,90.32258065
2018020587,6,3824,0.0,28,26,2,0,2,92.85714286
2018020587,7,3822,0.0,42,39,6,2,3,92.85714286
2018020588,2,3600,0.0,36,36,5,0,0,100.0
2018020588,10,3599,0.0,28,24,1,1,4,85.71428571
2018020589,15,3600,0.0,33,31,0,0,2,93.93939394
2018020589,9,3530,0.0,24,21,0,0,3,87.5
2018020590,8,3547,0.0,32,26,2,1,6,81.25
2018020590,14,3600,0.0,38,33,7,1,5,86.84210526
2018020591,4,3544,0.0,36,34,2,2,2,94.44444444
2018020591,13,3600,0.0,35,34,4,0,1,97.14285714
2018020592,5,3600,0.0,31,30,5,0,1,96.77419355
2018020592,19,1765,0.0,17,13,1,2,4,76.47058824
2018020592,19,1835,0.0,13,11,1,0,2,84.61538462
2018020593,3,3600,0.0,37,34,8,0,3,91.89189189
2018020593,18,3451,0.0,22,18,0,1,4,81.81818182
2018020594,17,3598,0.0,42,37,4,2,5,88.0952381
2018020594,25,3593,0.0,34,33,6,0,1,97.05882353
2018020595,16,3641,0.0,32,30,5,0,2,93.75
2018020595,21,3635,0.0,37,34,8,0,3,91.89189189
2018020596,23,3754,0.0,33,31,6,2,2,93.93939394
2018020596,20,3786,0.0,27,24,4,1,3,88.88888889
2018020597,53,3624,0.0,41,37,10,0,4,90.24390244
2018020597,24,3616,0.0,30,25,2,2,5,83.33333333
2018020598,54,3600,0.0,30,29,7,2,1,96.66666667
2018020598,53,3595,2.0,37,32,4,4,5,86.48648649
2018020599,18,3600,0.0,25,22,2,0,3,88.0
2018020599,15,3600,0.0,34,28,2,0,6,82.35294118
2018020600,23,3600,0.0,23,19,3,2,4,82.60869565
2018020600,1,3600,0.0,25,25,3,0,0,100.0
2018020601,2,3593,0.0,40,39,4,0,1,97.5
2018020601,7,3525,0.0,32,30,7,0,2,93.75
2018020602,4,2175,0.0,23,23,5,0,0,100.0
2018020602,4,1339,0.0,10,7,0,1,3,70.0
2018020602,12,3600,0.0,23,22,3,0,1,95.65217391
2018020603,5,3600,0.0,33,31,1,0,2,93.93939394
2018020603,30,3481,0.0,32,29,2,0,3,90.625
2018020604,9,3557,0.0,36,32,3,1,4,88.88888889
2018020604,29,3600,0.0,25,22,5,0,3,88.0
2018020605,3,3600,0.0,40,39,9,1,1,97.5
2018020605,19,3411,0.0,23,21,7,0,2,91.30434783
2018020606,13,1200,0.0,8,5,0,0,3,62.5
2018020606,13,2700,0.0,12,12,2,0,0,100.0
2018020606,17,3900,0.0,27,24,3,1,3,88.88888889
2018020607,26,3653,0.0,24,22,2,0,2,91.66666667
2018020607,21,3643,0.0,18,15,0,0,3,83.33333333
2018020608,8,3614,0.0,47,45,6,2,2,95.74468085
2018020608,25,3614,0.0,38,35,2,2,3,92.10526316
2018020609,28,3600,0.0,27,19,5,1,8,70.37037037
2018020609,20,3600,0.0,33,28,2,3,5,84.84848485
2018020610,52,3593,0.0,24,21,0,0,3,87.5
2018020610,22,3489,0.0,36,32,2,0,4,88.88888889
2018020611,14,3629,0.0,36,35,0,1,1,97.22222222
2018020611,24,3635,0.0,35,33,6,1,2,94.28571429
2018020612,6,3582,0.0,38,36,6,0,2,94.73684211
2018020612,16,3534,0.0,35,32,4,1,3,91.42857143
2018020613,4,3563,0.0,30,26,4,0,4,86.66666667
2018020613,18,3600,0.0,32,32,1,0,0,100.0
2018020614,26,3575,0.0,47,46,7,2,1,97.87234043
2018020614,54,3600,0.0,17,17,2,0,0,100.0
2018020615,23,3698,0.0,33,30,2,5,3,90.90909091
2018020615,9,3670,0.0,45,41,5,0,4,91.11111111
2018020616,20,3600,0.0,32,29,0,1,3,90.625
2018020616,17,3546,0.0,34,30,3,0,4,88.23529412
2018020617,5,3587,0.0,30,28,3,1,2,93.33333333
2018020617,3,2680,0.0,18,12,1,0,6,66.66666667
2018020617,3,920,0.0,7,6,0,0,1,85.71428571
2018020618,1,3482,0.0,40,35,5,2,5,87.5
2018020618,25,3600,0.0,34,30,8,0,4,88.23529412
2018020619,28,3600,0.0,35,31,4,1,4,88.57142857
2018020619,21,1559,0.0,14,10,3,0,4,71.42857143
2018020619,21,1916,0.0,13,12,0,1,1,92.30769231
2018020620,22,3587,0.0,30,29,0,0,1,96.66666667
2018020620,53,3497,0.0,23,21,4,0,2,91.30434783
2018020621,30,3600,0.0,41,38,9,1,3,92.68292683
2018020621,10,3423,0.0,34,30,3,0,4,88.23529412
2018020622,20,3587,0.0,26,21,2,4,5,80.76923077
2018020622,6,3600,0.0,37,33,4,2,4,89.18918919
2018020623,13,3442,0.0,33,29,5,0,4,87.87878788
2018020623,7,3600,0.0,38,35,7,0,3,92.10526316
2018020624,16,3692,0.0,50,47,3,1,3,94.0
2018020624,2,3708,0.0,21,19,1,0,2,90.47619048
2018020625,12,3600,0.0,37,34,4,1,3,91.89189189
2018020625,4,3445,0.0,28,23,1,1,5,82.14285714
2018020626,23,3435,0.0,27,25,1,0,2,92.59259259
2018020626,8,3563,0.0,33,33,12,0,0,100.0
2018020627,15,3600,0.0,42,37,3,2,5,88.0952381
2018020627,19,3597,0.0,25,23,3,5,2,92.0
2018020628,14,3600,0.0,30,28,5,1,2,93.33333333
2018020628,26,3597,0.0,33,27,5,1,6,81.81818182
2018020629,52,3506,0.0,32,29,4,2,3,90.625
2018020629,5,3590,0.0,33,33,1,1,0,100.0
2018020630,18,3860,0.0,39,35,0,2,4,89.74358974
2018020630,17,3873,0.0,30,27,3,1,3,90.0
2018020631,29,1826,0.0,14,14,0,0,0,100.0
2018020631,29,1681,0.0,16,13,1,0,3,81.25
2018020631,12,3596,0.0,24,22,1,1,2,91.66666667
2018020632,15,3817,0.0,29,27,5,1,2,93.10344828
2018020632,25,3817,0.0,37,36,8,1,1,97.2972973
2018020633,3,3600,0.0,47,41,15,2,6,87.23404255
2018020633,21,3591,0.0,25,24,2,0,1,96.0
2018020634,1,959,0.0,8,8,4,0,0,100.0
2018020634,1,2941,0.0,17,15,2,0,2,88.23529412
2018020634,53,3900,0.0,35,33,1,3,2,94.28571429
2018020635,54,3556,0.0,27,25,2,0,2,92.59259259
2018020635,24,3513,0.0,42,39,5,2,3,92.85714286
2018020636,20,3719,0.0,34,32,8,0,2,94.11764706
2018020636,4,3719,0.0,32,29,1,1,3,90.625
2018020637,30,3599,0.0,27,24,0,0,3,88.88888889
2018020637,9,3539,0.0,26,22,4,0,4,84.61538462
2018020638,7,3528,0.0,41,39,5,1,2,95.12195122
2018020638,6,3600,0.0,32,31,2,1,1,96.875
2018020639,23,3600,0.0,34,29,0,0,5,85.29411765
2018020639,10,3600,0.0,28,28,6,0,0,100.0
2018020640,18,3584,0.0,28,27,2,0,1,96.42857143
2018020640,8,3465,0.0,31,28,1,0,3,90.32258065
2018020641,29,3618,0.0,30,27,1,0,3,90.0
2018020641,13,3618,0.0,35,31,4,1,4,88.57142857
2018020642,2,3568,0.0,32,29,5,1,3,90.625
2018020642,19,3403,0.0,14,10,0,1,4,71.42857143
2018020643,22,837,0.0,8,5,0,0,3,62.5
2018020643,22,2755,0.0,15,14,4,1,1,93.33333333
2018020643,26,3595,0.0,16,16,4,1,0,100.0
2018020644,14,3600,0.0,33,28,3,1,5,84.84848485
2018020644,28,3525,0.0,19,17,4,0,2,89.47368421
2018020644,28,75,0.0,1,1,0,0,0,100.0
2018020645,3,2198,0.0,32,27,6,0,5,84.375
2018020645,3,1402,0.0,8,8,0,1,0,100.0
2018020645,53,3600,0.0,23,23,1,0,0,100.0
2018020646,1,3498,0.0,28,25,4,0,3,89.28571429
2018020646,54,3600,0.0,38,36,6,0,2,94.73684211
2018020647,12,3600,0.0,31,27,2,0,4,87.09677419
2018020647,9,1573,0.0,16,13,1,2,3,81.25
2018020647,9,1955,0.0,13,11,1,1,2,84.61538462
2018020648,15,3600,0.0,25,23,3,1,2,92.0
2018020648,17,3521,0.0,34,31,3,1,3,91.17647059
2018020649,25,3536,0.0,29,25,5,0,4,86.20689655
2018020649,52,3600,0.0,27,26,2,0,1,96.2962963
2018020650,16,3600,0.0,34,31,3,2,3,91.17647059
2018020650,5,3547,0.0,30,26,1,0,4,86.66666667
2018020651,22,3600,0.0,39,39,8,0,0,100.0
2018020651,24,3600,0.0,24,20,0,0,4,83.33333333
2018020652,18,3600,0.0,18,18,1,0,0,100.0
2018020652,10,3597,0.0,32,28,0,0,4,87.5
2018020653,19,3600,0.0,25,25,0,0,0,100.0
2018020653,4,3527,0.0,36,34,1,0,2,94.44444444
2018020654,30,3595,0.0,32,32,5,0,0,100.0
2018020654,8,3479,2.0,25,24,9,0,1,96.0
2018020655,20,3595,0.0,35,32,0,1,3,91.42857143
2018020655,16,3548,0.0,42,39,6,1,3,92.85714286
2018020656,26,3562,0.0,28,26,5,0,2,92.85714286
2018020656,28,3595,0.0,23,22,0,1,1,95.65217391
2018020657,30,3600,0.0,27,23,0,0,4,85.18518519
2018020657,6,3600,0.0,24,24,0,0,0,100.0
2018020658,1,3591,0.0,33,28,2,1,5,84.84848485
2018020658,7,3600,0.0,21,20,3,1,1,95.23809524
2018020659,12,3600,0.0,31,28,3,0,3,90.32258065
2018020659,2,3514,0.0,24,20,2,3,4,83.33333333
2018020660,13,1736,0.0,16,12,0,2,4,75.0
2018020660,13,1864,0.0,15,14,0,0,1,93.33333333
2018020660,5,3584,0.0,37,36,5,3,1,97.2972973
2018020661,4,3412,0.0,24,20,3,0,4,83.33333333
2018020661,15,3587,0.0,40,37,7,2,3,92.5
2018020662,8,3600,0.0,32,30,6,1,2,93.75
2018020662,17,3497,0.0,25,22,1,0,3,88.0
2018020663,29,667,0.0,3,3,0,0,0,100.0
2018020663,29,2933,0.0,19,15,2,1,4,78.94736842
2018020663,14,3578,0.0,31,31,1,1,0,100.0
2018020664,25,3600,0.0,27,26,3,0,1,96.2962963
2018020664,19,3424,0.0,17,14,2,0,3,82.35294118
2018020665,21,3462,0.0,20,14,2,0,6,70.0
2018020665,52,3600,0.0,41,37,6,4,4,90.24390244
2018020666,3,3528,0.0,30,27,1,0,3,90.0
2018020666,54,3596,0.0,29,27,4,2,2,93.10344828
2018020667,22,1926,0.0,19,16,0,0,3,84.21052632
2018020667,22,1674,0.0,17,13,3,0,4,76.47058824
2018020667,28,3591,0.0,22,20,4,2,2,90.90909091
2018020668,18,3660,0.0,31,28,2,0,3,90.32258065
2018020668,16,3660,0.0,37,33,6,0,4,89.18918919
2018020669,21,3486,0.0,15,11,0,1,4,73.33333333
2018020669,20,3600,0.0,35,32,5,0,3,91.42857143
2018020670,9,3694,0.0,33,32,7,0,1,96.96969697
2018020670,24,3694,0.0,30,28,0,2,2,93.33333333
2018020671,15,3576,0.0,41,39,10,1,2,95.12195122
2018020671,6,3505,0.0,21,18,1,2,3,85.71428571
2018020672,10,3600,0.0,29,27,5,0,2,93.10344828
2018020672,1,3564,0.0,42,39,1,4,3,92.85714286
2018020673,2,3600,0.0,30,27,3,0,3,90.0
2018020673,3,3518,0.0,20,16,3,0,4,80.0
2018020674,25,3534,0.0,22,20,3,2,2,90.90909091
2018020674,4,3560,0.0,38,37,2,0,1,97.36842105
2018020675,18,3682,0.0,33,29,0,0,4,87.87878788
2018020675,29,3682,0.0,35,32,3,0,3,91.42857143
2018020676,12,3546,0.0,29,27,3,0,2,93.10344828
2018020676,14,3564,0.0,27,26,2,0,1,96.2962963
2018020677,8,3596,0.0,30,26,10,0,4,86.66666667
2018020677,19,3600,0.0,29,28,7,2,1,96.55172414
2018020678,52,3487,0.0,22,19,3,2,3,86.36363636
2018020678,30,3587,0.0,28,26,4,1,2,92.85714286
2018020679,13,3894,0.0,24,21,1,1,3,87.5
2018020679,22,3830,0.0,30,27,2,0,3,90.0
2018020680,53,3849,0.0,36,33,9,2,3,91.66666667
2018020680,23,3850,0.0,22,18,2,0,4,81.81818182
2018020681,28,3600,0.0,38,36,7,1,2,94.73684211
2018020681,54,3431,2.0,27,24,4,0,3,88.88888889
2018020682,9,3600,0.0,34,33,3,1,1,97.05882353
2018020682,26,3533,0.0,26,23,1,3,3,88.46153846
2018020683,7,3472,0.0,30,26,0,1,4,86.66666667
2018020683,12,3581,0.0,33,30,3,3,3,90.90909091
2018020684,17,3503,0.0,26,23,3,0,3,88.46153846
2018020684,52,3598,0.0,35,33,3,0,2,94.28571429
2018020685,13,3525,0.0,23,20,0,1,3,86.95652174
2018020685,20,3600,2.0,27,24,3,0,3,88.88888889
2018020686,5,3600,0.0,25,21,3,0,4,84.0
2018020686,24,3583,0.0,35,29,3,1,6,82.85714286
2018020687,4,3434,0.0,26,23,4,1,3,88.46153846
2018020687,1,3584,0.0,34,32,4,1,2,94.11764706
2018020688,3,3600,0.0,25,24,7,1,1,96.0
2018020688,2,3544,0.0,26,24,2,2,2,92.30769231
2018020689,14,3600,0.0,33,30,6,1,3,90.90909091
2018020689,7,3539,0.0,30,25,0,0,5,83.33333333
2018020690,6,3600,0.0,32,30,4,2,2,93.75
2018020690,10,3476,0.0,29,26,3,0,3,89.65517241
2018020691,21,3533,0.0,30,28,4,0,2,93.33333333
2018020691,8,3600,0.0,28,28,1,2,0,100.0
2018020692,29,3810,0.0,33,32,1,0,1,96.96969697
2018020692,15,2061,0.0,11,10,0,0,1,90.90909091
2018020692,15,1723,0.0,11,10,1,0,1,90.90909091
2018020693,17,3591,0.0,18,16,1,3,2,88.88888889
2018020693,30,3586,0.0,37,32,8,2,5,86.48648649
2018020694,54,3679,0.0,23,20,3,0,3,86.95652174
2018020694,16,3652,0.0,34,30,6,0,4,88.23529412
2018020695,19,3600,0.0,22,21,1,0,1,95.45454545
2018020695,25,3471,0.0,28,25,3,0,3,89.28571429
2018020696,53,3600,0.0,25,23,0,0,2,92.0
2018020696,22,3515,0.0,29,26,2,1,3,89.65517241
2018020697,9,3532,0.0,31,28,1,1,3,90.32258065
2018020697,28,3600,0.0,28,27,5,0,1,96.42857143
2018020698,5,3514,0.0,24,20,2,2,4,83.33333333
2018020698,26,3600,0.0,40,38,2,3,2,95.0
2018020699,18,1770,0.0,20,15,3,1,5,75.0
2018020699,18,1764,0.0,13,13,3,0,0,100.0
2018020699,12,3600,0.0,23,20,4,1,3,86.95652174
2018020700,3,3502,0.0,40,33,6,1,7,82.5
2018020700,29,3600,0.0,27,22,3,0,5,81.48148148
2018020701,24,3889,0.0,34,30,4,2,4,88.23529412
2018020701,52,3882,0.0,31,28,2,1,3,90.32258065
2018020702,14,3300,0.0,27,23,1,1,4,85.18518519
2018020702,2,3596,0.0,39,38,7,0,1,97.43589744
2018020703,13,3501,0.0,34,31,3,1,3,91.17647059
2018020703,23,3600,0.0,24,23,0,0,1,95.83333333
2018020704,53,3600,0.0,26,19,1,1,7,73.07692308
2018020704,20,3600,0.0,23,22,5,0,1,95.65217391
2018020705,8,3615,0.0,43,41,4,0,2,95.34883721
2018020705,6,3560,0.0,22,19,0,0,3,86.36363636
2018020706,21,3597,0.0,20,17,3,0,3,85.0
2018020706,10,3562,0.0,36,32,1,1,4,88.88888889
2018020707,16,2398,0.0,25,19,1,2,6,76.0
2018020707,16,1149,0.0,15,14,0,0,1,93.33333333
2018020707,1,3596,0.0,32,27,1,0,5,84.375
2018020708,30,1053,0.0,6,5,1,2,1,83.33333333
2018020708,30,2400,2.0,20,15,5,0,5,75.0
2018020708,4,3597,0.0,38,34,0,3,4,89.47368421
2018020709,19,3599,0.0,29,28,4,0,1,96.55172414
2018020709,15,3473,0.0,37,33,5,1,4,89.18918919
2018020710,7,1489,0.0,12,7,0,0,5,58.33333333
2018020710,7,2108,0.0,13,11,1,0,2,84.61538462
2018020710,22,3600,0.0,43,41,4,0,2,95.34883721
2018020711,19,3697,0.0,25,23,2,0,2,92.0
2018020711,2,3625,0.0,31,30,8,0,1,96.77419355
2018020712,12,3600,0.0,28,22,2,1,6,78.57142857
2018020712,3,3584,0.0,36,34,3,0,2,94.44444444
2018020713,1,3600,0.0,34,30,1,2,4,88.23529412
2018020713,29,3600,0.0,30,29,6,0,1,96.66666667
2018020714,13,3426,0.0,27,23,1,0,4,85.18518519
2018020714,8,3574,0.0,53,52,4,0,1,98.11320755
2018020715,24,3501,0.0,25,22,0,0,3,88.0
2018020715,17,3600,0.0,24,23,4,0,1,95.83333333
2018020716,15,3600,0.0,29,22,4,0,7,75.86206897
2018020716,18,3600,0.0,28,26,2,1,2,92.85714286
2018020717,26,3900,0.0,42,40,3,0,2,95.23809524
2018020717,30,3900,0.0,33,31,1,3,2,93.93939394
2018020718,54,3490,0.0,25,23,5,0,2,92.0
2018020718,52,3600,0.0,44,43,12,0,1,97.72727273
2018020719,14,3600,2.0,35,35,10,0,0,100.0
2018020719,25,3582,0.0,21,19,3,0,2,90.47619048
2018020720,5,3426,0.0,28,24,0,1,4,85.71428571
2018020720,28,3599,0.0,24,22,2,1,2,91.66666667
2018020721,21,3381,2.0,30,26,2,0,4,86.66666667
2018020721,9,3600,0.0,32,30,3,1,2,93.75
2018020722,6,3524,0.0,19,15,1,0,4,78.94736842
2018020722,4,3600,0.0,42,39,6,2,3,92.85714286
2018020723,7,3662,0.0,33,30,1,2,3,90.90909091
2018020723,20,3670,0.0,23,19,2,1,4,82.60869565
2018020724,22,3864,0.0,22,20,1,0,2,90.90909091
2018020724,23,3900,0.0,30,28,3,0,2,93.33333333
2018020725,28,3533,0.0,39,35,6,0,4,89.74358974
2018020725,53,3600,0.0,29,26,4,0,3,89.65517241
2018020726,19,3452,0.0,26,22,1,0,4,84.61538462
2018020726,6,3600,0.0,30,28,2,1,2,93.33333333
2018020727,1,3564,0.0,25,22,2,0,3,88.0
2018020727,2,3560,0.0,17,16,2,1,1,94.11764706
2018020728,16,3511,0.0,32,29,6,0,3,90.625
2018020728,3,3600,0.0,27,24,2,0,3,88.88888889
2018020729,10,3600,0.0,38,36,9,1,2,94.73684211
2018020729,14,3477,0.0,30,27,3,1,3,90.0
2018020730,52,3600,0.0,38,37,7,2,1,97.36842105
2018020730,18,3600,0.0,34,29,2,2,5,85.29411765
2018020731,24,3600,0.0,37,37,10,0,0,100.0
2018020731,30,478,0.0,8,5,1,0,3,62.5
2018020731,30,3107,0.0,15,15,7,0,0,100.0
2018020732,26,3583,0.0,30,29,1,0,1,96.66666667
2018020732,25,3458,0.0,19,17,0,0,2,89.47368421
2018020733,10,3508,0.0,28,26,2,0,2,92.85714286
2018020733,13,3600,0.0,21,20,0,0,1,95.23809524
2018020734,8,3598,0.0,35,34,2,3,1,97.14285714
2018020734,29,3583,0.0,25,22,0,0,3,88.0
2018020735,2,3600,0.0,19,19,3,1,0,100.0
2018020735,15,3469,0.0,25,23,2,0,2,92.0
2018020736,9,3600,0.0,34,33,2,0,1,97.05882353
2018020736,12,3600,0.0,26,22,1,1,4,84.61538462
2018020737,17,3538,0.0,35,30,4,1,5,85.71428571
2018020737,20,3567,0.0,35,31,3,3,4,88.57142857
2018020738,5,3850,2.0,33,31,6,1,2,93.93939394
2018020738,53,3850,0.0,35,32,4,1,3,91.42857143
2018020739,7,3511,0.0,23,19,0,1,4,82.60869565
2018020739,23,3581,0.0,39,36,5,1,3,92.30769231
2018020740,24,3600,0.0,31,29,7,3,2,93.5483871
2018020740,1,3372,0.0,14,11,0,1,3,78.57142857
2018020741,26,1714,0.0,22,17,2,1,5,77.27272727
2018020741,26,1886,0.0,18,16,4,1,2,88.88888889
2018020741,21,3600,0.0,31,30,4,0,1,96.77419355
2018020742,3,3600,0.0,29,27,6,0,2,93.10344828
2018020742,6,2400,0.0,13,11,0,0,2,84.61538462
2018020742,6,1112,0.0,7,6,0,3,1,85.71428571
2018020743,4,3600,0.0,35,33,1,1,2,94.28571429
2018020743,8,3481,0.0,23,19,5,0,4,82.60869565
2018020744,28,3600,0.0,26,20,4,0,6,76.92307692
2018020744,14,3600,0.0,39,36,8,2,3,92.30769231
2018020745,9,3512,0.0,38,35,0,0,3,92.10526316
2018020745,19,3600,0.0,30,28,2,0,2,93.33333333
2018020746,52,3522,0.0,39,35,13,1,4,89.74358974
2018020746,25,3595,0.0,29,27,6,2,2,93.10344828
2018020747,13,3588,0.0,39,37,8,2,2,94.87179487
2018020747,18,3452,0.0,30,26,5,1,4,86.66666667
2018020748,29,3491,0.0,31,29,3,2,2,93.5483871
2018020748,30,3599,0.0,20,19,4,1,1,95.0
2018020749,20,3561,0.0,24,22,4,2,2,91.66666667
2018020749,22,3580,0.0,34,29,12,2,5,85.29411765
2018020750,5,3422,0.0,34,28,5,1,6,82.35294118
2018020750,54,3600,0.0,37,34,8,1,3,91.89189189
2018020751,15,2201,0.0,17,14,1,0,3,82.35294118
2018020751,15,1350,0.0,11,7,0,0,4,63.63636364
2018020751,16,3589,0.0,39,34,4,1,5,87.17948718
2018020752,24,3600,0.0,28,25,3,0,3,89.28571429
2018020752,2,3595,0.0,19,19,0,0,0,100.0
2018020753,17,3475,0.0,31,28,5,1,3,90.32258065
2018020753,23,3588,0.0,37,35,7,1,2,94.59459459
2018020754,53,3600,2.0,26,24,1,2,2,92.30769231
2018020754,10,3513,0.0,30,27,4,0,3,90.0
2018020755,12,3600,0.0,21,17,2,0,4,80.95238095
2018020755,22,2871,0.0,18,15,1,0,3,83.33333333
2018020755,22,662,0.0,15,12,0,0,3,80.0
2018020756,18,3600,0.0,36,35,7,2,1,97.22222222
2018020756,21,3576,0.0,26,23,2,1,3,88.46153846
2018020757,30,3600,0.0,32,30,5,0,2,93.75
2018020757,54,3515,0.0,21,18,3,0,3,85.71428571
2018020758,28,2842,0.0,21,16,2,4,5,76.19047619
2018020758,28,758,0.0,9,8,0,0,1,88.88888889
2018020758,13,3600,0.0,29,27,4,0,2,93.10344828
2018020759,19,3477,0.0,29,25,6,0,4,86.20689655
2018020759,26,3599,0.0,36,33,1,3,3,91.66666667
2018020760,28,3580,0.0,39,33,4,1,6,84.61538462
2018020760,15,3708,0.0,43,36,10,0,7,83.72093023
2018020761,53,3600,0.0,27,25,2,0,2,92.59259259
2018020761,9,3539,0.0,33,30,2,1,3,90.90909091
2018020762,2,3898,0.0,40,38,3,0,2,95.0
2018020762,16,3897,0.0,36,34,3,0,2,94.44444444
2018020763,12,3576,0.0,25,22,6,1,3,88.0
2018020763,20,3615,0.0,35,33,1,0,2,94.28571429
2018020764,17,3600,0.0,34,32,4,1,2,94.11764706
2018020764,22,3451,0.0,27,24,4,0,3,88.88888889
2018020765,15,3488,0.0,36,31,1,0,5,86.11111111
2018020765,10,3600,0.0,44,41,1,0,3,93.18181818
2018020766,53,3573,0.0,24,22,0,4,2,91.66666667
2018020766,8,3598,0.0,31,30,3,2,1,96.77419355
2018020767,30,3600,0.0,22,20,0,2,2,90.90909091
2018020767,21,3600,0.0,28,23,4,0,5,82.14285714
2018020768,18,3600,0.0,48,47,7,2,1,97.91666667
2018020768,54,3450,0.0,27,25,3,1,2,92.59259259
2018020769,19,3600,0.0,13,12,0,0,1,92.30769231
2018020769,24,565,0.0,1,1,0,0,0,100.0
2018020769,24,3035,0.0,31,26,0,0,5,83.87096774
2018020770,12,3600,0.0,26,24,3,0,2,92.30769231
2018020770,23,3600,0.0,34,29,3,0,5,85.29411765
2018020771,52,3472,0.0,31,28,6,1,3,90.32258065
2018020771,4,3600,0.0,32,31,7,2,1,96.875
2018020772,1,3600,0.0,40,37,7,4,3,92.5
2018020772,5,3600,0.0,32,26,4,2,6,81.25
2018020773,52,3900,0.0,39,36,6,0,3,92.30769231
2018020773,6,3899,0.0,27,24,0,1,3,88.88888889
2018020774,4,3600,0.0,38,38,7,2,0,100.0
2018020774,3,3481,0.0,19,18,0,0,1,94.73684211
2018020775,7,3582,0.0,37,33,5,0,4,89.18918919
2018020775,29,3482,0.0,34,29,4,0,5,85.29411765
2018020776,14,3506,0.0,22,18,1,0,4,81.81818182
2018020776,5,3600,0.0,35,33,2,1,2,94.28571429
2018020777,7,3538,0.0,27,26,2,0,1,96.2962963
2018020777,25,3600,0.0,30,30,1,3,0,100.0
2018020778,4,3776,0.0,25,23,1,1,2,92.0
2018020778,6,3776,0.0,41,38,5,1,3,92.68292683
2018020779,3,3597,0.0,22,19,7,0,3,86.36363636
2018020779,1,3485,0.0,25,21,2,2,4,84.0
2018020780,29,3570,0.0,26,22,4,0,4,84.61538462
2018020780,52,3600,0.0,31,28,1,1,3,90.32258065
2018020781,16,3600,0.0,43,40,11,0,3,93.02325581
2018020781,7,2400,0.0,22,18,1,0,4,81.81818182
2018020781,7,1162,0.0,7,5,0,0,2,71.42857143
2018020782,18,3600,0.0,28,27,8,0,1,96.42857143
2018020782,13,3524,0.0,25,22,3,0,3,88.0
2018020783,14,3900,0.0,36,36,7,0,0,100.0
2018020783,2,3900,0.0,41,41,3,0,0,100.0
2018020784,9,3512,0.0,40,35,5,0,5,87.5
2018020784,5,3600,0.0,40,37,2,1,3,92.5
2018020785,20,3556,0.0,40,36,9,0,4,90.0
2018020785,15,3600,0.0,30,27,5,1,3,90.0
2018020786,10,3715,0.0,33,30,5,0,3,90.90909091
2018020786,17,3749,0.0,21,19,3,1,2,90.47619048
2018020787,54,3571,0.0,31,27,5,0,4,87.09677419
2018020787,12,3600,0.0,25,23,2,2,2,92.0
2018020788,30,3569,0.0,31,29,4,0,2,93.5483871
2018020788,25,3600,0.0,22,21,1,0,1,95.45454545
2018020789,22,3721,0.0,39,34,10,0,5,87.17948718
2018020789,4,3719,0.0,44,40,7,2,4,90.90909091
2018020790,1,3704,0.0,39,37,7,1,2,94.87179487
2018020790,8,3716,0.0,27,24,3,1,3,88.88888889
2018020791,5,3512,0.0,33,30,1,0,3,90.90909091
2018020791,10,3596,0.0,30,28,2,2,2,93.33333333
2018020792,17,3600,0.0,35,35,1,2,0,100.0
2018020792,9,3416,0.0,21,19,5,0,2,90.47619048
2018020793,54,3552,0.0,24,22,0,1,2,91.66666667
2018020793,13,3600,0.0,35,34,3,0,1,97.14285714
2018020794,26,3557,0.0,31,28,4,0,3,90.32258065
2018020794,2,3567,0.0,36,34,9,1,2,94.44444444
2018020795,14,3600,0.0,33,31,2,1,2,93.93939394
2018020795,3,3461,0.0,23,20,1,2,3,86.95652174
2018020796,19,3600,0.0,20,18,3,0,2,90.0
2018020796,29,3519,0.0,32,29,2,0,3,90.625
2018020797,24,2539,0.0,17,14,5,1,3,82.35294118
2018020797,24,1061,0.0,14,8,1,0,6,57.14285714
2018020797,52,3600,0.0,29,26,1,0,3,89.65517241
2018020798,25,3600,0.0,39,38,5,1,1,97.43589744
2018020798,18,3356,0.0,26,23,4,1,3,88.46153846
2018020799,16,3679,0.0,31,28,3,0,3,90.32258065
2018020799,30,3679,0.0,31,27,7,2,4,87.09677419
2018020800,23,3600,0.0,35,34,4,0,1,97.14285714
2018020800,21,3600,0.0,26,21,1,3,5,80.76923077
2018020801,53,3769,0.0,35,32,6,4,3,91.42857143
2018020801,28,3789,0.0,33,31,5,0,2,93.93939394
2018020802,6,3600,0.0,24,24,3,0,0,100.0
2018020802,15,3512,0.0,39,38,5,1,1,97.43589744
2018020803,22,3658,0.0,27,23,4,0,4,85.18518519
2018020803,8,3655,0.0,24,21,7,0,3,87.5
2018020804,20,3600,0.0,37,34,4,2,3,91.89189189
2018020804,12,3491,0.0,32,28,4,1,4,87.5
2018020805,24,818,0.0,9,8,3,0,1,88.88888889
2018020805,24,2782,0.0,35,30,2,0,5,85.71428571
2018020805,10,3594,0.0,25,24,0,0,1,96.0
2018020806,26,3602,0.0,27,24,2,1,3,88.88888889
2018020806,3,3625,0.0,30,26,2,2,4,86.66666667
2018020807,23,3478,0.0,30,28,3,2,2,93.33333333
2018020807,4,3584,0.0,42,41,8,2,1,97.61904762
2018020808,53,3462,0.0,29,24,1,2,5,82.75862069
2018020808,25,3600,0.0,42,38,7,1,4,90.47619048
2018020809,2,3562,0.0,26,24,3,2,2,92.30769231
2018020809,6,3600,0.0,29,28,6,0,1,96.55172414
2018020810,30,3851,0.0,39,35,3,2,4,89.74358974
2018020810,7,3900,0.0,45,41,4,0,4,91.11111111
2018020811,19,3598,0.0,24,22,1,0,2,91.66666667
2018020811,13,3476,0.0,34,31,0,1,3,91.17647059
2018020812,26,3600,0.0,30,29,3,2,1,96.66666667
2018020812,1,3600,0.0,25,20,3,2,5,80.0
2018020813,12,3600,0.0,23,23,3,0,0,100.0
2018020813,5,3562,0.0,31,28,1,2,3,90.32258065
2018020814,23,3413,0.0,31,28,5,1,3,90.32258065
2018020814,15,3600,0.0,32,30,3,0,2,93.75
2018020815,24,3600,0.0,32,28,5,0,4,87.5
2018020815,8,3568,0.0,25,24,1,1,1,96.0
2018020816,54,3893,0.0,26,24,7,1,2,92.30769231
2018020816,14,3900,0.0,37,35,3,2,2,94.59459459
2018020817,53,3463,0.0,46,42,10,0,4,91.30434783
2018020817,18,3600,0.0,26,24,1,4,2,92.30769231
2018020818,28,3752,0.0,27,25,9,0,2,92.59259259
2018020818,52,3769,0.0,38,35,6,2,3,92.10526316
2018020819,29,3600,0.0,30,27,2,0,3,90.0
2018020819,21,3534,0.0,36,31,8,1,5,86.11111111
2018020820,16,3594,0.0,27,25,7,1,2,92.59259259
2018020820,22,849,0.0,8,6,3,0,2,75.0
2018020820,22,2751,0.0,27,23,2,0,4,85.18518519
2018020821,9,3531,0.0,30,25,3,2,5,83.33333333
2018020821,10,3600,0.0,44,40,4,0,4,90.90909091
2018020822,6,3900,0.0,39,36,5,1,3,92.30769231
2018020822,3,3900,0.0,30,27,4,2,3,90.0
2018020823,12,3805,0.0,39,34,6,1,5,87.17948718
2018020823,7,3759,0.0,30,24,4,0,6,80.0
2018020824,5,3854,0.0,42,39,4,3,3,92.85714286
2018020824,13,3854,0.0,31,29,3,1,2,93.5483871
2018020825,2,3900,0.0,31,30,5,2,1,96.77419355
2018020825,1,3893,0.0,28,27,6,0,1,96.42857143
2018020826,26,3900,0.0,32,30,2,0,2,93.75
2018020826,4,3801,0.0,39,37,0,0,2,94.87179487
2018020827,21,3852,0.0,42,38,14,1,4,90.47619048
2018020827,15,3837,0.0,37,34,3,6,3,91.89189189
2018020828,52,3600,0.0,53,48,2,1,5,90.56603774
2018020828,8,3600,0.0,34,32,6,1,2,94.11764706
2018020829,24,921,0.0,10,9,0,2,1,90.0
2018020829,24,2400,0.0,24,22,3,0,2,91.66666667
2018020829,9,3600,0.0,45,45,6,0,0,100.0
2018020830,54,3600,0.0,39,36,6,1,3,92.30769231
2018020830,17,3469,0.0,32,28,4,0,4,87.5
2018020831,19,3840,0.0,32,32,1,2,0,100.0
2018020831,14,3841,0.0,39,38,4,1,1,97.43589744
2018020832,25,3643,0.0,24,21,0,0,3,87.5
2018020832,18,3643,0.0,29,27,0,0,2,93.10344828
2018020833,22,3600,0.0,36,35,0,0,1,97.22222222
2018020833,30,3533,0.0,22,19,4,1,3,86.36363636
2018020834,23,3781,0.0,35,31,9,2,4,88.57142857
2018020834,16,3793,0.0,43,40,4,3,3,93.02325581
2018020835,28,3600,2.0,38,36,13,2,2,94.73684211
2018020835,20,2778,2.0,24,21,3,2,3,87.5
2018020835,20,822,0.0,6,4,1,0,2,66.66666667
2018020836,29,3600,0.0,31,29,2,0,2,93.5483871
2018020836,53,3452,0.0,33,29,2,1,4,87.87878788
2018020837,12,3593,0.0,27,27,1,0,0,100.0
2018020837,3,3562,0.0,31,30,2,0,1,96.77419355
2018020838,26,3754,0.0,33,28,4,2,5,84.84848485
2018020838,6,3754,0.0,29,25,8,3,4,86.20689655
2018020839,17,3448,0.0,21,18,2,0,3,85.71428571
2018020839,7,3600,0.0,29,28,0,0,1,96.55172414
2018020840,30,3586,0.0,18,16,1,0,2,88.88888889
2018020840,1,3401,0.0,33,29,3,2,4,87.87878788
2018020841,21,3743,0.0,41,37,0,0,4,90.24390244
2018020841,2,3743,0.0,28,25,3,1,3,89.28571429
2018020842,24,1200,0.0,14,10,2,0,4,71.42857143
2018020842,24,2400,0.0,26,24,5,0,2,92.30769231
2018020842,4,3600,0.0,32,30,3,0,2,93.75
2018020843,52,3600,0.0,32,27,0,1,5,84.375
2018020843,9,3600,0.0,46,44,6,0,2,95.65217391
2018020844,18,3436,0.0,33,30,3,0,3,90.90909091
2018020844,19,3578,0.0,31,29,1,0,2,93.5483871
2018020845,25,3495,0.0,39,36,7,0,3,92.30769231
2018020845,53,3600,0.0,35,33,6,2,2,94.28571429
2018020846,10,3737,0.0,38,35,4,3,3,92.10526316
2018020846,8,3729,0.0,32,28,1,3,4,87.5
2018020847,5,3505,0.0,34,29,0,0,5,85.29411765
2018020847,14,3600,0.0,32,28,0,0,4,87.5
2018020848,13,3691,0.0,30,26,1,2,4,86.66666667
2018020848,15,3691,0.0,31,26,5,1,5,83.87096774
2018020849,28,3600,0.0,23,21,2,1,2,91.30434783
2018020849,22,3600,0.0,31,26,9,1,5,83.87096774
2018020850,20,3868,0.0,25,22,5,2,3,88.0
2018020850,23,3900,0.0,47,44,9,1,3,93.61702128
2018020851,29,3589,0.0,23,20,0,1,3,86.95652174
2018020851,54,3471,0.0,33,29,3,0,4,87.87878788
2018020852,19,3616,0.0,44,40,8,0,4,90.90909091
2018020852,18,3616,0.0,29,24,2,2,5,82.75862069
2018020853,21,3843,0.0,35,33,8,1,2,94.28571429
2018020853,6,3843,0.0,36,35,6,4,1,97.22222222
2018020854,52,3599,0.0,36,35,8,0,1,97.22222222
2018020854,7,3503,0.0,28,26,0,2,2,92.85714286
2018020855,12,3375,0.0,21,18,3,2,3,85.71428571
2018020855,1,3600,0.0,35,33,8,2,2,94.28571429
2018020856,30,3512,0.0,34,32,11,1,2,94.11764706
2018020856,2,3600,0.0,27,26,6,1,1,96.2962963
2018020857,17,3517,0.0,35,31,5,1,4,88.57142857
2018020857,16,3600,0.0,45,43,4,3,2,95.55555556
2018020858,14,3599,0.0,27,25,2,0,2,92.59259259
2018020858,13,1116,0.0,11,9,1,0,2,81.81818182
2018020858,13,2377,0.0,12,9,0,0,3,75.0
2018020859,10,3450,0.0,29,26,3,0,3,89.65517241
2018020859,3,3600,0.0,56,55,23,0,1,98.21428571
2018020860,5,3600,0.0,51,50,11,0,1,98.03921569
2018020860,4,3446,0.0,27,24,0,0,3,88.88888889
2018020861,26,3462,0.0,31,25,10,1,6,80.64516129
2018020861,15,3596,0.0,33,29,1,0,4,87.87878788
2018020862,28,3600,0.0,27,25,2,1,2,92.59259259
2018020862,23,3600,0.0,24,17,3,1,7,70.83333333
2018020863,16,3595,0.0,37,31,2,0,6,83.78378378
2018020863,6,3600,0.0,26,23,5,1,3,88.46153846
2018020864,2,3479,0.0,22,19,0,0,3,86.36363636
2018020864,7,3600,0.0,25,24,0,1,1,96.0
2018020865,25,3571,0.0,30,30,9,1,0,100.0
2018020865,13,3551,0.0,18,16,1,0,2,88.88888889
2018020866,15,3449,0.0,31,29,6,3,2,93.5483871
2018020866,29,3586,0.0,20,20,1,0,0,100.0
2018020867,12,3600,0.0,26,25,3,0,1,96.15384615
2018020867,9,3594,0.0,37,33,5,1,4,89.18918919
2018020868,20,3600,0.0,27,21,3,0,6,77.77777778
2018020868,14,3584,0.0,22,19,1,2,3,86.36363636
2018020869,1,3600,0.0,39,31,3,1,8,79.48717949
2018020869,19,3582,0.0,23,20,3,1,3,86.95652174
2018020870,17,3591,0.0,34,32,6,2,2,94.11764706
2018020870,18,3531,0.0,27,24,3,2,3,88.88888889
2018020871,4,3600,0.0,39,35,4,1,4,89.74358974
2018020871,30,3533,0.0,26,21,5,1,5,80.76923077
2018020872,3,3540,0.0,36,32,5,0,4,88.88888889
2018020872,52,3600,0.0,37,34,3,1,3,91.89189189
2018020873,10,3600,0.0,36,34,4,3,2,94.44444444
2018020873,21,1628,0.0,17,13,4,1,4,76.47058824
2018020873,21,1972,0.0,11,10,1,0,1,90.90909091
2018020874,53,3600,0.0,43,41,4,0,2,95.34883721
2018020874,54,3547,0.0,25,21,3,0,4,84.0
2018020875,22,3583,0.0,33,31,3,0,2,93.93939394
2018020875,5,3600,0.0,39,38,3,0,1,97.43589744
2018020876,23,3514,0.0,22,21,1,0,1,95.45454545
2018020876,24,3600,0.0,35,35,6,0,0,100.0
2018020877,20,3829,0.0,32,30,1,2,2,93.75
2018020877,13,3900,0.0,43,41,5,2,2,95.34883721
2018020878,2,3600,0.0,31,31,2,2,0,100.0
2018020878,29,3600,0.0,27,24,1,1,3,88.88888889
2018020879,9,3506,0.0,29,26,1,2,3,89.65517241
2018020879,17,3600,0.0,42,40,1,1,2,95.23809524
2018020880,25,1973,0.0,21,16,4,0,5,76.19047619
2018020880,25,1627,0.0,5,4,1,0,1,80.0
2018020880,14,3600,0.0,32,32,2,2,0,100.0
2018020881,8,3491,0.0,38,35,4,0,3,92.10526316
2018020881,18,3600,0.0,35,34,5,0,1,97.14285714
2018020882,21,3600,0.0,25,24,4,0,1,96.0
2018020882,52,3588,0.0,35,31,4,0,4,88.57142857
2018020883,1,3600,0.0,36,31,3,3,5,86.11111111
2018020883,16,3595,0.0,43,41,5,1,2,95.34883721
2018020884,19,3600,0.0,21,21,4,0,0,100.0
2018020884,53,3600,0.0,24,20,3,1,4,83.33333333
2018020885,10,3600,0.0,33,30,8,6,3,90.90909091
2018020885,54,3585,0.0,43,37,6,0,6,86.04651163
2018020886,23,3900,0.0,38,35,7,0,3,92.10526316
2018020886,26,3876,0.0,27,24,3,2,3,88.88888889
2018020887,15,3600,0.0,26,25,0,0,1,96.15384615
2018020887,28,3456,0.0,28,24,4,0,4,85.71428571
2018020888,3,3600,0.0,33,31,2,0,2,93.93939394
2018020888,7,3473,0.0,28,23,0,0,5,82.14285714
2018020889,22,3496,0.0,27,24,6,0,3,88.88888889
2018020889,12,3600,0.0,41,40,6,2,1,97.56097561
2018020890,1,2160,0.0,15,15,0,0,0,100.0
2018020890,1,1639,0.0,17,13,0,0,4,76.47058824
2018020890,30,3798,0.0,28,23,2,0,5,82.14285714
2018020891,6,3582,0.0,30,30,7,1,0,100.0
2018020891,24,3526,0.0,28,26,2,1,2,92.85714286
2018020892,17,2484,0.0,24,19,2,1,5,79.16666667
2018020892,17,1120,0.0,8,7,0,0,1,87.5
2018020892,4,3687,0.0,38,33,1,1,5,86.84210526
2018020893,20,3600,0.0,38,34,3,0,4,89.47368421
2018020893,5,2400,0.0,24,19,2,0,5,79.16666667
2018020893,5,1112,0.0,7,7,2,1,0,100.0
2018020894,19,3583,0.0,32,32,4,2,0,100.0
2018020894,21,3524,0.0,32,30,3,0,2,93.75
2018020895,8,3600,0.0,37,34,2,1,3,91.89189189
2018020895,14,3589,0.0,20,20,0,1,0,100.0
2018020896,22,3596,0.0,23,19,3,0,4,82.60869565
2018020896,2,3600,0.0,36,34,8,1,2,94.44444444
2018020897,9,3824,0.0,26,23,1,3,3,88.46153846
2018020897,52,3824,0.0,41,37,8,2,4,90.24390244
2018020898,10,3392,0.0,29,27,2,0,2,93.10344828
2018020898,53,3600,0.0,22,22,6,1,0,100.0
2018020899,25,3600,0.0,27,24,3,0,3,88.88888889
2018020899,12,3600,2.0,33,33,3,0,0,100.0
2018020900,29,3600,0.0,41,39,0,0,2,95.12195122
2018020900,16,3600,0.0,30,25,1,0,5,83.33333333
2018020901,18,3600,0.0,50,45,5,5,5,90.0
2018020901,54,3554,0.0,30,29,2,0,1,96.66666667
2018020902,23,3448,0.0,26,23,5,0,3,88.46153846
2018020902,28,3548,0.0,34,32,7,5,2,94.11764706
2018020903,6,3600,0.0,25,23,5,3,2,92.0
2018020903,26,3600,0.0,24,20,2,1,4,83.33333333
2018020904,3,3454,0.0,41,35,7,0,6,85.36585366
2018020904,5,3600,0.0,44,39,4,2,5,88.63636364
2018020905,19,3600,0.0,31,31,10,0,0,100.0
2018020905,30,3586,2.0,30,26,6,2,4,86.66666667
2018020906,7,3567,0.0,23,20,3,0,3,86.95652174
2018020906,1,3600,0.0,35,34,3,1,1,97.14285714
2018020907,4,3600,0.0,38,37,5,0,1,97.36842105
2018020907,17,2292,0.0,12,11,0,0,1,91.66666667
2018020907,17,1200,0.0,10,9,0,0,1,90.0
2018020908,8,2716,0.0,26,24,5,1,2,92.30769231
2018020908,8,837,0.0,9,6,1,0,3,66.66666667
2018020908,13,3600,0.0,31,28,2,0,3,90.32258065
2018020909,15,3600,0.0,39,34,6,0,5,87.17948718
2018020909,24,3600,0.0,25,23,3,2,2,92.0
2018020910,53,3525,0.0,32,28,5,1,4,87.5
2018020910,20,3599,0.0,29,27,1,3,2,93.10344828
2018020911,14,3600,0.0,40,39,3,1,1,97.5
2018020911,29,3600,0.0,20,15,1,0,5,75.0
2018020912,9,2693,0.0,30,26,1,1,4,86.66666667
2018020912,9,802,0.0,12,8,0,0,4,66.66666667
2018020912,16,3125,0.0,28,24,3,5,4,85.71428571
2018020912,16,475,0.0,10,7,0,0,3,70.0
2018020913,54,3587,0.0,38,35,3,2,3,92.10526316
2018020913,21,3576,0.0,40,40,10,2,0,100.0
2018020914,15,3600,0.0,28,26,5,0,2,92.85714286
2018020914,26,3468,0.0,21,18,0,0,3,85.71428571
2018020915,6,3839,0.0,38,33,2,6,5,86.84210526
2018020915,28,3839,0.0,20,14,3,0,6,70.0
2018020916,7,3595,0.0,41,37,8,1,4,90.24390244
2018020916,13,3600,0.0,34,32,6,4,2,94.11764706
2018020917,5,3600,0.0,36,33,3,0,3,91.66666667
2018020917,1,3563,0.0,28,24,1,3,4,85.71428571
2018020918,14,3589,0.0,30,28,5,0,2,93.33333333
2018020918,4,2910,0.0,23,22,4,0,1,95.65217391
2018020918,4,623,0.0,9,6,2,0,3,66.66666667
2018020919,3,3600,0.0,44,43,4,0,1,97.72727273
2018020919,12,3443,0.0,26,24,4,0,2,92.30769231
2018020920,29,3499,0.0,32,29,3,0,3,90.625
2018020920,8,3548,0.0,33,31,1,3,2,93.93939394
2018020921,10,3634,0.0,41,38,6,0,3,92.68292683
2018020921,19,3634,0.0,33,31,0,2,2,93.93939394
2018020922,24,3598,0.0,31,31,5,0,0,100.0
2018020922,30,3528,0.0,23,20,3,1,3,86.95652174
2018020923,18,3592,0.0,39,36,6,2,3,92.30769231
2018020923,25,3499,0.0,46,42,0,0,4,91.30434783
2018020924,53,3900,0.0,37,35,2,1,2,94.59459459
2018020924,22,3802,0.0,35,33,4,3,2,94.28571429
2018020925,16,3762,0.0,35,31,7,0,4,88.57142857
2018020925,17,1277,0.0,8,4,0,0,4,50.0
2018020925,17,2459,0.0,12,11,0,0,1,91.66666667
2018020926,52,3545,0.0,46,39,8,3,7,84.7826087
2018020926,21,3600,0.0,27,26,2,1,1,96.2962963
2018020927,2,3505,0.0,32,28,0,1,4,87.5
2018020927,20,3588,0.0,19,17,4,0,2,89.47368421
2018020928,6,3900,0.0,33,31,4,3,2,93.93939394
2018020928,54,3891,0.0,27,25,1,0,2,92.59259259
2018020929,15,3599,0.0,42,40,6,0,2,95.23809524
2018020929,10,3369,0.0,28,25,3,0,3,89.28571429
2018020930,12,3600,0.0,30,27,3,1,3,90.0
2018020930,13,3484,0.0,25,21,5,0,4,84.0
2018020931,9,3600,0.0,31,27,6,2,4,87.09677419
2018020931,1,3600,0.0,30,30,5,0,0,100.0
2018020932,30,3600,0.0,34,33,5,0,1,97.05882353
2018020932,3,3492,0.0,34,31,2,1,3,91.17647059
2018020933,28,3600,0.0,26,26,1,2,0,100.0
2018020933,5,3598,0.0,33,29,7,1,4,87.87878788
2018020934,4,2967,0.0,31,29,0,1,2,93.5483871
2018020934,4,633,0.0,9,6,0,1,3,66.66666667
2018020934,8,3600,0.0,30,29,7,0,1,96.66666667
2018020935,7,3900,0.0,40,39,4,0,1,97.5
2018020935,14,3900,0.0,30,29,6,0,1,96.66666667
2018020936,26,3526,0.0,29,27,3,1,2,93.10344828
2018020936,18,3578,0.0,29,28,7,2,1,96.55172414
2018020937,19,3441,0.0,24,20,4,0,4,83.33333333
2018020937,25,3600,0.0,45,43,2,6,2,95.55555556
2018020938,2,3682,0.0,41,37,7,0,4,90.24390244
2018020938,22,3646,0.0,23,20,1,0,3,86.95652174
2018020939,53,3714,0.0,32,30,4,0,2,93.75
2018020939,23,3714,0.0,38,35,5,0,3,92.10526316
2018020940,29,3579,0.0,22,22,3,1,0,100.0
2018020940,9,3600,0.0,40,37,7,5,3,92.5
2018020941,30,3600,0.0,28,26,3,1,2,92.85714286
2018020941,17,3506,0.0,35,32,5,0,3,91.42857143
2018020942,21,3595,0.0,44,41,8,3,3,93.18181818
2018020942,16,3498,0.0,30,26,4,0,4,86.66666667
2018020943,24,3508,0.0,28,26,0,1,2,92.85714286
2018020943,20,3596,0.0,26,25,1,0,1,96.15384615
2018020944,52,3600,0.0,32,29,4,1,3,90.625
2018020944,54,3580,0.0,28,23,0,1,5,82.14285714
2018020945,15,3524,0.0,37,33,1,1,4,89.18918919
2018020945,7,3600,0.0,33,31,5,0,2,93.93939394
2018020946,1,3458,0.0,33,29,4,1,4,87.87878788
2018020946,3,3600,0.0,21,19,3,1,2,90.47619048
2018020947,6,3900,0.0,29,28,4,2,1,96.55172414
2018020947,19,3900,0.0,32,31,0,0,1,96.875
2018020948,26,2802,0.0,23,17,6,0,6,73.91304348
2018020948,26,798,0.0,2,2,0,0,0,100.0
2018020948,13,3547,0.0,19,18,0,2,1,94.73684211
2018020949,28,2945,0.0,23,19,1,1,4,82.60869565
2018020949,28,655,0.0,3,3,0,0,0,100.0
2018020949,29,3600,0.0,26,26,1,1,0,100.0
2018020950,12,3600,0.0,24,24,2,0,0,100.0
2018020950,25,3559,0.0,30,28,4,1,2,93.33333333
2018020951,21,3600,0.0,38,38,9,2,0,100.0
2018020951,18,3591,0.0,21,16,4,0,5,76.19047619
2018020952,8,3532,0.0,35,31,4,0,4,88.57142857
2018020952,10,3600,2.0,35,32,7,3,3,91.42857143
2018020953,5,3719,0.0,37,33,8,0,4,89.18918919
2018020953,4,3578,0.0,43,40,0,1,3,93.02325581
2018020954,24,3485,0.0,21,19,4,0,2,90.47619048
2018020954,22,3585,0.0,34,33,3,0,1,97.05882353
2018020955,2,3557,0.0,36,36,5,2,0,100.0
2018020955,23,3410,0.0,22,19,0,1,3,86.36363636
2018020956,3,3816,0.0,35,29,5,2,6,82.85714286
2018020956,15,3860,0.0,31,26,0,3,5,83.87096774
2018020957,28,3600,0.0,23,20,1,0,3,86.95652174
2018020957,17,3535,0.0,36,32,3,2,4,88.88888889
2018020958,25,3600,0.0,47,44,13,0,3,93.61702128
2018020958,16,3506,0.0,29,25,1,0,4,86.20689655
2018020959,20,3600,0.0,23,22,1,0,1,95.65217391
2018020959,9,3570,0.0,35,33,6,0,2,94.28571429
2018020960,19,3749,0.0,35,33,6,0,2,94.28571429
2018020960,30,3749,0.0,28,27,1,0,1,96.42857143
2018020961,52,3513,0.0,23,20,1,3,3,86.95652174
2018020961,53,3600,0.0,35,34,11,0,1,97.14285714
2018020962,7,1552,0.0,12,9,0,1,3,75.0
2018020962,7,1931,0.0,21,19,0,1,2,90.47619048
2018020962,10,3600,0.0,34,31,5,0,3,91.17647059
2018020963,8,3509,0.0,22,20,4,1,2,90.90909091
2018020963,1,3600,0.0,35,34,5,3,1,97.14285714
2018020964,26,3900,0.0,34,31,4,0,3,91.17647059
2018020964,14,3886,0.0,33,30,5,0,3,90.90909091
2018020965,22,3867,2.0,38,36,7,0,2,94.73684211
2018020965,18,3900,0.0,27,25,1,0,2,92.59259259
2018020966,13,3569,0.0,39,36,3,1,3,92.30769231
2018020966,21,3626,0.0,38,34,7,1,4,89.47368421
2018020967,24,3600,0.0,29,25,1,1,4,86.20689655
2018020967,23,3600,0.0,29,29,0,1,0,100.0
2018020968,28,3425,0.0,32,28,4,2,4,87.5
2018020968,6,3588,0.0,20,19,2,1,1,95.0
2018020969,20,3600,0.0,27,26,9,1,1,96.2962963
2018020969,2,3499,0.0,27,24,1,0,3,88.88888889
2018020970,7,3591,0.0,44,40,2,1,4,90.90909091
2018020970,4,3600,0.0,36,34,4,1,2,94.44444444
2018020971,9,1767,0.0,13,12,0,0,1,92.30769231
2018020971,9,1833,0.0,24,18,1,0,6,75.0
2018020971,15,3600,0.0,23,21,0,0,2,91.30434783
2018020972,26,2400,0.0,20,14,0,0,6,70.0
2018020972,26,1200,0.0,14,14,1,0,0,100.0
2018020972,12,3600,0.0,23,22,2,0,1,95.65217391
2018020973,5,3600,0.0,23,21,1,1,2,91.30434783
2018020973,29,3550,0.0,26,22,0,2,4,84.61538462
2018020974,8,3600,0.0,29,28,8,0,1,96.55172414
2018020974,17,2382,0.0,22,16,0,0,6,72.72727273
2018020974,17,1200,0.0,12,10,0,4,2,83.33333333
2018020975,18,3586,0.0,43,42,4,1,1,97.6744186
2018020975,19,3600,0.0,19,19,2,0,0,100.0
2018020976,30,3576,0.0,32,30,5,1,2,93.75
2018020976,52,3539,0.0,40,37,3,2,3,92.5
2018020977,13,2668,0.0,30,27,6,0,3,90.0
2018020977,13,1232,0.0,10,10,0,0,0,100.0
2018020977,53,3897,0.0,27,24,0,0,3,88.88888889
2018020978,25,3537,0.0,46,44,9,1,2,95.65217391
2018020978,54,3594,0.0,24,23,3,0,1,95.83333333
2018020979,22,2110,0.0,20,18,3,0,2,90.0
2018020979,22,1486,0.0,16,12,4,0,4,75.0
2018020979,10,3600,0.0,36,34,2,0,2,94.44444444
2018020980,20,3586,0.0,20,19,5,1,1,95.0
2018020980,1,3447,0.0,35,33,6,0,2,94.28571429
2018020981,14,3805,0.0,36,33,9,0,3,91.66666667
2018020981,3,3801,0.0,30,26,0,2,4,86.66666667
2018020982,23,3898,0.0,45,43,5,4,2,95.55555556
2018020982,21,3896,0.0,32,30,6,1,2,93.75
2018020983,16,3600,0.0,32,29,3,3,3,90.625
2018020983,24,3565,0.0,35,31,3,0,4,88.57142857
2018020984,14,3468,0.0,41,37,1,0,4,90.24390244
2018020984,6,3600,0.0,21,20,2,2,1,95.23809524
2018020985,10,3600,0.0,37,31,1,0,6,83.78378378
2018020985,2,3600,0.0,35,34,5,0,1,97.14285714
2018020986,4,3867,2.0,40,36,4,1,4,90.0
2018020986,29,3863,0.0,31,28,0,1,3,90.32258065
2018020987,22,3600,0.0,37,35,1,3,2,94.59459459
2018020987,9,3548,0.0,25,22,4,0,3,88.0
2018020988,23,3600,0.0,24,19,1,0,5,79.16666667
2018020988,53,3600,0.0,39,37,5,1,2,94.87179487
2018020989,13,3900,0.0,46,41,1,2,5,89.13043478
2018020989,54,3893,0.0,37,32,2,1,5,86.48648649
2018020990,25,3799,0.0,30,27,1,2,3,90.0
2018020990,26,3799,0.0,33,29,7,1,4,87.87878788
2018020991,5,3828,0.0,30,26,3,1,4,86.66666667
2018020991,7,3851,0.0,44,41,1,2,3,93.18181818
2018020992,4,3600,0.0,33,30,1,4,3,90.90909091
2018020992,1,3518,0.0,23,18,3,1,5,78.26086957
2018020993,15,3600,0.0,21,20,3,1,1,95.23809524
2018020993,2,3518,0.0,28,26,1,0,2,92.85714286
2018020994,8,3600,0.0,30,28,3,0,2,93.33333333
2018020994,3,3529,0.0,35,32,3,0,3,91.42857143
2018020995,19,3512,0.0,23,19,2,1,4,82.60869565
2018020995,12,3600,0.0,23,21,3,1,2,91.30434783
2018020996,18,3477,0.0,30,27,7,0,3,90.0
2018020996,52,3600,0.0,38,35,5,1,3,92.10526316
2018020997,54,3596,0.0,34,34,3,0,0,100.0
2018020997,24,3476,0.0,33,31,2,0,2,93.93939394
2018020998,21,3487,0.0,40,36,9,1,4,90.0
2018020998,28,3600,0.0,25,22,1,2,3,88.0
2018020999,22,3600,0.0,30,30,2,0,0,100.0
2018020999,29,2400,0.0,19,15,0,0,4,78.94736842
2018020999,29,1198,0.0,5,5,1,1,0,100.0
2018021000,16,3592,0.0,25,19,3,0,6,76.0
2018021000,26,3600,0.0,32,29,3,0,3,90.625
2018021001,1,3520,0.0,30,29,1,1,1,96.66666667
2018021001,6,3600,0.0,20,20,1,0,0,100.0
2018021002,7,3536,0.0,31,27,5,0,4,87.09677419
2018021002,10,3600,0.0,37,35,3,1,2,94.59459459
2018021003,5,3600,0.0,37,36,5,0,1,97.2972973
2018021003,8,3374,0.0,24,20,5,2,4,83.33333333
2018021004,9,3592,0.0,34,29,1,0,5,85.29411765
2018021004,14,3563,0.0,37,36,4,4,1,97.2972973
2018021005,12,3706,0.0,34,31,4,0,3,91.17647059
2018021005,13,3704,0.0,26,22,0,0,4,84.61538462
2018021006,25,3600,0.0,30,29,6,0,1,96.66666667
2018021006,19,3394,0.0,20,17,0,1,3,85.0
2018021007,17,3519,0.0,44,41,4,0,3,93.18181818
2018021007,53,3600,0.0,23,22,0,0,1,95.65217391
2018021008,30,3600,0.0,37,35,3,2,2,94.59459459
2018021008,20,3563,0.0,23,19,3,0,4,82.60869565
2018021009,15,3900,0.0,24,22,1,1,2,91.66666667
2018021009,3,3900,0.0,39,37,5,1,2,94.87179487
2018021010,4,3600,0.0,30,29,2,0,1,96.66666667
2018021010,2,1398,0.0,13,10,0,0,3,76.92307692
2018021010,2,2202,0.0,13,12,2,0,1,92.30769231
2018021011,23,3600,0.0,48,45,3,0,3,93.75
2018021011,54,3600,0.0,19,19,0,0,0,100.0
2018021012,21,3533,0.0,23,21,2,0,2,91.30434783
2018021012,24,3600,0.0,26,25,3,0,1,96.15384615
2018021013,9,3600,0.0,32,30,1,1,2,93.75
2018021013,13,3531,0.0,33,30,0,1,3,90.90909091
2018021014,52,3600,2.0,42,40,7,0,2,95.23809524
2018021014,29,3511,0.0,25,21,3,1,4,84.0
2018021015,18,3900,0.0,26,24,2,0,2,92.30769231
2018021015,30,3891,0.0,43,41,4,0,2,95.34883721
2018021016,16,3452,0.0,33,29,1,0,4,87.87878788
2018021016,28,3597,0.0,30,28,8,0,2,93.33333333
2018021017,22,3600,0.0,38,35,9,0,3,92.10526316
2018021017,7,1083,0.0,7,7,0,0,0,100.0
2018021017,7,2400,0.0,20,16,0,1,4,80.0
2018021018,10,3582,0.0,37,35,1,1,2,94.59459459
2018021018,20,3600,0.0,32,26,2,0,6,81.25
2018021019,12,3706,0.0,38,34,1,2,4,89.47368421
2018021019,6,3687,0.0,37,34,6,0,3,91.89189189
2018021020,29,3852,0.0,30,29,2,0,1,96.66666667
2018021020,1,3898,0.0,18,17,0,0,1,94.44444444
2018021021,9,3900,0.0,38,34,9,0,4,89.47368421
2018021021,2,3307,0.0,25,21,0,1,4,84.0
2018021021,2,580,0.0,2,2,0,0,0,100.0
2018021022,13,3754,0.0,37,34,2,1,3,91.89189189
2018021022,5,3764,0.0,34,32,3,1,2,94.11764706
2018021023,52,3384,0.0,36,32,3,0,4,88.88888889
2018021023,52,196,0.0,2,1,0,0,1,50.0
2018021023,14,3600,0.0,32,30,4,0,2,93.75
2018021024,30,3850,0.0,25,21,0,0,4,84.0
2018021024,18,3900,0.0,33,29,0,0,4,87.87878788
2018021025,3,3564,0.0,32,31,5,3,1,96.875
2018021025,25,3600,0.0,28,28,3,3,0,100.0
2018021026,17,3749,0.0,34,30,5,1,4,88.23529412
2018021026,21,3739,0.0,23,20,3,0,3,86.95652174
2018021027,24,3547,0.0,23,22,9,1,1,95.65217391
2018021027,53,3427,0.0,31,28,5,0,3,90.32258065
2018021028,8,3600,0.0,27,26,2,0,1,96.2962963
2018021028,26,3523,0.0,24,21,1,0,3,87.5
2018021029,15,3548,0.0,30,27,0,3,3,90.0
2018021029,4,1458,0.0,19,15,1,0,4,78.94736842
2018021029,4,2007,0.0,16,15,2,0,1,93.75
2018021030,10,3791,0.0,31,28,2,1,3,90.32258065
2018021030,23,3791,0.0,30,28,2,0,2,93.33333333
2018021031,19,3557,0.0,27,23,6,1,4,85.18518519
2018021031,24,3555,0.0,33,28,8,0,5,84.84848485
2018021032,20,3446,0.0,38,36,5,3,2,94.73684211
2018021032,54,3593,0.0,34,33,3,1,1,97.05882353
2018021033,13,3548,0.0,28,24,6,0,4,85.71428571
2018021033,6,3561,0.0,25,22,6,0,3,88.0
2018021034,29,3468,0.0,30,28,6,2,2,93.33333333
2018021034,5,3600,0.0,25,25,5,1,0,100.0
2018021035,2,3589,0.0,37,35,7,0,2,94.59459459
2018021035,9,3460,0.0,30,27,2,3,3,90.0
2018021036,3,3900,0.0,45,43,3,0,2,95.55555556
2018021036,17,3899,0.0,34,32,0,3,2,94.11764706
2018021037,30,3544,0.0,25,25,1,0,0,100.0
2018021037,14,3511,0.0,29,27,5,1,2,93.10344828
2018021038,7,3888,0.0,45,41,6,2,4,91.11111111
2018021038,16,3870,0.0,39,35,1,0,4,89.74358974
2018021039,21,3186,0.0,29,26,0,1,3,89.65517241
2018021039,21,299,0.0,3,3,0,0,0,100.0
2018021039,25,3600,0.0,31,31,1,1,0,100.0
2018021040,23,3525,0.0,34,31,3,0,3,91.17647059
2018021040,22,3592,0.0,37,35,5,2,2,94.59459459
2018021041,20,3339,0.0,26,24,3,0,2,92.30769231
2018021041,53,3600,2.0,30,30,2,0,0,100.0
2018021042,19,3563,0.0,28,28,5,0,0,100.0
2018021042,26,3600,0.0,32,28,5,0,4,87.5
2018021043,8,3467,0.0,24,20,0,0,4,83.33333333
2018021043,28,3600,0.0,39,37,2,0,2,94.87179487
2018021044,30,2400,0.0,22,19,2,0,3,86.36363636
2018021044,30,1200,0.0,7,4,0,0,3,57.14285714
2018021044,13,3600,0.0,27,25,6,3,2,92.59259259
2018021045,1,3544,0.0,35,33,8,2,2,94.28571429
2018021045,15,3600,0.0,25,25,6,0,0,100.0
2018021046,52,3572,0.0,29,28,4,1,1,96.55172414
2018021046,12,3592,0.0,29,21,2,0,8,72.4137931
2018021047,8,3600,0.0,29,21,4,1,8,72.4137931
2018021047,24,3600,0.0,37,35,9,1,2,94.59459459
2018021048,7,3520,0.0,42,40,6,0,2,95.23809524
2018021048,21,3575,0.0,18,18,1,0,0,100.0
2018021049,19,3744,0.0,33,30,3,0,3,90.90909091
2018021049,28,3801,0.0,19,17,4,0,2,89.47368421
2018021050,9,3584,0.0,31,28,4,4,3,90.32258065
2018021050,6,3598,0.0,19,17,4,0,2,89.47368421
2018021051,17,3455,0.0,33,30,4,1,3,90.90909091
2018021051,14,3600,0.0,24,22,7,2,2,91.66666667
2018021052,4,3599,0.0,27,25,5,1,2,92.59259259
2018021052,2,2396,0.0,15,10,2,0,5,66.66666667
2018021052,2,1200,0.0,10,10,2,0,0,100.0
2018021053,1,3535,0.0,40,37,7,0,3,92.5
2018021053,3,3600,0.0,24,22,4,4,2,91.66666667
2018021054,5,3547,0.0,32,29,5,0,3,90.625
2018021054,29,3600,0.0,29,28,5,1,1,96.55172414
2018021055,10,3600,0.0,33,31,5,1,2,93.93939394
2018021055,22,3532,0.0,40,37,1,1,3,92.5
2018021056,12,3598,0.0,34,31,4,0,3,91.17647059
2018021056,18,3483,0.0,31,27,8,1,4,87.09677419
2018021057,16,3600,0.0,27,26,0,0,1,96.2962963
2018021057,25,3533,0.0,39,37,3,0,2,94.87179487
2018021058,26,3558,0.0,32,28,2,0,4,87.5
2018021058,53,3547,0.0,36,34,4,1,2,94.44444444
2018021059,54,3590,0.0,31,29,2,1,2,93.5483871
2018021059,23,857,0.0,16,11,0,0,5,68.75
2018021059,23,2743,0.0,17,16,1,0,1,94.11764706
2018021060,17,3600,0.0,43,37,6,0,6,86.04651163
2018021060,13,3567,0.0,20,19,2,2,1,95.0
2018021061,52,3516,0.0,17,15,0,0,2,88.23529412
2018021061,15,3568,0.0,34,33,7,3,1,97.05882353
2018021062,6,3386,0.0,36,33,2,0,3,91.66666667
2018021062,5,3593,0.0,41,39,10,1,2,95.12195122
2018021063,54,3559,2.0,34,29,2,1,5,85.29411765
2018021063,20,3600,0.0,28,25,4,1,3,89.28571429
2018021064,26,3600,0.0,20,18,2,0,2,90.0
2018021064,24,3502,0.0,25,22,2,0,3,88.0
2018021065,14,3600,0.0,28,26,1,0,2,92.85714286
2018021065,10,1490,0.0,19,15,2,0,4,78.94736842
2018021065,10,2110,0.0,23,21,0,0,2,91.30434783
2018021066,29,3489,0.0,19,18,2,0,1,94.73684211
2018021066,2,3600,0.0,31,31,1,1,0,100.0
2018021067,9,3546,0.0,36,33,6,0,3,91.66666667
2018021067,4,3600,0.0,22,20,2,0,2,90.90909091
2018021068,28,3597,0.0,24,24,4,0,0,100.0
2018021068,30,3600,0.0,29,26,3,0,3,89.65517241
2018021069,53,2014,0.0,18,15,0,1,3,83.33333333
2018021069,53,1586,0.0,16,12,0,0,4,75.0
2018021069,16,3600,0.0,25,24,4,0,1,96.0
2018021070,12,3600,0.0,38,38,8,0,0,100.0
2018021070,21,3534,0.0,32,30,3,2,2,93.75
2018021071,3,3625,0.0,33,30,2,0,3,90.90909091
2018021071,22,3635,0.0,30,28,2,2,2,93.33333333
2018021072,25,3600,0.0,35,35,1,0,0,100.0
2018021072,7,3418,0.0,27,25,6,2,2,92.59259259
2018021073,15,3519,0.0,29,25,3,0,4,86.20689655
2018021073,5,3600,0.0,41,38,4,1,3,92.68292683
2018021074,6,1873,0.0,10,9,1,0,1,90.0
2018021074,6,1689,0.0,24,19,2,1,5,79.16666667
2018021074,29,3600,0.0,31,27,1,1,4,87.09677419
2018021075,17,3572,0.0,35,33,4,0,2,94.28571429
2018021075,8,3598,0.0,21,20,2,1,1,95.23809524
2018021076,53,3600,2.0,40,39,1,0,1,97.5
2018021076,19,3523,0.0,21,19,3,0,2,90.47619048
2018021077,28,3596,0.0,25,21,1,0,4,84.0
2018021077,52,3583,0.0,36,31,5,1,5,86.11111111
2018021078,1,3598,0.0,39,30,0,0,9,76.92307692
2018021078,20,3595,0.0,26,22,0,1,4,84.61538462
2018021079,18,3386,0.0,18,15,0,1,3,83.33333333
2018021079,24,3600,0.0,34,32,5,1,2,94.11764706
2018021080,16,2400,0.0,18,17,0,0,1,94.44444444
2018021080,16,1200,0.0,29,26,0,0,3,89.65517241
2018021080,10,1200,0.0,14,10,0,0,4,71.42857143
2018021080,10,2207,0.0,25,24,0,0,1,96.0
2018021081,1,3600,0.0,39,36,8,1,3,92.30769231
2018021081,22,1631,0.0,17,15,3,1,2,88.23529412
2018021081,22,1969,0.0,18,14,0,0,4,77.77777778
2018021082,3,3452,0.0,27,24,7,0,3,88.88888889
2018021082,23,3600,0.0,22,21,6,2,1,95.45454545
2018021083,5,3592,0.0,26,26,5,0,0,100.0
2018021083,7,3600,0.0,28,23,2,1,5,82.14285714
2018021084,8,3555,0.0,38,36,5,0,2,94.73684211
2018021084,2,3592,0.0,34,33,2,0,1,97.05882353
2018021085,15,3600,0.0,24,22,5,0,2,91.66666667
2018021085,4,3585,0.0,31,27,3,1,4,87.09677419
2018021086,19,3515,0.0,20,19,1,1,1,95.0
2018021086,9,3600,0.0,35,35,2,1,0,100.0
2018021087,14,3600,2.0,27,23,3,1,4,85.18518519
2018021087,17,3493,0.0,39,34,3,0,5,87.17948718
2018021088,25,2007,0.0,15,14,2,0,1,93.33333333
2018021088,25,1593,0.0,7,7,0,0,0,100.0
2018021088,30,3502,0.0,30,27,1,0,3,90.0
2018021089,6,3499,0.0,24,20,2,1,4,83.33333333
2018021089,52,3600,0.0,39,36,0,0,3,92.30769231
2018021090,24,3600,0.0,24,18,8,0,6,75.0
2018021090,53,3600,2.0,37,36,7,0,1,97.2972973
2018021091,18,3600,0.0,26,25,1,2,1,96.15384615
2018021091,26,3451,0.0,34,31,1,2,3,91.17647059
2018021092,13,3600,0.0,28,26,3,1,2,92.85714286
2018021092,28,3468,0.0,27,23,7,1,4,85.18518519
2018021093,4,3482,0.0,51,44,7,2,7,86.2745098
2018021093,10,3583,0.0,29,23,2,1,6,79.31034483
2018021094,12,3560,0.0,19,17,2,0,2,89.47368421
2018021094,29,3600,0.0,46,46,2,0,0,100.0
2018021095,54,3600,0.0,41,40,13,1,1,97.56097561
2018021095,25,3482,0.0,37,35,5,3,2,94.59459459
2018021096,24,3581,0.0,44,41,5,0,3,93.18181818
2018021096,21,3557,0.0,36,32,5,0,4,88.88888889
2018021097,3,3600,0.0,32,27,4,0,5,84.375
2018021097,20,3600,0.0,25,24,4,0,1,96.0
2018021098,1,3900,0.0,27,25,2,0,2,92.59259259
2018021098,23,3900,0.0,33,31,3,1,2,93.93939394
2018021099,19,3600,0.0,41,40,11,1,1,97.56097561
2018021099,5,1361,0.0,13,9,0,0,4,69.23076923
2018021099,5,2239,0.0,13,12,1,0,1,92.30769231
2018021100,2,3550,0.0,22,20,2,0,2,90.90909091
2018021100,17,3600,0.0,42,41,8,2,1,97.61904762
2018021101,13,3600,0.0,27,24,2,3,3,88.88888889
2018021101,26,3535,0.0,35,31,5,1,4,88.57142857
2018021102,29,3810,0.0,33,31,2,0,2,93.93939394
2018021102,6,3810,0.0,25,24,2,0,1,96.0
2018021103,16,3600,0.0,48,48,9,0,0,100.0
2018021103,8,3469,0.0,24,22,0,0,2,91.66666667
2018021104,10,3594,0.0,44,38,5,2,6,86.36363636
2018021104,9,3600,0.0,37,35,7,0,2,94.59459459
2018021105,15,3458,0.0,33,29,3,1,4,87.87878788
2018021105,14,3600,0.0,34,31,3,1,3,91.17647059
2018021106,7,3554,0.0,29,25,1,2,4,86.20689655
2018021106,12,3591,0.0,37,35,3,0,2,94.59459459
2018021107,20,3472,0.0,21,19,6,0,2,90.47619048
2018021107,52,3597,0.0,28,27,5,0,1,96.42857143
2018021108,3,3590,0.0,46,42,3,0,4,91.30434783
2018021108,30,3600,0.0,28,26,1,0,2,92.85714286
2018021109,22,3619,0.0,30,28,8,1,2,93.33333333
2018021109,53,3658,0.0,25,22,2,1,3,88.0
2018021110,18,3600,0.0,26,24,1,0,2,92.30769231
2018021110,28,3566,0.0,29,26,3,0,3,89.65517241
2018021111,1,3549,0.0,33,31,4,3,2,93.93939394
2018021111,21,3600,0.0,22,22,7,0,0,100.0
2018021112,19,3899,0.0,34,31,3,0,3,91.17647059
2018021112,7,3894,0.0,33,30,2,0,3,90.90909091
2018021113,2,3664,2.0,34,32,5,0,2,94.11764706
2018021113,30,3655,0.0,20,17,2,0,3,85.0
2018021114,23,3900,0.0,46,44,6,1,2,95.65217391
2018021114,25,3900,0.0,27,25,5,0,2,92.59259259
2018021115,4,3801,0.0,42,41,3,2,1,97.61904762
2018021115,5,3881,0.0,38,36,5,2,2,94.73684211
2018021116,13,3559,0.0,22,19,1,0,3,86.36363636
2018021116,24,3600,0.0,39,37,1,1,2,94.87179487
2018021117,22,3600,0.0,34,28,2,1,6,82.35294118
2018021117,54,3596,0.0,19,16,2,0,3,84.21052632
2018021118,53,3548,0.0,22,20,0,1,2,90.90909091
2018021118,14,3600,0.0,29,28,2,0,1,96.55172414
2018021119,23,3616,0.0,31,29,5,0,2,93.5483871
2018021119,16,3616,0.0,34,31,0,1,3,91.17647059
2018021120,52,3600,0.0,17,15,2,0,2,88.23529412
2018021120,26,3510,0.0,28,25,1,1,3,89.28571429
2018021121,54,3600,0.0,39,36,6,1,3,92.30769231
2018021121,28,744,0.0,11,8,0,0,3,72.72727273
2018021121,28,2820,0.0,30,27,8,3,3,90.0
2018021122,15,3600,0.0,21,20,2,0,1,95.23809524
2018021122,1,3600,0.0,22,18,0,0,4,81.81818182
2018021123,6,3600,0.0,13,13,1,0,0,100.0
2018021123,2,3600,0.0,39,34,1,1,5,87.17948718
2018021124,17,3600,0.0,43,41,3,0,2,95.34883721
2018021124,3,3527,0.0,29,27,4,2,2,93.10344828
2018021125,8,3600,0.0,33,32,3,0,1,96.96969697
2018021125,4,3501,0.0,35,33,0,1,2,94.28571429
2018021126,5,3900,0.0,39,37,3,0,2,94.87179487
2018021126,12,3863,0.0,38,36,2,1,2,94.73684211
2018021127,22,2049,0.0,24,20,4,0,4,83.33333333
2018021127,22,1542,0.0,20,17,3,0,3,85.0
2018021127,19,3600,0.0,17,15,0,3,2,88.23529412
2018021128,10,3524,0.0,19,17,0,2,2,89.47368421
2018021128,18,3600,0.0,22,22,4,0,0,100.0
2018021129,21,3600,0.0,37,36,8,0,1,97.2972973
2018021129,30,3518,0.0,37,35,6,1,2,94.59459459
2018021130,13,3530,0.0,36,33,4,1,3,91.66666667
2018021130,25,3581,0.0,22,20,2,0,2,90.90909091
2018021131,29,3510,0.0,30,27,3,0,3,90.0
2018021131,20,3599,0.0,33,31,7,0,2,93.93939394
2018021132,10,3600,0.0,24,22,1,2,2,91.66666667
2018021132,7,3541,0.0,45,42,7,1,3,93.33333333
2018021133,14,3781,0.0,58,54,15,1,4,93.10344828
2018021133,15,3700,0.0,28,23,1,2,5,82.14285714
2018021134,9,3596,0.0,39,33,2,0,6,84.61538462
2018021134,23,3600,0.0,25,21,1,1,4,84.0
2018021135,52,3541,0.0,29,29,9,1,0,100.0
2018021135,24,3598,0.0,23,20,6,0,3,86.95652174
2018021136,53,3476,0.0,21,18,2,1,3,85.71428571
2018021136,13,3600,0.0,34,32,1,1,2,94.11764706
2018021137,6,3600,0.0,22,21,2,1,1,95.45454545
2018021137,1,3560,0.0,26,22,4,0,4,84.61538462
2018021138,14,3593,0.0,28,25,1,0,3,89.28571429
2018021138,12,3523,0.0,31,26,5,0,5,83.87096774
2018021139,2,1901,0.0,12,12,0,1,0,100.0
2018021139,2,1699,0.0,22,18,1,3,4,81.81818182
2018021139,8,3594,0.0,28,28,3,0,0,100.0
2018021140,17,3525,0.0,23,19,4,0,4,82.60869565
2018021140,19,3600,0.0,22,20,3,0,2,90.90909091
2018021141,5,3886,0.0,29,28,2,1,1,96.55172414
2018021141,18,3900,0.0,33,32,1,2,1,96.96969697
2018021142,4,3600,0.0,41,40,1,2,1,97.56097561
2018021142,16,3467,0.0,27,25,5,2,2,92.59259259
2018021143,21,3600,0.0,45,44,8,0,1,97.77777778
2018021143,25,3528,0.0,31,29,4,0,2,93.5483871
2018021144,9,3600,0.0,36,31,2,1,5,86.11111111
2018021144,20,3564,0.0,19,18,2,1,1,94.73684211
2018021145,29,3600,0.0,22,18,0,0,4,81.81818182
2018021145,22,3596,0.0,20,19,0,0,1,95.0
2018021146,52,2040,0.0,20,18,0,0,2,90.0
2018021146,52,1560,0.0,18,15,5,1,3,83.33333333
2018021146,54,3600,0.0,20,20,1,0,0,100.0
2018021147,28,3571,0.0,34,31,0,1,3,91.17647059
2018021147,26,3600,0.0,25,23,2,0,2,92.0
2018021148,30,3599,0.0,22,21,1,1,1,95.45454545
2018021148,15,3462,0.0,27,25,0,1,2,92.59259259
2018021149,28,3608,0.0,21,17,0,4,4,80.95238095
2018021149,24,3623,0.0,26,23,4,1,3,88.46153846
2018021150,53,3900,2.0,32,31,12,2,1,96.875
2018021150,1,3900,0.0,24,23,4,0,1,95.83333333
2018021151,2,3600,0.0,24,22,2,0,2,91.66666667
2018021151,4,3472,0.0,40,36,5,0,4,90.0
2018021152,16,3488,0.0,24,21,8,0,3,87.5
2018021152,21,3600,0.0,31,29,6,1,2,93.5483871
2018021153,9,3729,0.0,29,26,0,0,3,89.65517241
2018021153,22,3729,0.0,35,31,1,1,4,88.57142857
2018021154,3,3698,0.0,45,44,8,1,1,97.77777778
2018021154,10,3701,0.0,28,26,5,0,2,92.85714286
2018021155,7,3595,0.0,43,37,0,1,6,86.04651163
2018021155,8,3600,0.0,27,23,4,0,4,85.18518519
2018021156,6,3600,0.0,34,31,2,1,3,91.17647059
2018021156,13,3464,0.0,38,32,1,1,6,84.21052632
2018021157,30,3600,0.0,33,28,5,1,5,84.84848485
2018021157,12,3600,0.0,25,24,5,1,1,96.0
2018021158,18,3600,0.0,43,38,3,0,5,88.37209302
2018021158,52,3600,0.0,33,33,0,0,0,100.0
2018021159,14,3480,0.0,26,22,2,2,4,84.61538462
2018021159,19,3600,0.0,42,39,3,1,3,92.85714286
2018021160,5,3600,0.0,31,29,1,0,2,93.5483871
2018021160,25,3510,0.0,30,27,1,0,3,90.0
2018021161,20,3600,0.0,28,27,0,1,1,96.42857143
2018021161,23,3555,2.0,31,28,4,0,3,90.32258065
2018021162,17,3619,0.0,30,28,3,0,2,93.33333333
2018021162,54,3619,0.0,30,27,2,1,3,90.0
2018021163,24,3900,0.0,30,27,2,0,3,90.0
2018021163,26,3894,0.0,20,17,1,1,3,85.0
2018021164,4,3486,0.0,30,27,5,1,3,90.0
2018021164,15,3600,0.0,36,35,5,1,1,97.22222222
2018021165,53,3476,0.0,26,24,1,0,2,92.30769231
2018021165,2,3600,0.0,31,31,0,3,0,100.0
2018021166,8,3794,0.0,40,38,1,0,2,95.0
2018021166,12,3786,0.0,29,28,2,1,1,96.55172414
2018021167,21,3683,0.0,42,40,6,1,2,95.23809524
2018021167,16,3683,0.0,20,19,4,0,1,95.0
2018021168,29,3593,0.0,21,21,6,2,0,100.0
2018021168,23,3600,0.0,33,28,1,2,5,84.84848485
2018021169,13,3210,0.0,33,28,4,1,5,84.84848485
2018021169,13,261,0.0,4,2,0,0,2,50.0
2018021169,10,3600,0.0,36,31,1,2,5,86.11111111
2018021170,7,3505,0.0,20,18,0,0,2,90.0
2018021170,1,3600,0.0,46,45,6,1,1,97.82608696
2018021171,5,3600,0.0,35,33,3,1,2,94.28571429
2018021171,3,3600,0.0,36,31,3,1,5,86.11111111
2018021172,6,3568,0.0,28,23,5,1,5,82.14285714
2018021172,14,3577,0.0,17,13,1,1,4,76.47058824
2018021173,54,3527,0.0,22,19,1,1,3,86.36363636
2018021173,19,3600,0.0,25,24,1,0,1,96.0
2018021174,18,3600,0.0,29,29,1,0,0,100.0
2018021174,30,3457,0.0,19,18,2,1,1,94.73684211
2018021175,25,3600,0.0,23,21,2,1,2,91.30434783
2018021175,52,3513,0.0,36,32,8,1,4,88.88888889
2018021176,26,3600,0.0,42,42,8,0,0,100.0
2018021176,20,3563,0.0,19,17,4,1,2,89.47368421
2018021177,17,3600,0.0,41,39,7,0,2,95.12195122
2018021177,28,3449,0.0,23,20,1,1,3,86.95652174
2018021178,12,3538,2.0,27,24,2,0,3,88.88888889
2018021178,15,3590,0.0,28,27,0,1,1,96.42857143
2018021179,2,3431,0.0,32,29,1,0,3,90.625
2018021179,29,3600,0.0,26,26,0,1,0,100.0
2018021180,13,2732,0.0,18,15,0,0,3,83.33333333
2018021180,13,868,0.0,9,6,0,1,3,66.66666667
2018021180,8,3600,0.0,34,33,9,3,1,97.05882353
2018021181,7,3600,0.0,31,27,8,1,4,87.09677419
2018021181,9,3600,0.0,35,35,3,0,0,100.0
2018021182,26,1200,0.0,11,6,0,0,5,54.54545455
2018021182,26,2400,0.0,21,18,0,0,3,85.71428571
2018021182,22,3600,0.0,38,34,5,0,4,89.47368421
2018021183,24,3561,0.0,32,28,2,1,4,87.5
2018021183,23,3475,0.0,24,19,2,0,5,79.16666667
2018021184,16,3537,0.0,29,28,1,0,1,96.55172414
2018021184,53,3600,0.0,31,31,2,2,0,100.0
2018021185,10,3891,0.0,44,40,1,0,4,90.90909091
2018021185,4,3900,0.0,42,38,3,0,4,90.47619048
2018021186,3,3595,0.0,32,26,5,0,6,81.25
2018021186,6,3598,0.0,23,20,2,0,3,86.95652174
2018021187,25,1590,0.0,16,15,1,1,1,93.75
2018021187,25,2002,0.0,20,20,3,0,0,100.0
2018021187,20,3429,0.0,23,21,1,0,2,91.30434783
2018021188,54,3528,0.0,30,26,3,1,4,86.66666667
2018021188,21,3600,0.0,37,34,2,1,3,91.89189189
2018021189,17,3730,0.0,39,35,3,0,4,89.74358974
2018021189,7,3738,0.0,34,29,9,0,5,85.29411765
2018021190,15,3598,0.0,26,24,2,0,2,92.30769231
2018021190,12,3488,0.0,20,17,0,1,3,85.0
2018021191,8,3441,0.0,29,24,0,1,5,82.75862069
2018021191,29,3582,0.0,28,26,0,1,2,92.85714286
2018021192,13,3600,0.0,30,28,2,1,2,93.33333333
2018021192,9,3529,0.0,32,29,2,3,3,90.625
2018021193,2,3600,0.0,37,33,9,0,4,89.18918919
2018021193,52,3570,0.0,44,39,7,1,5,88.63636364
2018021194,25,3894,0.0,42,40,3,0,2,95.23809524
2018021194,22,3900,0.0,22,20,3,0,2,90.90909091
2018021195,26,3900,0.0,38,36,0,3,2,94.73684211
2018021195,23,3900,0.0,39,37,7,0,2,94.87179487
2018021196,16,3596,0.0,30,26,7,0,4,86.66666667
2018021196,28,3512,0.0,27,22,5,0,5,81.48148148
2018021197,19,3478,0.0,24,21,0,1,3,87.5
2018021197,3,3600,0.0,46,44,3,0,2,95.65217391
2018021198,18,3600,0.0,43,42,15,2,1,97.6744186
2018021198,5,3497,0.0,26,23,0,4,3,88.46153846
2018021199,1,3581,0.0,32,29,2,0,3,90.625
2018021199,17,2400,0.0,21,21,3,0,0,100.0
2018021199,17,1200,0.0,7,7,0,2,0,100.0
2018021200,53,3878,0.0,27,25,2,2,2,92.59259259
2018021200,21,3890,0.0,44,42,5,1,2,95.45454545
2018021201,24,3600,0.0,37,31,5,0,6,83.78378378
2018021201,20,3600,0.0,22,21,1,1,1,95.45454545
2018021202,30,3589,0.0,37,35,5,2,2,94.59459459
2018021202,54,3477,0.0,32,29,6,0,3,90.625
2018021203,4,3435,0.0,30,27,0,0,3,90.0
2018021203,12,3597,0.0,32,30,7,1,2,93.75
2018021204,13,3600,0.0,31,30,1,0,1,96.77419355
2018021204,6,3574,0.0,22,19,0,0,3,86.36363636
2018021205,10,3566,0.0,21,18,1,2,3,85.71428571
2018021205,9,3582,0.0,44,42,2,1,2,95.45454545
2018021206,15,3583,0.0,28,25,4,1,3,89.28571429
2018021206,14,3600,2.0,35,29,4,0,6,82.85714286
2018021207,19,3888,0.0,27,25,0,0,2,92.59259259
2018021207,1,3897,0.0,27,24,0,3,3,88.88888889
2018021208,7,3600,0.0,38,33,3,0,5,86.84210526
2018021208,2,3600,0.0,32,31,3,1,1,96.875
2018021209,8,3600,0.0,24,23,0,0,1,95.83333333
2018021209,52,3539,0.0,43,41,8,0,2,95.34883721
2018021210,29,3573,0.0,25,23,4,2,2,92.0
2018021210,18,3543,0.0,32,27,4,0,5,84.375
2018021211,54,3622,0.0,34,30,5,0,4,88.23529412
2018021211,28,3622,0.0,26,23,1,2,3,88.46153846
2018021212,24,3600,0.0,31,30,2,1,1,96.77419355
2018021212,22,1487,0.0,17,16,0,0,1,94.11764706
2018021212,22,2113,0.0,21,17,0,0,4,80.95238095
2018021213,25,3900,0.0,31,29,6,0,2,93.5483871
2018021213,23,3900,0.0,40,38,4,1,2,95.0
2018021214,16,3888,0.0,29,26,2,1,3,89.65517241
2018021214,26,3888,0.0,35,33,5,0,2,94.28571429
2018021215,3,3583,0.0,29,29,7,0,0,100.0
2018021215,4,3600,0.0,25,22,2,2,3,88.0
2018021216,12,3427,0.0,28,25,5,0,3,89.28571429
2018021216,5,3600,0.0,38,37,3,0,1,97.36842105
2018021217,30,3452,0.0,21,19,2,2,2,90.47619048
2018021217,53,3597,0.0,39,39,3,2,0,100.0
2018021218,29,3600,0.0,38,38,0,0,0,100.0
2018021218,7,3600,0.0,36,32,1,0,4,88.88888889
2018021219,6,3421,0.0,27,22,3,3,5,81.48148148
2018021219,17,3600,0.0,34,31,4,1,3,91.17647059
2018021220,20,3567,0.0,15,12,1,2,3,80.0
2018021220,28,3599,0.0,28,23,6,0,5,82.14285714
2018021221,15,3386,0.0,33,29,7,2,4,87.87878788
2018021221,13,3600,0.0,30,27,0,0,3,90.0
2018021222,3,3576,0.0,40,37,4,2,3,92.5
2018021222,1,3596,0.0,32,30,1,2,2,93.75
2018021223,10,3591,0.0,29,28,4,2,1,96.55172414
2018021223,2,3572,0.0,38,36,8,4,2,94.73684211
2018021224,14,3584,0.0,24,22,4,0,2,91.66666667
2018021224,9,3600,0.0,26,21,2,0,5,80.76923077
2018021225,21,3811,0.0,27,25,2,1,2,92.59259259
2018021225,19,3900,0.0,26,24,0,0,2,92.30769231
2018021226,52,3806,0.0,28,25,2,3,3,89.28571429
2018021226,16,3784,0.0,38,34,5,2,4,89.47368421
2018021227,22,3528,0.0,30,28,1,0,2,93.33333333
2018021227,54,3600,0.0,19,18,2,0,1,94.73684211
2018021228,20,3600,0.0,25,23,4,0,2,92.0
2018021228,26,2913,0.0,25,18,0,1,7,72.0
2018021228,26,675,0.0,5,5,1,0,0,100.0
2018021229,18,3599,0.0,28,26,6,0,2,92.85714286
2018021229,7,3482,0.0,35,32,1,3,3,91.42857143
2018021230,6,3600,0.0,34,32,4,0,2,94.11764706
2018021230,29,2160,0.0,23,19,0,0,4,82.60869565
2018021230,29,1435,0.0,5,3,0,0,2,60.0
2018021231,12,3579,0.0,24,23,1,0,1,95.83333333
2018021231,10,3488,0.0,36,33,1,0,3,91.66666667
2018021232,14,3418,0.0,45,41,4,0,4,91.11111111
2018021232,8,3563,0.0,24,22,0,0,2,91.66666667
2018021233,5,3547,0.0,25,22,0,1,3,88.0
2018021233,17,3600,0.0,39,38,5,0,1,97.43589744
2018021234,52,3593,0.0,28,23,0,1,5,82.14285714
2018021234,30,3598,0.0,33,32,2,1,1,96.96969697
2018021235,4,3600,0.0,30,24,7,1,6,80.0
2018021235,25,3591,0.0,34,32,8,2,2,94.11764706
2018021236,22,3600,0.0,29,23,4,0,6,79.31034483
2018021236,21,3600,0.0,29,27,6,0,2,93.10344828
2018021237,28,3564,0.0,22,19,2,2,3,86.36363636
2018021237,23,3600,0.0,35,33,4,0,2,94.28571429
2018021238,26,3600,0.0,50,49,12,0,1,98.0
2018021238,53,916,0.0,5,5,1,0,0,100.0
2018021238,53,2581,0.0,18,16,0,1,2,88.88888889
2018021239,9,3595,0.0,28,27,4,3,1,96.42857143
2018021239,3,3595,0.0,31,27,7,0,4,87.09677419
2018021240,19,3797,0.0,38,35,5,1,3,92.10526316
2018021240,16,3900,0.0,40,37,4,1,3,92.5
2018021241,20,3499,0.0,32,29,1,2,3,90.625
2018021241,24,3600,0.0,26,25,8,0,1,96.15384615
2018021242,9,3600,0.0,40,35,1,2,5,87.5
2018021242,7,3600,0.0,23,21,3,0,2,91.30434783
2018021243,14,3564,0.0,30,29,3,1,1,96.66666667
2018021243,10,3508,0.0,28,26,1,0,2,92.85714286
2018021244,2,3900,0.0,30,29,1,2,1,96.66666667
2018021244,13,3867,0.0,36,35,3,0,1,97.22222222
2018021245,17,3600,0.0,47,43,7,1,4,91.4893617
2018021245,5,3596,0.0,34,33,4,0,1,97.05882353
2018021246,8,3509,0.0,31,29,0,0,2,93.5483871
2018021246,15,3600,0.0,34,33,0,0,1,97.05882353
2018021247,1,3439,0.0,25,22,2,0,3,88.0
2018021247,12,3600,0.0,37,36,4,1,1,97.2972973
2018021248,4,418,0.0,5,1,0,0,4,20.0
2018021248,4,3182,0.0,30,27,4,1,3,90.0
2018021248,19,3586,0.0,29,26,5,0,3,89.65517241
2018021249,23,3580,0.0,33,30,1,2,3,90.90909091
2018021249,18,3600,0.0,32,30,3,0,2,93.75
2018021250,6,3598,0.0,26,26,1,2,0,100.0
2018021250,30,3583,0.0,34,32,3,0,2,94.11764706
2018021251,52,3709,0.0,38,35,3,1,3,92.10526316
2018021251,21,3709,0.0,36,34,3,0,2,94.44444444
2018021252,28,3578,0.0,28,26,3,2,2,92.85714286
2018021252,22,3512,0.0,27,24,3,0,3,88.88888889
2018021253,53,3600,0.0,38,37,2,0,1,97.36842105
2018021253,54,3600,0.0,41,37,6,1,4,90.24390244
2018021254,29,3900,0.0,27,25,0,0,2,92.59259259
2018021254,3,3795,0.0,41,39,1,0,2,95.12195122
2018021255,25,3600,0.0,32,26,4,0,6,81.25
2018021255,16,1993,0.0,26,25,1,0,1,96.15384615
2018021255,16,1546,0.0,9,9,0,0,0,100.0
2018021256,26,3533,0.0,32,28,1,0,4,87.5
2018021256,24,3600,0.0,46,44,11,1,2,95.65217391
2018021257,14,3600,0.0,33,30,4,1,3,90.90909091
2018021257,6,3510,0.0,21,16,1,1,5,76.19047619
2018021258,23,3884,0.0,36,34,6,0,2,94.44444444
2018021258,19,3900,0.0,25,23,6,2,2,92.0
2018021259,10,3887,0.0,49,44,0,2,5,89.79591837
2018021259,8,3900,0.0,49,44,4,0,5,89.79591837
2018021260,29,3600,0.0,29,27,0,0,2,93.10344828
2018021260,9,633,0.0,7,4,0,0,3,57.14285714
2018021260,9,2941,0.0,19,17,0,0,2,89.47368421
2018021261,7,3600,0.0,24,23,4,1,1,95.83333333
2018021261,17,1633,0.0,11,9,0,0,2,81.81818182
2018021261,17,1950,0.0,26,21,0,0,5,80.76923077
2018021262,1,3655,0.0,40,37,6,5,3,92.5
2018021262,13,3631,0.0,27,23,5,1,4,85.18518519
2018021263,12,3600,0.0,31,28,5,1,3,90.32258065
2018021263,4,3513,0.0,28,24,4,1,4,85.71428571
2018021264,3,3729,0.0,39,36,3,0,3,92.30769231
2018021264,5,3721,0.0,30,26,0,3,4,86.66666667
2018021265,2,3600,0.0,29,29,4,2,0,100.0
2018021265,15,3474,0.0,23,21,1,0,2,91.30434783
2018021266,16,3582,0.0,49,45,5,1,4,91.83673469
2018021266,18,3561,0.0,33,31,4,1,2,93.93939394
2018021267,30,3599,0.0,44,41,4,0,3,93.18181818
2018021267,25,3596,0.0,24,24,0,0,0,100.0
2018021268,22,3600,0.0,31,30,7,0,1,96.77419355
2018021268,20,3540,0.0,25,22,1,1,3,88.0
2018021269,52,3600,0.0,21,19,1,0,2,90.47619048
2018021269,53,3467,0.0,32,28,2,0,4,87.5
2018021270,54,3595,0.0,31,27,10,1,4,87.09677419
2018021270,26,3599,0.0,31,29,0,1,2,93.5483871
2018021271,21,3400,0.0,29,25,6,0,4,86.20689655
2018021271,28,3591,0.0,30,28,4,0,2,93.33333333
2018030111,29,3600,0.0,29,26,2,0,3,89.65517241
2018030111,14,3502,0.0,26,22,1,0,4,84.61538462
2018030112,29,3600,0.0,24,23,5,1,1,95.83333333
2018030112,14,3599,0.0,27,22,6,0,5,81.48148148
2018030113,14,3517,0.0,29,27,2,0,2,93.10344828
2018030113,29,3586,0.0,31,30,0,0,1,96.77419355
2018030114,14,3506,0.0,22,18,1,0,4,81.81818182
2018030114,29,3570,0.0,33,30,1,0,3,90.90909091
2018030121,10,3600,0.0,38,37,3,0,1,97.36842105
2018030121,6,3511,0.0,32,29,2,1,3,90.625
2018030122,10,3600,0.0,41,37,9,0,4,90.24390244
2018030122,6,3600,0.0,31,30,5,2,1,96.77419355
2018030123,6,3514,0.0,34,31,3,0,3,91.17647059
2018030123,10,3587,0.0,36,34,0,1,2,94.44444444
2018030124,6,3600,0.0,42,38,1,1,4,90.47619048
2018030124,10,3491,0.0,30,25,5,0,5,83.33333333
2018030125,10,3600,0.0,29,28,5,0,1,96.55172414
2018030125,6,3457,0.0,27,25,3,0,2,92.59259259
2018030126,6,3589,0.0,24,22,2,0,2,91.66666667
2018030126,10,3474,0.0,40,37,4,0,3,92.5
2018030127,10,3477,0.0,30,27,0,1,3,90.0
2018030127,6,3600,0.0,33,32,4,0,1,96.96969697
2018030131,12,3489,0.0,17,14,3,0,3,82.35294118
2018030131,15,3600,0.0,29,27,3,0,2,93.10344828
2018030132,12,3701,0.0,33,29,9,1,4,87.87878788
2018030132,15,3708,0.0,28,25,7,0,3,89.28571429
2018030133,15,3600,0.0,45,40,8,0,5,88.88888889
2018030133,12,3597,0.0,18,18,6,0,0,100.0
2018030134,15,3477,0.0,24,22,1,0,2,91.66666667
2018030134,12,3600,0.0,31,30,2,3,1,96.77419355
2018030135,12,3528,0.0,28,22,7,1,6,78.57142857
2018030135,15,3600,0.0,30,30,6,0,0,100.0
2018030136,15,3488,0.0,35,31,5,0,4,88.57142857
2018030136,12,3597,0.0,25,23,2,1,2,92.0
2018030137,12,5465,0.0,37,34,2,0,3,91.89189189
2018030137,15,5465,0.0,42,38,2,1,4,90.47619048
2018030141,5,3860,0.0,33,29,4,1,4,87.87878788
2018030141,2,3879,0.0,44,41,4,0,3,93.18181818
2018030142,5,3447,0.0,34,31,7,2,3,91.17647059
2018030142,2,3600,0.0,33,32,2,2,1,96.96969697
2018030143,2,3600,0.0,26,25,4,0,1,96.15384615
2018030143,5,3506,0.0,35,32,5,2,3,91.42857143
2018030144,2,3600,2.0,33,32,2,1,1,96.96969697
2018030144,5,3511,0.0,25,23,5,2,2,92.0
2018030151,25,3600,2.0,32,30,4,1,2,93.75
2018030151,18,3421,0.0,29,26,5,0,3,89.65517241
2018030152,25,3885,0.0,42,40,6,3,2,95.23809524
2018030152,18,3873,0.0,23,22,9,0,1,95.65217391
2018030153,18,3600,0.0,42,40,11,0,2,95.23809524
2018030153,25,3469,0.0,28,25,3,0,3,89.28571429
2018030154,18,2729,2.0,21,20,3,1,1,95.23809524
2018030154,18,825,0.0,8,4,2,0,4,50.0
2018030154,25,3600,0.0,35,34,3,2,1,97.14285714
2018030155,25,3600,0.0,33,30,1,1,3,90.90909091
2018030155,18,3479,0.0,26,21,5,0,5,80.76923077
2018030156,18,4580,0.0,51,49,3,1,2,96.07843137
2018030156,25,4622,0.0,48,47,4,1,1,97.91666667
2018030161,19,3600,0.0,25,24,1,2,1,96.0
2018030161,52,3500,0.0,26,24,2,0,2,92.30769231
2018030162,19,3585,0.0,29,26,1,1,3,89.65517241
2018030162,52,3490,0.0,32,28,6,1,4,87.5
2018030163,52,3600,0.0,29,26,3,3,3,89.65517241
2018030163,19,3540,0.0,29,23,4,0,6,79.31034483
2018030164,52,3957,0.0,32,31,5,0,1,96.875
2018030164,19,3962,0.0,39,37,2,0,2,94.87179487
2018030165,19,3600,0.0,31,29,2,1,2,93.5483871
2018030165,52,3585,0.0,29,26,1,0,3,89.65517241
2018030166,52,3464,0.0,36,33,5,0,3,91.66666667
2018030166,19,3600,0.0,20,18,0,2,2,90.0
2018030171,21,3555,0.0,31,28,6,1,3,90.32258065
2018030171,20,3594,0.0,26,26,5,0,0,100.0
2018030172,21,4077,0.0,37,35,5,4,2,94.59459459
2018030172,20,4107,4.0,39,36,6,2,3,92.30769231
2018030173,20,3600,0.0,56,50,13,1,6,89.28571429
2018030173,21,3596,0.0,29,27,2,1,2,93.10344828
2018030174,20,4223,0.0,52,49,5,0,3,94.23076923
2018030174,21,4223,0.0,37,35,2,0,2,94.59459459
2018030175,21,3541,0.0,29,28,5,4,1,96.55172414
2018030175,20,3588,0.0,32,27,3,1,5,84.375
2018030181,54,3557,0.0,32,28,10,0,4,87.5
2018030181,28,3574,0.0,26,24,2,0,2,92.30769231
2018030182,54,3600,0.0,37,34,11,0,3,91.89189189
2018030182,28,399,0.0,7,4,0,0,3,57.14285714
2018030182,28,2973,0.0,16,14,2,1,2,87.5
2018030183,28,3600,0.0,40,34,13,1,6,85.0
2018030183,54,3600,0.0,28,25,6,2,3,89.28571429
2018030184,28,1200,0.0,7,5,0,1,2,71.42857143
2018030184,28,2400,0.0,20,17,11,0,3,85.0
2018030184,54,3599,0.0,28,28,12,0,0,100.0
2018030185,54,3543,0.0,28,24,8,1,4,85.71428571
2018030185,28,3587,0.0,32,30,2,0,2,93.75
2018030186,28,5477,0.0,59,58,1,2,1,98.30508475
2018030186,54,5464,0.0,29,27,2,0,2,93.10344828
2018030187,54,4629,0.0,48,43,11,0,5,89.58333333
2018030187,28,4690,0.0,38,34,2,2,4,89.47368421
2018030211,29,3915,0.0,37,34,5,2,3,91.89189189
2018030211,6,3915,0.0,22,20,3,0,2,90.90909091
2018030212,29,4995,0.0,31,29,1,2,2,93.5483871
2018030212,6,5022,0.0,41,38,4,2,3,92.68292683
2018030213,6,3471,0.0,34,32,5,1,2,94.11764706
2018030213,29,3600,0.0,37,36,2,1,1,97.2972973
2018030214,6,3600,0.0,40,39,9,6,1,97.5
2018030214,29,3600,0.0,46,42,10,0,4,91.30434783
2018030215,29,3519,0.0,36,32,3,0,4,88.88888889
2018030215,6,3600,0.0,36,33,4,0,3,91.66666667
2018030216,6,3600,0.0,39,39,11,1,0,100.0
2018030216,29,3391,0.0,29,26,0,5,3,89.65517241
2018030221,12,3844,0.0,31,31,7,1,0,100.0
2018030221,2,3844,0.0,32,31,7,2,1,96.875
2018030222,12,1587,0.0,10,9,0,0,1,90.0
2018030222,12,2013,0.0,17,17,1,0,0,100.0
2018030222,2,3468,0.0,18,16,2,0,2,88.88888889
2018030223,2,3552,0.0,36,33,3,1,3,91.66666667
2018030223,12,3600,0.0,30,28,4,1,2,93.33333333
2018030224,2,1397,0.0,11,8,1,0,3,72.72727273
2018030224,2,2187,0.0,10,8,4,0,2,80.0
2018030224,12,3600,0.0,28,26,5,1,2,92.85714286
2018030231,25,3531,0.0,20,17,0,1,3,85.0
2018030231,19,3600,0.0,29,27,7,0,2,93.10344828
2018030232,25,3600,0.0,34,32,8,0,2,94.11764706
2018030232,19,3503,0.0,34,31,9,0,3,91.17647059
2018030233,19,3584,0.0,31,28,0,1,3,90.32258065
2018030233,25,3512,0.0,34,30,3,0,4,88.23529412
2018030234,19,3429,4.0,31,27,3,1,4,87.09677419
2018030234,25,3600,0.0,29,27,5,0,2,93.10344828
2018030235,25,3600,0.0,39,38,5,0,1,97.43589744
2018030235,19,3533,0.0,27,25,2,2,2,92.59259259
2018030236,19,3600,0.0,23,22,0,0,1,95.65217391
2018030236,25,665,0.0,5,5,1,0,0,100.0
2018030236,25,2890,0.0,20,16,4,0,4,80.0
2018030237,25,5150,0.0,54,52,1,0,2,96.2962963
2018030237,19,5144,0.0,30,29,0,0,1,96.66666667
2018030241,21,3503,0.0,26,22,1,1,4,84.61538462
2018030241,28,3600,0.0,28,26,2,0,2,92.85714286
2018030242,21,3600,0.0,34,31,3,0,3,91.17647059
2018030242,28,3516,0.0,31,28,4,0,3,90.32258065
2018030243,28,3598,0.0,27,25,3,0,2,92.59259259
2018030243,21,3516,0.0,30,27,2,2,3,90.0
2018030244,28,3486,0.0,27,25,3,1,2,92.59259259
2018030244,21,3600,0.0,32,32,0,2,0,100.0
2018030245,21,3474,0.0,39,37,12,2,2,94.87179487
2018030245,28,3598,0.0,22,21,1,0,1,95.45454545
2018030246,28,3752,0.0,26,22,2,0,4,84.61538462
2018030246,21,3752,0.0,22,19,0,0,3,86.36363636
2018030247,21,3470,0.0,27,24,3,1,3,88.88888889
2018030247,28,3600,0.0,29,27,1,2,2,93.10344828
2018030311,12,3575,0.0,27,23,3,0,4,85.18518519
2018030311,6,3594,0.0,31,29,7,1,2,93.5483871
2018030312,12,3600,0.0,25,19,3,1,6,76.0
2018030312,6,3600,0.0,23,21,5,2,2,91.30434783
2018030313,6,3600,0.0,36,35,14,0,1,97.22222222
2018030313,12,3478,0.0,31,29,8,1,2,93.5483871
2018030314,6,3600,0.0,24,24,3,0,0,100.0
2018030314,12,3414,0.0,22,19,2,2,3,86.36363636
2018030321,19,3462,0.0,24,19,4,1,5,79.16666667
2018030321,28,3600,0.0,31,28,0,3,3,90.32258065
2018030322,19,3600,0.0,26,24,3,3,2,92.30769231
2018030322,28,3452,0.0,25,21,8,1,4,84.0
2018030323,28,3858,0.0,32,28,0,0,4,87.5
2018030323,19,3923,0.0,32,27,1,0,5,84.375
2018030324,28,3451,0.0,22,20,4,2,2,90.90909091
2018030324,19,3600,0.0,30,29,3,3,1,96.66666667
2018030325,19,3577,0.0,21,21,2,1,0,100.0
2018030325,28,3600,0.0,40,35,10,1,5,87.5
2018030326,28,3582,0.0,18,14,0,0,4,77.77777778
2018030326,19,3600,0.0,26,25,1,0,1,96.15384615
2018030411,19,3486,0.0,37,34,9,1,3,91.89189189
2018030411,6,3580,0.0,20,18,2,2,2,90.0
2018030412,19,3823,0.0,23,21,3,0,2,91.30434783
2018030412,6,3829,0.0,37,34,4,3,3,91.89189189
2018030413,6,3600,0.0,29,27,7,0,2,93.10344828
2018030413,19,1468,0.0,4,3,0,0,1,75.0
2018030413,19,1932,0.0,19,14,0,0,5,73.68421053
2018030414,6,3532,0.0,37,34,7,2,3,91.89189189
2018030414,19,3600,0.0,23,21,1,2,2,91.30434783
2018030415,19,3600,0.0,39,38,5,1,1,97.43589744
2018030415,6,3522,0.0,21,19,1,1,2,90.47619048
2018030416,6,3600,0.0,29,28,12,1,1,96.55172414
2018030416,19,3487,0.0,31,27,3,1,4,87.09677419
2018030417,19,3600,0.0,33,32,3,0,1,96.96969697
2018030417,6,3394,0.0,20,16,0,0,4,80.0
2018040642,88,600,0.0,13,11,0,0,2,84.61538462
2018040642,88,600,0.0,7,5,0,0,2,71.42857143
2018040642,87,600,0.0,13,10,0,0,3,76.92307692
2018040642,87,600,0.0,13,9,0,0,4,69.23076923
2018040643,88,600,0.0,17,12,0,0,5,70.58823529
2018040643,88,600,0.0,6,6,0,0,0,100.0
2018040643,89,583,0.0,10,6,0,0,4,60.0
2018040643,89,600,0.0,11,6,0,0,5,54.54545455
2019020001,9,3507,0.0,42,37,9,0,5,88.0952381
2019020001,10,3591,0.0,26,23,0,2,3,88.46153846
2019020002,15,3771,0.0,22,20,1,3,2,90.90909091
2019020002,19,3771,0.0,34,31,4,1,3,91.17647059
2019020003,23,3494,0.0,22,19,3,0,3,86.36363636
2019020003,22,3600,0.0,33,31,7,0,2,93.93939394
2019020004,28,3600,0.0,35,31,5,2,4,88.57142857
2019020004,54,3592,0.0,22,21,6,0,1,95.45454545
2019020005,13,3511,0.0,29,25,6,1,4,86.20689655
2019020005,14,3553,0.0,37,35,7,0,2,94.59459459
2019020006,52,3549,0.0,31,26,3,1,5,83.87096774
2019020006,3,3600,0.0,47,43,10,1,4,91.4893617
2019020007,7,3600,0.0,29,28,6,1,1,96.55172414
2019020007,5,3465,0.0,41,38,5,3,3,92.68292683
2019020008,8,3895,0.0,43,40,5,1,3,93.02325581
2019020008,12,3900,0.0,36,33,4,0,3,91.66666667
2019020009,30,3556,0.0,31,27,6,1,4,87.09677419
2019020009,18,3600,0.0,24,22,1,0,2,91.66666667
2019020010,6,3588,0.0,29,28,5,2,1,96.55172414
2019020010,25,3516,0.0,20,18,2,0,2,90.0
2019020011,20,3551,0.0,31,27,5,1,4,87.09677419
2019020011,21,3592,0.0,30,27,4,0,3,90.0
2019020012,53,3478,0.0,29,27,0,0,2,93.10344828
2019020012,24,3600,0.0,33,32,0,1,1,96.96969697
2019020013,52,3900,0.0,39,35,8,1,4,89.74358974
2019020013,1,2561,0.0,21,19,0,0,2,90.47619048
2019020013,1,1339,0.0,9,7,0,0,2,77.77777778
2019020014,15,3585,0.0,26,25,2,2,1,96.15384615
2019020014,2,3529,0.0,28,26,1,0,2,92.85714286
2019020015,10,3600,0.0,29,28,4,0,1,96.55172414
2019020015,29,3600,0.0,29,25,3,0,4,86.20689655
2019020016,16,3484,0.0,38,34,1,1,4,89.47368421
2019020016,4,3600,0.0,31,28,0,1,3,90.32258065
2019020017,54,3600,0.0,35,34,11,0,1,97.14285714
2019020017,28,2400,0.0,23,19,4,1,4,82.60869565
2019020017,28,1200,0.0,6,5,1,0,1,83.33333333
2019020018,1,3586,0.0,36,29,6,0,7,80.55555556
2019020018,7,3600,0.0,20,18,5,0,2,90.0
2019020019,8,3900,0.0,37,32,8,1,5,86.48648649
2019020019,10,3892,0.0,42,37,2,0,5,88.0952381
2019020020,3,3600,0.0,32,31,7,0,1,96.875
2019020020,9,3600,0.0,30,26,2,3,4,86.66666667
2019020021,14,3510,0.0,28,24,3,0,4,85.71428571
2019020021,13,3600,0.0,35,32,3,0,3,91.42857143
2019020022,29,3600,0.0,40,33,6,0,7,82.5
2019020022,5,3595,0.0,30,28,5,1,2,93.33333333
2019020023,12,3841,0.0,34,32,7,1,2,94.11764706
2019020023,15,3836,0.0,28,25,5,3,3,89.28571429
2019020024,25,3465,0.0,30,27,4,1,3,90.0
2019020024,19,3600,0.0,29,27,6,0,2,93.10344828
2019020025,17,3583,0.0,42,39,0,1,3,92.85714286
2019020025,18,3473,0.0,27,23,5,2,4,85.18518519
2019020026,30,3483,0.0,31,28,5,2,3,90.32258065
2019020026,21,3600,0.0,31,29,3,1,2,93.5483871
2019020027,6,3600,0.0,35,35,1,2,0,100.0
2019020027,53,3552,0.0,26,25,3,0,1,96.15384615
2019020028,23,3518,0.0,29,27,5,1,2,93.10344828
2019020028,20,3600,0.0,34,34,11,2,0,100.0
2019020029,26,3489,0.0,31,25,5,1,6,80.64516129
2019020029,22,3594,0.0,32,27,5,1,5,84.375
2019020030,28,3468,0.0,33,30,6,3,3,90.90909091
2019020030,24,3600,0.0,36,35,12,0,1,97.22222222
2019020031,14,3713,0.0,44,40,3,0,4,90.90909091
2019020031,12,3708,0.0,13,10,0,0,3,76.92307692
2019020032,25,3546,0.0,33,29,7,0,4,87.87878788
2019020032,17,3600,0.0,22,19,3,0,3,86.36363636
2019020033,52,3600,0.0,33,29,2,3,4,87.87878788
2019020033,2,3600,0.0,36,35,2,0,1,97.22222222
2019020034,19,3578,0.0,34,32,2,2,2,94.11764706
2019020034,10,3464,0.0,30,27,4,2,3,90.0
2019020035,7,3640,0.0,44,40,7,3,4,90.90909091
2019020035,29,3707,0.0,18,15,1,0,3,83.33333333
2019020036,12,3600,0.0,50,47,10,0,3,94.0
2019020036,13,1195,0.0,14,10,1,1,4,71.42857143
2019020036,13,2262,0.0,20,19,8,0,1,95.0
2019020037,22,3600,0.0,27,25,1,0,2,92.59259259
2019020037,2,1874,0.0,8,7,1,0,1,87.5
2019020037,2,1726,0.0,19,15,7,0,4,78.94736842
2019020038,52,3600,0.0,38,37,5,0,1,97.36842105
2019020038,5,3600,0.0,22,18,0,0,4,81.81818182
2019020039,25,3632,0.0,32,29,6,0,3,90.625
2019020039,15,3586,0.0,26,22,3,2,4,84.61538462
2019020040,24,3600,0.0,32,31,4,0,1,96.875
2019020040,17,3414,0.0,29,26,6,0,3,89.65517241
2019020041,28,3501,0.0,24,20,5,0,4,83.33333333
2019020041,18,3600,0.0,35,33,2,0,2,94.28571429
2019020042,26,3648,0.0,29,26,1,1,3,89.65517241
2019020042,20,3612,0.0,40,36,2,1,4,90.0
2019020043,6,3600,0.0,34,31,4,1,3,91.17647059
2019020043,54,3497,0.0,35,31,4,0,4,88.57142857
2019020044,8,3651,0.0,39,34,12,0,5,87.17948718
2019020044,7,3676,0.0,27,23,7,1,4,85.18518519
2019020045,1,3595,0.0,34,30,6,2,4,88.23529412
2019020045,4,3600,0.0,25,25,4,2,0,100.0
2019020046,26,3544,0.0,25,17,3,0,8,68.0
2019020046,23,3598,0.0,39,37,10,0,2,94.87179487
2019020047,14,3583,0.0,28,25,2,1,3,89.28571429
2019020047,10,783,0.0,5,5,0,0,0,100.0
2019020047,10,2801,0.0,28,21,5,0,7,75.0
2019020048,17,3599,0.0,35,33,6,3,2,94.28571429
2019020048,8,3500,0.0,33,30,3,2,3,90.90909091
2019020049,22,3877,0.0,31,28,2,0,3,90.32258065
2019020049,1,3900,0.0,22,19,3,1,3,86.36363636
2019020050,24,3518,0.0,28,26,6,1,2,92.85714286
2019020050,5,3600,0.0,32,31,5,0,1,96.875
2019020051,19,3596,0.0,29,25,0,1,4,86.20689655
2019020051,9,3537,0.0,36,31,4,0,5,86.11111111
2019020052,15,3508,0.0,38,32,4,0,6,84.21052632
2019020052,18,3600,0.0,26,21,2,1,5,80.76923077
2019020053,30,3575,0.0,31,27,5,1,4,87.09677419
2019020053,52,3580,0.0,40,38,4,2,2,95.0
2019020054,28,3600,0.0,30,26,0,1,4,86.66666667
2019020054,16,3510,0.0,34,29,5,0,5,85.29411765
2019020055,20,3900,0.0,36,34,7,0,2,94.44444444
2019020055,25,3900,2.0,29,27,0,0,2,93.10344828
2019020056,6,3507,0.0,35,32,1,1,3,91.42857143
2019020056,21,3600,0.0,41,39,2,0,2,95.12195122
2019020057,54,2400,0.0,15,13,0,1,2,86.66666667
2019020057,54,1200,0.0,14,12,1,1,2,85.71428571
2019020057,53,3600,0.0,38,37,13,3,1,97.36842105
2019020058,13,3788,0.0,32,30,3,0,2,93.75
2019020058,7,3900,0.0,43,41,4,1,2,95.34883721
2019020059,24,3600,0.0,27,26,2,1,1,96.2962963
2019020059,29,3481,0.0,23,21,1,1,2,91.30434783
2019020060,2,3532,0.0,39,35,2,0,4,89.74358974
2019020060,12,3600,0.0,19,17,3,0,2,89.47368421
2019020061,22,3600,0.0,21,20,7,0,1,95.23809524
2019020061,3,3523,0.0,26,23,3,1,3,88.46153846
2019020062,14,3460,0.0,33,30,6,2,3,90.90909091
2019020062,9,3600,0.0,21,19,1,2,2,90.47619048
2019020063,18,3582,0.0,37,31,4,1,6,83.78378378
2019020063,26,3600,0.0,32,28,7,1,4,87.5
2019020064,1,3586,0.0,32,29,3,1,3,90.625
2019020064,6,3600,0.0,31,31,5,1,0,100.0
2019020065,19,3578,0.0,37,32,4,1,5,86.48648649
2019020065,8,3600,0.0,29,26,2,2,3,89.65517241
2019020066,10,3600,0.0,27,25,2,3,2,92.59259259
2019020066,17,3577,0.0,40,36,4,0,4,90.0
2019020067,13,3900,0.0,28,26,0,2,2,92.85714286
2019020067,2,3879,0.0,37,35,2,0,2,94.59459459
2019020068,29,3600,0.0,32,30,4,0,2,93.75
2019020068,12,3433,0.0,35,32,6,0,3,91.42857143
2019020069,52,3643,0.0,29,27,1,2,2,93.10344828
2019020069,16,3647,0.0,33,30,3,1,3,90.90909091
2019020070,15,3589,0.0,25,24,5,3,1,96.0
2019020070,25,3469,0.0,24,21,6,1,3,87.5
2019020071,5,3597,0.0,33,29,0,1,4,87.87878788
2019020071,30,1489,0.0,11,10,0,0,1,90.90909091
2019020071,30,2019,2.0,23,18,1,0,5,78.26086957
2019020072,53,3806,0.0,32,29,2,3,3,90.625
2019020072,21,3796,0.0,36,34,8,0,2,94.44444444
2019020073,4,3900,0.0,24,22,1,0,2,91.66666667
2019020073,23,3900,0.0,32,30,3,0,2,93.75
2019020074,20,3600,0.0,30,24,4,1,6,80.0
2019020074,54,3600,0.0,35,33,13,0,2,94.28571429
2019020075,5,3598,0.0,29,27,5,0,2,93.10344828
2019020075,52,3600,0.0,28,21,3,3,7,75.0
2019020076,54,3600,0.0,38,36,6,0,2,94.73684211
2019020076,26,3600,0.0,36,31,7,1,5,86.11111111
2019020077,20,3421,0.0,20,17,1,0,3,85.0
2019020077,28,3585,0.0,33,32,2,1,1,96.96969697
2019020078,24,3450,0.0,23,19,0,1,4,82.60869565
2019020078,6,3549,0.0,32,30,6,2,2,93.75
2019020079,30,3600,0.0,26,26,5,3,0,100.0
2019020079,9,3470,0.0,34,33,9,1,1,97.05882353
2019020080,13,3600,0.0,21,17,3,1,4,80.95238095
2019020080,1,3483,0.0,34,28,4,1,6,82.35294118
2019020081,19,3673,0.0,32,29,3,3,3,90.625
2019020081,2,3628,0.0,23,21,1,1,2,91.30434783
2019020082,25,3598,0.0,22,18,0,0,4,81.81818182
2019020082,7,3600,0.0,25,25,1,0,0,100.0
2019020083,21,3556,0.0,32,29,2,2,3,90.625
2019020083,15,474,0.0,3,0,0,0,3,0.0
2019020083,15,2928,0.0,21,19,1,0,2,90.47619048
2019020084,22,3523,0.0,34,32,7,0,2,94.11764706
2019020084,16,3594,0.0,28,27,1,0,1,96.42857143
2019020085,30,3576,0.0,34,30,3,0,4,88.23529412
2019020085,10,3600,0.0,29,27,9,0,2,93.10344828
2019020086,14,3600,0.0,34,33,5,0,1,97.05882353
2019020086,8,3461,0.0,22,19,0,1,3,86.36363636
2019020087,53,3600,0.0,40,38,9,3,2,95.0
2019020087,52,3473,0.0,35,31,3,1,4,88.57142857
2019020088,4,3466,0.0,37,35,2,3,2,94.59459459
2019020088,20,3600,0.0,22,21,4,2,1,95.45454545
2019020089,17,3600,0.0,32,27,5,0,5,84.375
2019020089,23,3600,0.0,27,26,2,2,1,96.2962963
2019020090,18,3573,0.0,35,33,0,0,2,94.28571429
2019020090,54,3600,0.0,39,34,11,2,5,87.17948718
2019020091,12,3600,0.0,31,31,7,0,0,100.0
2019020091,26,3464,0.0,22,21,3,1,1,95.45454545
2019020092,21,3837,0.0,32,29,5,-1,3,90.625
2019020092,5,3837,0.0,28,26,0,0,2,92.85714286
2019020093,10,3461,0.0,32,28,4,0,4,87.5
2019020093,15,3600,0.0,32,29,1,2,3,90.625
2019020094,25,3473,0.0,35,32,4,0,3,91.42857143
2019020094,29,3596,0.0,32,30,2,0,2,93.75
2019020095,4,1383,0.0,8,6,3,0,2,75.0
2019020095,4,2072,0.0,14,10,1,0,4,71.42857143
2019020095,22,3600,0.0,52,49,17,0,3,94.23076923
2019020096,7,3572,2.0,30,26,4,2,4,86.66666667
2019020096,24,3594,0.0,33,31,6,1,2,93.93939394
2019020097,12,3494,0.0,21,17,1,0,4,80.95238095
2019020097,28,3600,0.0,38,36,7,1,2,94.73684211
2019020098,14,3897,0.0,37,34,3,0,3,91.89189189
2019020098,6,3879,0.0,36,33,2,3,3,91.66666667
2019020099,30,3600,0.0,33,29,6,1,4,87.87878788
2019020099,8,3600,0.0,17,17,5,1,0,100.0
2019020100,3,3438,0.0,37,33,12,2,4,89.18918919
2019020100,1,3580,0.0,31,29,7,0,2,93.5483871
2019020101,23,3896,0.0,37,34,7,1,3,91.89189189
2019020101,19,3900,0.0,32,29,1,0,3,90.625
2019020102,2,3600,0.0,33,32,5,0,1,96.96969697
2019020102,52,3505,0.0,25,23,0,0,2,92.0
2019020103,17,3600,0.0,36,31,7,0,5,86.11111111
2019020103,20,3582,0.0,28,27,4,1,1,96.42857143
2019020104,18,3575,0.0,31,27,3,2,4,87.09677419
2019020104,53,3576,0.0,25,23,5,3,2,92.0
2019020105,9,3896,0.0,54,52,13,2,2,96.2962963
2019020105,54,3900,2.0,39,37,8,1,2,94.87179487
2019020106,7,3600,0.0,47,47,5,1,0,100.0
2019020106,26,3600,0.0,24,21,4,1,3,87.5
2019020107,21,3783,0.0,44,40,5,2,4,90.90909091
2019020107,13,3772,0.0,41,36,5,4,5,87.80487805
2019020108,25,3526,0.0,32,29,7,0,3,90.625
2019020108,5,3600,0.0,24,22,0,0,2,91.66666667
2019020109,3,3494,0.0,33,29,3,2,4,87.87878788
2019020109,15,3600,0.0,28,26,6,2,2,92.85714286
2019020110,29,3612,0.0,33,30,8,2,3,90.90909091
2019020110,16,3644,2.0,39,37,7,1,2,94.87179487
2019020111,17,3483,0.0,37,35,3,1,2,94.59459459
2019020111,22,3600,0.0,26,25,1,1,1,96.15384615
2019020112,12,1551,0.0,13,9,0,1,4,69.23076923
2019020112,12,1809,0.0,7,7,0,0,0,100.0
2019020112,24,3600,0.0,24,22,0,0,2,91.66666667
2019020113,23,3501,0.0,24,23,7,3,1,95.83333333
2019020113,1,3600,0.0,25,25,9,1,0,100.0
2019020114,8,3600,0.0,34,32,7,1,2,94.11764706
2019020114,19,3303,0.0,24,20,4,3,4,83.33333333
2019020115,6,3823,0.0,29,25,0,0,4,86.20689655
2019020115,10,3834,0.0,46,43,9,0,3,93.47826087
2019020116,21,3600,0.0,46,44,1,0,2,95.65217391
2019020116,14,3569,0.0,24,18,0,1,6,75.0
2019020117,25,3583,0.0,39,38,6,1,1,97.43589744
2019020117,4,3501,0.0,15,12,0,0,3,80.0
2019020118,54,3575,0.0,29,29,5,0,0,100.0
2019020118,5,3526,0.0,22,21,1,1,1,95.45454545
2019020119,2,3633,0.0,36,34,3,0,2,94.44444444
2019020119,29,3633,0.0,34,31,0,0,3,91.17647059
2019020120,9,3518,0.0,26,22,6,0,4,84.61538462
2019020120,53,3600,0.0,36,34,2,4,2,94.44444444
2019020121,13,3893,0.0,27,25,2,0,2,92.59259259
2019020121,18,3900,0.0,30,28,5,0,2,93.33333333
2019020122,20,2389,4.0,28,24,9,0,4,85.71428571
2019020122,20,1200,0.0,8,8,1,1,0,100.0
2019020122,26,3600,0.0,24,23,8,0,1,95.83333333
2019020123,7,3599,0.0,32,29,5,0,3,90.625
2019020123,28,3472,0.0,35,31,9,0,4,88.57142857
2019020124,23,3600,0.0,40,38,7,0,2,95.0
2019020124,3,3492,0.0,43,40,8,0,3,93.02325581
2019020125,8,3504,0.0,33,29,5,0,4,87.87878788
2019020125,30,3600,0.0,33,30,1,0,3,90.90909091
2019020126,15,3600,0.0,44,41,9,0,3,93.18181818
2019020126,16,3478,0.0,29,25,0,1,4,86.20689655
2019020127,22,3900,0.0,23,23,10,0,0,100.0
2019020127,52,3900,0.0,28,28,2,0,0,100.0
2019020128,20,3600,0.0,30,29,4,0,1,96.66666667
2019020128,24,3534,0.0,29,27,0,0,2,93.10344828
2019020129,29,3717,0.0,31,28,6,2,3,90.32258065
2019020129,10,3717,0.0,38,34,8,0,4,89.47368421
2019020130,54,3600,0.0,37,31,6,0,6,83.78378378
2019020130,4,3591,0.0,35,33,8,1,2,94.28571429
2019020131,21,3578,0.0,25,22,2,2,3,88.0
2019020131,19,3586,0.0,18,17,6,1,1,94.44444444
2019020132,9,3472,0.0,43,41,10,1,2,95.34883721
2019020132,25,3600,0.0,20,19,3,0,1,95.0
2019020133,10,3485,0.0,39,35,4,2,4,89.74358974
2019020133,6,3600,0.0,30,28,5,2,2,93.33333333
2019020134,28,3793,0.0,29,25,6,2,4,86.20689655
2019020134,7,3781,0.0,28,25,3,0,3,89.28571429
2019020135,5,3560,0.0,21,18,0,0,3,85.71428571
2019020135,13,3600,0.0,25,23,1,1,2,92.0
2019020136,53,3661,0.0,19,17,2,0,2,89.47368421
2019020136,3,3664,0.0,35,32,7,0,3,91.42857143
2019020137,23,3599,0.0,33,31,10,2,2,93.93939394
2019020137,17,3474,0.0,40,36,11,0,4,90.0
2019020138,24,1200,0.0,11,9,2,0,2,81.81818182
2019020138,24,2400,0.0,19,15,3,0,4,78.94736842
2019020138,18,3549,0.0,27,26,5,0,1,96.2962963
2019020139,22,3600,0.0,30,27,3,0,3,90.0
2019020139,30,2281,0.0,16,16,2,1,0,100.0
2019020139,30,1319,0.0,9,9,0,0,0,100.0
2019020140,26,3600,0.0,28,26,9,1,2,92.85714286
2019020140,52,3480,0.0,41,38,9,2,3,92.68292683
2019020141,54,3879,0.0,32,31,7,2,1,96.875
2019020141,16,3892,0.0,34,33,6,1,1,97.05882353
2019020142,15,3600,0.0,35,32,5,0,3,91.42857143
2019020142,20,3479,0.0,29,25,4,1,4,86.20689655
2019020143,17,3548,0.0,37,33,1,2,4,89.18918919
2019020143,9,3589,0.0,36,34,4,2,2,94.44444444
2019020144,5,3552,0.0,48,45,5,1,3,93.75
2019020144,14,3570,0.0,39,37,2,1,2,94.87179487
2019020145,28,3600,0.0,37,35,7,0,2,94.59459459
2019020145,8,3446,0.0,23,19,3,1,4,82.60869565
2019020146,53,3514,0.0,21,18,0,1,3,85.71428571
2019020146,2,3600,0.0,23,21,2,0,2,91.30434783
2019020147,7,3547,0.0,24,18,2,1,6,75.0
2019020147,3,3597,0.0,33,31,6,2,2,93.93939394
2019020148,12,3808,0.0,31,27,5,2,4,87.09677419
2019020148,29,3808,0.0,24,21,2,0,3,87.5
2019020149,26,3474,0.0,34,30,5,0,4,88.23529412
2019020149,19,3581,0.0,35,33,7,2,2,94.28571429
2019020150,30,3595,0.0,21,17,2,0,4,80.95238095
2019020150,18,3600,0.0,26,26,3,0,0,100.0
2019020151,4,3600,0.0,24,23,1,0,1,95.83333333
2019020151,16,3600,0.0,23,19,1,1,4,82.60869565
2019020152,24,3458,0.0,29,27,5,2,2,93.10344828
2019020152,25,3600,0.0,30,29,6,0,1,96.66666667
2019020153,13,3877,0.0,24,19,4,1,5,79.16666667
2019020153,20,3900,0.0,23,18,1,0,5,78.26086957
2019020154,15,3678,0.0,40,36,2,1,4,90.0
2019020154,22,3667,0.0,28,25,2,0,3,89.28571429
2019020155,21,3600,0.0,26,25,2,0,1,96.15384615
2019020155,54,1956,0.0,26,22,0,0,4,84.61538462
2019020155,54,1644,0.0,14,12,3,0,2,85.71428571
2019020156,28,3518,0.0,26,23,4,0,3,88.46153846
2019020156,10,3598,0.0,17,16,0,3,1,94.11764706
2019020157,53,3600,0.0,35,32,10,1,3,91.42857143
2019020157,1,3583,0.0,16,12,0,0,4,75.0
2019020158,2,3593,0.0,32,30,5,2,2,93.75
2019020158,9,1890,0.0,8,8,2,0,0,100.0
2019020158,9,1568,0.0,16,12,0,2,4,75.0
2019020159,7,3600,0.0,41,41,7,0,0,100.0
2019020159,17,3416,0.0,25,23,3,0,2,92.0
2019020160,15,3890,0.0,34,29,5,1,5,85.29411765
2019020160,23,3898,0.0,29,24,0,1,5,82.75862069
2019020161,16,3600,0.0,31,27,2,1,4,87.09677419
2019020161,12,3583,0.0,32,32,2,0,0,100.0
2019020162,19,3494,0.0,23,21,5,2,2,91.30434783
2019020162,6,3600,0.0,26,26,5,3,0,100.0
2019020163,10,3600,0.0,38,33,5,0,5,86.84210526
2019020163,8,3557,0.0,31,29,1,0,2,93.5483871
2019020164,18,3795,0.0,30,28,4,2,2,93.33333333
2019020164,14,3761,0.0,40,37,7,2,3,92.5
2019020165,29,3533,0.0,45,39,5,3,6,86.66666667
2019020165,4,3590,0.0,26,22,2,0,4,84.61538462
2019020166,5,3600,0.0,25,25,2,0,0,100.0
2019020166,25,3482,0.0,26,24,0,0,2,92.30769231
2019020167,26,3600,0.0,27,22,4,0,5,81.48148148
2019020167,30,3597,0.0,31,30,5,3,1,96.77419355
2019020168,20,3784,0.0,45,43,6,1,2,95.55555556
2019020168,52,3766,0.0,30,29,5,0,1,96.66666667
2019020169,24,3600,0.0,37,35,12,0,2,94.59459459
2019020169,21,3548,0.0,26,22,1,2,4,84.61538462
2019020170,13,3600,0.0,26,24,5,0,2,92.30769231
2019020170,22,1356,0.0,13,10,2,0,3,76.92307692
2019020170,22,2199,0.0,15,13,0,0,2,86.66666667
2019020171,19,3688,0.0,33,29,1,0,4,87.87878788
2019020171,17,3688,0.0,20,15,4,2,5,75.0
2019020172,28,1200,0.0,8,7,0,3,1,87.5
2019020172,28,2400,0.0,22,18,5,0,4,81.81818182
2019020172,9,3600,0.0,36,34,14,0,2,94.44444444
2019020173,4,1707,0.0,19,19,1,1,0,100.0
2019020173,4,1726,0.0,14,9,1,0,5,64.28571429
2019020173,2,3596,0.0,31,28,5,2,3,90.32258065
2019020174,6,3600,0.0,29,25,8,1,4,86.20689655
2019020174,3,2400,2.0,31,27,4,2,4,87.09677419
2019020174,3,1154,0.0,11,9,0,0,2,81.81818182
2019020175,26,3600,0.0,26,21,3,0,5,80.76923077
2019020175,16,3600,0.0,39,38,7,0,1,97.43589744
2019020176,24,3569,0.0,49,44,6,1,5,89.79591837
2019020176,54,3585,0.0,15,13,0,0,2,86.66666667
2019020177,53,3900,0.0,26,24,1,0,2,92.30769231
2019020177,7,3892,2.0,44,42,5,0,2,95.45454545
2019020178,13,822,0.0,6,4,0,0,2,66.66666667
2019020178,13,2778,0.0,30,25,5,0,5,83.33333333
2019020178,23,3600,0.0,31,29,4,0,2,93.5483871
2019020179,28,3599,0.0,41,36,17,0,5,87.80487805
2019020179,6,3599,0.0,17,16,3,4,1,94.11764706
2019020180,15,3839,0.0,31,28,10,2,3,90.32258065
2019020180,10,3840,0.0,33,29,9,1,4,87.87878788
2019020181,14,3535,0.0,41,38,6,1,3,92.68292683
2019020181,3,3600,0.0,30,29,5,2,1,96.66666667
2019020182,4,2400,0.0,28,22,0,0,6,78.57142857
2019020182,4,1122,0.0,9,8,0,0,1,88.88888889
2019020182,5,3597,0.0,30,29,6,1,1,96.66666667
2019020183,20,3518,0.0,28,26,2,0,2,92.85714286
2019020183,12,3582,0.0,29,28,5,0,1,96.55172414
2019020184,22,3516,0.0,27,25,3,2,2,92.59259259
2019020184,17,3600,0.0,32,31,4,1,1,96.875
2019020185,16,3593,0.0,51,48,8,1,3,94.11764706
2019020185,18,3595,0.0,20,20,0,1,0,100.0
2019020186,30,3554,0.0,36,31,8,0,5,86.11111111
2019020186,25,2400,0.0,12,11,0,0,1,91.66666667
2019020186,25,1169,0.0,10,8,4,0,2,80.0
2019020187,52,1750,0.0,19,14,2,0,5,73.68421053
2019020187,52,1701,0.0,8,7,0,1,1,87.5
2019020187,24,3600,0.0,40,36,4,0,4,90.0
2019020188,14,3676,0.0,42,36,8,1,6,85.71428571
2019020188,1,3579,0.0,23,16,0,1,7,69.56521739
2019020189,22,3600,0.0,24,23,3,2,1,95.83333333
2019020189,29,1496,0.0,12,8,3,0,4,66.66666667
2019020189,29,2104,0.0,19,19,3,1,0,100.0
2019020190,30,3500,0.0,26,24,8,0,2,92.30769231
2019020190,19,3600,0.0,36,35,4,1,1,97.22222222
2019020191,13,3588,0.0,30,27,3,0,3,90.0
2019020191,21,3629,0.0,38,34,5,0,4,89.47368421
2019020192,8,3590,0.0,33,32,5,0,1,96.96969697
2019020192,53,3600,0.0,36,32,4,1,4,88.88888889
2019020193,23,3571,0.0,24,21,3,1,3,87.5
2019020193,26,3600,0.0,49,44,6,5,5,89.79591837
2019020194,20,3850,0.0,36,31,2,0,5,86.11111111
2019020194,18,3898,0.0,27,21,1,0,6,77.77777778
2019020195,8,3606,0.0,35,31,2,3,4,88.57142857
2019020195,54,3625,0.0,29,24,3,0,5,82.75862069
2019020196,4,3900,0.0,26,23,1,2,3,88.46153846
2019020196,1,3862,0.0,31,28,4,1,3,90.32258065
2019020197,14,3475,0.0,25,21,5,1,4,84.0
2019020197,2,3564,0.0,35,33,8,0,2,94.28571429
2019020198,7,3600,0.0,34,28,3,2,6,82.35294118
2019020198,15,3600,0.0,30,29,1,0,1,96.66666667
2019020199,17,1843,0.0,21,16,6,1,5,76.19047619
2019020199,17,1670,0.0,12,11,1,1,1,91.66666667
2019020199,12,3600,0.0,32,29,2,1,3,90.625
2019020200,29,3608,0.0,27,23,1,1,4,85.18518519
2019020200,19,3582,0.0,30,27,1,2,3,90.0
2019020201,25,3584,0.0,39,38,9,0,1,97.43589744
2019020201,21,3503,0.0,29,27,5,2,2,93.10344828
2019020202,23,3750,2.0,29,27,6,3,2,93.10344828
2019020202,24,3750,0.0,40,39,5,1,1,97.5
2019020203,52,3600,0.0,53,51,10,4,2,96.22641509
2019020203,28,3509,0.0,19,16,4,2,3,84.21052632
2019020204,22,3757,0.0,52,51,11,1,1,98.07692308
2019020204,5,3757,0.0,28,26,4,3,2,92.85714286
2019020205,3,3584,0.0,33,32,4,3,1,96.96969697
2019020205,18,3500,0.0,30,28,7,1,2,93.33333333
2019020206,9,3597,0.0,32,27,4,2,5,84.375
2019020206,6,3600,0.0,32,30,9,1,2,93.75
2019020207,2,3600,0.0,27,27,3,0,0,100.0
2019020207,7,3505,0.0,21,20,1,1,1,95.23809524
2019020208,17,3568,0.0,41,37,4,4,4,90.24390244
2019020208,13,3600,0.0,22,22,2,0,0,100.0
2019020209,10,3900,0.0,40,37,10,1,3,92.5
2019020209,4,3863,0.0,26,23,2,1,3,88.46153846
2019020210,1,3600,0.0,27,24,3,2,3,88.88888889
2019020210,12,3485,0.0,25,21,2,0,4,84.0
2019020211,20,3600,0.0,43,43,5,1,0,100.0
2019020211,29,3578,0.0,28,26,2,3,2,92.85714286
2019020212,8,3464,0.0,39,36,2,2,3,92.30769231
2019020212,25,3600,0.0,36,35,5,0,1,97.22222222
2019020213,19,3747,0.0,23,20,0,0,3,86.95652174
2019020213,30,3747,0.0,29,25,2,0,4,86.20689655
2019020214,21,3583,0.0,28,25,2,0,3,89.28571429
2019020214,53,3537,2.0,33,33,7,0,0,100.0
2019020215,52,3802,0.0,26,23,1,0,3,88.46153846
2019020215,54,3802,0.0,39,35,5,0,4,89.74358974
2019020216,23,3588,0.0,26,24,8,2,2,92.30769231
2019020216,28,3600,0.0,28,23,2,1,5,82.14285714
2019020217,16,318,0.0,5,5,3,0,0,100.0
2019020217,16,3496,0.0,44,40,7,0,4,90.90909091
2019020217,26,3873,0.0,27,24,0,1,3,88.88888889
2019020218,20,3492,0.0,32,28,3,0,4,87.5
2019020218,15,3577,0.0,27,25,3,0,2,92.59259259
2019020219,16,3624,0.0,38,36,4,7,2,94.73684211
2019020219,24,3622,0.0,37,34,9,0,3,91.89189189
2019020220,5,1462,0.0,11,8,0,0,3,72.72727273
2019020220,5,2077,0.0,14,12,3,0,2,85.71428571
2019020220,6,3600,0.0,44,40,1,3,4,90.90909091
2019020221,9,3582,0.0,34,32,5,2,2,94.11764706
2019020221,3,3575,0.0,30,24,5,0,6,80.0
2019020222,18,3576,0.0,24,23,4,0,1,95.83333333
2019020222,17,1656,0.0,15,11,0,0,4,73.33333333
2019020222,17,1944,0.0,11,9,6,0,2,81.81818182
2019020223,53,3721,0.0,28,26,3,2,2,92.85714286
2019020223,22,3721,0.0,24,21,3,1,3,87.5
2019020224,6,3541,0.0,31,26,2,0,5,83.87096774
2019020224,8,3596,0.0,25,21,1,0,4,84.0
2019020225,9,3600,0.0,32,28,6,0,4,87.5
2019020225,2,3599,0.0,28,27,4,0,1,96.42857143
2019020226,12,3594,0.0,28,24,3,1,4,85.71428571
2019020226,4,3581,0.0,34,33,5,1,1,97.05882353
2019020227,54,3600,0.0,30,29,9,0,1,96.66666667
2019020227,29,3509,0.0,25,23,5,0,2,92.0
2019020228,26,3429,0.0,23,20,3,3,3,86.95652174
2019020228,10,3600,0.0,25,24,4,2,1,96.0
2019020229,1,3900,0.0,33,32,2,2,1,96.96969697
2019020229,52,3900,0.0,32,31,5,0,1,96.875
2019020230,21,3582,0.0,38,34,10,6,4,89.47368421
2019020230,25,3580,0.0,37,36,15,0,1,97.2972973
2019020231,53,3866,0.0,43,39,10,2,4,90.69767442
2019020231,20,3852,0.0,37,34,11,4,3,91.89189189
2019020232,19,3808,0.0,34,33,6,1,1,97.05882353
2019020232,23,3808,0.0,27,25,1,1,2,92.59259259
2019020233,30,3600,2.0,31,29,4,0,2,93.5483871
2019020233,24,3512,0.0,25,22,4,0,3,88.0
2019020234,16,3487,0.0,31,28,5,2,3,90.32258065
2019020234,28,3598,0.0,21,19,2,0,2,90.47619048
2019020235,17,3402,0.0,30,26,3,1,4,86.66666667
2019020235,3,3587,0.0,36,35,5,2,1,97.22222222
2019020236,19,3578,0.0,34,32,2,0,2,94.11764706
2019020236,22,3511,0.0,23,20,4,0,3,86.95652174
2019020237,54,3746,0.0,37,35,12,3,2,94.59459459
2019020237,10,3751,0.0,38,37,12,1,1,97.36842105
2019020238,15,3616,0.0,36,32,3,2,4,88.88888889
2019020238,13,3605,0.0,31,26,5,1,5,83.87096774
2019020239,5,3777,0.0,23,20,1,0,3,86.95652174
2019020239,2,3805,0.0,39,35,4,0,4,89.74358974
2019020240,8,3655,0.0,43,40,10,0,3,93.02325581
2019020240,4,3650,0.0,24,22,0,1,2,91.66666667
2019020241,3,3600,0.0,47,45,5,0,2,95.74468085
2019020241,12,3484,0.0,18,15,2,0,3,83.33333333
2019020242,26,3710,0.0,33,30,2,0,3,90.90909091
2019020242,9,3792,0.0,28,26,3,1,2,92.85714286
2019020243,23,3521,0.0,35,32,2,2,3,91.42857143
2019020243,16,3577,0.0,38,36,4,2,2,94.73684211
2019020244,18,1617,0.0,22,17,5,0,5,77.27272727
2019020244,18,1983,0.0,23,19,1,2,4,82.60869565
2019020244,21,3574,0.0,24,20,2,1,4,83.33333333
2019020245,1,3600,0.0,38,33,7,1,5,86.84210526
2019020245,20,3595,0.0,23,21,4,2,2,91.30434783
2019020246,29,3564,0.0,32,30,5,3,2,93.75
2019020246,53,3489,0.0,33,30,2,0,3,90.90909091
2019020247,30,1199,0.0,12,8,0,0,4,66.66666667
2019020247,30,2308,0.0,19,17,5,0,2,89.47368421
2019020247,28,3597,0.0,26,21,5,0,5,80.76923077
2019020248,6,3573,0.0,31,28,7,2,3,90.32258065
2019020248,17,3600,0.0,28,26,8,0,2,92.85714286
2019020249,14,3600,0.0,22,20,1,2,2,90.90909091
2019020249,7,3493,0.0,34,31,5,0,3,91.17647059
2019020250,23,3553,0.0,34,31,7,0,3,91.17647059
2019020250,52,3600,0.0,33,32,2,1,1,96.96969697
2019020251,1,3600,0.0,32,28,5,0,4,87.5
2019020251,22,3590,0.0,29,29,4,1,0,100.0
2019020252,13,3486,0.0,36,34,6,1,2,94.44444444
2019020252,2,3592,0.0,38,37,7,0,1,97.36842105
2019020253,4,3900,0.0,40,38,5,2,2,95.0
2019020253,10,3899,0.0,32,30,2,1,2,93.75
2019020254,26,3513,0.0,37,34,7,2,3,91.89189189
2019020254,8,3572,0.0,33,31,8,1,2,93.93939394
2019020255,12,3600,0.0,30,26,5,0,4,86.66666667
2019020255,9,3582,0.0,39,38,3,3,1,97.43589744
2019020256,7,3378,0.0,40,35,10,1,5,87.5
2019020256,14,3600,0.0,43,40,4,0,3,93.02325581
2019020257,16,3900,0.0,31,29,2,0,2,93.5483871
2019020257,5,3890,0.0,31,29,3,0,2,93.5483871
2019020258,54,3509,0.0,33,29,11,1,4,87.87878788
2019020258,15,3585,0.0,32,30,9,0,2,93.75
2019020259,30,3600,0.0,35,32,4,0,3,91.42857143
2019020259,53,3499,0.0,24,20,3,0,4,83.33333333
2019020260,29,3506,0.0,36,32,6,2,4,88.88888889
2019020260,21,3600,0.0,41,39,3,2,2,95.12195122
2019020261,19,3763,0.0,29,27,2,2,2,93.10344828
2019020261,20,3766,0.0,28,25,3,1,3,89.28571429
2019020262,18,3898,0.0,32,31,7,1,1,96.875
2019020262,28,3857,0.0,25,24,9,1,1,96.0
2019020263,13,3900,0.0,34,29,5,0,5,85.29411765
2019020263,3,3900,0.0,35,30,7,1,5,85.71428571
2019020264,25,3621,2.0,29,26,6,3,3,89.65517241
2019020264,52,3621,0.0,28,26,0,1,2,92.85714286
2019020265,1,3600,0.0,31,30,5,0,1,96.77419355
2019020265,23,3464,0.0,27,25,3,0,2,92.59259259
2019020266,54,3574,0.0,19,16,0,1,3,84.21052632
2019020266,17,3594,0.0,19,17,6,0,2,89.47368421
2019020267,4,3900,0.0,28,26,4,0,2,92.85714286
2019020267,6,3900,0.0,29,27,2,0,2,93.10344828
2019020268,10,3440,0.0,34,29,9,2,5,85.29411765
2019020268,16,3600,0.0,57,53,8,0,4,92.98245614
2019020269,22,3600,0.0,33,31,4,1,2,93.93939394
2019020269,24,3600,0.0,31,25,3,2,6,80.64516129
2019020270,53,3900,0.0,34,31,3,0,3,91.17647059
2019020270,15,3839,0.0,35,32,3,2,3,91.42857143
2019020271,9,1635,0.0,24,20,2,0,4,83.33333333
2019020271,9,1961,0.0,19,15,1,0,4,78.94736842
2019020271,12,3600,0.0,29,27,2,1,2,93.10344828
2019020272,13,2400,0.0,23,19,1,1,4,82.60869565
2019020272,13,1499,0.0,15,15,2,0,0,100.0
2019020272,6,3900,0.0,29,25,6,0,4,86.20689655
2019020273,29,3900,0.0,32,30,3,0,2,93.75
2019020273,8,3837,0.0,35,33,10,3,2,94.28571429
2019020274,5,3744,0.0,27,24,1,1,3,88.88888889
2019020274,3,3744,0.0,32,30,3,1,2,93.75
2019020275,53,3848,0.0,35,33,2,0,2,94.28571429
2019020275,19,3897,0.0,22,20,2,3,2,90.90909091
2019020276,21,31,0.0,0,0,0,0,0,
2019020276,21,3569,0.0,40,40,7,2,0,100.0
2019020276,52,3600,0.0,25,21,4,0,4,84.0
2019020277,18,3449,0.0,25,21,1,0,4,84.0
2019020277,23,3571,0.0,37,34,2,1,3,91.89189189
2019020278,17,3629,0.0,27,24,1,2,3,88.88888889
2019020278,24,3724,0.0,36,32,7,1,4,88.88888889
2019020279,30,3526,0.0,34,32,1,3,2,94.11764706
2019020279,26,3600,0.0,28,27,1,0,1,96.42857143
2019020280,22,3600,0.0,25,19,2,0,6,76.0
2019020280,28,3600,0.0,24,21,2,1,3,87.5
2019020281,9,3600,0.0,23,21,3,0,2,91.30434783
2019020281,1,3531,0.0,24,21,0,1,3,87.5
2019020282,10,3487,0.0,29,25,2,3,4,86.20689655
2019020282,2,3597,0.0,27,23,0,0,4,85.18518519
2019020283,15,3900,0.0,31,30,2,1,1,96.77419355
2019020283,4,3833,0.0,36,35,2,2,1,97.22222222
2019020284,25,3600,0.0,25,24,7,1,1,96.0
2019020284,20,3526,0.0,31,29,8,1,2,93.5483871
2019020285,16,3600,0.0,42,39,5,0,3,92.85714286
2019020285,54,3547,0.0,26,21,1,0,5,80.76923077
2019020286,12,3748,0.0,33,29,5,0,4,87.87878788
2019020286,7,3684,0.0,29,24,3,1,5,82.75862069
2019020287,3,1998,0.0,19,15,0,1,4,78.94736842
2019020287,3,1602,0.0,26,21,10,0,5,80.76923077
2019020287,14,3563,0.0,23,20,5,1,3,86.95652174
2019020288,52,3600,0.0,37,34,4,0,3,91.89189189
2019020288,13,3446,0.0,30,26,0,0,4,86.66666667
2019020289,53,3452,0.0,34,31,2,0,3,91.17647059
2019020289,30,3600,0.0,29,27,3,1,2,93.10344828
2019020290,21,1884,0.0,10,9,2,1,1,90.0
2019020290,21,1701,0.0,18,13,5,2,5,72.22222222
2019020290,22,3570,0.0,33,31,4,1,2,93.93939394
2019020291,25,3600,0.0,34,32,4,3,2,94.11764706
2019020291,23,3489,0.0,29,25,4,1,4,86.20689655
2019020292,28,3600,0.0,32,29,6,3,3,90.625
2019020292,24,3527,0.0,35,30,3,1,5,85.71428571
2019020293,17,3622,0.0,31,28,1,0,3,90.32258065
2019020293,26,3578,0.0,21,19,0,1,2,90.47619048
2019020294,6,3600,0.0,31,29,2,1,2,93.5483871
2019020294,10,3573,0.0,33,30,1,1,3,90.90909091
2019020295,5,3535,0.0,21,19,3,2,2,90.47619048
2019020295,1,3600,0.0,39,38,4,3,1,97.43589744
2019020296,8,3600,0.0,28,26,2,0,2,92.85714286
2019020296,15,3535,0.0,39,35,2,1,4,89.74358974
2019020297,19,3814,0.0,39,36,2,1,3,92.30769231
2019020297,29,3814,0.0,27,25,1,1,2,92.59259259
2019020298,4,3448,0.0,19,17,2,0,2,89.47368421
2019020298,9,3600,0.0,27,26,6,3,1,96.2962963
2019020299,12,3693,0.0,35,32,3,1,3,91.42857143
2019020299,30,3667,0.0,28,24,6,1,4,85.71428571
2019020300,52,3600,0.0,34,31,2,2,3,91.17647059
2019020300,14,3461,0.0,26,23,5,2,3,88.46153846
2019020301,25,2260,0.0,19,18,1,0,1,94.73684211
2019020301,25,1414,0.0,15,12,2,0,3,80.0
2019020301,22,3657,0.0,36,31,4,0,5,86.11111111
2019020302,20,3486,2.0,23,21,5,0,2,91.30434783
2019020302,53,3600,4.0,37,37,8,1,0,100.0
2019020303,15,3878,2.0,23,21,2,2,2,91.30434783
2019020303,6,3900,0.0,44,42,4,5,2,95.45454545
2019020304,9,3513,0.0,31,28,7,1,3,90.32258065
2019020304,7,3600,0.0,23,21,3,0,2,91.30434783
2019020305,1,3667,0.0,34,31,3,1,3,91.17647059
2019020305,8,3677,0.0,43,39,2,1,4,90.69767442
2019020306,3,3442,0.0,30,26,1,2,4,86.66666667
2019020306,13,3600,0.0,33,30,4,0,3,90.90909091
2019020307,2,3871,0.0,31,28,6,0,3,90.32258065
2019020307,4,3900,0.0,36,33,4,1,3,91.66666667
2019020308,10,3600,0.0,38,32,6,0,6,84.21052632
2019020308,5,3595,0.0,33,32,3,0,1,96.96969697
2019020309,24,3599,0.0,38,37,4,0,1,97.36842105
2019020309,19,3497,0.0,24,21,7,2,3,87.5
2019020310,16,3580,0.0,41,39,3,0,2,95.12195122
2019020310,18,1899,0.0,14,10,0,0,4,71.42857143
2019020310,18,1701,0.0,10,7,0,1,3,70.0
2019020311,21,3621,0.0,32,28,3,1,4,87.5
2019020311,23,3486,0.0,23,18,4,1,5,78.26086957
2019020312,54,3483,0.0,25,21,2,1,4,84.0
2019020312,26,3600,0.0,31,28,3,1,3,90.32258065
2019020313,17,3900,0.0,19,16,3,0,3,84.21052632
2019020313,28,3891,0.0,28,25,5,1,3,89.28571429
2019020314,7,3598,0.0,27,23,7,2,4,85.18518519
2019020314,16,3593,0.0,34,33,7,2,1,97.05882353
2019020315,20,3600,0.0,37,31,5,1,6,83.78378378
2019020315,54,3598,0.0,34,34,0,0,0,100.0
2019020316,24,3573,0.0,30,26,0,1,4,86.66666667
2019020316,15,3600,0.0,34,32,8,0,2,94.11764706
2019020317,26,3600,0.0,27,24,3,1,3,88.88888889
2019020317,53,3600,0.0,31,31,8,2,0,100.0
2019020318,30,3600,0.0,31,30,4,2,1,96.77419355
2019020318,7,3474,0.0,25,22,8,0,3,88.0
2019020319,4,1703,0.0,7,7,2,0,0,100.0
2019020319,4,1823,0.0,18,14,0,0,4,77.77777778
2019020319,13,3600,0.0,37,35,2,2,2,94.59459459
2019020320,6,3595,0.0,26,25,1,0,1,96.15384615
2019020320,1,3600,0.0,28,23,0,0,5,82.14285714
2019020321,2,3693,0.0,31,27,6,1,4,87.09677419
2019020321,5,3772,0.0,42,37,7,0,5,88.0952381
2019020322,8,3600,0.0,26,21,2,0,5,80.76923077
2019020322,29,3600,0.0,32,30,4,0,2,93.75
2019020323,9,3600,0.0,38,35,4,4,3,92.10526316
2019020323,17,3474,0.0,33,29,7,1,4,87.87878788
2019020324,14,3522,2.0,33,31,4,3,2,93.93939394
2019020324,19,3600,0.0,18,17,0,2,1,94.44444444
2019020325,52,3600,0.0,39,38,0,2,1,97.43589744
2019020325,18,3501,0.0,25,23,2,0,2,92.0
2019020326,12,3594,0.0,32,30,9,0,2,93.75
2019020326,16,3472,0.0,32,29,2,2,3,90.625
2019020327,23,3600,0.0,31,25,2,0,6,80.64516129
2019020327,25,3564,0.0,33,32,9,0,1,96.96969697
2019020328,21,3600,0.0,33,31,7,0,2,93.93939394
2019020328,20,3514,0.0,26,23,7,0,3,88.46153846
2019020329,10,3513,0.0,36,33,2,0,3,91.66666667
2019020329,54,3600,0.0,33,31,0,0,2,93.93939394
2019020330,22,3600,0.0,35,33,4,1,2,94.28571429
2019020330,28,3593,0.0,29,24,2,0,5,82.75862069
2019020331,9,3638,0.0,36,35,1,2,1,97.22222222
2019020331,8,3638,0.0,24,22,2,0,2,91.66666667
2019020332,15,3466,0.0,31,27,5,0,4,87.09677419
2019020332,3,3586,0.0,31,30,6,2,1,96.77419355
2019020333,7,3503,0.0,27,24,4,3,3,88.88888889
2019020333,6,3600,0.0,38,36,6,0,2,94.73684211
2019020334,24,3622,0.0,28,23,1,0,5,82.14285714
2019020334,13,3622,0.0,32,28,0,0,4,87.5
2019020335,5,3784,0.0,24,20,6,1,4,83.33333333
2019020335,2,3856,0.0,26,23,1,0,3,88.46153846
2019020336,4,3592,0.0,36,33,5,0,3,91.66666667
2019020336,12,3506,0.0,22,18,3,1,4,81.81818182
2019020337,17,3417,0.0,37,32,4,4,5,86.48648649
2019020337,29,3534,0.0,26,22,1,0,4,84.61538462
2019020338,20,3597,0.0,31,26,0,1,5,83.87096774
2019020338,19,3600,0.0,40,40,5,0,0,100.0
2019020339,23,3600,0.0,48,45,16,1,3,93.75
2019020339,18,2400,0.0,17,12,3,0,5,70.58823529
2019020339,18,1152,0.0,5,5,0,0,0,100.0
2019020340,21,3435,0.0,31,28,5,1,3,90.32258065
2019020340,30,3588,0.0,27,25,1,0,2,92.59259259
2019020341,14,3600,0.0,34,32,3,1,2,94.11764706
2019020341,16,3460,0.0,34,31,6,0,3,91.17647059
2019020342,52,3514,0.0,35,31,1,1,4,88.57142857
2019020342,25,3600,0.0,26,23,1,1,3,88.46153846
2019020343,10,3600,0.0,31,30,6,0,1,96.77419355
2019020343,53,3595,0.0,33,30,0,0,3,90.90909091
2019020344,28,3782,0.0,38,37,5,1,1,97.36842105
2019020344,54,3800,2.0,29,27,5,0,2,93.10344828
2019020345,22,1200,0.0,12,9,1,0,3,75.0
2019020345,22,2400,0.0,18,16,3,0,2,88.88888889
2019020345,26,3600,0.0,26,25,2,2,1,96.15384615
2019020346,1,1050,0.0,5,5,1,0,0,100.0
2019020346,1,2550,0.0,36,32,2,0,4,88.88888889
2019020346,5,3600,0.0,37,36,8,2,1,97.2972973
2019020347,3,3600,0.0,39,35,7,4,4,89.74358974
2019020347,9,3567,0.0,31,30,4,2,1,96.77419355
2019020348,23,3896,0.0,33,32,4,1,1,96.96969697
2019020348,15,3900,0.0,33,32,9,0,1,96.96969697
2019020349,20,3832,0.0,38,36,4,2,2,94.73684211
2019020349,4,3893,0.0,27,25,0,2,2,92.59259259
2019020350,53,3600,0.0,45,43,5,0,2,95.55555556
2019020350,26,3476,0.0,18,16,0,1,2,88.88888889
2019020351,30,3739,0.0,39,34,4,2,5,87.17948718
2019020351,6,3711,0.0,36,32,12,0,4,88.88888889
2019020352,3,3583,0.0,43,38,9,1,5,88.37209302
2019020352,8,3457,0.0,34,28,5,1,6,82.35294118
2019020353,24,3591,0.0,27,21,7,0,6,77.77777778
2019020353,14,3600,0.0,38,36,10,0,2,94.73684211
2019020354,17,3563,0.0,33,29,10,0,4,87.87878788
2019020354,1,3600,0.0,20,19,3,0,1,95.0
2019020355,13,3531,0.0,33,30,8,2,3,90.90909091
2019020355,12,3600,0.0,23,21,3,0,2,91.30434783
2019020356,29,3499,0.0,31,27,5,0,4,87.09677419
2019020356,52,679,0.0,5,5,0,0,0,100.0
2019020356,52,2921,0.0,30,27,7,0,3,90.0
2019020357,10,3578,0.0,37,34,4,0,3,91.89189189
2019020357,21,1200,0.0,15,11,0,0,4,73.33333333
2019020357,21,2231,0.0,12,12,1,0,0,100.0
2019020358,18,3600,0.0,26,24,3,0,2,92.30769231
2019020358,19,3490,2.0,42,39,6,3,3,92.85714286
2019020359,16,3900,0.0,41,40,9,2,1,97.56097561
2019020359,25,3900,0.0,39,38,9,0,1,97.43589744
2019020360,22,3589,0.0,27,25,0,0,2,92.59259259
2019020360,54,3477,0.0,31,27,5,0,4,87.09677419
2019020361,2,3750,0.0,26,24,4,1,2,92.30769231
2019020361,28,3741,0.0,28,27,10,0,1,96.42857143
2019020362,7,3593,0.0,45,43,2,5,2,95.55555556
2019020362,13,3514,0.0,26,21,1,2,5,80.76923077
2019020363,12,3600,0.0,19,19,0,2,0,100.0
2019020363,17,3487,0.0,35,34,3,0,1,97.14285714
2019020364,22,3900,0.0,30,27,5,0,3,90.0
2019020364,53,3900,0.0,37,34,0,0,3,91.89189189
2019020365,7,3476,2.0,29,24,5,0,5,82.75862069
2019020365,14,3600,0.0,30,28,9,2,2,93.33333333
2019020366,30,3632,0.0,31,28,5,0,3,90.32258065
2019020366,3,3620,0.0,28,26,2,0,2,92.85714286
2019020367,23,3488,0.0,34,32,0,0,2,94.11764706
2019020367,4,3553,0.0,17,16,1,1,1,94.11764706
2019020368,20,3837,0.0,38,35,6,0,3,92.10526316
2019020368,5,3844,0.0,34,32,2,1,2,94.11764706
2019020369,9,3465,0.0,19,18,2,0,1,94.73684211
2019020369,29,3600,0.0,25,25,0,1,0,100.0
2019020370,19,3900,0.0,39,37,9,1,2,94.87179487
2019020370,18,3900,0.0,25,23,4,0,2,92.0
2019020371,54,3477,0.0,28,24,6,0,4,85.71428571
2019020371,25,3599,0.0,28,26,4,1,2,92.85714286
2019020372,2,3600,0.0,23,20,2,0,3,86.95652174
2019020372,24,3600,0.0,26,26,3,0,0,100.0
2019020373,28,3755,0.0,36,33,13,1,3,91.66666667
2019020373,26,3755,0.0,25,21,2,0,4,84.0
2019020374,6,3600,0.0,37,36,1,0,1,97.2972973
2019020374,8,1270,0.0,11,6,2,0,5,54.54545455
2019020374,8,2330,0.0,13,10,0,1,3,76.92307692
2019020375,30,3600,0.0,34,32,4,0,2,94.11764706
2019020375,1,3530,0.0,29,26,2,0,3,89.65517241
2019020376,25,3547,0.0,37,35,2,0,2,94.59459459
2019020376,16,3600,0.0,32,32,4,0,0,100.0
2019020377,20,3677,0.0,36,34,6,1,2,94.44444444
2019020377,7,3649,0.0,29,26,1,1,3,89.65517241
2019020378,6,3600,0.0,34,33,2,2,1,97.05882353
2019020378,9,3502,0.0,21,19,4,1,2,90.47619048
2019020379,10,3600,0.0,25,25,0,0,0,100.0
2019020379,17,588,0.0,14,11,0,0,3,78.57142857
2019020379,17,3012,0.0,40,37,2,0,3,92.5
2019020380,19,3597,0.0,35,32,2,0,3,91.42857143
2019020380,14,3466,0.0,33,29,3,1,4,87.87878788
2019020381,12,3474,0.0,25,22,3,2,3,88.0
2019020381,3,3600,0.0,43,41,8,3,2,95.34883721
2019020382,23,3529,0.0,39,32,6,1,7,82.05128205
2019020382,5,2341,0.0,14,10,0,0,4,71.42857143
2019020382,5,1259,0.0,8,6,1,1,2,75.0
2019020383,13,3538,0.0,20,16,2,1,4,80.0
2019020383,15,3600,0.0,40,37,7,1,3,92.5
2019020384,4,3600,0.0,30,28,1,2,2,93.33333333
2019020384,29,3486,0.0,22,19,6,0,3,86.36363636
2019020385,54,3643,0.0,34,31,1,0,3,91.17647059
2019020385,18,3712,0.0,30,26,0,2,4,86.66666667
2019020386,24,3900,0.0,28,25,2,1,3,89.28571429
2019020386,53,3900,0.0,34,31,5,0,3,91.17647059
2019020387,22,3600,0.0,50,46,10,0,4,92.0
2019020387,21,3600,0.0,20,19,0,0,1,95.0
2019020388,2,3553,0.0,29,26,2,2,3,89.65517241
2019020388,26,3573,0.0,25,24,5,1,1,96.0
2019020389,52,3600,0.0,33,32,8,2,1,96.96969697
2019020389,28,3585,0.0,25,21,3,1,4,84.0
2019020390,1,3600,0.0,48,44,3,0,4,91.66666667
2019020390,8,3553,0.0,34,29,3,0,5,85.29411765
2019020391,3,3700,0.0,27,24,4,1,3,88.88888889
2019020391,6,3672,0.0,28,26,6,0,2,92.85714286
2019020392,10,3488,0.0,35,30,2,2,5,85.71428571
2019020392,7,3567,0.0,29,25,6,1,4,86.20689655
2019020393,17,3581,0.0,35,29,4,0,6,82.85714286
2019020393,4,3600,0.0,33,32,5,2,1,96.96969697
2019020394,21,3600,0.0,36,34,2,0,2,94.44444444
2019020394,16,3594,0.0,23,18,0,0,5,78.26086957
2019020395,9,3600,0.0,35,28,2,0,7,80.0
2019020395,30,3600,0.0,35,33,3,0,2,94.28571429
2019020396,52,3596,0.0,24,24,1,1,0,100.0
2019020396,24,3600,0.0,20,17,3,0,3,85.0
2019020397,26,3596,0.0,22,18,3,0,4,81.81818182
2019020397,28,3554,0.0,34,33,1,0,1,97.05882353
2019020398,14,3777,0.0,35,31,3,0,4,88.57142857
2019020398,15,3779,0.0,30,27,3,0,3,90.0
2019020399,53,3900,0.0,38,37,7,0,1,97.36842105
2019020399,54,3900,0.0,36,35,2,0,1,97.22222222
2019020400,5,3475,0.0,29,25,3,2,4,86.20689655
2019020400,29,3600,0.0,31,29,6,2,2,93.5483871
2019020401,18,3564,0.0,31,31,3,2,0,100.0
2019020401,12,3600,0.0,28,25,8,1,3,89.28571429
2019020402,19,3600,0.0,32,31,0,0,1,96.875
2019020402,25,3505,0.0,39,37,7,0,2,94.87179487
2019020403,3,3580,0.0,33,33,7,0,0,100.0
2019020403,1,3592,0.0,22,19,3,2,3,86.36363636
2019020404,4,3631,0.0,42,39,7,0,3,92.85714286
2019020404,8,3631,0.0,29,25,2,0,4,86.20689655
2019020405,7,3701,0.0,43,41,2,0,2,95.34883721
2019020405,10,3687,0.0,30,29,0,0,1,96.66666667
2019020406,15,3562,0.0,27,25,1,0,2,92.59259259
2019020406,17,3553,0.0,32,29,4,2,3,90.625
2019020407,12,3578,0.0,38,36,9,0,2,94.73684211
2019020407,14,3457,0.0,24,21,2,2,3,87.5
2019020408,18,3600,0.0,28,25,2,1,3,89.28571429
2019020408,13,3600,0.0,27,27,6,1,0,100.0
2019020409,29,3397,0.0,27,25,0,0,2,92.59259259
2019020409,2,846,0.0,9,9,0,0,0,100.0
2019020409,2,2754,0.0,30,30,2,0,0,100.0
2019020410,9,3530,0.0,26,24,1,0,2,92.30769231
2019020410,20,3600,0.0,27,26,0,1,1,96.2962963
2019020411,5,3600,0.0,27,22,7,1,5,81.48148148
2019020411,19,3598,0.0,31,29,6,0,2,93.5483871
2019020412,28,3598,0.0,23,21,1,1,2,91.30434783
2019020412,53,3538,0.0,29,26,1,2,3,89.65517241
2019020413,16,1550,0.0,14,9,2,1,5,64.28571429
2019020413,16,2050,0.0,15,13,2,0,2,86.66666667
2019020413,21,3600,0.0,29,26,7,1,3,89.65517241
2019020414,23,3600,0.0,30,28,7,1,2,93.33333333
2019020414,22,3585,0.0,38,33,6,2,5,86.84210526
2019020415,52,3530,0.0,34,32,0,0,2,94.11764706
2019020415,26,3600,0.0,34,33,4,0,1,97.05882353
2019020416,25,3874,0.0,29,27,5,0,2,93.10344828
2019020416,30,3897,0.0,28,26,5,0,2,92.85714286
2019020417,8,3573,0.0,34,31,3,0,3,91.17647059
2019020417,6,3600,0.0,29,28,4,3,1,96.55172414
2019020418,22,3600,0.0,32,30,4,0,2,93.75
2019020418,23,3493,0.0,28,25,1,1,3,89.28571429
2019020419,1,1200,0.0,15,10,0,2,5,66.66666667
2019020419,1,2392,0.0,17,15,1,0,2,88.23529412
2019020419,7,3600,0.0,45,44,10,0,1,97.77777778
2019020420,54,3600,0.0,30,29,9,0,1,96.66666667
2019020420,3,3493,0.0,32,28,2,1,4,87.5
2019020421,2,3600,0.0,31,30,9,0,1,96.77419355
2019020421,17,3600,0.0,25,21,6,1,4,84.0
2019020422,19,3600,0.0,38,38,2,0,0,100.0
2019020422,16,3600,0.0,30,26,1,0,4,86.66666667
2019020423,26,3529,0.0,19,16,0,1,3,84.21052632
2019020423,24,3600,0.0,36,34,7,0,2,94.44444444
2019020424,12,3556,0.0,34,32,3,1,2,94.11764706
2019020424,6,3589,0.0,24,24,2,1,0,100.0
2019020425,2,3495,0.0,39,36,0,3,3,92.30769231
2019020425,2,39,0.0,0,0,0,0,0,
2019020425,8,3600,2.0,23,21,8,0,2,91.30434783
2019020426,30,3600,0.0,46,44,2,1,2,95.65217391
2019020426,13,3481,0.0,25,22,1,0,3,88.0
2019020427,54,3600,0.0,35,32,4,2,3,91.42857143
2019020427,1,3496,0.0,30,26,7,1,4,86.66666667
2019020428,10,3570,0.0,28,23,1,0,5,82.14285714
2019020428,4,3600,0.0,28,27,6,1,1,96.42857143
2019020429,53,3600,0.0,35,33,2,0,2,94.28571429
2019020429,29,3551,0.0,27,24,1,1,3,88.88888889
2019020430,14,3755,0.0,32,30,1,5,2,93.75
2019020430,18,3730,0.0,31,28,7,2,3,90.32258065
2019020431,25,3600,0.0,30,25,3,0,5,83.33333333
2019020431,52,3600,0.0,28,27,2,0,1,96.42857143
2019020432,9,2400,0.0,14,13,1,0,1,92.85714286
2019020432,9,1200,0.0,15,11,0,0,4,73.33333333
2019020432,23,3600,0.0,42,40,5,1,2,95.23809524
2019020433,15,3600,0.0,25,23,0,0,2,92.0
2019020433,28,2400,0.0,23,18,1,0,5,78.26086957
2019020433,28,1200,0.0,5,5,5,0,0,100.0
2019020434,21,3600,0.0,39,38,1,3,1,97.43589744
2019020434,10,3470,0.0,29,27,3,0,2,93.10344828
2019020435,19,3486,0.0,33,30,5,0,3,90.90909091
2019020435,5,3600,0.0,28,28,8,1,0,100.0
2019020436,9,3590,0.0,26,24,7,0,2,92.30769231
2019020436,22,1698,0.0,13,11,0,0,2,84.61538462
2019020436,22,1902,0.0,12,9,3,1,3,75.0
2019020437,15,3600,0.0,23,22,4,1,1,95.65217391
2019020437,26,3514,0.0,21,19,4,1,2,90.47619048
2019020438,16,3654,0.0,40,37,10,0,3,92.5
2019020438,6,3654,0.0,31,27,5,3,4,87.09677419
2019020439,21,3600,0.0,40,38,5,0,2,95.0
2019020439,8,3475,0.0,35,32,6,1,3,91.42857143
2019020440,30,3600,0.0,34,30,6,1,4,88.23529412
2019020440,14,3469,0.0,21,16,1,4,5,76.19047619
2019020441,54,3796,0.0,31,28,0,1,3,90.32258065
2019020441,2,3800,0.0,33,31,2,0,2,93.93939394
2019020442,53,3598,0.0,29,28,4,1,1,96.55172414
2019020442,4,3473,0.0,17,15,1,0,2,88.23529412
2019020443,28,3897,0.0,29,27,4,1,2,93.10344828
2019020443,12,3861,2.0,30,28,3,1,2,93.33333333
2019020444,3,3574,0.0,47,45,16,0,2,95.74468085
2019020444,29,3517,0.0,19,16,3,0,3,84.21052632
2019020445,52,3649,0.0,39,36,6,0,3,92.30769231
2019020445,25,3692,0.0,38,36,8,3,2,94.73684211
2019020446,7,3461,0.0,29,25,2,1,4,86.20689655
2019020446,20,3600,0.0,29,26,3,1,3,89.65517241
2019020447,16,3900,0.0,30,29,2,0,1,96.66666667
2019020447,1,3880,0.0,29,28,1,2,1,96.55172414
2019020448,8,3579,0.0,30,29,7,1,1,96.66666667
2019020448,3,3553,0.0,33,31,1,2,2,93.93939394
2019020449,53,3483,0.0,25,24,3,0,1,96.0
2019020449,5,3600,0.0,33,33,10,0,0,100.0
2019020450,26,3485,0.0,20,18,3,0,2,90.0
2019020450,22,3600,0.0,36,35,8,0,1,97.22222222
2019020451,15,3600,0.0,29,27,3,0,2,93.10344828
2019020451,24,3484,0.0,36,33,3,0,3,91.66666667
2019020452,9,419,0.0,6,4,0,0,2,66.66666667
2019020452,9,3021,0.0,15,13,0,1,2,86.66666667
2019020452,4,3564,0.0,30,27,10,2,3,90.0
2019020453,7,3720,0.0,30,24,1,0,6,80.0
2019020453,23,3801,0.0,28,23,2,0,5,82.14285714
2019020454,21,1045,0.0,4,3,0,0,1,75.0
2019020454,21,2555,0.0,16,16,3,0,0,100.0
2019020454,6,3452,0.0,19,16,0,1,3,84.21052632
2019020455,5,3590,0.0,28,25,3,1,3,89.28571429
2019020455,17,2962,0.0,23,19,1,0,4,82.60869565
2019020455,17,493,0.0,4,4,0,0,0,100.0
2019020456,28,2452,0.0,21,17,2,2,4,80.95238095
2019020456,28,1148,0.0,17,14,2,0,3,82.35294118
2019020456,14,3600,0.0,38,37,8,3,1,97.36842105
2019020457,29,3570,0.0,26,23,3,0,3,88.46153846
2019020457,13,3600,0.0,34,33,1,1,1,97.05882353
2019020458,30,3510,0.0,39,34,3,2,5,87.17948718
2019020458,12,3600,0.0,24,22,2,0,2,91.66666667
2019020459,10,3564,0.0,28,26,3,0,2,92.85714286
2019020459,19,2823,0.0,16,15,0,2,1,93.75
2019020459,19,777,0.0,11,7,2,0,4,63.63636364
2019020460,1,3519,0.0,37,31,4,2,6,83.78378378
2019020460,18,3568,0.0,33,29,3,1,4,87.87878788
2019020461,2,3475,0.0,37,34,1,0,3,91.89189189
2019020461,25,3600,0.0,35,34,2,2,1,97.14285714
2019020462,26,3523,0.0,30,26,3,1,4,86.66666667
2019020462,20,3577,0.0,33,30,0,0,3,90.90909091
2019020463,24,3495,0.0,33,30,2,1,3,90.90909091
2019020463,52,3586,0.0,33,31,3,1,2,93.93939394
2019020464,28,3553,0.0,32,28,5,1,4,87.5
2019020464,13,3600,0.0,31,30,5,1,1,96.77419355
2019020465,53,3900,0.0,29,26,2,1,3,89.65517241
2019020465,16,3891,0.0,47,44,10,0,3,93.61702128
2019020466,3,3600,0.0,38,38,5,1,0,100.0
2019020466,54,3589,0.0,25,20,3,1,5,80.0
2019020467,7,3673,0.0,28,26,5,3,2,92.85714286
2019020467,22,3667,0.0,22,19,0,2,3,86.36363636
2019020468,2,3600,0.0,32,31,4,0,1,96.875
2019020468,14,3600,0.0,24,19,2,1,5,79.16666667
2019020469,29,3593,0.0,39,37,7,1,2,94.87179487
2019020469,15,3529,2.0,37,33,7,0,4,89.18918919
2019020470,6,3474,0.0,26,23,4,1,3,88.46153846
2019020470,9,3555,0.0,40,38,9,2,2,95.0
2019020471,20,3729,0.0,32,28,1,0,4,87.5
2019020471,21,3729,0.0,33,28,7,0,5,84.84848485
2019020472,19,3511,0.0,31,28,5,0,3,90.32258065
2019020472,7,3600,0.0,30,28,2,0,2,93.33333333
2019020473,14,3600,0.0,28,27,9,0,1,96.42857143
2019020473,13,3468,0.0,48,46,7,1,2,95.83333333
2019020474,8,3600,0.0,34,33,0,0,1,97.05882353
2019020474,5,3589,0.0,25,22,0,0,3,88.0
2019020475,28,3528,0.0,31,29,7,0,2,93.5483871
2019020475,18,3597,0.0,25,24,5,3,1,96.0
2019020476,24,3900,0.0,24,22,5,1,2,91.66666667
2019020476,30,3891,0.0,33,31,4,3,2,93.93939394
2019020477,17,3596,0.0,30,25,3,4,5,83.33333333
2019020477,52,69,0.0,2,1,0,0,1,50.0
2019020477,52,3531,0.0,15,15,2,1,0,100.0
2019020478,1,3518,0.0,35,33,5,0,2,94.28571429
2019020478,25,3600,0.0,26,26,7,6,0,100.0
2019020479,12,3524,0.0,36,33,7,1,3,91.66666667
2019020479,22,3600,0.0,32,26,1,3,6,81.25
2019020480,20,3584,0.0,48,46,1,0,2,95.83333333
2019020480,53,3599,0.0,29,24,3,0,5,82.75862069
2019020481,10,3582,0.0,39,38,2,1,1,97.43589744
2019020481,23,3546,0.0,25,22,1,0,3,88.0
2019020482,16,3590,0.0,37,32,3,1,5,86.48648649
2019020482,54,3600,0.0,29,28,0,0,1,96.55172414
2019020483,3,3457,0.0,25,23,1,1,2,92.0
2019020483,26,3600,0.0,30,29,7,1,1,96.66666667
2019020484,6,3491,0.0,25,22,0,1,3,88.0
2019020484,15,3600,0.0,32,30,8,1,2,93.75
2019020485,9,3656,0.0,29,26,4,1,3,89.65517241
2019020485,8,3671,0.0,37,35,7,1,2,94.59459459
2019020486,4,3416,0.0,27,24,0,2,3,88.88888889
2019020486,21,3600,0.0,33,32,2,0,1,96.96969697
2019020487,18,3496,0.0,32,28,1,0,4,87.5
2019020487,7,3600,0.0,39,36,2,0,3,92.30769231
2019020488,6,3480,0.0,31,28,4,1,3,90.32258065
2019020488,14,3600,0.0,29,27,2,3,2,93.10344828
2019020489,2,3600,0.0,33,32,4,3,1,96.96969697
2019020489,13,3533,0.0,29,27,3,1,2,93.10344828
2019020490,29,3760,0.0,32,31,1,0,1,96.875
2019020490,5,3740,0.0,17,17,1,1,0,100.0
2019020491,52,3520,0.0,33,29,0,1,4,87.87878788
2019020491,17,3600,0.0,28,26,0,0,2,92.85714286
2019020492,54,3476,0.0,29,25,0,2,4,86.20689655
2019020492,19,3600,0.0,29,27,4,0,2,93.10344828
2019020493,22,3500,0.0,26,20,0,1,6,76.92307692
2019020493,30,3600,0.0,33,28,0,0,5,84.84848485
2019020494,10,3374,0.0,24,20,1,0,4,83.33333333
2019020494,20,3600,0.0,34,32,4,0,2,94.11764706
2019020495,16,3600,0.0,40,35,9,3,5,87.5
2019020495,53,3600,0.0,30,28,3,0,2,93.33333333
2019020496,12,3614,0.0,26,25,5,1,1,96.15384615
2019020496,23,3640,0.0,43,43,9,0,0,100.0
2019020497,26,3600,0.0,37,36,2,0,1,97.2972973
2019020497,24,3490,0.0,27,25,4,1,2,92.59259259
2019020498,3,3600,0.0,18,15,1,0,3,83.33333333
2019020498,28,3581,0.0,29,24,5,0,5,82.75862069
2019020499,54,3651,0.0,30,28,6,0,2,93.33333333
2019020499,25,3647,0.0,32,29,5,1,3,90.625
2019020500,1,1848,0.0,17,15,3,0,2,88.23529412
2019020500,1,1745,0.0,19,19,0,2,0,100.0
2019020500,21,3600,0.0,38,37,7,4,1,97.36842105
2019020501,29,2516,0.0,19,17,1,1,2,89.47368421
2019020501,29,1200,0.0,8,6,0,0,2,75.0
2019020501,9,3716,0.0,41,38,4,0,3,92.68292683
2019020502,7,3770,0.0,26,23,2,1,3,88.46153846
2019020502,2,3784,0.0,35,33,8,2,2,94.28571429
2019020503,12,3600,0.0,32,32,8,1,0,100.0
2019020503,20,3511,0.0,30,27,6,0,3,90.0
2019020504,3,3897,0.0,42,39,7,0,3,92.85714286
2019020504,24,3900,0.0,32,29,1,0,3,90.625
2019020505,25,3600,0.0,38,37,8,0,1,97.36842105
2019020505,18,3506,0.0,22,18,6,0,4,81.81818182
2019020506,17,3600,0.0,43,42,2,2,1,97.6744186
2019020506,8,3531,0.0,20,18,4,0,2,90.0
2019020507,15,3600,0.0,28,26,5,0,2,92.85714286
2019020507,14,3451,0.0,33,29,1,5,4,87.87878788
2019020508,6,3600,0.0,33,31,5,0,2,93.93939394
2019020508,13,3505,0.0,41,38,7,4,3,92.68292683
2019020509,26,3900,0.0,27,23,3,0,4,85.18518519
2019020509,5,3900,0.0,42,38,6,2,4,90.47619048
2019020510,4,3542,0.0,27,24,3,1,3,88.88888889
2019020510,30,3597,0.0,18,17,2,0,1,94.44444444
2019020511,10,3600,0.0,37,36,1,1,1,97.2972973
2019020511,22,3554,0.0,31,28,0,0,3,90.32258065
2019020512,16,3488,0.0,38,34,3,0,4,89.47368421
2019020512,19,3600,0.0,22,19,8,0,3,86.36363636
2019020513,1,3578,0.0,32,31,3,0,1,96.875
2019020513,53,3505,0.0,33,31,5,1,2,93.93939394
2019020514,23,3529,0.0,25,23,4,0,2,92.0
2019020514,28,3600,0.0,35,33,6,3,2,94.28571429
2019020515,4,2400,0.0,17,11,2,0,6,64.70588235
2019020515,4,1200,0.0,7,6,1,0,1,85.71428571
2019020515,52,3600,0.0,32,29,2,2,3,90.625
2019020516,26,3600,0.0,24,22,2,1,2,91.66666667
2019020516,17,3486,0.0,32,28,3,1,4,87.5
2019020517,30,3561,0.0,26,22,2,0,4,84.61538462
2019020517,16,3600,0.0,26,23,0,0,3,88.46153846
2019020518,23,3049,0.0,39,34,3,1,5,87.17948718
2019020518,23,503,0.0,7,6,0,2,1,85.71428571
2019020518,54,3580,0.0,29,26,3,0,3,89.65517241
2019020519,9,3600,0.0,31,25,8,0,6,80.64516129
2019020519,13,3600,0.0,30,29,3,1,1,96.66666667
2019020520,18,3600,0.0,41,39,11,1,2,95.12195122
2019020520,3,3524,0.0,22,19,2,0,3,86.36363636
2019020521,15,3298,0.0,21,18,1,0,3,85.71428571
2019020521,29,3600,0.0,30,30,6,0,0,100.0
2019020522,21,3582,0.0,34,30,4,0,4,88.23529412
2019020522,19,3597,0.0,28,26,4,0,2,92.85714286
2019020523,22,3600,0.0,35,34,5,0,1,97.14285714
2019020523,25,3442,0.0,28,26,8,1,2,92.85714286
2019020524,26,3798,0.0,40,37,4,1,3,92.5
2019020524,6,3795,0.0,27,23,0,1,4,85.18518519
2019020525,7,3495,0.0,32,28,4,0,4,87.5
2019020525,10,3600,0.0,30,27,1,0,3,90.0
2019020526,9,3881,0.0,40,36,1,0,4,90.0
2019020526,14,3881,2.0,28,25,4,0,3,89.28571429
2019020527,18,3600,0.0,30,27,4,0,3,90.0
2019020527,2,2400,0.0,15,10,0,0,5,66.66666667
2019020527,2,1200,0.0,9,6,3,0,3,66.66666667
2019020528,24,3473,0.0,30,27,3,2,3,90.0
2019020528,4,3600,0.0,41,40,2,2,1,97.56097561
2019020529,29,3569,0.0,21,18,3,0,3,85.71428571
2019020529,17,3523,0.0,38,34,2,1,4,89.47368421
2019020530,12,3600,0.0,33,30,3,0,3,90.90909091
2019020530,52,2400,0.0,23,18,4,1,5,78.26086957
2019020530,52,1068,0.0,5,4,0,0,1,80.0
2019020531,5,3590,0.0,34,33,0,0,1,97.05882353
2019020531,20,3561,0.0,31,29,2,0,2,93.5483871
2019020532,8,3600,0.0,39,38,2,0,1,97.43589744
2019020532,23,3413,0.0,30,27,2,1,3,90.0
2019020533,30,3447,0.0,29,26,0,3,3,89.65517241
2019020533,54,3600,2.0,26,24,5,0,2,92.30769231
2019020534,53,3598,0.0,28,26,3,0,2,92.85714286
2019020534,28,3520,0.0,19,16,4,2,3,84.21052632
2019020535,24,3386,0.0,20,17,2,0,3,85.0
2019020535,1,3600,0.0,27,26,2,1,1,96.2962963
2019020536,21,3600,2.0,32,31,5,1,1,96.875
2019020536,16,3582,0.0,35,32,1,2,3,91.42857143
2019020537,22,3469,0.0,44,42,12,0,2,95.45454545
2019020537,19,3593,0.0,36,35,8,1,1,97.22222222
2019020538,2,3900,0.0,29,27,5,1,2,93.10344828
2019020538,6,3900,0.0,21,19,2,1,2,90.47619048
2019020539,25,3780,0.0,48,45,3,0,3,93.75
2019020539,14,3780,0.0,20,16,1,0,4,80.0
2019020540,7,3600,0.0,29,23,2,1,6,79.31034483
2019020540,4,3596,0.0,17,16,0,0,1,94.11764706
2019020541,26,3671,0.0,28,25,5,0,3,89.28571429
2019020541,29,3615,0.0,25,23,4,0,2,92.0
2019020542,18,3760,0.0,24,19,0,0,5,79.16666667
2019020542,9,3707,0.0,37,33,0,0,4,89.18918919
2019020543,16,3600,0.0,37,36,5,0,1,97.2972973
2019020543,52,3600,0.0,32,28,2,0,4,87.5
2019020544,12,3600,2.0,28,27,11,0,1,96.42857143
2019020544,21,3514,0.0,39,37,6,3,2,94.87179487
2019020545,8,3832,0.0,27,24,0,0,3,88.88888889
2019020545,20,3830,0.0,43,39,4,0,4,90.69767442
2019020546,30,3600,0.0,40,35,4,2,5,87.5
2019020546,53,3402,0.0,32,25,4,0,7,78.125
2019020546,53,48,0.0,0,0,0,0,0,
2019020547,54,3690,0.0,34,29,5,0,5,85.29411765
2019020547,23,3680,0.0,43,39,2,2,4,90.69767442
2019020548,25,1916,0.0,13,12,1,1,1,92.30769231
2019020548,25,1678,0.0,20,14,0,0,6,70.0
2019020548,13,3600,0.0,31,27,4,1,4,87.09677419
2019020549,15,3600,0.0,27,24,5,1,3,88.88888889
2019020549,1,2905,0.0,26,21,2,1,5,80.76923077
2019020549,1,695,0.0,3,2,0,0,1,66.66666667
2019020550,10,3578,0.0,22,19,2,0,3,86.36363636
2019020550,3,3600,0.0,40,34,5,3,6,85.0
2019020551,5,3600,0.0,28,26,3,0,2,92.85714286
2019020551,22,3555,2.0,25,21,2,1,4,84.0
2019020552,26,3499,0.0,27,25,2,1,2,92.59259259
2019020552,7,3600,0.0,27,25,1,2,2,92.59259259
2019020553,24,3888,0.0,33,28,2,2,5,84.84848485
2019020553,2,3900,0.0,28,23,4,1,5,82.14285714
2019020554,52,3600,0.0,31,31,6,0,0,100.0
2019020554,30,2873,0.0,28,22,1,1,6,78.57142857
2019020554,30,727,0.0,3,3,3,0,0,100.0
2019020555,18,3826,0.0,32,29,6,0,3,90.625
2019020555,6,3778,0.0,29,25,7,1,4,86.20689655
2019020556,17,3188,0.0,20,16,3,0,4,80.0
2019020556,17,412,0.0,3,3,0,0,0,100.0
2019020556,10,3577,0.0,30,29,4,0,1,96.66666667
2019020557,4,3900,0.0,34,30,5,4,4,88.23529412
2019020557,9,3900,0.0,38,34,4,3,4,89.47368421
2019020558,14,3437,0.0,34,32,4,3,2,94.11764706
2019020558,15,3600,0.0,27,26,8,1,1,96.2962963
2019020559,13,3600,0.0,44,42,3,2,2,95.45454545
2019020559,12,3411,0.0,22,18,1,3,4,81.81818182
2019020560,1,3510,0.0,38,35,7,0,3,92.10526316
2019020560,29,3600,0.0,22,21,3,3,1,95.45454545
2019020561,8,3489,0.0,26,22,8,0,4,84.61538462
2019020561,22,3571,0.0,26,23,1,1,3,88.46153846
2019020562,16,3600,0.0,31,28,4,0,3,90.32258065
2019020562,21,3494,0.0,31,27,6,1,4,87.09677419
2019020563,5,3366,0.0,14,10,1,1,4,71.42857143
2019020563,23,3600,0.0,29,28,7,0,1,96.55172414
2019020564,19,3600,0.0,36,34,5,0,2,94.44444444
2019020564,28,3530,0.0,26,23,1,0,3,88.46153846
2019020565,24,3600,0.0,41,36,8,3,5,87.80487805
2019020565,3,3572,0.0,20,19,2,1,1,95.0
2019020566,53,3567,0.0,30,28,6,0,2,93.33333333
2019020566,17,3600,0.0,45,40,0,4,5,88.88888889
2019020567,20,3587,0.0,27,26,4,0,1,96.2962963
2019020567,25,3510,0.0,29,25,3,0,4,86.20689655
2019020568,54,3600,0.0,38,37,11,2,1,97.36842105
2019020568,28,3421,0.0,37,34,4,0,3,91.89189189
2019020569,12,3249,0.0,31,27,2,0,4,87.09677419
2019020569,12,310,0.0,7,4,0,0,3,57.14285714
2019020569,10,3600,0.0,40,34,8,1,6,85.0
2019020570,20,3563,0.0,33,31,0,0,2,93.93939394
2019020570,30,3600,0.0,22,22,2,0,0,100.0
2019020571,15,1200,0.0,11,7,1,1,4,63.63636364
2019020571,15,2261,0.0,4,3,1,0,1,75.0
2019020571,6,3582,0.0,42,39,9,3,3,92.85714286
2019020572,13,3600,0.0,34,28,3,1,6,82.35294118
2019020572,14,3565,0.0,30,29,7,1,1,96.66666667
2019020573,29,3600,0.0,37,35,6,1,2,94.59459459
2019020573,2,3513,0.0,35,32,1,0,3,91.42857143
2019020574,3,3585,0.0,30,25,7,0,5,83.33333333
2019020574,4,3600,0.0,35,34,5,4,1,97.14285714
2019020575,7,3490,0.0,29,27,5,0,2,93.10344828
2019020575,9,3598,0.0,44,43,3,0,1,97.72727273
2019020576,53,3454,0.0,41,38,0,0,3,92.68292683
2019020576,18,3600,0.0,28,26,0,0,2,92.85714286
2019020577,8,3600,0.0,29,27,5,0,2,93.10344828
2019020577,52,3600,0.0,48,42,4,2,6,87.5
2019020578,1,3600,0.0,33,32,8,0,1,96.96969697
2019020578,16,1760,0.0,24,21,4,2,3,87.5
2019020578,16,1840,0.0,20,16,0,1,4,80.0
2019020579,22,3497,0.0,27,24,1,0,3,88.88888889
2019020579,23,3590,0.0,29,27,1,1,2,93.10344828
2019020580,21,3600,0.0,32,29,1,4,3,90.625
2019020580,54,3600,0.0,38,31,4,0,7,81.57894737
2019020581,19,3600,0.0,30,29,5,0,1,96.66666667
2019020581,26,3591,0.0,28,24,0,2,4,85.71428571
2019020582,6,3600,0.0,26,26,1,1,0,100.0
2019020582,7,3516,2.0,24,22,1,1,2,91.66666667
2019020583,10,3750,0.0,28,24,2,0,4,85.71428571
2019020583,1,3699,0.0,37,32,4,0,5,86.48648649
2019020584,12,3468,0.0,24,19,2,1,5,79.16666667
2019020584,3,3600,0.0,42,39,14,2,3,92.85714286
2019020585,29,3793,0.0,36,34,9,0,2,94.44444444
2019020585,15,3788,0.0,28,27,5,1,1,96.42857143
2019020586,5,3600,0.0,32,30,5,0,2,93.75
2019020586,18,890,0.0,6,3,0,0,3,50.0
2019020586,18,2542,0.0,19,17,0,0,2,89.47368421
2019020587,19,3794,0.0,29,25,9,0,4,86.20689655
2019020587,52,3730,0.0,35,30,5,0,5,85.71428571
2019020588,30,3599,0.0,44,40,5,3,4,90.90909091
2019020588,21,3510,0.0,32,27,0,0,5,84.375
2019020589,2,716,0.0,11,8,0,0,3,72.72727273
2019020589,2,2884,0.0,19,17,3,0,2,89.47368421
2019020589,16,3600,0.0,40,38,6,2,2,95.0
2019020590,20,3600,0.0,29,28,3,0,1,96.55172414
2019020590,22,1386,0.0,7,6,0,1,1,85.71428571
2019020590,22,2214,0.0,24,20,4,1,4,83.33333333
2019020591,54,3519,0.0,18,14,2,0,4,77.77777778
2019020591,24,3600,0.0,29,26,3,0,3,89.65517241
2019020592,26,3687,0.0,24,22,3,0,2,91.66666667
2019020592,28,3691,0.0,38,35,2,0,3,92.10526316
2019020593,3,3652,0.0,48,44,5,0,4,91.66666667
2019020593,10,3607,0.0,38,33,2,0,5,86.84210526
2019020594,8,3483,0.0,30,25,3,0,5,83.33333333
2019020594,14,3600,0.0,43,39,6,1,4,90.69767442
2019020595,17,3372,0.0,30,25,1,0,5,83.33333333
2019020595,13,3599,0.0,39,35,2,0,4,89.74358974
2019020596,18,3008,0.0,27,25,1,0,2,92.59259259
2019020596,18,544,0.0,8,5,0,0,3,62.5
2019020596,5,3578,0.0,48,44,7,0,4,91.66666667
2019020597,15,3576,0.0,28,23,0,1,5,82.14285714
2019020597,12,3600,0.0,29,25,9,0,4,86.20689655
2019020598,21,3900,0.0,40,38,13,1,2,95.0
2019020598,25,3900,0.0,43,41,3,3,2,95.34883721
2019020599,26,3509,0.0,26,23,2,0,3,88.46153846
2019020599,23,3593,0.0,51,49,6,0,2,96.07843137
2019020600,53,2286,0.0,20,20,1,0,0,100.0
2019020600,53,1296,0.0,16,12,2,0,4,75.0
2019020600,54,3598,0.0,28,27,3,1,1,96.42857143
2019020601,4,3600,0.0,29,23,0,0,6,79.31034483
2019020601,28,3600,0.0,27,26,5,0,1,96.2962963
2019020602,52,3484,0.0,27,24,2,0,3,88.88888889
2019020602,19,3600,2.0,26,25,6,0,1,96.15384615
2019020603,1,3654,0.0,23,20,4,0,3,86.95652174
2019020603,9,3654,0.0,34,30,7,2,4,88.23529412
2019020604,16,3900,0.0,33,31,3,0,2,93.93939394
2019020604,29,3900,0.0,30,28,7,1,2,93.33333333
2019020604,29,0,0.0,0,0,0,0,0,
2019020605,2,3600,0.0,26,25,1,0,1,96.15384615
2019020605,30,3459,0.0,28,25,3,0,3,89.28571429
2019020606,7,3440,0.0,22,19,4,1,3,86.36363636
2019020606,6,3581,0.0,26,24,3,2,2,92.30769231
2019020607,17,3518,0.0,39,37,11,1,2,94.87179487
2019020607,14,3558,0.0,20,19,1,1,1,95.0
2019020608,8,3447,0.0,34,28,5,1,6,82.35294118
2019020608,13,3600,0.0,43,38,6,1,5,88.37209302
2019020609,25,3600,0.0,35,33,5,2,2,94.28571429
2019020609,53,3496,0.0,24,21,3,0,3,87.5
2019020610,4,3833,0.0,28,27,4,0,1,96.42857143
2019020610,24,3808,0.0,35,33,2,0,2,94.28571429
2019020611,23,3579,0.0,25,23,5,1,2,92.0
2019020611,20,652,0.0,7,4,1,0,3,57.14285714
2019020611,20,2937,0.0,20,19,5,0,1,95.0
2019020612,9,3600,0.0,33,28,0,1,5,84.84848485
2019020612,5,3600,0.0,26,24,2,0,2,92.30769231
2019020613,6,3900,0.0,44,42,7,0,2,95.45454545
2019020613,1,3900,0.0,30,28,2,1,2,93.33333333
2019020614,2,3600,0.0,39,36,4,2,3,92.30769231
2019020614,15,3497,0.0,22,18,1,0,4,81.81818182
2019020615,24,3515,0.0,42,38,1,0,4,90.47619048
2019020615,54,3599,0.0,28,26,5,0,2,92.85714286
2019020616,10,3600,0.0,27,26,5,0,1,96.2962963
2019020616,30,3461,0.0,28,25,1,1,3,89.28571429
2019020617,14,3600,0.0,28,24,3,3,4,85.71428571
2019020617,7,3449,0.0,26,21,5,0,5,80.76923077
2019020618,8,3519,0.0,35,33,5,0,2,94.28571429
2019020618,12,3600,0.0,30,29,1,0,1,96.66666667
2019020619,13,3495,0.0,28,24,4,1,4,85.71428571
2019020619,29,3600,0.0,37,36,7,1,1,97.2972973
2019020620,28,3476,0.0,22,21,4,1,1,95.45454545
2019020620,17,3600,0.0,34,34,5,1,0,100.0
2019020621,52,3600,0.0,43,39,4,0,4,90.69767442
2019020621,21,3539,0.0,24,19,0,0,5,79.16666667
2019020622,16,3600,0.0,44,41,1,1,3,93.18181818
2019020622,20,3452,0.0,32,28,2,0,4,87.5
2019020623,3,1458,0.0,6,6,0,0,0,100.0
2019020623,3,2118,0.0,24,18,6,0,6,75.0
2019020623,22,3600,0.0,33,28,2,2,5,84.84848485
2019020624,19,3508,0.0,25,23,4,1,2,92.0
2019020624,53,3559,2.0,39,38,6,4,1,97.43589744
2019020625,4,1200,0.0,15,11,3,1,4,73.33333333
2019020625,4,2252,0.0,14,13,1,2,1,92.85714286
2019020625,26,3588,0.0,35,32,3,1,3,91.42857143
2019020626,18,3449,0.0,35,31,4,1,4,88.57142857
2019020626,25,3597,0.0,33,31,4,1,2,93.93939394
2019020627,29,3652,0.0,26,25,1,0,1,96.15384615
2019020627,6,3652,0.0,33,31,3,1,2,93.93939394
2019020628,22,3669,0.0,26,23,2,1,3,88.46153846
2019020628,7,3669,0.0,27,25,1,1,2,92.59259259
2019020629,14,3600,0.0,39,38,1,0,1,97.43589744
2019020629,8,3487,0.0,23,21,0,1,2,91.30434783
2019020630,1,3600,0.0,30,29,2,0,1,96.66666667
2019020630,2,3444,0.0,31,29,2,0,2,93.5483871
2019020631,28,3722,0.0,38,36,4,1,2,94.73684211
2019020631,5,3718,0.0,32,29,1,0,3,90.625
2019020632,13,3600,0.0,31,28,3,0,3,90.32258065
2019020632,9,3556,0.0,30,25,1,0,5,83.33333333
2019020633,10,3600,0.0,48,45,3,3,3,93.75
2019020633,52,2400,0.0,17,12,3,1,5,70.58823529
2019020633,52,1102,0.0,11,10,0,0,1,90.90909091
2019020634,19,341,0.0,1,1,0,0,0,100.0
2019020634,19,3259,0.0,41,34,8,0,7,82.92682927
2019020634,21,3600,0.0,27,24,2,0,3,88.88888889
2019020635,3,3530,0.0,29,25,7,1,4,86.20689655
2019020635,20,3593,0.0,27,24,2,1,3,88.88888889
2019020636,24,3513,0.0,34,30,3,0,4,88.23529412
2019020636,53,3600,0.0,28,26,1,1,2,92.85714286
2019020637,16,3531,0.0,36,30,3,2,6,83.33333333
2019020637,23,3599,0.0,33,28,4,0,5,84.84848485
2019020638,4,3486,0.0,33,28,1,1,5,84.84848485
2019020638,54,3599,0.0,38,34,7,0,4,89.47368421
2019020639,15,3575,2.0,41,38,7,1,3,92.68292683
2019020639,12,3547,0.0,29,25,1,1,4,86.20689655
2019020639,12,59:07:00,0.0,29,25,1,1,4,0.862068966
2019020639,15,59:35:00,2.0,41,38,7,1,3,0.926829268
2019020640,17,3564,2.0,26,23,5,1,3,88.46153846
2019020640,25,3600,0.0,23,22,4,0,1,95.65217391
2019020640,25,60:00:00,0.0,23,22,4,0,1,0.956521739
2019020640,17,59:24:00,2.0,26,23,5,1,3,0.884615385
2019020641,22,3600,0.0,36,35,1,3,1,97.22222222
2019020641,6,3433,0.0,25,22,1,1,3,88.0
2019020641,6,57:13:00,0.0,25,22,1,1,3,0.88
2019020641,22,60:00:00,0.0,36,35,1,3,1,0.972222222
2019020642,28,3600,0.0,23,21,0,1,2,91.30434783
2019020642,29,3452,0.0,28,25,0,0,3,89.28571429
2019020642,29,57:32:00,0.0,28,25,0,0,3,0.892857143
2019020642,28,60:00:00,0.0,23,21,0,1,2,0.913043478
2019020643,52,3712,0.0,44,41,6,1,3,93.18181818
2019020643,30,3712,0.0,21,19,2,0,2,90.47619048
2019020643,30,61:52:00,0.0,21,19,2,0,2,0.904761905
2019020643,52,61:52:00,0.0,44,41,6,1,3,0.931818182
2019020644,19,3781,0.0,33,28,2,0,5,84.84848485
2019020644,54,3758,0.0,31,27,5,0,4,87.09677419
2019020644,54,62:38:00,0.0,31,27,5,0,4,0.870967742
2019020644,19,63:01:00,0.0,33,28,2,0,5,0.848484848
2019020645,13,1940,0.0,11,11,2,0,0,100.0
2019020645,13,1537,0.0,7,4,0,0,3,57.14285714
2019020645,7,3583,0.0,34,32,4,1,2,94.11764706
2019020645,7,59:43:00,0.0,34,32,4,1,2,0.941176471
2019020645,13,32:20:00,0.0,11,11,2,0,0,1.0
2019020645,13,25:37:00,0.0,7,4,0,0,3,0.571428571
2019020646,2,3571,0.0,22,20,0,1,2,90.90909091
2019020646,10,3600,0.0,33,33,2,0,0,100.0
2019020646,10,60:00:00,0.0,33,33,2,0,0,1.0
2019020646,2,59:31:00,0.0,22,20,0,1,2,0.909090909
2019020647,5,3709,0.0,28,26,3,4,2,92.85714286
2019020647,8,3709,0.0,37,34,5,1,3,91.89189189
2019020647,8,61:49:00,0.0,37,34,5,1,3,0.918918919
2019020647,5,61:49:00,0.0,28,26,3,4,2,0.928571429
2019020648,14,3600,0.0,28,25,4,1,3,89.28571429
2019020648,9,3532,0.0,27,23,0,1,4,85.18518519
2019020648,9,58:52:00,0.0,27,23,0,1,4,0.851851852
2019020648,14,60:00:00,0.0,28,25,4,1,3,0.892857143
2019020649,21,3600,0.0,30,28,5,1,2,93.33333333
2019020649,1,3448,0.0,33,29,3,1,4,87.87878788
2019020649,1,57:28:00,0.0,33,29,3,1,4,0.878787879
2019020649,21,60:00:00,0.0,30,28,5,1,2,0.933333333
2019020650,4,2555,0.0,9,7,0,2,2,77.77777778
2019020650,4,975,0.0,12,9,2,0,3,75.0
2019020650,53,1200,0.0,12,10,2,0,2,83.33333333
2019020650,53,2400,0.0,17,17,2,0,0,100.0
2019020650,53,20:00,0.0,12,10,2,0,2,0.833333333
2019020650,53,40:00:00,0.0,17,17,2,0,0,1.0
2019020650,4,42:35:00,0.0,9,7,0,2,2,0.777777778
2019020650,4,16:15,0.0,12,9,2,0,3,0.75
2019020651,3,3512,0.0,27,25,9,1,2,92.59259259
2019020651,23,3600,0.0,37,36,4,1,1,97.2972973
2019020651,23,60:00:00,0.0,37,36,4,1,1,0.972972973
2019020651,3,58:32:00,0.0,27,25,9,1,2,0.925925926
2019020652,18,3600,0.0,24,23,2,1,1,95.83333333
2019020652,26,3600,0.0,38,34,5,1,4,89.47368421
2019020652,26,60:00:00,0.0,38,34,5,1,4,0.894736842
2019020652,18,60:00:00,0.0,24,23,2,1,1,0.958333333
2019020653,28,3714,0.0,29,24,3,0,5,82.75862069
2019020653,15,3644,0.0,28,25,1,0,3,89.28571429
2019020653,15,60:44:00,0.0,28,25,1,0,3,0.892857143
2019020653,28,61:54:00,0.0,29,24,3,0,5,0.827586207
2019020654,13,3600,0.0,32,31,4,0,1,96.875
2019020654,5,3576,0.0,34,31,0,1,3,91.17647059
2019020654,5,59:36:00,0.0,34,31,0,1,3,0.911764706
2019020654,13,60:00:00,0.0,32,31,4,0,1,0.96875
2019020655,14,3600,0.0,29,28,6,1,1,96.55172414
2019020655,12,3426,0.0,26,23,4,1,3,88.46153846
2019020655,12,57:06:00,0.0,26,23,4,1,3,0.884615385
2019020655,14,60:00:00,0.0,29,28,6,1,1,0.965517241
2019020656,20,3884,0.0,34,30,3,1,4,88.23529412
2019020656,30,3900,0.0,37,33,1,0,4,89.18918919
2019020656,30,65:00:00,0.0,37,33,1,0,4,0.891891892
2019020656,20,64:44:00,0.0,34,30,3,1,4,0.882352941
2019020657,17,3486,0.0,26,23,7,0,3,88.46153846
2019020657,16,3600,0.0,21,19,1,0,2,90.47619048
2019020657,16,60:00:00,0.0,21,19,1,0,2,0.904761905
2019020657,17,58:06:00,0.0,26,23,7,0,3,0.884615385
2019020658,18,3900,0.0,47,43,7,1,4,91.4893617
2019020658,24,3894,0.0,26,22,1,0,4,84.61538462
2019020658,24,64:54:00,0.0,26,22,1,0,4,0.846153846
2019020658,18,65:00:00,0.0,47,43,7,1,4,0.914893617
2019020659,22,3583,0.0,36,32,6,0,4,88.88888889
2019020659,10,2174,0.0,16,13,2,0,3,81.25
2019020659,10,1305,0.0,19,16,1,0,3,84.21052632
2019020659,10,36:14:00,0.0,16,13,2,0,3,0.8125
2019020659,10,21:45,0.0,19,16,1,0,3,0.842105263
2019020659,22,59:43:00,0.0,36,32,6,0,4,0.888888889
2019020660,52,3600,0.0,31,29,3,1,2,93.5483871
2019020660,8,3464,0.0,27,24,2,0,3,88.88888889
2019020660,8,57:44:00,0.0,27,24,2,0,3,0.888888889
2019020660,52,60:00:00,0.0,31,29,3,1,2,0.935483871
2019020661,21,3513,0.0,33,32,2,0,1,96.96969697
2019020661,2,3600,0.0,32,32,0,0,0,100.0
2019020661,2,60:00:00,0.0,32,32,0,0,0,1.0
2019020661,21,58:33:00,0.0,33,32,2,0,1,0.96969697
2019020662,29,3600,0.0,37,35,0,1,2,94.59459459
2019020662,26,3499,0.0,23,20,2,0,3,86.95652174
2019020662,26,58:19:00,0.0,23,20,2,0,3,0.869565217
2019020662,29,60:00:00,0.0,37,35,0,1,2,0.945945946
2019020663,23,1292,0.0,16,13,3,0,3,81.25
2019020663,23,2226,0.0,21,15,2,0,6,71.42857143
2019020663,14,3585,0.0,23,21,4,1,2,91.30434783
2019020663,14,59:45:00,0.0,23,21,4,1,2,0.913043478
2019020663,23,37:06:00,0.0,21,15,2,0,6,0.714285714
2019020663,23,21:32,0.0,16,13,3,0,3,0.8125
2019020664,53,3600,0.0,39,37,7,0,2,94.87179487
2019020664,13,3536,0.0,36,32,2,2,4,88.88888889
2019020664,13,58:56:00,0.0,36,32,2,2,4,0.888888889
2019020664,53,60:00:00,0.0,39,37,7,0,2,0.948717949
2019020665,2,3849,2.0,35,32,2,0,3,91.42857143
2019020665,1,3839,0.0,41,37,0,0,4,90.24390244
2019020665,1,63:59:00,0.0,41,37,0,0,4,0.902439024
2019020665,2,64:09:00,2.0,35,32,2,0,3,0.914285714
2019020666,21,3503,0.0,28,24,1,0,4,85.71428571
2019020666,3,3566,0.0,32,29,6,0,3,90.625
2019020666,3,59:26:00,0.0,32,29,6,0,3,0.90625
2019020666,21,58:23:00,0.0,28,24,1,0,4,0.857142857
2019020667,9,2528,0.0,30,25,0,2,5,83.33333333
2019020667,9,1072,0.0,11,10,0,0,1,90.90909091
2019020667,15,3600,0.0,27,26,0,0,1,96.2962963
2019020667,15,60:00:00,0.0,27,26,0,0,1,0.962962963
2019020667,9,17:52,0.0,11,10,0,0,1,0.909090909
2019020667,9,42:08:00,0.0,30,25,0,2,5,0.833333333
2019020668,4,3716,0.0,33,28,1,0,5,84.84848485
2019020668,12,3716,0.0,21,17,2,1,4,80.95238095
2019020668,12,61:56:00,0.0,21,17,2,1,4,0.80952381
2019020668,4,61:56:00,0.0,33,28,1,0,5,0.848484848
2019020669,8,3479,0.0,30,26,4,0,4,86.66666667
2019020669,17,3600,0.0,26,23,6,0,3,88.46153846
2019020669,17,60:00:00,0.0,26,23,6,0,3,0.884615385
2019020669,8,57:59:00,0.0,30,26,4,0,4,0.866666667
2019020670,28,3563,0.0,27,24,0,0,3,88.88888889
2019020670,19,3600,0.0,29,27,1,2,2,93.10344828
2019020670,19,60:00:00,0.0,29,27,1,2,2,0.931034483
2019020670,28,59:23:00,0.0,27,24,0,0,3,0.888888889
2019020671,6,3596,0.0,35,33,11,1,2,94.28571429
2019020671,18,3586,0.0,35,30,6,0,5,85.71428571
2019020671,18,59:46:00,0.0,35,30,6,0,5,0.857142857
2019020671,6,59:56:00,0.0,35,33,11,1,2,0.942857143
2019020672,20,3551,0.0,32,31,3,0,1,96.875
2019020672,16,3481,0.0,28,26,5,0,2,92.85714286
2019020672,16,58:01:00,0.0,28,26,5,0,2,0.928571429
2019020672,20,59:11:00,0.0,32,31,3,0,1,0.96875
2019020673,5,3600,0.0,34,31,5,0,3,91.17647059
2019020673,54,3466,0.0,16,12,0,0,4,75.0
2019020673,54,57:46:00,0.0,16,12,0,0,4,0.75
2019020673,5,60:00:00,0.0,34,31,5,0,3,0.911764706
2019020674,29,3600,0.0,40,37,1,1,3,92.5
2019020674,24,3519,0.0,26,23,4,0,3,88.46153846
2019020674,24,58:39:00,0.0,26,23,4,0,3,0.884615385
2019020674,29,60:00:00,0.0,40,37,1,1,3,0.925
2019020675,52,3900,0.0,28,25,1,1,3,89.28571429
2019020675,10,3765,0.0,28,25,2,0,3,89.28571429
2019020675,10,62:45:00,0.0,28,25,2,0,3,0.892857143
2019020675,52,65:00:00,0.0,28,25,1,1,3,0.892857143
2019020676,15,3554,0.0,27,24,0,1,3,88.88888889
2019020676,4,3600,0.0,28,26,5,1,2,92.85714286
2019020676,4,60:00:00,0.0,28,26,5,1,2,0.928571429
2019020676,15,59:14:00,0.0,27,24,0,1,3,0.888888889
2019020677,25,3600,0.0,31,30,2,0,1,96.77419355
2019020677,26,3498,0.0,32,30,3,0,2,93.75
2019020677,26,58:18:00,0.0,32,30,3,0,2,0.9375
2019020677,25,60:00:00,0.0,31,30,2,0,1,0.967741935
2019020678,52,3513,0.0,36,31,5,1,5,86.11111111
2019020678,6,3600,0.0,21,17,0,0,4,80.95238095
2019020678,6,60:00:00,0.0,21,17,0,0,4,0.80952381
2019020678,52,58:33:00,0.0,36,31,5,1,5,0.861111111
2019020679,22,3600,0.0,37,35,4,0,2,94.59459459
2019020679,8,3518,0.0,25,22,2,0,3,88.0
2019020679,8,58:38:00,0.0,25,22,2,0,3,0.88
2019020679,22,60:00:00,0.0,37,35,4,0,2,0.945945946
2019020680,53,3590,0.0,34,30,1,2,4,88.23529412
2019020680,14,3600,0.0,25,25,1,0,0,100.0
2019020680,14,60:00:00,0.0,25,25,1,0,0,1.0
2019020680,53,59:50:00,0.0,34,30,1,2,4,0.882352941
2019020681,23,3600,0.0,49,44,7,1,5,89.79591837
2019020681,13,3565,0.0,32,30,6,0,2,93.75
2019020681,13,59:25:00,0.0,32,30,6,0,2,0.9375
2019020681,23,60:00:00,0.0,49,44,7,1,5,0.897959184
2019020682,1,1498,0.0,12,11,2,0,1,91.66666667
2019020682,1,2102,0.0,25,20,3,0,5,80.0
2019020682,3,3600,0.0,49,46,6,4,3,93.87755102
2019020682,3,60:00:00,0.0,49,46,6,4,3,0.93877551
2019020682,1,35:02:00,0.0,25,20,3,0,5,0.8
2019020682,1,24:58:00,0.0,12,11,2,0,1,0.916666667
2019020683,7,3572,0.0,30,26,2,0,4,86.66666667
2019020683,19,3554,0.0,19,18,1,0,1,94.73684211
2019020683,19,59:14:00,0.0,19,18,1,0,1,0.947368421
2019020683,7,59:32:00,0.0,30,26,2,0,4,0.866666667
2019020684,18,3600,0.0,31,29,1,1,2,93.5483871
2019020684,16,3542,0.0,28,25,3,1,3,89.28571429
2019020684,16,59:02:00,0.0,28,25,3,1,3,0.892857143
2019020684,18,60:00:00,0.0,31,29,1,1,2,0.935483871
2019020685,30,3470,0.0,37,35,8,1,2,94.59459459
2019020685,20,3600,0.0,43,42,0,1,1,97.6744186
2019020685,20,60:00:00,0.0,43,42,0,1,1,0.976744186
2019020685,30,57:50:00,0.0,37,35,8,1,2,0.945945946
2019020686,26,3600,0.0,46,44,1,0,2,95.65217391
2019020686,54,3441,0.0,23,18,0,1,5,78.26086957
2019020686,54,57:21:00,0.0,23,18,0,1,5,0.782608696
2019020686,26,60:00:00,0.0,46,44,1,0,2,0.956521739
2019020687,25,3576,0.0,27,27,0,1,0,100.0
2019020687,24,3574,0.0,26,24,3,0,2,92.30769231
2019020687,24,59:34:00,0.0,26,24,3,0,2,0.923076923
2019020687,25,59:36:00,0.0,27,27,0,1,0,1.0
2019020688,29,3390,0.0,33,30,4,0,3,90.90909091
2019020688,28,3600,0.0,31,30,3,0,1,96.77419355
2019020688,28,60:00:00,0.0,31,30,3,0,1,0.967741935
2019020688,29,56:30:00,0.0,33,30,4,0,3,0.909090909
2019020689,9,3900,0.0,28,26,5,0,2,92.85714286
2019020689,17,3900,0.0,31,29,5,1,2,93.5483871
2019020690,53,1200,0.0,1,1,0,0,0,100.0
2019020690,53,2400,0.0,28,25,1,2,3,89.28571429
2019020690,12,3600,0.0,32,32,4,2,0,100.0
2019020691,5,3799,0.0,31,28,4,1,3,90.32258065
2019020691,21,3777,0.0,30,26,1,2,4,86.66666667
2019020692,23,3579,0.0,28,25,3,0,3,89.28571429
2019020692,7,3545,0.0,34,29,4,0,5,85.29411765
2019020693,8,3848,0.0,42,41,9,2,1,97.61904762
2019020693,9,3848,0.0,25,23,1,0,2,92.0
2019020694,6,3693,0.0,37,35,0,1,2,94.59459459
2019020694,2,3693,0.0,33,30,4,0,3,90.90909091
2019020695,14,3600,0.0,23,23,5,2,0,100.0
2019020695,4,3496,0.0,28,27,2,0,1,96.42857143
2019020696,1,3600,0.0,34,33,5,0,1,97.05882353
2019020696,15,3587,0.0,21,17,0,3,4,80.95238095
2019020697,26,3480,0.0,29,28,1,2,1,96.55172414
2019020697,12,3600,0.0,41,41,5,1,0,100.0
2019020698,3,3600,0.0,29,24,2,2,5,82.75862069
2019020698,19,3600,0.0,23,21,4,0,2,91.30434783
2019020699,24,3433,0.0,33,29,0,0,4,87.87878788
2019020699,16,3600,0.0,37,35,1,0,2,94.59459459
2019020700,22,3493,0.0,33,29,1,2,4,87.87878788
2019020700,20,3600,0.0,32,29,2,0,3,90.625
2019020701,29,3595,0.0,27,27,3,0,0,100.0
2019020701,54,3600,0.0,22,19,4,0,3,86.36363636
2019020702,25,3489,0.0,26,24,1,0,2,92.30769231
2019020702,28,3587,0.0,28,27,2,2,1,96.42857143
2019020703,18,3600,0.0,28,28,3,1,0,100.0
2019020703,52,3505,0.0,32,31,3,0,1,96.875
2019020704,23,3600,0.0,24,23,7,0,1,95.83333333
2019020704,30,3414,0.0,29,26,8,1,3,89.65517241
2019020705,7,3589,0.0,22,21,3,0,1,95.45454545
2019020705,17,3600,0.0,27,22,6,1,5,81.48148148
2019020706,5,3890,0.0,27,24,2,1,3,88.88888889
2019020706,53,3862,0.0,34,31,5,4,3,91.17647059
2019020707,10,2351,0.0,17,13,2,0,4,76.47058824
2019020707,10,1249,0.0,12,8,0,0,4,66.66666667
2019020707,13,3595,0.0,47,43,5,1,4,91.4893617
2019020708,14,3465,0.0,19,17,10,0,2,89.47368421
2019020708,1,3600,0.0,27,26,3,0,1,96.2962963
2019020709,20,3366,0.0,37,35,7,2,2,94.59459459
2019020709,8,3535,0.0,31,31,4,0,0,100.0
2019020710,2,585,0.0,1,1,0,0,0,100.0
2019020710,2,2992,0.0,35,29,3,0,6,82.85714286
2019020710,3,3581,0.0,34,32,3,0,2,94.11764706
2019020711,6,3900,0.0,39,34,4,2,5,87.17948718
2019020711,4,3900,0.0,31,26,1,0,5,83.87096774
2019020712,12,3437,0.0,30,28,1,0,2,93.33333333
2019020712,15,3587,0.0,23,23,6,2,0,100.0
2019020713,24,3600,0.0,34,30,0,0,4,88.23529412
2019020713,19,3600,0.0,21,20,4,0,1,95.23809524
2019020714,54,3502,0.0,25,22,1,0,3,88.0
2019020714,7,3600,0.0,26,24,2,1,2,92.30769231
2019020715,1,1891,0.0,19,14,4,0,5,73.68421053
2019020715,1,1623,0.0,14,13,3,1,1,92.85714286
2019020715,10,3576,0.0,29,25,4,1,4,86.20689655
2019020716,26,3900,0.0,38,35,5,2,3,92.10526316
2019020716,14,3869,0.0,41,38,7,0,3,92.68292683
2019020717,17,476,0.0,7,4,0,0,3,57.14285714
2019020717,17,3124,0.0,19,14,2,0,5,73.68421053
2019020717,2,3585,0.0,36,34,2,1,2,94.44444444
2019020718,30,3600,0.0,29,22,3,0,7,75.86206897
2019020718,5,3600,0.0,29,26,4,1,3,89.65517241
2019020719,6,3528,0.0,27,24,2,1,3,88.88888889
2019020719,6,72,0.0,0,0,0,0,0,
2019020719,29,3594,0.0,34,34,6,0,0,100.0
2019020720,16,3642,0.0,22,20,4,0,2,90.90909091
2019020720,9,3617,0.0,30,27,3,0,3,90.0
2019020721,23,3472,0.0,24,21,4,0,3,87.5
2019020721,52,3600,0.0,41,41,10,0,0,100.0
2019020722,25,3714,0.0,43,41,1,1,2,95.34883721
2019020722,21,3704,0.0,30,27,2,0,3,90.0
2019020723,18,3585,0.0,31,28,4,0,3,90.32258065
2019020723,22,3556,0.0,32,30,5,0,2,93.75
2019020724,28,3504,0.0,38,34,2,1,4,89.47368421
2019020724,53,3600,2.0,28,25,4,0,3,89.28571429
2019020725,16,3590,0.0,33,32,5,0,1,96.96969697
2019020725,8,3587,0.0,28,24,6,3,4,85.71428571
2019020726,4,3813,0.0,33,30,5,0,3,90.90909091
2019020726,19,3813,0.0,25,21,0,4,4,84.0
2019020727,5,3505,0.0,29,26,5,2,3,89.65517241
2019020727,6,3593,0.0,30,29,2,6,1,96.66666667
2019020728,20,3900,0.0,36,35,5,0,1,97.22222222
2019020728,10,3877,0.0,32,31,3,2,1,96.875
2019020729,26,3496,0.0,26,22,1,2,4,84.61538462
2019020729,13,605,0.0,4,4,0,0,0,100.0
2019020729,13,2995,0.0,26,23,4,2,3,88.46153846
2019020730,3,3590,0.0,40,38,9,0,2,95.0
2019020730,2,3589,0.0,28,25,5,1,3,89.28571429
2019020731,8,3600,0.0,41,40,9,2,1,97.56097561
2019020731,4,3600,0.0,40,36,3,0,4,90.0
2019020732,1,1200,0.0,15,13,2,1,2,86.66666667
2019020732,1,2389,0.0,23,20,3,0,3,86.95652174
2019020732,15,3590,0.0,34,32,5,3,2,94.11764706
2019020733,12,3526,0.0,18,15,0,0,3,83.33333333
2019020733,29,3597,0.0,34,32,2,0,2,94.11764706
2019020734,54,3600,0.0,35,33,6,0,2,94.28571429
2019020734,9,3420,0.0,43,39,2,1,4,90.69767442
2019020735,24,3600,0.0,35,33,0,0,2,94.28571429
2019020735,18,3516,0.0,27,23,2,0,4,85.18518519
2019020736,14,3518,0.0,23,20,7,0,3,86.95652174
2019020736,30,3578,0.0,20,18,4,0,2,90.0
2019020737,7,3593,0.0,29,28,2,0,1,96.55172414
2019020737,25,3459,0.0,20,18,0,3,2,90.0
2019020738,28,3593,0.0,38,34,4,1,4,89.47368421
2019020738,21,3600,0.0,27,27,4,0,0,100.0
2019020739,53,3557,0.0,24,22,0,0,2,91.66666667
2019020739,23,3600,0.0,35,34,2,1,1,97.14285714
2019020740,5,3643,0.0,29,28,3,0,1,96.55172414
2019020740,17,3688,0.0,37,35,4,0,2,94.59459459
2019020741,24,3692,0.0,26,25,4,1,1,96.15384615
2019020741,12,3693,0.0,37,35,3,1,2,94.59459459
2019020742,14,3600,0.0,31,30,3,1,1,96.77419355
2019020742,52,1870,0.0,12,7,0,1,5,58.33333333
2019020742,52,1730,0.0,14,12,3,0,2,85.71428571
2019020743,15,2400,0.0,22,18,3,0,4,81.81818182
2019020743,15,1200,0.0,7,7,0,0,0,100.0
2019020743,2,3499,0.0,29,24,6,0,5,82.75862069
2019020744,19,1278,0.0,6,6,0,0,0,100.0
2019020744,19,2208,0.0,11,7,0,0,4,63.63636364
2019020744,21,3592,0.0,24,21,3,1,3,87.5
2019020745,53,1123,0.0,8,8,0,1,0,100.0
2019020745,53,2400,0.0,18,12,2,0,6,66.66666667
2019020745,22,3600,0.0,30,27,3,1,3,90.0
2019020746,20,3588,0.0,20,16,3,1,4,80.0
2019020746,9,3600,0.0,42,40,7,0,2,95.23809524
2019020747,16,3586,0.0,33,31,1,0,2,93.93939394
2019020747,10,3600,0.0,34,28,0,1,6,82.35294118
2019020748,54,3816,0.0,32,28,1,0,4,87.5
2019020748,8,3900,0.0,34,30,3,1,4,88.23529412
2019020749,13,3600,0.0,28,27,11,3,1,96.42857143
2019020749,17,3589,0.0,37,34,8,3,3,91.89189189
2019020750,26,3600,0.0,26,22,3,0,4,84.61538462
2019020750,4,3598,0.0,35,34,3,0,1,97.14285714
2019020751,1,1934,0.0,17,13,2,1,4,76.47058824
2019020751,1,1666,0.0,14,13,0,0,1,92.85714286
2019020751,29,3600,0.0,41,41,5,0,0,100.0
2019020752,7,3580,0.0,37,35,6,0,2,94.59459459
2019020752,18,3600,0.0,31,30,6,0,1,96.77419355
2019020753,25,1451,0.0,17,13,2,0,4,76.47058824
2019020753,25,2149,0.0,15,12,1,0,3,80.0
2019020753,30,3546,0.0,27,27,4,1,0,100.0
2019020754,28,3584,0.0,39,35,9,2,4,89.74358974
2019020754,23,3600,0.0,18,17,1,0,1,94.44444444
2019020755,6,3510,0.0,22,18,4,0,4,81.81818182
2019020755,5,3600,0.0,38,35,3,2,3,92.10526316
2019020756,2,3887,0.0,32,31,4,1,1,96.875
2019020756,12,3900,0.0,27,26,7,0,1,96.2962963
2019020757,29,3600,0.0,32,31,0,1,1,96.875
2019020757,3,3591,0.0,31,29,2,0,2,93.5483871
2019020758,52,3555,0.0,32,28,7,1,4,87.5
2019020758,16,3600,0.0,38,36,13,0,2,94.73684211
2019020759,17,3595,0.0,45,40,10,1,5,88.88888889
2019020759,21,3600,0.0,25,22,3,3,3,88.0
2019020760,13,3600,0.0,33,29,6,0,4,87.87878788
2019020760,30,3594,0.0,25,20,3,0,5,80.0
2019020761,54,3498,0.0,37,34,3,1,3,91.89189189
2019020761,6,3600,0.0,29,27,3,0,2,93.10344828
2019020762,2,3563,0.0,42,40,7,2,2,95.23809524
2019020762,3,3317,0.0,18,14,2,0,4,77.77777778
2019020763,5,3586,0.0,29,27,3,1,2,93.10344828
2019020763,4,3574,0.0,19,19,3,0,0,100.0
2019020764,52,3384,0.0,29,25,5,2,4,86.20689655
2019020764,12,3597,2.0,17,16,2,0,1,94.11764706
2019020765,13,3600,0.0,35,32,8,0,3,91.42857143
2019020765,16,3529,0.0,26,22,0,0,4,84.61538462
2019020766,52,3463,0.0,29,25,1,0,4,86.20689655
2019020766,29,3575,0.0,30,27,2,0,3,90.0
2019020767,17,3332,0.0,33,29,0,0,4,87.87878788
2019020767,30,3600,0.0,27,25,3,0,2,92.59259259
2019020768,15,3600,0.0,33,31,2,1,2,93.93939394
2019020768,8,3515,0.0,39,36,4,3,3,92.30769231
2019020769,1,3900,0.0,38,35,2,0,3,92.10526316
2019020769,9,3900,0.0,53,50,10,1,3,94.33962264
2019020770,10,3585,0.0,36,34,1,0,2,94.44444444
2019020770,18,3553,0.0,30,26,1,0,4,86.66666667
2019020771,14,3705,0.0,35,32,2,1,3,91.42857143
2019020771,25,3720,0.0,25,23,5,1,2,92.0
2019020772,19,3520,0.0,25,23,5,0,2,92.0
2019020772,23,3600,0.0,37,36,6,1,1,97.2972973
2019020773,24,3508,0.0,31,27,1,0,4,87.09677419
2019020773,28,3567,0.0,28,26,2,0,2,92.85714286
2019020774,9,3600,0.0,30,28,6,1,2,93.33333333
2019020774,7,433,0.0,4,4,3,0,0,100.0
2019020774,7,3028,0.0,33,30,5,1,3,90.90909091
2019020775,19,3900,0.0,31,27,2,0,4,87.09677419
2019020775,20,3896,0.0,34,30,3,1,4,88.23529412
2019020776,18,3600,0.0,33,29,14,1,4,87.87878788
2019020776,15,3523,0.0,24,19,3,0,5,79.16666667
2019020777,10,3600,0.0,34,31,2,1,3,91.17647059
2019020777,25,3498,0.0,33,29,1,1,4,87.87878788
2019020778,20,3900,0.0,34,31,3,0,3,91.17647059
2019020778,22,3897,2.0,28,25,4,1,3,89.28571429
2019020779,53,3569,0.0,32,28,1,4,4,87.5
2019020779,24,3600,0.0,27,25,7,3,2,92.59259259
2019020780,14,3600,0.0,34,32,0,0,2,94.11764706
2019020780,26,3496,0.0,23,20,6,0,3,86.95652174
2019020781,23,3593,0.0,40,38,2,0,2,95.0
2019020781,28,3514,0.0,24,20,2,0,4,83.33333333
2019020782,8,3595,0.0,21,20,2,0,1,95.23809524
2019020782,7,3535,0.0,29,27,0,0,2,93.10344828
2019020783,18,3883,0.0,32,27,1,1,5,84.375
2019020783,1,3889,0.0,30,25,1,1,5,83.33333333
2019020784,26,3617,0.0,28,26,4,0,2,92.85714286
2019020784,53,3617,0.0,37,34,3,2,3,91.89189189
2019020785,17,3505,0.0,39,35,4,0,4,89.74358974
2019020785,3,3569,0.0,25,23,0,0,2,92.0
2019020786,4,3655,0.0,20,16,1,1,4,80.0
2019020786,5,3655,0.0,30,27,2,0,3,90.0
2019020787,15,3570,0.0,28,25,0,0,3,89.28571429
2019020787,9,3517,0.0,36,32,8,0,4,88.88888889
2019020788,54,3594,0.0,25,22,2,0,3,88.0
2019020788,12,3520,0.0,37,33,4,1,4,89.18918919
2019020789,6,3600,0.0,38,37,12,0,1,97.36842105
2019020789,52,3512,0.0,25,23,4,0,2,92.0
2019020790,19,3502,0.0,34,31,1,1,3,91.17647059
2019020790,22,3600,0.0,32,30,5,0,2,93.75
2019020791,14,3600,0.0,26,23,5,1,3,88.46153846
2019020791,24,3398,0.0,22,18,1,1,4,81.81818182
2019020792,29,3636,0.0,24,22,0,0,2,91.66666667
2019020792,7,3636,0.0,23,22,5,0,1,95.65217391
2019020793,23,3642,0.0,37,34,2,0,3,91.89189189
2019020793,2,3588,0.0,24,20,0,0,4,83.33333333
2019020794,13,3594,0.0,35,31,3,4,4,88.57142857
2019020794,8,3600,2.0,29,29,14,0,0,100.0
2019020795,9,3834,0.0,36,34,2,2,2,94.44444444
2019020795,10,3834,0.0,25,24,3,2,1,96.0
2019020796,3,3600,0.0,33,33,2,1,0,100.0
2019020796,17,3510,0.0,31,30,5,1,1,96.77419355
2019020797,25,3699,0.0,31,29,4,0,2,93.5483871
2019020797,1,3699,0.0,31,28,2,0,3,90.32258065
2019020798,21,3436,0.0,27,22,7,1,5,81.48148148
2019020798,4,3600,0.0,31,28,4,1,3,90.32258065
2019020799,19,3506,0.0,31,28,3,2,3,90.32258065
2019020799,52,3600,0.0,40,38,3,0,2,95.0
2019020800,54,3574,0.0,19,19,4,1,0,100.0
2019020800,18,3567,0.0,38,36,11,3,2,94.73684211
2019020801,6,3597,0.0,26,25,6,0,1,96.15384615
2019020801,30,3600,0.0,34,28,6,1,6,82.35294118
2019020802,16,3900,0.0,42,40,4,0,2,95.23809524
2019020802,53,3900,0.0,44,42,6,1,2,95.45454545
2019020803,22,2373,17.0,18,15,2,1,3,83.33333333
2019020803,22,1224,0.0,8,8,0,0,0,100.0
2019020803,20,2622,0.0,28,22,4,3,6,78.57142857
2019020803,20,975,21.0,21,19,0,0,2,90.47619048
2019020804,24,3600,0.0,47,46,2,0,1,97.87234043
2019020804,26,3404,0.0,28,25,0,2,3,89.28571429
2019020805,14,3583,0.0,30,30,4,0,0,100.0
2019020805,28,3515,0.0,34,32,3,1,2,94.11764706
2019020806,5,3593,0.0,32,29,1,1,3,90.625
2019020806,15,3504,0.0,33,29,7,3,4,87.87878788
2019020807,29,3600,0.0,30,27,0,0,3,90.0
2019020807,8,3505,0.0,26,23,3,3,3,88.46153846
2019020808,23,3897,0.0,32,29,0,2,3,90.625
2019020808,12,3898,0.0,35,32,7,0,3,91.42857143
2019020809,13,3600,0.0,34,31,5,0,3,91.17647059
2019020809,10,2278,0.0,13,10,0,1,3,76.92307692
2019020809,10,1200,0.0,8,7,5,0,1,87.5
2019020810,25,3600,0.0,36,33,3,1,3,91.66666667
2019020810,3,2400,0.0,15,11,1,1,4,73.33333333
2019020810,3,1047,0.0,6,5,1,0,1,83.33333333
2019020811,4,3592,0.0,16,16,1,3,0,100.0
2019020811,17,3521,0.0,30,28,1,0,2,93.33333333
2019020812,23,3600,0.0,42,38,8,4,4,90.47619048
2019020812,6,3600,0.0,25,25,1,0,0,100.0
2019020813,21,3600,0.0,24,23,4,0,1,95.83333333
2019020813,7,1826,0.0,13,8,0,0,5,61.53846154
2019020813,7,1774,0.0,14,13,0,0,1,92.85714286
2019020814,54,3509,0.0,17,14,1,2,3,82.35294118
2019020814,14,3600,0.0,29,27,1,0,2,93.10344828
2019020815,8,3900,0.0,24,20,4,2,4,83.33333333
2019020815,1,3846,0.0,36,32,2,3,4,88.88888889
2019020816,25,3772,0.0,41,37,12,0,4,90.24390244
2019020816,2,3736,0.0,31,28,3,1,3,90.32258065
2019020817,26,3547,0.0,23,20,0,0,3,86.95652174
2019020817,15,3600,0.0,31,29,1,0,2,93.5483871
2019020818,13,3714,0.0,45,44,4,2,1,97.77777778
2019020818,29,3714,0.0,32,32,2,0,0,100.0
2019020819,24,3896,0.0,32,30,5,1,2,93.75
2019020819,9,3900,0.0,28,26,4,1,2,92.85714286
2019020820,12,3596,0.0,26,20,3,0,6,76.92307692
2019020820,19,3591,0.0,28,25,4,1,3,89.28571429
2019020821,16,3741,0.0,34,31,1,1,3,91.17647059
2019020821,30,3737,0.0,29,27,3,1,2,93.10344828
2019020822,18,3640,0.0,34,33,6,0,1,97.05882353
2019020822,52,3650,0.0,36,34,4,2,2,94.44444444
2019020823,28,3600,0.0,31,30,3,0,1,96.77419355
2019020823,20,3487,0.0,26,23,1,0,3,88.46153846
2019020824,22,3513,0.0,26,24,5,0,2,92.30769231
2019020824,53,3600,0.0,30,30,5,0,0,100.0
2019020825,10,3508,0.0,34,30,3,0,4,88.23529412
2019020825,3,3600,0.0,30,27,0,0,3,90.0
2019020826,6,3653,0.0,22,21,3,0,1,95.45454545
2019020826,16,3679,0.0,40,38,5,2,2,95.0
2019020827,17,3900,0.0,32,29,4,0,3,90.625
2019020827,7,3805,0.0,21,18,7,0,3,85.71428571
2019020828,24,3625,0.0,27,24,5,1,3,88.88888889
2019020828,8,3604,0.0,37,35,8,0,2,94.59459459
2019020829,5,3562,2.0,28,25,4,1,3,89.28571429
2019020829,14,3600,0.0,31,29,5,1,2,93.5483871
2019020830,54,3568,0.0,25,23,2,4,2,92.0
2019020830,13,2933,0.0,29,23,3,0,6,79.31034483
2019020830,13,667,0.0,10,9,0,0,1,90.0
2019020831,26,3435,0.0,32,28,1,0,4,87.5
2019020831,2,3600,0.0,25,22,1,0,3,88.0
2019020832,1,3587,0.0,46,46,6,5,0,100.0
2019020832,4,2641,0.0,17,13,3,3,4,76.47058824
2019020832,4,919,0.0,2,1,0,0,1,50.0
2019020833,21,3600,0.0,26,25,2,0,1,96.15384615
2019020833,9,3595,0.0,34,30,2,1,4,88.23529412
2019020834,52,3600,0.0,37,35,8,0,2,94.59459459
2019020834,19,3542,0.0,24,21,3,0,3,87.5
2019020835,23,3452,0.0,37,33,5,2,4,89.18918919
2019020835,30,3582,0.0,26,24,3,0,2,92.30769231
2019020836,18,3600,0.0,39,37,3,1,2,94.87179487
2019020836,20,3493,0.0,35,32,3,0,3,91.42857143
2019020837,28,3571,0.0,31,28,1,1,3,90.32258065
2019020837,22,3592,0.0,31,25,4,0,6,80.64516129
2019020838,12,3600,0.0,33,30,7,1,3,90.90909091
2019020838,53,3508,0.0,30,26,1,1,4,86.66666667
2019020839,24,3871,0.0,35,30,4,0,5,85.71428571
2019020839,10,3893,0.0,30,26,3,1,4,86.66666667
2019020840,7,3600,0.0,39,37,3,0,2,94.87179487
2019020840,3,3477,0.0,28,25,3,0,3,89.28571429
2019020841,17,3494,0.0,43,42,5,1,1,97.6744186
2019020841,29,3513,0.0,16,16,1,1,0,100.0
2019020842,30,3600,0.0,33,31,10,0,2,93.93939394
2019020842,25,3580,0.0,31,28,4,3,3,90.32258065
2019020843,9,2384,0.0,22,18,3,0,4,81.81818182
2019020843,9,1200,0.0,12,11,0,0,1,91.66666667
2019020843,52,3600,0.0,27,25,2,0,2,92.59259259
2019020844,53,3521,0.0,32,29,3,2,3,90.625
2019020844,6,3537,0.0,31,29,8,1,2,93.5483871
2019020845,10,3699,0.0,30,28,1,0,2,93.33333333
2019020845,8,3703,0.0,23,22,2,1,1,95.65217391
2019020846,2,3483,0.0,29,27,2,0,2,93.10344828
2019020846,14,3600,0.0,18,17,1,0,1,94.44444444
2019020847,5,3589,0.0,35,33,3,0,2,94.28571429
2019020847,13,3509,0.0,22,19,3,2,3,86.36363636
2019020848,26,3570,0.0,34,31,6,1,3,91.17647059
2019020848,1,3576,0.0,37,37,5,3,0,100.0
2019020849,4,3600,2.0,27,25,1,0,2,92.59259259
2019020849,15,2842,0.0,25,18,2,1,7,72.0
2019020849,15,718,0.0,1,1,0,0,0,100.0
2019020850,21,3600,0.0,32,31,4,0,1,96.875
2019020850,29,3463,0.0,22,20,0,1,2,90.90909091
2019020851,18,3490,0.0,36,33,5,0,3,91.66666667
2019020851,22,3586,0.0,29,27,5,1,2,93.10344828
2019020852,25,3724,0.0,25,23,6,0,2,92.0
2019020852,19,3739,0.0,34,31,11,1,3,91.17647059
2019020853,20,3594,0.0,27,25,6,0,2,92.59259259
2019020853,23,3561,2.0,31,26,2,0,5,83.87096774
2019020854,12,3891,0.0,38,33,1,1,5,86.84210526
2019020854,54,3900,0.0,34,29,1,1,5,85.29411765
2019020855,6,3529,0.0,19,17,1,0,2,89.47368421
2019020855,17,3600,0.0,40,39,8,2,1,97.5
2019020856,24,3582,0.0,33,31,2,0,2,93.93939394
2019020856,7,3479,0.0,28,25,1,2,3,89.28571429
2019020857,26,3579,0.0,40,37,1,1,3,92.5
2019020857,3,3600,0.0,43,42,4,0,1,97.6744186
2019020858,16,3554,0.0,34,31,6,2,3,91.17647059
2019020858,52,3600,0.0,26,24,2,1,2,92.30769231
2019020859,21,3600,0.0,36,34,4,1,2,94.44444444
2019020859,30,3490,0.0,33,30,5,0,3,90.90909091
2019020860,53,3600,0.0,28,26,4,2,2,92.85714286
2019020860,8,3556,0.0,34,31,10,1,3,91.17647059
2019020861,13,3570,0.0,33,30,9,3,3,90.90909091
2019020861,4,3591,0.0,31,30,6,5,1,96.77419355
2019020862,2,3600,0.0,29,26,5,0,3,89.65517241
2019020862,15,1585,0.0,12,12,0,0,0,100.0
2019020862,15,1836,0.0,20,15,2,1,5,75.0
2019020863,14,3631,0.0,32,31,2,2,1,96.875
2019020863,29,3631,0.0,30,28,3,1,2,93.33333333
2019020864,18,1258,0.0,17,13,0,1,4,76.47058824
2019020864,18,2342,0.0,15,13,4,0,2,86.66666667
2019020864,23,3597,0.0,38,36,6,0,2,94.73684211
2019020865,20,3600,0.0,36,34,0,4,2,94.44444444
2019020865,28,3600,0.0,37,31,5,0,6,83.78378378
2019020866,17,3574,0.0,25,22,9,2,3,88.0
2019020866,7,3600,2.0,29,27,2,4,2,93.10344828
2019020867,53,3823,0.0,41,38,6,2,3,92.68292683
2019020867,10,3823,0.0,37,35,4,5,2,94.59459459
2019020868,13,3596,0.0,28,25,2,0,3,89.28571429
2019020868,1,3455,0.0,33,28,4,0,5,84.84848485
2019020869,4,3527,0.0,24,20,0,0,4,83.33333333
2019020869,2,3600,0.0,38,35,4,2,3,92.10526316
2019020870,14,3765,0.0,36,35,5,1,1,97.22222222
2019020870,5,3765,0.0,38,36,9,1,2,94.73684211
2019020871,54,2400,0.0,20,16,5,1,4,80.0
2019020871,54,1200,0.0,5,5,0,0,0,100.0
2019020871,30,3596,0.0,26,26,4,2,0,100.0
2019020872,3,364,0.0,1,1,0,0,0,100.0
2019020872,3,3236,0.0,43,42,11,0,1,97.6744186
2019020872,52,3419,0.0,32,28,1,2,4,87.5
2019020873,12,3535,0.0,36,33,3,0,3,91.66666667
2019020873,25,3600,0.0,25,24,1,3,1,96.0
2019020874,9,3444,0.0,35,33,5,0,2,94.28571429
2019020874,21,3600,0.0,34,34,6,0,0,100.0
2019020875,16,3474,0.0,30,26,4,1,4,86.66666667
2019020875,22,3600,0.0,41,38,8,2,3,92.68292683
2019020876,19,3552,0.0,27,26,5,0,1,96.2962963
2019020876,24,3513,0.0,35,33,5,0,2,94.28571429
2019020877,8,3465,0.0,37,34,6,0,3,91.89189189
2019020877,6,3598,0.0,29,28,5,0,1,96.55172414
2019020878,20,3384,0.0,32,28,1,1,4,87.5
2019020878,26,3600,0.0,38,35,6,1,3,92.10526316
2019020879,16,3538,0.0,19,17,3,2,2,89.47368421
2019020879,23,3583,0.0,49,49,10,0,0,100.0
2019020880,29,3719,0.0,27,23,2,0,4,85.18518519
2019020880,7,3756,0.0,31,28,1,0,3,90.32258065
2019020881,25,3600,0.0,31,29,2,1,2,93.5483871
2019020881,10,3393,0.0,19,16,2,0,3,84.21052632
2019020882,22,3540,0.0,36,34,0,0,2,94.44444444
2019020882,14,3600,0.0,30,29,1,0,1,96.66666667
2019020883,4,3600,0.0,28,26,0,2,2,92.85714286
2019020883,13,1200,0.0,9,6,2,0,3,66.66666667
2019020883,13,2400,0.0,19,16,0,1,3,84.21052632
2019020884,17,3573,0.0,26,22,8,1,4,84.61538462
2019020884,1,3600,0.0,26,25,1,1,1,96.15384615
2019020885,53,3513,0.0,31,28,3,1,3,90.32258065
2019020885,9,3600,0.0,34,32,0,2,2,94.11764706
2019020886,2,813,0.0,8,5,0,0,3,62.5
2019020886,2,2787,0.0,18,16,0,1,2,88.88888889
2019020886,18,3600,0.0,31,31,1,0,0,100.0
2019020887,3,3853,0.0,26,23,3,0,3,88.46153846
2019020887,30,3885,0.0,31,28,0,0,3,90.32258065
2019020888,15,3573,0.0,34,32,5,0,2,94.11764706
2019020888,21,3469,0.0,38,35,9,0,3,92.10526316
2019020889,19,3750,0.0,52,46,9,0,6,88.46153846
2019020889,54,3743,0.0,24,19,2,1,5,79.16666667
2019020890,20,3600,0.0,44,44,9,0,0,100.0
2019020890,24,2398,0.0,16,14,0,0,2,87.5
2019020890,24,1200,0.0,16,12,2,2,4,75.0
2019020891,8,3552,0.0,27,24,4,3,3,88.88888889
2019020891,5,3600,0.0,35,34,3,0,1,97.14285714
2019020892,3,3574,0.0,37,36,4,2,1,97.2972973
2019020892,29,3515,0.0,27,25,2,1,2,92.59259259
2019020893,28,3600,0.0,32,30,13,0,2,93.75
2019020893,52,3477,0.0,35,32,5,2,3,91.42857143
2019020894,1,3476,0.0,30,25,0,3,5,83.33333333
2019020894,12,3598,0.0,37,35,12,0,2,94.59459459
2019020895,17,3584,0.0,41,37,2,1,4,90.24390244
2019020895,6,3576,0.0,26,25,1,1,1,96.15384615
2019020896,18,3600,0.0,26,23,6,0,3,88.46153846
2019020896,19,3497,0.0,27,23,7,0,4,85.18518519
2019020897,4,3409,0.0,23,19,7,0,4,82.60869565
2019020897,14,3600,0.0,33,30,5,2,3,90.90909091
2019020898,22,3600,0.0,34,33,5,1,1,97.05882353
2019020898,13,3526,0.0,27,25,1,2,2,92.59259259
2019020899,28,3600,0.0,39,39,3,0,0,100.0
2019020899,30,3509,0.0,20,19,4,0,1,95.0
2019020900,25,3772,0.0,32,29,0,0,3,90.625
2019020900,8,3772,0.0,26,22,3,0,4,84.61538462
2019020901,10,3596,0.0,27,25,2,0,2,92.59259259
2019020901,9,1590,0.0,14,14,0,2,0,100.0
2019020901,9,1908,0.0,16,13,4,0,3,81.25
2019020902,26,3600,0.0,33,32,0,0,1,96.96969697
2019020902,21,2553,0.0,15,14,0,0,1,93.33333333
2019020902,21,1016,0.0,7,6,3,0,1,85.71428571
2019020903,16,3600,0.0,42,38,6,2,4,90.47619048
2019020903,20,1523,0.0,15,11,3,2,4,73.33333333
2019020903,20,2072,0.0,13,9,2,0,4,69.23076923
2019020904,15,3486,0.0,29,27,1,3,2,93.10344828
2019020904,53,3575,0.0,37,36,8,1,1,97.2972973
2019020905,2,3467,0.0,43,42,6,1,1,97.6744186
2019020905,54,3600,0.0,19,19,1,1,0,100.0
2019020906,17,1675,0.0,16,12,1,0,4,75.0
2019020906,17,1925,0.0,19,18,0,0,1,94.73684211
2019020906,5,3600,0.0,28,27,0,0,1,96.42857143
2019020907,6,3600,0.0,26,25,4,0,1,96.15384615
2019020907,3,3525,0.0,33,31,7,3,2,93.93939394
2019020908,22,3806,0.0,31,28,8,0,3,90.32258065
2019020908,12,3822,0.0,24,20,3,0,4,83.33333333
2019020909,24,3600,0.0,38,37,3,0,1,97.36842105
2019020909,23,3596,0.0,28,23,4,1,5,82.14285714
2019020910,25,3828,2.0,46,42,2,0,4,91.30434783
2019020910,9,3828,0.0,39,36,0,0,3,92.30769231
2019020911,29,3900,0.0,26,23,0,1,3,88.46153846
2019020911,1,3900,0.0,55,52,7,0,3,94.54545455
2019020912,19,3496,0.0,24,22,2,1,2,91.66666667
2019020912,18,3600,0.0,39,38,2,2,1,97.43589744
2019020913,10,3600,0.0,36,31,4,0,5,86.11111111
2019020913,7,3600,0.0,22,20,1,0,2,90.90909091
2019020914,16,3489,0.0,38,35,0,0,3,92.10526316
2019020914,52,3600,0.0,33,31,0,0,2,93.93939394
2019020915,24,3532,0.0,42,37,5,1,5,88.0952381
2019020915,20,3577,0.0,30,26,5,0,4,86.66666667
2019020916,2,3526,0.0,32,30,1,1,2,93.75
2019020916,53,3600,0.0,29,28,5,0,1,96.55172414
2019020917,13,3600,0.0,32,29,3,1,3,90.625
2019020917,28,3516,0.0,27,23,5,0,4,85.18518519
2019020918,15,3509,0.0,29,26,3,1,3,89.65517241
2019020918,54,3600,0.0,27,25,1,0,2,92.59259259
2019020919,14,3783,0.0,27,24,6,0,3,88.88888889
2019020919,21,3783,0.0,27,23,0,0,4,85.18518519
2019020920,29,980,0.0,3,2,0,0,1,66.66666667
2019020920,29,2620,0.0,12,8,0,0,4,66.66666667
2019020920,4,3600,0.0,29,28,4,0,1,96.55172414
2019020921,10,3600,0.0,24,19,0,0,5,79.16666667
2019020921,5,3600,0.0,36,34,6,1,2,94.44444444
2019020922,7,3477,0.0,39,33,2,0,6,84.61538462
2019020922,9,3600,0.0,27,23,2,0,4,85.18518519
2019020923,8,3573,0.0,25,21,4,0,4,84.0
2019020923,17,3575,0.0,22,19,1,0,3,86.36363636
2019020924,1,3600,0.0,39,36,3,0,3,92.30769231
2019020924,19,3592,0.0,17,17,2,2,0,100.0
2019020925,12,3600,0.0,29,28,8,1,1,96.55172414
2019020925,18,3600,0.0,30,26,0,0,4,86.66666667
2019020926,26,3585,0.0,34,29,7,1,5,85.29411765
2019020926,52,3596,0.0,34,31,3,1,3,91.17647059
2019020927,3,3600,0.0,40,37,6,0,3,92.5
2019020927,16,3561,2.0,41,35,6,0,6,85.36585366
2019020928,53,3467,0.0,33,30,4,1,3,90.90909091
2019020928,25,3600,0.0,41,39,6,1,2,95.12195122
2019020929,6,3674,0.0,29,28,10,3,1,96.55172414
2019020929,22,3656,0.0,34,32,11,3,2,94.11764706
2019020930,2,3446,0.0,29,26,2,0,3,89.65517241
2019020930,21,3572,0.0,28,27,4,1,1,96.42857143
2019020931,13,3600,0.0,36,35,2,0,1,97.22222222
2019020931,24,3530,2.0,31,28,3,1,3,90.32258065
2019020932,30,3900,0.0,34,31,1,0,3,91.17647059
2019020932,23,3878,0.0,28,25,0,0,3,89.28571429
2019020933,5,3600,0.0,30,26,2,0,4,86.66666667
2019020933,10,3599,0.0,24,24,6,0,0,100.0
2019020934,28,3540,0.0,25,23,6,2,2,92.0
2019020934,1,3600,0.0,37,36,6,2,1,97.2972973
2019020935,8,3658,0.0,32,29,0,0,3,90.625
2019020935,15,3571,0.0,32,28,1,0,4,87.5
2019020936,4,3831,0.0,31,28,4,0,3,90.32258065
2019020936,29,3831,0.0,33,29,0,0,4,87.87878788
2019020937,52,3600,0.0,30,29,5,3,1,96.66666667
2019020937,9,3592,0.0,34,29,8,0,5,85.29411765
2019020938,53,3467,0.0,46,45,5,1,1,97.82608696
2019020938,19,3597,0.0,14,14,3,0,0,100.0
2019020939,14,3448,0.0,33,28,8,3,5,84.84848485
2019020939,54,3594,2.0,27,24,5,0,3,88.88888889
2019020940,13,3546,0.0,40,35,10,0,5,87.5
2019020940,26,3590,0.0,29,25,2,5,4,86.20689655
2019020941,17,3474,0.0,39,36,8,0,3,92.30769231
2019020941,2,3600,0.0,22,21,4,1,1,95.45454545
2019020942,3,3600,0.0,29,27,8,1,2,93.10344828
2019020942,12,3505,0.0,35,31,7,1,4,88.57142857
2019020943,18,3842,0.0,38,36,10,1,2,94.73684211
2019020943,16,3816,0.0,43,42,8,0,1,97.6744186
2019020944,19,3600,0.0,19,18,4,1,1,94.73684211
2019020944,25,2115,0.0,10,9,0,2,1,90.0
2019020944,25,1485,0.0,13,9,1,0,4,69.23076923
2019020945,6,3600,0.0,21,18,3,0,3,85.71428571
2019020945,20,3551,0.0,23,19,0,0,4,82.60869565
2019020946,30,3600,0.0,26,23,2,1,3,88.46153846
2019020946,22,3547,0.0,38,34,4,1,4,89.47368421
2019020947,21,3600,0.0,26,26,5,1,0,100.0
2019020947,24,3525,0.0,29,28,3,0,1,96.55172414
2019020948,15,3445,0.0,29,26,5,1,3,89.65517241
2019020948,1,3600,0.0,35,33,13,0,2,94.28571429
2019020949,52,3474,0.0,30,26,3,1,4,86.66666667
2019020949,4,3590,0.0,29,27,0,1,2,93.10344828
2019020950,7,3600,0.0,43,41,6,2,2,95.34883721
2019020950,5,3600,0.0,26,21,1,0,5,80.76923077
2019020951,12,1509,0.0,15,14,1,0,1,93.33333333
2019020951,12,370,0.0,1,1,0,0,0,100.0
2019020951,12,1721,0.0,10,8,1,0,2,80.0
2019020951,10,3576,0.0,47,41,10,5,6,87.23404255
2019020952,8,3597,2.0,30,30,3,3,0,100.0
2019020952,9,3600,0.0,37,34,1,2,3,91.89189189
2019020953,28,3529,0.0,33,30,3,2,3,90.90909091
2019020953,3,3587,0.0,46,44,7,4,2,95.65217391
2019020954,29,3900,0.0,36,33,3,0,3,91.66666667
2019020954,18,3898,0.0,43,40,5,0,3,93.02325581
2019020955,14,3600,0.0,41,34,3,0,7,82.92682927
2019020955,53,3600,0.0,30,27,1,5,3,90.0
2019020956,6,812,0.0,8,5,0,0,3,62.5
2019020956,6,2788,0.0,27,21,3,1,6,77.77777778
2019020956,23,108,0.0,0,0,0,0,0,
2019020956,23,3492,0.0,37,34,0,1,3,91.89189189
2019020957,13,3515,0.0,38,34,8,0,4,89.47368421
2019020957,54,3593,0.0,35,32,5,0,3,91.42857143
2019020958,21,3883,0.0,21,20,2,0,1,95.23809524
2019020958,26,3900,0.0,31,30,6,1,1,96.77419355
2019020959,5,3539,0.0,22,18,1,0,4,81.81818182
2019020959,15,3600,0.0,35,32,5,0,3,91.42857143
2019020960,52,3549,0.0,25,23,2,0,2,92.0
2019020960,7,3594,0.0,26,25,0,0,1,96.15384615
2019020961,16,3484,0.0,33,31,0,0,2,93.93939394
2019020961,25,3600,0.0,32,31,8,0,1,96.875
2019020962,28,3571,0.0,25,22,5,0,3,88.0
2019020962,2,3600,0.0,30,29,0,0,1,96.66666667
2019020963,20,3600,0.0,29,27,4,1,2,93.10344828
2019020963,17,3419,0.0,30,27,0,2,3,90.0
2019020964,19,3600,0.0,33,32,7,1,1,96.96969697
2019020964,30,3600,0.0,26,22,5,1,4,84.61538462
2019020965,54,3827,0.0,30,25,3,0,5,83.33333333
2019020965,24,3780,0.0,28,22,1,0,6,78.57142857
2019020966,22,3582,0.0,23,21,0,0,2,91.30434783
2019020966,26,3530,0.0,30,27,2,0,3,90.0
2019020967,9,3875,0.0,45,41,3,0,4,91.11111111
2019020967,29,1999,0.0,15,14,0,0,1,93.33333333
2019020967,29,1876,0.0,18,16,0,0,2,88.88888889
2019020968,20,3600,0.0,28,26,2,1,2,92.85714286
2019020968,6,3586,0.0,30,26,3,0,4,86.66666667
2019020969,23,3693,0.0,40,37,0,0,3,92.5
2019020969,8,3689,0.0,34,30,1,0,4,88.23529412
2019020970,10,3600,0.0,29,26,1,1,3,89.65517241
2019020970,14,3510,0.0,23,19,1,1,4,82.60869565
2019020971,3,3628,0.0,45,42,4,1,3,93.33333333
2019020971,2,3508,0.0,28,24,2,1,4,85.71428571
2019020972,28,3475,0.0,27,23,4,0,4,85.18518519
2019020972,4,3600,0.0,28,26,4,1,2,92.85714286
2019020973,52,3900,0.0,37,34,1,2,3,91.89189189
2019020973,15,3900,0.0,33,30,2,0,3,90.90909091
2019020974,25,3581,0.0,41,40,9,3,1,97.56097561
2019020974,12,3592,0.0,16,12,3,0,4,75.0
2019020975,1,3568,0.0,28,27,1,1,1,96.42857143
2019020975,17,3564,0.0,31,27,6,2,4,87.09677419
2019020976,16,3470,0.0,37,31,5,1,6,83.78378378
2019020976,19,3580,0.0,30,25,2,3,5,83.33333333
2019020977,9,3446,0.0,33,30,8,1,3,90.90909091
2019020977,18,3600,0.0,35,33,3,0,2,94.28571429
2019020978,29,3505,0.0,40,35,1,1,5,87.5
2019020978,30,3600,0.0,28,24,3,0,4,85.71428571
2019020979,13,3600,0.0,38,37,0,1,1,97.36842105
2019020979,53,3462,0.0,26,24,2,0,2,92.30769231
2019020980,22,3725,0.0,21,17,0,0,4,80.95238095
2019020980,24,3725,0.0,32,29,2,1,3,90.625
2019020981,7,3511,0.0,34,31,4,0,3,91.17647059
2019020981,21,3597,0.0,33,31,4,1,2,93.93939394
2019020982,22,3571,0.0,33,30,7,0,3,90.90909091
2019020982,54,3579,0.0,29,29,1,1,0,100.0
2019020983,5,3525,0.0,22,20,4,1,2,90.90909091
2019020983,26,3583,0.0,36,35,3,1,1,97.22222222
2019020984,25,3460,0.0,28,24,5,1,4,85.71428571
2019020984,6,3592,0.0,34,31,1,0,3,91.17647059
2019020985,3,3600,0.0,34,32,3,0,2,94.11764706
2019020985,8,3537,0.0,34,30,4,1,4,88.23529412
2019020986,16,3600,0.0,38,36,11,3,2,94.73684211
2019020986,14,3520,0.0,26,22,5,0,4,84.61538462
2019020987,10,3597,0.0,27,24,0,1,3,88.88888889
2019020987,13,3509,0.0,28,24,3,2,4,85.71428571
2019020988,23,3563,0.0,24,20,0,0,4,83.33333333
2019020988,9,3600,0.0,34,32,4,0,2,94.11764706
2019020989,30,3565,0.0,26,25,3,0,1,96.15384615
2019020989,17,1668,0.0,9,7,1,0,2,77.77777778
2019020989,17,1925,0.0,17,12,3,0,5,70.58823529
2019020990,2,3803,0.0,32,29,1,0,3,90.625
2019020990,19,3803,0.0,17,15,2,0,2,88.23529412
2019020991,20,3680,0.0,38,34,3,0,4,89.47368421
2019020991,18,3649,0.0,39,36,0,0,3,92.30769231
2019020992,15,3551,0.0,31,29,2,2,2,93.5483871
2019020992,52,3598,0.0,34,34,6,1,0,100.0
2019020993,1,3638,0.0,30,27,5,0,3,90.0
2019020993,28,3629,0.0,23,21,4,0,2,91.30434783
2019020994,3,3600,0.0,40,35,3,1,5,87.5
2019020994,4,3600,0.0,28,26,4,0,2,92.85714286
2019020995,30,3600,0.0,24,24,1,1,0,100.0
2019020995,29,1650,0.0,11,10,3,0,1,90.90909091
2019020995,29,1950,0.0,15,11,1,0,4,73.33333333
2019020996,21,3600,0.0,47,45,9,2,2,95.74468085
2019020996,12,3450,0.0,32,29,7,0,3,90.625
2019020997,7,3522,0.0,27,24,0,0,3,88.88888889
2019020997,54,3600,0.0,34,32,1,0,2,94.11764706
2019020998,5,3432,0.0,21,18,7,1,3,85.71428571
2019020998,24,3600,0.0,30,28,2,2,2,93.33333333
2019020999,6,3600,0.0,25,25,7,0,0,100.0
2019020999,2,3571,0.0,30,26,7,0,4,86.66666667
2019021000,20,3418,0.0,33,29,6,1,4,87.87878788
2019021000,14,3600,0.0,21,18,2,1,3,85.71428571
2019021001,1,3718,0.0,38,36,0,0,2,94.73684211
2019021001,26,3718,0.0,33,32,5,0,1,96.96969697
2019021002,16,3900,0.0,40,38,8,1,2,95.0
2019021002,13,3900,0.0,29,27,2,0,2,93.10344828
2019021003,23,3526,0.0,29,26,8,0,3,89.65517241
2019021003,10,3600,0.0,27,25,2,2,2,92.59259259
2019021004,12,2187,0.0,19,18,2,0,1,94.73684211
2019021004,12,1443,0.0,20,17,1,0,3,85.0
2019021004,8,3652,0.0,30,27,3,2,3,90.0
2019021005,17,3897,2.0,39,36,8,0,3,92.30769231
2019021005,9,3900,0.0,28,25,2,4,3,89.28571429
2019021006,25,3844,0.0,29,26,5,0,3,89.65517241
2019021006,19,3900,0.0,31,28,0,1,3,90.32258065
2019021007,21,3600,0.0,32,30,9,2,2,93.75
2019021007,18,3597,0.0,30,28,11,0,2,93.33333333
2019021008,7,3495,0.0,30,26,2,2,4,86.66666667
2019021008,53,3578,0.0,27,25,6,1,2,92.59259259
2019021009,52,3430,0.0,22,19,3,1,3,86.36363636
2019021009,22,3600,0.0,41,39,3,0,2,95.12195122
2019021010,5,3600,0.0,32,27,1,1,5,84.375
2019021010,28,3600,0.0,30,30,7,0,0,100.0
2019021011,4,3600,0.0,26,23,5,0,3,88.46153846
2019021011,3,3462,0.0,26,21,7,0,5,80.76923077
2019021012,20,3600,0.0,38,38,10,0,0,100.0
2019021012,13,3600,0.0,28,25,0,1,3,89.28571429
2019021013,23,3527,0.0,34,30,2,1,4,88.23529412
2019021013,29,3599,0.0,39,36,5,0,3,92.30769231
2019021014,15,3600,0.0,40,37,3,1,3,92.5
2019021014,30,3535,2.0,30,26,1,2,4,86.66666667
2019021015,1,3600,0.0,34,34,4,1,0,100.0
2019021015,24,3600,2.0,34,31,0,1,3,91.17647059
2019021016,26,3600,0.0,43,42,6,0,1,97.6744186
2019021016,54,3440,0.0,17,13,3,1,4,76.47058824
2019021017,21,3600,0.0,18,17,5,0,1,94.44444444
2019021017,17,3487,0.0,27,25,1,0,2,92.59259259
2019021018,22,3600,0.0,30,27,2,0,3,90.0
2019021018,18,2995,0.0,31,23,0,1,8,74.19354839
2019021018,18,605,0.0,4,4,0,0,0,100.0
2019021019,6,3600,0.0,21,20,2,1,1,95.23809524
2019021019,14,3535,0.0,35,33,3,0,2,94.28571429
2019021020,8,3600,0.0,22,20,2,0,2,90.90909091
2019021020,2,2352,0.0,14,12,0,1,2,85.71428571
2019021020,2,1200,0.0,12,9,0,0,3,75.0
2019021021,19,3600,0.0,26,25,3,0,1,96.15384615
2019021021,3,3522,0.0,21,19,3,1,2,90.47619048
2019021022,9,3588,0.0,35,28,3,0,7,80.0
2019021022,5,3584,0.0,26,23,2,2,3,88.46153846
2019021023,18,3462,0.0,33,30,12,0,3,90.90909091
2019021023,30,3586,0.0,38,37,14,1,1,97.36842105
2019021024,7,3469,0.0,35,32,2,0,3,91.42857143
2019021024,52,3600,0.0,26,25,2,2,1,96.15384615
2019021025,24,2400,0.0,24,19,0,2,5,79.16666667
2019021025,24,1200,0.0,16,15,2,2,1,93.75
2019021025,16,70,0.0,0,0,0,0,0,
2019021025,16,3530,0.0,39,37,5,1,2,94.87179487
2019021026,22,3668,0.0,43,42,11,1,1,97.6744186
2019021026,25,3668,0.0,27,25,5,0,2,92.59259259
2019021027,1,3587,0.0,32,29,1,0,3,90.625
2019021027,54,3600,0.0,27,27,4,0,0,100.0
2019021028,10,3464,0.0,37,33,3,1,4,89.18918919
2019021028,28,3600,0.0,27,25,6,2,2,92.59259259
2019021029,4,3600,0.0,27,25,4,1,2,92.59259259
2019021029,15,3600,0.0,29,24,8,2,5,82.75862069
2019021030,29,3889,0.0,37,34,2,1,3,91.89189189
2019021030,20,3847,0.0,22,20,3,0,2,90.90909091
2019021031,24,3898,0.0,35,32,3,1,3,91.42857143
2019021031,21,3895,0.0,30,26,2,0,4,86.66666667
2019021032,53,3597,0.0,38,36,2,1,2,94.73684211
2019021032,23,3513,0.0,39,36,7,2,3,92.30769231
2019021033,5,3600,0.0,30,28,2,3,2,93.33333333
2019021033,7,3457,0.0,32,28,0,0,4,87.5
2019021034,8,3600,0.0,23,19,2,1,4,82.60869565
2019021034,14,3600,0.0,32,32,7,2,0,100.0
2019021035,6,3823,0.0,33,32,2,2,1,96.96969697
2019021035,13,3845,0.0,28,26,5,1,2,92.85714286
2019021036,15,3532,0.0,39,33,6,2,6,84.61538462
2019021036,3,3629,0.0,34,29,8,2,5,85.29411765
2019021037,12,3600,0.0,32,28,2,0,4,87.5
2019021037,4,3600,0.0,29,28,0,0,1,96.55172414
2019021038,2,3486,0.0,29,25,7,0,4,86.20689655
2019021038,9,3600,0.0,40,37,8,0,3,92.5
2019021039,25,3400,0.0,32,30,3,1,2,93.75
2019021039,18,3600,0.0,33,33,4,4,0,100.0
2019021040,22,1969,0.0,21,17,2,1,4,80.95238095
2019021040,22,1516,0.0,10,10,0,0,0,100.0
2019021040,16,3584,0.0,24,21,0,0,3,87.5
2019021041,10,3900,0.0,30,30,4,0,0,100.0
2019021041,26,3897,0.0,36,36,4,4,0,100.0
2019021042,30,3600,0.0,42,40,4,0,2,95.23809524
2019021042,28,3478,0.0,27,24,0,1,3,88.88888889
2019021043,19,3547,0.0,31,28,4,2,3,90.32258065
2019021043,1,3600,0.0,33,31,6,2,2,93.93939394
2019021044,16,3478,0.0,25,23,3,1,2,92.0
2019021044,17,3600,0.0,33,32,4,0,1,96.96969697
2019021045,54,3597,0.0,24,20,0,0,4,83.33333333
2019021045,52,3600,0.0,29,29,0,1,0,100.0
2019021046,53,3558,0.0,34,31,10,0,3,91.17647059
2019021046,20,3584,0.0,34,32,3,0,2,94.11764706
2019021047,21,3584,0.0,24,19,2,1,5,79.16666667
2019021047,23,3587,0.0,32,29,4,1,3,90.625
2019021048,10,3446,0.0,28,26,4,0,2,92.85714286
2019021048,24,580,0.0,5,4,2,0,1,80.0
2019021048,24,3001,2.0,26,26,5,2,0,100.0
2019021049,12,3696,0.0,26,24,1,0,2,92.30769231
2019021049,2,3696,0.0,28,25,4,0,3,89.28571429
2019021050,15,3600,0.0,28,26,3,0,2,92.85714286
2019021050,5,3380,0.0,28,23,1,2,5,82.14285714
2019021051,18,3600,0.0,37,37,4,1,0,100.0
2019021051,25,3466,0.0,23,22,1,1,1,95.65217391
2019021052,30,3560,0.0,34,28,6,2,6,82.35294118
2019021052,26,3600,0.0,28,25,1,2,3,89.28571429
2019021053,14,3593,0.0,38,35,7,1,3,92.10526316
2019021053,6,3554,0.0,24,20,0,2,4,83.33333333
2019021054,8,3514,0.0,31,28,6,0,3,90.32258065
2019021054,13,3559,0.0,34,33,6,0,1,97.05882353
2019021055,1,3600,0.0,35,31,3,0,4,88.57142857
2019021055,3,1047,0.0,5,5,0,0,0,100.0
2019021055,3,2346,0.0,23,18,0,1,5,78.26086957
2019021056,7,3458,0.0,24,21,4,2,3,87.5
2019021056,4,3596,0.0,39,38,7,3,1,97.43589744
2019021057,9,3633,0.0,32,31,3,0,1,96.875
2019021057,28,3621,0.0,38,36,1,0,2,94.73684211
2019021058,29,3541,0.0,23,20,0,0,3,86.95652174
2019021058,22,3600,0.0,46,45,5,1,1,97.82608696
2019021059,12,3600,0.0,30,28,10,1,2,93.33333333
2019021059,5,3600,0.0,36,30,8,3,6,83.33333333
2019021060,14,3894,0.0,28,24,2,0,4,85.71428571
2019021060,17,3859,0.0,37,33,6,2,4,89.18918919
2019021061,19,3600,0.0,29,29,1,1,0,100.0
2019021061,16,3384,0.0,26,24,1,1,2,92.30769231
2019021062,54,3600,0.0,22,19,0,1,3,86.36363636
2019021062,20,3569,0.0,31,27,0,0,4,87.09677419
2019021063,30,3841,0.0,26,22,3,1,4,84.61538462
2019021063,24,3817,0.0,30,25,2,3,5,83.33333333
2019021064,29,3600,0.0,27,26,4,2,1,96.2962963
2019021064,23,3497,0.0,22,20,1,2,2,90.90909091
2019021065,21,3600,0.0,25,22,7,1,3,88.0
2019021065,28,3470,0.0,24,20,2,1,4,83.33333333
2019021066,15,3900,0.0,26,24,5,0,2,92.30769231
2019021066,7,3900,0.0,35,33,2,1,2,94.28571429
2019021067,53,3514,0.0,33,30,4,0,3,90.90909091
2019021067,52,3600,0.0,38,36,3,0,2,94.73684211
2019021068,54,3730,0.0,24,22,0,0,2,91.66666667
2019021068,22,3733,0.0,48,45,5,0,3,93.75
2019021069,21,3519,0.0,35,32,1,2,3,91.42857143
2019021069,26,3600,0.0,22,21,1,0,1,95.45454545
2019021070,14,3522,0.0,36,34,4,2,2,94.44444444
2019021070,10,3600,0.0,33,32,9,1,1,96.96969697
2019021071,18,3600,0.0,34,32,5,3,2,94.11764706
2019021071,8,3482,0.0,36,32,5,1,4,88.88888889
2019021072,5,3597,0.0,22,20,3,0,2,90.90909091
2019021072,1,3572,0.0,32,28,7,0,4,87.5
2019021073,6,3600,0.0,36,36,5,2,0,100.0
2019021073,4,3435,0.0,29,27,4,1,2,93.10344828
2019021074,12,3596,0.0,25,23,8,1,2,92.0
2019021074,17,3600,0.0,36,31,7,3,5,86.11111111
2019021075,13,3600,0.0,27,26,1,1,1,96.2962963
2019021075,19,3449,0.0,34,32,0,2,2,94.11764706
2019021076,3,3600,0.0,33,31,4,1,2,93.93939394
2019021076,25,3459,0.0,27,23,1,1,4,85.18518519
2019021077,2,3900,0.0,34,30,3,0,4,88.23529412
2019021077,23,3879,0.0,49,45,11,1,4,91.83673469
2019021078,9,3587,0.0,15,10,0,0,5,66.66666667
2019021078,24,3598,0.0,42,40,10,0,2,95.23809524
2019021079,28,3588,0.0,45,39,2,0,6,86.66666667
2019021079,16,3600,0.0,36,34,6,1,2,94.44444444
2019021080,52,3600,0.0,38,36,3,0,2,94.73684211
2019021080,22,3478,0.0,24,21,0,0,3,87.5
2019021081,3,3704,0.0,28,25,3,1,3,89.28571429
2019021081,21,3770,0.0,32,30,6,3,2,93.75
2019021082,9,3478,0.0,39,36,10,1,3,92.30769231
2019021082,26,3574,0.0,26,24,3,2,2,92.30769231
2019030001,4,3600,0.0,35,34,4,0,1,97.14285714
2019030001,6,3349,0.0,29,25,1,0,4,86.20689655
2019030001,6,55:49:00,0.0,29,25,1,0,4,0.862068966
2019030001,4,60:00:00,0.0,35,34,4,0,1,0.971428571
2019030002,15,3896,0.0,28,26,0,0,2,92.85714286
2019030002,14,3900,0.0,33,31,4,0,2,93.93939394
2019030002,14,65:00:00,0.0,33,31,4,0,2,0.939393939
2019030002,15,64:56:00,0.0,28,26,0,0,2,0.928571429
2019030003,14,3600,0.0,27,25,5,0,2,92.59259259
2019030003,6,3518,0.0,35,32,2,1,3,91.42857143
2019030003,6,58:38:00,0.0,35,32,2,1,3,0.914285714
2019030003,14,60:00:00,0.0,27,25,5,0,2,0.925925926
2019030004,15,3433,0.0,21,18,3,1,3,85.71428571
2019030004,4,3596,0.0,17,16,6,0,1,94.11764706
2019030004,4,59:56:00,0.0,17,16,6,0,1,0.941176471
2019030004,15,57:13:00,0.0,21,18,3,1,3,0.857142857
2019030005,6,3537,0.0,25,23,6,1,2,92.0
2019030005,15,3600,0.0,31,30,1,1,1,96.77419355
2019030005,15,60:00:00,0.0,31,30,1,1,1,0.967741935
2019030005,6,58:57:00,0.0,25,23,6,1,2,0.92
2019030006,4,3600,0.0,24,23,3,1,1,95.83333333
2019030006,14,3526,0.0,29,26,2,1,3,89.65517241
2019030006,14,58:46:00,0.0,29,26,2,1,3,0.896551724
2019030006,4,60:00:00,0.0,24,23,3,1,1,0.958333333
2019030011,19,3565,0.0,38,36,7,1,2,94.73684211
2019030011,21,3559,0.0,32,31,7,2,1,96.875
2019030011,21,59:19:00,0.0,32,31,7,2,1,0.96875
2019030011,19,59:25:00,0.0,38,36,7,1,2,0.947368421
2019030012,25,3533,0.0,32,28,3,0,4,87.5
2019030012,54,3581,0.0,27,24,0,1,3,88.88888889
2019030012,54,59:41:00,0.0,27,24,0,1,3,0.888888889
2019030012,25,58:53:00,0.0,32,28,3,0,4,0.875
2019030013,21,3581,0.0,27,27,2,2,0,100.0
2019030013,25,3600,0.0,40,36,5,0,4,90.0
2019030013,25,60:00:00,0.0,40,36,5,0,4,0.9
2019030013,21,59:41:00,0.0,27,27,2,2,0,1.0
2019030014,54,3600,0.0,17,13,1,1,4,76.47058824
2019030014,19,3454,0.0,38,32,6,4,6,84.21052632
2019030014,19,57:34:00,0.0,38,32,6,4,6,0.842105263
2019030014,54,60:00:00,0.0,17,13,1,1,4,0.764705882
2019030015,54,3884,0.0,35,32,7,0,3,91.42857143
2019030015,21,3784,0.0,26,22,2,0,4,84.61538462
2019030015,21,63:04:00,0.0,26,22,2,0,4,0.846153846
2019030015,54,64:44:00,0.0,35,32,7,0,3,0.914285714
2019030016,25,3827,0.0,22,21,1,7,1,95.45454545
2019030016,19,3900,0.0,38,37,11,0,1,97.36842105
2019030016,19,65:00:00,0.0,38,37,11,0,1,0.973684211
2019030016,25,63:47:00,0.0,22,21,1,7,1,0.954545455
2019030021,8,4437,0.0,41,39,9,0,2,95.12195122
2019030021,5,4437,0.0,35,32,2,3,3,91.42857143
2019030022,8,3490,0.0,37,35,14,0,2,94.59459459
2019030022,5,3600,0.0,27,26,1,0,1,96.2962963
2019030022,5,60:00:00,0.0,27,26,1,0,1,0.962962963
2019030022,8,58:10:00,0.0,37,35,14,0,2,0.945945946
2019030023,5,3490,0.0,31,27,5,1,4,87.09677419
2019030023,8,3588,0.0,33,30,4,0,3,90.90909091
2019030023,8,59:48:00,0.0,33,30,4,0,3,0.909090909
2019030023,5,58:10:00,0.0,31,27,5,1,4,0.870967742
2019030024,5,3526,0.0,21,20,0,2,1,95.23809524
2019030024,8,3600,0.0,22,22,1,1,0,100.0
2019030024,8,60:00:00,0.0,22,22,1,1,0,1.0
2019030024,5,58:46:00,0.0,21,20,0,2,1,0.952380952
2019030031,3,3549,0.0,37,34,11,2,3,91.89189189
2019030031,12,3590,0.0,26,24,8,1,2,92.30769231
2019030032,3,3600,0.0,34,30,3,1,4,88.23529412
2019030032,12,3600,0.0,24,23,1,1,1,95.83333333
2019030032,12,60:00:00,0.0,24,23,1,1,1,0.958333333
2019030032,3,60:00:00,0.0,34,30,3,1,4,0.882352941
2019030033,12,3600,0.0,38,37,5,0,1,97.36842105
2019030033,3,3488,0.0,30,27,3,3,3,90.0
2019030033,3,58:08:00,0.0,30,27,3,3,3,0.9
2019030033,12,60:00:00,0.0,38,37,5,0,1,0.973684211
2019030041,13,3543,0.0,28,26,2,0,2,92.85714286
2019030041,2,3600,0.0,28,27,3,0,1,96.42857143
2019030042,13,3449,0.0,34,30,3,0,4,88.23529412
2019030042,2,3583,0.0,28,26,1,2,2,92.85714286
2019030042,2,59:43:00,0.0,28,26,1,2,2,0.928571429
2019030042,13,57:29:00,0.0,34,30,3,0,4,0.882352941
2019030043,2,3472,2.0,22,19,8,1,3,86.36363636
2019030043,13,3591,0.0,22,20,0,2,2,90.90909091
2019030043,13,59:51:00,0.0,22,20,0,2,2,0.909090909
2019030043,2,57:52:00,2.0,22,19,8,1,3,0.863636364
2019030044,2,3600,0.0,25,24,4,2,1,96.0
2019030044,13,3480,0.0,37,33,6,1,4,89.18918919
2019030044,13,58:00:00,0.0,37,33,6,1,4,0.891891892
2019030044,2,60:00:00,0.0,25,24,4,2,1,0.96
2019030051,29,3600,0.0,28,28,2,1,0,100.0
2019030051,10,3560,0.0,34,33,2,2,1,97.05882353
2019030051,10,59:20:00,0.0,34,33,2,2,1,0.970588235
2019030051,29,60:00:00,0.0,28,28,2,1,0,1.0
2019030052,29,3468,0.0,38,36,11,0,2,94.73684211
2019030052,10,3600,0.0,20,20,3,3,0,100.0
2019030052,10,60:00:00,0.0,20,20,3,3,0,1.0
2019030052,29,57:48:00,0.0,38,36,11,0,2,0.947368421
2019030053,10,4704,0.0,43,39,2,0,4,90.69767442
2019030053,29,1728,0.0,15,12,0,1,3,80.0
2019030053,29,2975,0.0,21,21,0,0,0,100.0
2019030053,29,28:48:00,0.0,15,12,0,1,3,0.8
2019030053,29,49:35:00,0.0,21,21,0,0,0,1.0
2019030053,10,78:24:00,0.0,43,39,2,0,4,0.906976744
2019030054,10,4246,0.0,39,36,4,4,3,92.30769231
2019030054,29,4390,0.0,53,49,6,2,4,92.45283019
2019030054,29,73:10:00,0.0,53,49,6,2,4,0.924528302
2019030054,10,70:46:00,0.0,39,36,4,4,3,0.923076923
2019030055,29,3600,0.0,33,33,2,1,0,100.0
2019030055,10,3467,0.0,21,19,1,0,2,90.47619048
2019030055,10,57:47:00,0.0,21,19,1,0,2,0.904761905
2019030055,29,60:00:00,0.0,33,33,2,1,0,1.0
2019030061,16,3600,0.0,29,25,3,2,4,86.20689655
2019030061,22,1592,0.0,23,18,3,1,5,78.26086957
2019030061,22,1846,0.0,19,18,7,0,1,94.73684211
2019030062,16,3597,0.0,35,29,7,0,6,82.85714286
2019030062,22,3585,0.0,26,23,6,2,3,88.46153846
2019030062,22,59:45:00,0.0,26,23,6,2,3,0.884615385
2019030062,16,59:57:00,0.0,35,29,7,0,6,0.828571429
2019030063,22,3546,0.0,25,21,6,1,4,84.0
2019030063,16,3600,0.0,28,25,5,0,3,89.28571429
2019030063,16,60:00:00,0.0,28,25,5,0,3,0.892857143
2019030063,22,59:06:00,0.0,25,21,6,1,4,0.84
2019030064,22,3558,0.0,29,26,4,3,3,89.65517241
2019030064,16,3600,0.0,45,43,8,2,2,95.55555556
2019030064,16,60:00:00,0.0,45,43,8,2,2,0.955555556
2019030064,22,59:18:00,0.0,29,26,4,3,3,0.896551724
2019030071,53,3545,0.0,43,40,7,2,3,93.02325581
2019030071,18,3503,0.0,37,33,11,2,4,89.18918919
2019030071,18,58:23:00,0.0,37,33,11,2,4,0.891891892
2019030071,53,59:05:00,0.0,43,40,7,2,3,0.930232558
2019030072,53,3560,0.0,28,24,2,0,4,85.71428571
2019030072,18,3597,0.0,26,24,2,1,2,92.30769231
2019030072,18,59:57:00,0.0,26,24,2,1,2,0.923076923
2019030072,53,59:20:00,0.0,28,24,2,0,4,0.857142857
2019030073,18,3593,0.0,27,24,2,1,3,88.88888889
2019030073,53,3600,0.0,40,39,2,1,1,97.5
2019030073,53,60:00:00,0.0,40,39,2,1,1,0.975
2019030073,18,59:53:00,0.0,27,24,2,1,3,0.888888889
2019030074,18,3836,0.0,34,30,1,3,4,88.23529412
2019030074,53,3600,0.0,52,49,4,0,3,94.23076923
2019030074,53,65:27:00,0.0,52,49,4,0,3,0.942307692
2019030074,18,63:56:00,0.0,34,30,1,3,4,0.882352941
2019030081,30,3597,0.0,28,28,0,0,0,100.0
2019030081,23,3506,0.0,30,28,0,1,2,93.33333333
2019030081,23,58:26:00,0.0,30,28,0,1,2,0.933333333
2019030081,30,59:57:00,0.0,28,28,0,0,0,1.0
2019030082,30,3481,0.0,28,24,10,1,4,85.71428571
2019030082,23,3590,0.0,35,32,9,1,3,91.42857143
2019030082,23,59:50:00,0.0,35,32,9,1,3,0.914285714
2019030082,30,58:01:00,0.0,28,24,10,1,4,0.857142857
2019030083,23,3600,0.0,27,27,8,0,0,100.0
2019030083,30,3600,0.0,29,26,7,2,3,89.65517241
2019030083,30,60:00:00,0.0,29,26,7,2,3,0.896551724
2019030083,23,60:00:00,0.0,27,27,8,0,0,1.0
2019030084,23,3606,0.0,29,25,3,1,4,86.20689655
2019030084,30,3556,0.0,31,26,5,0,5,83.87096774
2019030084,30,59:16:00,0.0,31,26,5,0,5,0.838709677
2019030084,23,60:06:00,0.0,29,25,3,1,4,0.862068966
2019030091,52,3591,0.0,33,30,8,3,3,90.90909091
2019030091,20,3600,0.0,18,17,4,0,1,94.44444444
2019030092,52,3600,0.0,30,28,4,2,2,93.33333333
2019030092,20,3503,0.0,26,23,4,2,3,88.46153846
2019030092,20,58:23:00,0.0,26,23,4,2,3,0.884615385
2019030092,52,60:00:00,0.0,30,28,4,2,2,0.933333333
2019030093,20,3598,0.0,35,33,1,1,2,94.28571429
2019030093,52,3469,0.0,31,26,6,1,5,83.87096774
2019030093,52,57:49:00,0.0,31,26,6,1,5,0.838709677
2019030093,20,59:58:00,0.0,35,33,1,1,2,0.942857143
2019030094,20,3598,0.0,31,31,5,1,0,100.0
2019030094,52,3532,0.0,32,30,6,1,2,93.75
2019030094,52,58:52:00,0.0,32,30,6,1,2,0.9375
2019030094,20,59:58:00,0.0,31,31,5,1,0,1.0
2019030111,8,3534,0.0,31,29,3,0,2,93.5483871
2019030111,4,3597,0.0,28,27,2,0,1,96.42857143
2019030111,4,59:57:00,0.0,28,27,2,0,1,0.964285714
2019030111,8,58:54:00,0.0,31,29,3,0,2,0.935483871
2019030112,8,3600,0.0,30,30,13,0,0,100.0
2019030112,4,1317,0.0,6,5,1,0,1,83.33333333
2019030112,4,2277,0.0,26,22,1,0,4,84.61538462
2019030112,4,21:57,0.0,6,5,1,0,1,0.833333333
2019030112,4,37:57:00,0.0,26,22,1,0,4,0.846153846
2019030112,8,60:00:00,0.0,30,30,13,0,0,1.0
2019030113,4,3600,2.0,23,23,4,2,0,100.0
2019030113,8,3479,0.0,20,19,3,0,1,95.0
2019030113,8,57:59:00,0.0,20,19,3,0,1,0.95
2019030113,4,60:00:00,2.0,23,23,4,2,0,1.0
2019030114,4,3600,0.0,29,29,1,2,0,100.0
2019030114,8,3517,0.0,22,20,4,0,2,90.90909091
2019030114,8,58:37:00,0.0,22,20,4,0,2,0.909090909
2019030114,4,60:00:00,0.0,29,29,1,2,0,1.0
2019030115,8,3590,0.0,29,26,7,3,3,89.65517241
2019030115,4,3534,0.0,32,28,4,2,4,87.5
2019030115,4,58:54:00,0.0,32,28,4,2,4,0.875
2019030115,8,59:50:00,0.0,29,26,7,3,3,0.896551724
2019030116,4,3600,0.0,33,31,0,2,2,93.93939394
2019030116,8,3497,0.0,17,14,5,0,3,82.35294118
2019030116,8,58:17:00,0.0,17,14,5,0,3,0.823529412
2019030116,4,60:00:00,0.0,33,31,0,2,2,0.939393939
2019030121,29,9026,0.0,88,85,7,2,3,96.59090909
2019030121,14,9027,0.0,63,61,4,0,2,96.82539683
2019030121,14,150:27:00,0.0,63,61,4,0,2,0.968253968
2019030121,29,150:26:00,0.0,88,85,7,2,3,0.965909091
2019030122,29,3598,0.0,37,36,3,1,1,97.2972973
2019030122,14,3378,0.0,22,19,0,1,3,86.36363636
2019030122,14,56:18:00,0.0,22,19,0,1,3,0.863636364
2019030122,29,59:58:00,0.0,37,36,3,1,1,0.972972973
2019030123,14,3600,0.0,17,15,7,0,2,88.23529412
2019030123,29,3499,0.0,34,31,2,0,3,91.17647059
2019030123,29,58:19:00,0.0,34,31,2,0,3,0.911764706
2019030123,14,60:00:00,0.0,17,15,7,0,2,0.882352941
2019030124,14,3600,0.0,29,28,1,1,1,96.55172414
2019030124,29,3539,0.0,22,20,6,0,2,90.90909091
2019030124,29,58:59:00,0.0,22,20,6,0,2,0.909090909
2019030124,14,60:00:00,0.0,29,28,1,1,1,0.965517241
2019030125,29,3882,0.0,25,20,0,0,5,80.0
2019030125,14,3897,0.0,41,37,9,0,4,90.24390244
2019030125,14,64:57:00,0.0,41,37,9,0,4,0.902439024
2019030125,29,64:42:00,0.0,25,20,0,0,5,0.8
2019030131,2,3600,0.0,26,24,10,1,2,92.30769231
2019030131,15,3450,0.0,27,23,4,2,4,85.18518519
2019030131,15,57:30:00,0.0,27,23,4,2,4,0.851851852
2019030131,2,60:00:00,0.0,26,24,10,1,2,0.923076923
2019030132,2,3600,0.0,25,23,1,1,2,92.0
2019030132,15,3573,0.0,31,27,4,0,4,87.09677419
2019030132,15,59:33:00,0.0,31,27,4,0,4,0.870967742
2019030132,2,60:00:00,0.0,25,23,1,1,2,0.92
2019030133,15,3868,0.0,34,32,6,0,2,94.11764706
2019030133,2,3868,0.0,23,22,0,4,1,95.65217391
2019030133,2,64:28:00,0.0,23,22,0,4,1,0.956521739
2019030133,15,64:28:00,0.0,34,32,6,0,2,0.941176471
2019030134,15,3597,0.0,26,24,12,0,2,92.30769231
2019030134,2,3492,0.0,29,26,4,2,3,89.65517241
2019030134,2,58:12:00,0.0,29,26,4,2,3,0.896551724
2019030134,15,59:57:00,0.0,26,24,12,0,2,0.923076923
2019030135,2,3599,0.0,21,21,1,1,0,100.0
2019030135,15,3539,0.0,15,13,2,1,2,86.66666667
2019030135,15,58:59:00,0.0,15,13,2,1,2,0.866666667
2019030135,2,59:59:00,0.0,21,21,1,1,0,1.0
2019030141,12,4873,0.0,40,36,3,1,4,90.0
2019030141,6,4852,0.0,28,25,4,0,3,89.28571429
2019030141,6,80:52:00,0.0,28,25,4,0,3,0.892857143
2019030141,12,81:13:00,0.0,40,36,3,1,4,0.9
2019030142,12,3586,0.0,35,33,3,3,2,94.28571429
2019030142,6,3523,0.0,26,23,3,0,3,88.46153846
2019030142,6,58:43:00,0.0,26,23,3,0,3,0.884615385
2019030142,12,59:46:00,0.0,35,33,3,3,2,0.942857143
2019030143,6,3592,0.0,30,29,9,1,1,96.66666667
2019030143,12,3467,0.0,38,36,10,1,2,94.73684211
2019030143,12,57:47:00,0.0,38,36,10,1,2,0.947368421
2019030143,6,59:52:00,0.0,30,29,9,1,1,0.966666667
2019030144,6,3598,0.0,19,16,0,0,3,84.21052632
2019030144,12,3499,0.0,33,29,9,0,4,87.87878788
2019030144,12,58:19:00,0.0,33,29,9,0,4,0.878787879
2019030144,6,59:58:00,0.0,19,16,0,0,3,0.842105263
2019030145,12,3466,0.0,27,25,8,0,2,92.59259259
2019030145,6,3600,0.0,24,23,5,1,1,95.83333333
2019030145,6,60:00:00,0.0,24,23,5,1,1,0.958333333
2019030145,12,57:46:00,0.0,27,25,8,0,2,0.925925926
2019030151,16,3600,0.0,34,30,6,5,4,88.23529412
2019030151,54,3585,0.0,20,19,6,0,1,95.0
2019030151,54,59:45:00,0.0,20,19,6,0,1,0.95
2019030151,16,60:00:00,0.0,34,30,6,5,4,0.882352941
2019030152,16,4033,0.0,39,35,3,0,4,89.74358974
2019030152,54,4033,0.0,25,22,2,0,3,88.0
2019030152,54,67:13:00,0.0,25,22,2,0,3,0.88
2019030152,16,67:13:00,0.0,39,35,3,0,4,0.897435897
2019030153,54,3600,0.0,27,26,6,1,1,96.2962963
2019030153,16,3485,0.0,26,24,5,0,2,92.30769231
2019030153,16,58:05:00,0.0,26,24,5,0,2,0.923076923
2019030153,54,60:00:00,0.0,27,26,6,1,1,0.962962963
2019030154,54,3511,0.0,24,22,6,2,2,91.66666667
2019030154,16,3600,0.0,49,48,9,1,1,97.95918367
2019030154,16,60:00:00,0.0,49,48,9,1,1,0.979591837
2019030154,54,58:31:00,0.0,24,22,6,2,2,0.916666667
2019030155,16,3526,0.0,39,35,0,0,4,89.74358974
2019030155,54,3579,0.0,26,23,0,0,3,88.46153846
2019030155,54,59:39:00,0.0,26,23,0,0,3,0.884615385
2019030155,16,58:46:00,0.0,39,35,0,0,4,0.897435897
2019030161,53,3600,0.0,40,37,1,1,3,92.5
2019030161,21,3600,0.0,14,14,1,0,0,100.0
2019030161,21,60:00:00,0.0,14,14,1,0,0,1.0
2019030161,53,60:00:00,0.0,40,37,1,1,3,0.925
2019030162,53,3487,0.0,28,25,2,0,3,89.28571429
2019030162,21,3591,0.0,32,30,6,1,2,93.75
2019030162,21,59:51:00,0.0,32,30,6,1,2,0.9375
2019030162,53,58:07:00,0.0,28,25,2,0,3,0.892857143
2019030163,21,3465,0.0,21,19,3,1,2,90.47619048
2019030163,53,3600,0.0,51,49,8,2,2,96.07843137
2019030163,53,60:00:00,0.0,51,49,8,2,2,0.960784314
2019030163,21,57:45:00,0.0,21,19,3,1,2,0.904761905
2019030164,21,3600,0.0,15,14,1,0,1,93.33333333
2019030164,53,2400,0.0,22,18,6,0,4,81.81818182
2019030164,53,1200,0.0,8,5,1,1,3,62.5
2019030164,53,20:00,0.0,8,5,1,1,3,0.625
2019030164,53,40:00:00,0.0,22,18,6,0,4,0.818181818
2019030164,21,60:00:00,0.0,15,14,1,0,1,0.933333333
2019030165,53,2400,0.0,30,24,4,0,6,80.0
2019030165,53,1200,0.0,6,5,0,2,1,83.33333333
2019030165,21,3600,0.0,24,23,0,0,1,95.83333333
2019030165,21,60:00:00,0.0,24,23,0,0,1,0.958333333
2019030165,53,20:00,0.0,6,5,0,2,1,0.833333333
2019030165,53,40:00:00,0.0,30,24,4,0,6,0.8
2019030171,20,3600,0.0,26,24,2,0,2,92.30769231
2019030171,25,3547,0.0,26,23,2,0,3,88.46153846
2019030171,25,59:07:00,0.0,26,23,2,0,3,0.884615385
2019030171,20,60:00:00,0.0,26,24,2,0,2,0.923076923
2019030172,20,3577,0.0,36,31,7,0,5,86.11111111
2019030172,25,3600,0.0,26,22,5,0,4,84.61538462
2019030172,25,60:00:00,0.0,26,22,5,0,4,0.846153846
2019030172,20,59:37:00,0.0,36,31,7,0,5,0.861111111
2019030173,25,3389,0.0,23,21,4,2,2,91.30434783
2019030173,20,3600,0.0,35,35,10,0,0,100.0
2019030173,20,60:00:00,0.0,35,35,10,0,0,1.0
2019030173,25,56:29:00,0.0,23,21,4,2,2,0.913043478
2019030174,25,4446,0.0,40,36,6,2,4,90.0
2019030174,20,4565,2.0,62,57,11,1,5,91.93548387
2019030174,20,76:05:00,2.0,62,57,11,1,5,0.919354839
2019030174,25,74:06:00,0.0,40,36,6,2,4,0.9
2019030175,20,3487,0.0,32,30,1,0,2,93.75
2019030175,25,3600,0.0,29,28,0,0,1,96.55172414
2019030175,25,60:00:00,0.0,29,28,0,0,1,0.965517241
2019030175,20,58:07:00,0.0,32,30,1,0,2,0.9375
2019030176,25,3600,0.0,41,38,9,0,3,92.68292683
2019030176,20,2605,0.0,15,11,1,0,4,73.33333333
2019030176,20,995,0.0,9,6,4,0,3,66.66666667
2019030176,20,16:35,0.0,9,6,4,0,3,0.666666667
2019030176,20,43:25:00,0.0,15,11,1,0,4,0.733333333
2019030176,25,60:00:00,0.0,41,38,9,0,3,0.926829268
2019030181,23,3597,0.0,31,29,4,0,2,93.5483871
2019030181,19,3478,0.0,22,17,2,1,5,77.27272727
2019030181,19,57:58:00,0.0,22,17,2,1,5,0.772727273
2019030181,23,59:57:00,0.0,31,29,4,0,2,0.935483871
2019030182,23,3955,0.0,37,34,8,0,3,91.89189189
2019030182,19,3824,0.0,25,21,2,0,4,84.0
2019030182,19,63:44:00,0.0,25,21,2,0,4,0.84
2019030182,23,65:55:00,0.0,37,34,8,0,3,0.918918919
2019030183,19,4506,0.0,41,39,2,1,2,95.12195122
2019030183,23,4506,0.0,49,46,0,0,3,93.87755102
2019030183,23,75:06:00,0.0,49,46,0,0,3,0.93877551
2019030183,19,75:06:00,0.0,41,39,2,1,2,0.951219512
2019030184,19,3600,0.0,23,22,8,1,1,95.65217391
2019030184,23,3392,0.0,37,34,11,2,3,91.89189189
2019030184,23,56:32:00,0.0,37,34,11,2,3,0.918918919
2019030184,19,60:00:00,0.0,23,22,8,1,1,0.956521739
2019030185,23,3600,0.0,39,36,4,1,3,92.30769231
2019030185,19,3507,2.0,30,26,3,1,4,86.66666667
2019030185,19,58:27:00,2.0,30,26,3,1,4,0.866666667
2019030185,23,60:00:00,0.0,39,36,4,1,3,0.923076923
2019030186,19,1628,0.0,6,5,0,0,1,83.33333333
2019030186,19,1686,0.0,18,14,0,0,4,77.77777778
2019030186,23,3600,0.0,36,34,5,0,2,94.44444444
2019030186,23,60:00:00,0.0,36,34,5,0,2,0.944444444
2019030186,19,27:08:00,0.0,6,5,0,0,1,0.833333333
2019030186,19,28:06:00,0.0,18,14,0,0,4,0.777777778
2019030211,2,3596,0.0,29,29,1,1,0,100.0
2019030211,4,3589,0.0,28,25,0,0,3,89.28571429
2019030211,4,59:49:00,0.0,28,25,0,0,3,0.892857143
2019030211,2,59:56:00,0.0,29,29,1,1,0,1.0
2019030212,2,909,0.0,10,7,1,0,3,70.0
2019030212,2,2852,0.0,21,20,1,1,1,95.23809524
2019030212,4,3761,0.0,34,31,4,0,3,91.17647059
2019030212,4,62:41:00,0.0,34,31,4,0,3,0.911764706
2019030212,2,47:32:00,0.0,21,20,1,1,1,0.952380952
2019030212,2,15:09,0.0,10,7,1,0,3,0.7
2019030213,4,3350,0.0,29,26,0,0,3,89.65517241
2019030213,2,3555,0.0,27,26,4,0,1,96.2962963
2019030213,2,59:15:00,0.0,27,26,4,0,1,0.962962963
2019030213,4,55:50:00,0.0,29,26,0,0,3,0.896551724
2019030214,4,3457,0.0,33,30,9,0,3,90.90909091
2019030214,2,3595,0.0,38,36,0,1,2,94.73684211
2019030214,2,59:55:00,0.0,38,36,0,1,2,0.947368421
2019030214,4,57:37:00,0.0,33,30,9,0,3,0.909090909
2019030215,2,4340,0.0,32,28,2,0,4,87.5
2019030215,4,4319,0.0,32,29,3,0,3,90.625
2019030215,4,71:59:00,0.0,32,29,3,0,3,0.90625
2019030215,2,72:20:00,0.0,32,28,2,0,4,0.875
2019030216,4,5686,0.0,53,49,10,3,4,92.45283019
2019030216,2,5703,0.0,31,26,1,0,5,83.87096774
2019030216,2,95:03:00,0.0,31,26,1,0,5,0.838709677
2019030216,4,94:46:00,0.0,53,49,10,3,4,0.924528302
2019030217,2,3594,0.0,16,16,1,1,0,100.0
2019030217,4,3465,0.0,25,22,3,1,3,88.0
2019030217,4,57:45:00,0.0,25,22,3,1,3,0.88
2019030217,2,59:54:00,0.0,16,16,1,1,0,1.0
2019030221,6,3600,0.0,37,35,5,0,2,94.59459459
2019030221,14,3461,0.0,31,28,2,2,3,90.32258065
2019030221,14,57:41:00,0.0,31,28,2,2,3,0.903225806
2019030221,6,60:00:00,0.0,37,35,5,0,2,0.945945946
2019030222,6,3859,0.0,40,36,4,1,4,90.0
2019030222,14,3880,0.0,25,22,1,1,3,88.0
2019030222,14,64:40:00,0.0,25,22,1,1,3,0.88
2019030222,6,64:19:00,0.0,40,36,4,1,4,0.9
2019030223,14,3590,0.0,24,23,2,2,1,95.83333333
2019030223,6,1878,0.0,16,12,3,0,4,75.0
2019030223,6,1722,0.0,15,12,0,0,3,80.0
2019030223,6,31:18:00,0.0,16,12,3,0,4,0.75
2019030223,6,28:42:00,0.0,15,12,0,0,3,0.8
2019030223,14,59:50:00,0.0,24,23,2,2,1,0.958333333
2019030224,14,3577,0.0,30,29,8,1,1,96.66666667
2019030224,6,3466,0.0,26,23,8,2,3,88.46153846
2019030224,6,57:46:00,0.0,26,23,8,2,3,0.884615385
2019030224,14,59:37:00,0.0,30,29,8,1,1,0.966666667
2019030225,6,5650,0.0,35,32,4,0,3,91.42857143
2019030225,14,5650,0.0,47,45,3,2,2,95.74468085
2019030225,14,94:10:00,0.0,47,45,3,2,2,0.957446809
2019030225,6,94:10:00,0.0,35,32,4,0,3,0.914285714
2019030231,23,3094,0.0,34,29,3,0,5,85.29411765
2019030231,23,506,0.0,5,5,0,0,0,100.0
2019030231,54,3597,0.0,26,26,4,1,0,100.0
2019030231,54,59:57:00,0.0,26,26,4,1,0,1.0
2019030231,23,51:34:00,0.0,34,29,3,0,5,0.852941176
2019030231,23,8:26,0.0,5,5,0,0,0,1.0
2019030232,23,3577,0.0,40,38,9,0,2,95.0
2019030232,54,3452,0.0,26,22,6,2,4,84.61538462
2019030232,54,57:32:00,0.0,26,22,6,2,4,0.846153846
2019030232,23,59:37:00,0.0,40,38,9,0,2,0.95
2019030233,54,3599,0.0,31,31,10,1,0,100.0
2019030233,23,3444,0.0,34,31,5,2,3,91.17647059
2019030233,23,57:24:00,0.0,34,31,5,2,3,0.911764706
2019030233,54,59:59:00,0.0,31,31,10,1,0,1.0
2019030234,54,3600,2.0,31,28,3,0,3,90.32258065
2019030234,23,3404,0.0,33,28,0,1,5,84.84848485
2019030234,23,56:44:00,0.0,33,28,0,1,5,0.848484848
2019030234,54,60:00:00,2.0,31,28,3,0,3,0.903225806
2019030235,23,3600,0.0,43,42,4,0,1,97.6744186
2019030235,54,3500,0.0,17,15,2,0,2,88.23529412
2019030235,54,58:20:00,0.0,17,15,2,0,2,0.882352941
2019030235,23,60:00:00,0.0,43,42,4,0,1,0.976744186
2019030236,54,3510,0.0,22,19,4,0,3,86.36363636
2019030236,23,3600,0.0,48,48,11,4,0,100.0
2019030236,23,60:00:00,0.0,48,48,11,4,0,1.0
2019030236,54,58:30:00,0.0,22,19,4,0,3,0.863636364
2019030237,23,3473,0.0,34,33,3,3,1,97.05882353
2019030237,54,3568,0.0,14,14,2,0,0,100.0
2019030237,54,59:28:00,0.0,14,14,2,0,0,1.0
2019030237,23,57:53:00,0.0,34,33,3,3,1,0.970588235
2019030241,25,3594,0.0,31,28,3,0,3,90.32258065
2019030241,21,1386,0.0,10,7,1,0,3,70.0
2019030241,21,2010,0.0,20,18,0,0,2,90.0
2019030241,21,23:06,0.0,10,7,1,0,3,0.7
2019030241,21,33:30:00,0.0,20,18,0,0,2,0.9
2019030241,25,59:54:00,0.0,31,28,3,0,3,0.903225806
2019030242,25,3600,0.0,40,38,8,0,2,95.0
2019030242,21,3414,0.0,26,22,7,0,4,84.61538462
2019030242,21,56:54:00,0.0,26,22,7,0,4,0.846153846
2019030242,25,60:00:00,0.0,40,38,8,0,2,0.95
2019030243,21,3600,0.0,37,33,9,0,4,89.18918919
2019030243,25,3506,0.0,31,26,2,1,5,83.87096774
2019030243,25,58:26:00,0.0,31,26,2,1,5,0.838709677
2019030243,21,60:00:00,0.0,37,33,9,0,4,0.891891892
2019030244,21,2875,0.0,26,21,13,0,5,80.76923077
2019030244,21,561,0.0,3,3,0,0,0,100.0
2019030244,25,3600,0.0,37,33,4,1,4,89.18918919
2019030244,25,60:00:00,0.0,37,33,4,1,4,0.891891892
2019030244,21,9:21,0.0,3,3,0,0,0,1.0
2019030244,21,47:55:00,0.0,26,21,13,0,5,0.807692308
2019030245,25,2457,2.0,22,20,9,2,2,90.90909091
2019030245,25,823,0.0,19,15,3,0,4,78.94736842
2019030245,21,3589,0.0,34,31,10,0,3,91.17647059
2019030245,21,59:49:00,0.0,34,31,10,0,3,0.911764706
2019030245,25,13:43,0.0,19,15,3,0,4,0.789473684
2019030245,25,40:57:00,2.0,22,20,9,2,2,0.909090909
2019030246,21,3600,0.0,28,27,2,2,1,96.42857143
2019030246,25,3450,0.0,23,20,9,0,3,86.95652174
2019030246,25,57:30:00,0.0,23,20,9,0,3,0.869565217
2019030246,21,60:00:00,0.0,28,27,2,2,1,0.964285714
2019030247,25,4013,0.0,44,40,9,1,4,90.90909091
2019030247,21,4021,0.0,35,30,2,0,5,85.71428571
2019030247,21,67:01:00,0.0,35,30,2,0,5,0.857142857
2019030247,25,66:53:00,0.0,44,40,9,1,4,0.909090909
2019030311,2,2945,0.0,25,20,7,0,5,80.0
2019030311,2,646,0.0,9,6,2,0,3,66.66666667
2019030311,14,3590,2.0,24,22,9,0,2,91.66666667
2019030311,14,59:50:00,2.0,24,22,9,0,2,0.916666667
2019030311,2,10:46,0.0,9,6,2,0,3,0.666666667
2019030311,2,49:05:00,0.0,25,20,7,0,5,0.8
2019030312,2,3582,0.0,21,19,4,1,2,90.47619048
2019030312,14,3600,0.0,28,27,13,0,1,96.42857143
2019030312,14,60:00:00,0.0,28,27,13,0,1,0.964285714
2019030312,2,59:42:00,0.0,21,19,4,1,2,0.904761905
2019030313,14,3537,0.0,35,31,2,1,4,88.57142857
2019030313,2,3556,0.0,37,34,0,1,3,91.89189189
2019030313,2,59:16:00,0.0,37,34,0,1,3,0.918918919
2019030313,14,58:57:00,0.0,35,31,2,1,4,0.885714286
2019030314,14,3600,0.0,27,26,4,0,1,96.2962963
2019030314,2,3494,0.0,35,32,8,2,3,91.42857143
2019030314,2,58:14:00,0.0,35,32,8,2,3,0.914285714
2019030314,14,60:00:00,0.0,27,26,4,0,1,0.962962963
2019030315,2,5472,0.0,37,36,6,1,1,97.2972973
2019030315,14,5550,0.0,24,22,1,0,2,91.66666667
2019030315,14,92:30:00,0.0,24,22,1,0,2,0.916666667
2019030315,2,91:12:00,0.0,37,36,6,1,1,0.972972973
2019030316,14,4364,0.0,27,26,1,4,1,96.2962963
2019030316,2,4398,0.0,48,46,5,0,2,95.83333333
2019030316,2,73:18:00,0.0,48,46,5,0,2,0.958333333
2019030316,14,72:44:00,0.0,27,26,1,4,1,0.962962963
2019030321,25,3599,0.0,25,25,3,0,0,100.0
2019030321,54,3482,0.0,25,24,1,0,1,96.0
2019030321,54,58:02:00,0.0,25,24,1,0,1,0.96
2019030321,25,59:59:00,0.0,25,25,3,0,0,1.0
2019030322,25,2400,0.0,27,24,8,1,3,88.88888889
2019030322,25,1029,0.0,5,5,1,0,0,100.0
2019030322,54,3600,0.0,24,24,2,1,0,100.0
2019030322,54,60:00:00,0.0,24,24,2,1,0,1.0
2019030322,25,17:09,0.0,5,5,1,0,0,1.0
2019030322,25,40:00:00,0.0,27,24,8,1,3,0.888888889
2019030323,54,3631,0.0,23,20,0,0,3,86.95652174
2019030323,25,3595,0.0,40,38,8,2,2,95.0
2019030323,25,59:55:00,0.0,40,38,8,2,2,0.95
2019030323,54,60:31:00,0.0,23,20,0,0,3,0.869565217
2019030324,54,3506,0.0,20,18,4,2,2,90.0
2019030324,25,3600,0.0,33,32,12,1,1,96.96969697
2019030324,25,60:00:00,0.0,33,32,12,1,1,0.96969697
2019030324,54,58:26:00,0.0,20,18,4,2,2,0.9
2019030325,25,3816,0.0,36,34,4,4,2,94.44444444
2019030325,54,3816,0.0,26,23,3,0,3,88.46153846
2019030325,54,63:36:00,0.0,26,23,3,0,3,0.884615385
2019030325,25,63:36:00,0.0,36,34,4,4,2,0.944444444
2019030411,25,3600,0.0,36,35,4,1,1,97.22222222
2019030411,14,3464,0.0,19,16,7,0,3,84.21052632
2019030411,14,57:44:00,0.0,19,16,7,0,3,0.842105263
2019030411,25,60:00:00,0.0,36,35,4,1,1,0.972222222
2019030412,25,3523,0.0,31,28,4,0,3,90.32258065
2019030412,14,3580,0.0,29,27,11,0,2,93.10344828
2019030412,14,59:40:00,0.0,29,27,11,0,2,0.931034483
2019030412,25,58:43:00,0.0,31,28,4,0,3,0.903225806
2019030413,14,3600,0.0,24,22,5,2,2,91.66666667
2019030413,25,2398,0.0,29,24,3,1,5,82.75862069
2019030413,25,1171,0.0,3,3,1,0,0,100.0
2019030413,25,19:31,0.0,3,3,1,0,0,1.0
2019030413,25,39:58:00,0.0,29,24,3,1,5,0.827586207
2019030413,14,60:00:00,0.0,24,22,5,2,2,0.916666667
2019030414,14,3958,0.0,30,26,4,0,4,86.66666667
2019030414,25,3972,0.0,35,30,7,0,5,85.71428571
2019030414,25,66:12:00,0.0,35,30,7,0,5,0.857142857
2019030414,14,65:58:00,0.0,30,26,4,0,4,0.866666667
2019030415,25,5350,0.0,41,39,3,0,2,95.12195122
2019030415,14,5363,0.0,33,30,3,0,3,90.90909091
2019030415,14,89:23:00,0.0,33,30,3,0,3,0.909090909
2019030415,25,89:10:00,0.0,41,39,3,0,2,0.951219512
2019030416,14,3600,0.0,22,22,3,0,0,100.0
2019030416,25,3493,0.0,29,27,2,2,2,93.10344828
2019030416,25,58:13:00,0.0,29,27,2,2,2,0.931034483
2019030416,14,60:00:00,0.0,22,22,3,0,0,1.0
2019040651,88,570,0.0,11,8,0,0,3,72.72727273
2019040651,88,600,0.0,9,5,0,0,4,55.55555556
2019040651,87,600,0.0,7,6,0,0,1,85.71428571
2019040651,87,600,0.0,9,5,0,0,4,55.55555556
2019040652,90,600,0.0,10,9,0,0,1,90.0
2019040652,90,600,0.0,7,3,0,0,4,42.85714286
2019040652,89,600,0.0,12,8,0,0,4,66.66666667
2019040652,89,600,0.0,16,10,0,0,6,62.5
2019040653,87,559,0.0,11,7,0,0,4,63.63636364
2019040653,87,600,0.0,9,8,0,0,1,88.88888889
2019040653,90,600,0.0,4,3,0,0,1,75.0
2019040653,90,600,0.0,7,4,0,0,3,57.14285714
2020020001,4,59:45:00,0.0,34,31,3,0,3,0.911764706
2020020001,5,59:51:00,0.0,27,21,3,1,6,0.777777778
2020020002,14,59:37:00,0.0,23,22,3,0,1,0.956521739
2020020002,16,59:37:00,0.0,33,28,9,0,5,0.848484848
2020020003,10,63:24:00,0.0,32,28,6,0,4,0.875
2020020003,8,63:24:00,0.0,34,29,8,0,5,0.852941176
2020020004,22,58:13:00,0.0,35,30,3,1,5,0.857142857
2020020004,23,59:46:00,0.0,31,28,5,1,3,0.903225806
2020020005,21,60:00:00,0.0,32,28,5,0,4,0.875
2020020005,19,60:00:00,0.0,27,26,5,0,1,0.962962963
2020020006,7,58:36:00,0.0,27,22,5,0,5,0.814814815
2020020006,15,60:00:00,0.0,26,22,3,1,4,0.846153846
2020020007,1,65:00:00,0.0,37,35,6,2,2,0.945945946
2020020007,6,65:00:00,0.0,22,20,3,1,2,0.909090909
2020020008,3,59:55:00,0.0,33,29,5,0,4,0.878787879
2020020008,2,60:00:00,0.0,24,24,4,1,0,1.0
2020020009,13,59:43:00,0.0,25,24,2,1,1,0.96
2020020009,25,57:58:00,0.0,51,49,13,1,2,0.960784314
2020020010,17,58:52:00,0.0,42,40,5,1,2,0.952380952
2020020010,12,60:00:00,0.0,14,14,1,0,0,1.0
2020020011,18,60:00:00,0.0,30,29,4,0,1,0.966666667
2020020011,29,58:33:00,0.0,34,32,7,0,2,0.941176471
2020020012,52,61:18:00,0.0,26,23,3,2,3,0.884615385
2020020012,20,61:18:00,0.0,34,30,7,0,4,0.882352941
2020020013,22,60:00:00,0.0,40,38,8,0,2,0.95
2020020013,23,59:52:00,0.0,46,41,7,1,5,0.891304348
2020020014,53,63:00:00,0.0,35,32,4,1,3,0.914285714
2020020014,28,63:54:00,0.0,37,34,6,0,3,0.918918919
2020020015,54,60:00:00,0.0,22,20,1,1,2,0.909090909
2020020015,24,57:29:00,0.0,28,24,2,0,4,0.857142857
2020020016,26,63:47:00,0.0,27,23,11,0,4,0.851851852
2020020016,30,63:47:00,0.0,34,31,3,2,3,0.911764706
2020020017,7,57:58:00,0.0,21,19,0,0,2,0.904761905
2020020017,15,60:00:00,0.0,31,30,7,0,1,0.967741935
2020020018,4,59:50:00,0.0,33,31,4,5,2,0.939393939
2020020018,5,47:45:00,0.0,13,12,3,3,1,0.923076923
2020020018,5,11:30,0.0,6,3,0,0,3,0.5
2020020019,14,60:00:00,0.0,37,35,6,2,2,0.945945946
2020020019,16,60:00:00,0.0,37,32,7,1,5,0.864864865
2020020020,13,62:50:00,0.0,29,25,4,0,4,0.862068966
2020020020,25,42:05:00,0.0,28,27,3,0,1,0.964285714
2020020020,25,20:45,0.0,15,11,2,0,4,0.733333333
2020020021,9,59:42:00,0.0,23,20,3,1,3,0.869565217
2020020021,10,57:20:00,0.0,24,19,4,0,5,0.791666667
2020020022,21,58:59:00,0.0,21,21,4,2,0,1.0
2020020022,19,19:45,0.0,14,10,5,2,4,0.714285714
2020020022,19,40:00:00,0.0,24,20,5,0,4,0.833333333
2020020023,1,64:58:00,0.0,28,27,2,0,1,0.964285714
2020020023,6,64:58:00,0.0,31,29,5,0,2,0.935483871
2020020024,3,60:00:00,0.0,23,23,3,2,0,1.0
2020020024,2,59:53:00,0.0,32,27,10,0,5,0.84375
2020020025,17,59:55:00,0.0,31,29,2,1,2,0.935483871
2020020025,12,57:54:00,0.0,20,17,2,1,3,0.85
2020020026,18,60:00:00,0.0,44,42,6,2,2,0.954545455
2020020026,29,60:00:00,0.0,33,28,7,0,5,0.848484848
2020020027,9,59:40:00,0.0,40,37,11,1,3,0.925
2020020027,10,59:48:00,0.0,19,17,4,0,2,0.894736842
2020020028,20,59:59:00,0.0,32,32,7,0,0,1.0
2020020028,23,59:46:00,0.0,35,32,9,0,3,0.914285714
2020020029,22,60:00:00,0.0,36,31,4,2,5,0.861111111
2020020029,8,60:00:00,0.0,35,34,10,0,1,0.971428571
2020020030,53,59:53:00,0.0,34,31,6,1,3,0.911764706
2020020030,28,46:38:00,0.0,24,19,1,1,5,0.791666667
2020020030,28,12:05,0.0,2,2,1,0,0,1.0
2020020031,54,59:34:00,0.0,22,21,1,0,1,0.954545455
2020020031,24,60:07:00,0.0,33,31,0,4,2,0.939393939
2020020032,26,64:46:00,0.0,44,40,6,2,4,0.909090909
2020020032,30,62:36:00,0.0,33,30,2,2,3,0.909090909
2020020033,14,60:00:00,0.0,22,20,1,0,2,0.909090909
2020020033,25,58:21:00,0.0,18,14,2,0,4,0.777777778
2020020034,13,60:00:00,0.0,30,28,5,0,2,0.933333333
2020020034,16,60:00:00,0.0,36,31,4,1,5,0.861111111
2020020035,5,65:00:00,0.0,23,20,3,0,3,0.869565217
2020020035,15,65:00:00,0.0,27,24,4,1,3,0.888888889
2020020036,2,60:00:00,0.0,27,27,2,1,0,1.0
2020020036,6,58:25:00,0.0,17,16,6,1,1,0.941176471
2020020037,4,31:51:00,0.0,15,13,3,0,2,0.866666667
2020020037,4,28:09:00,2.0,22,18,1,0,4,0.818181818
2020020037,7,60:00:00,0.0,22,21,1,0,1,0.954545455
2020020038,17,56:50:00,0.0,29,26,3,0,3,0.896551724
2020020038,29,59:08:00,0.0,37,35,0,0,2,0.945945946
2020020039,19,60:00:00,0.0,26,22,5,0,4,0.846153846
2020020039,28,58:52:00,0.0,33,28,1,0,5,0.848484848
2020020040,18,59:18:00,0.0,23,20,2,1,3,0.869565217
2020020040,12,59:48:00,0.0,33,31,4,0,2,0.939393939
2020020041,10,59:58:00,0.0,28,27,7,0,1,0.964285714
2020020041,52,58:20:00,0.0,37,35,8,2,2,0.945945946
2020020042,20,59:44:00,0.0,27,25,8,2,2,0.925925926
2020020042,23,56:17:00,0.0,31,27,6,1,4,0.870967742
2020020043,22,58:22:00,0.0,34,31,11,0,3,0.911764706
2020020043,8,59:39:00,0.0,26,25,8,0,1,0.961538462
2020020044,54,59:32:00,0.0,32,30,8,3,2,0.9375
2020020044,53,58:51:00,0.0,27,24,11,1,3,0.888888889
2020020045,24,60:00:00,0.0,34,34,9,0,0,1.0
2020020045,30,58:52:00,0.0,27,26,3,2,1,0.962962963
2020020046,3,17:44,0.0,8,8,0,0,0,1.0
2020020046,3,40:00:00,0.0,20,16,0,0,4,0.8
2020020046,1,60:00:00,0.0,50,47,14,0,3,0.94
2020020047,4,59:58:00,0.0,40,40,6,0,0,1.0
2020020047,7,19:02,0.0,9,8,2,0,1,0.888888889
2020020047,7,39:53:00,0.0,20,19,2,1,1,0.95
2020020048,14,59:40:00,0.0,31,26,0,0,5,0.838709677
2020020048,25,60:00:00,0.0,27,25,3,0,2,0.925925926
2020020049,13,62:50:00,0.0,36,32,2,0,4,0.888888889
2020020049,16,62:40:00,0.0,30,25,3,1,5,0.833333333
2020020050,5,61:11:00,0.0,26,22,3,0,4,0.846153846
2020020050,15,61:11:00,0.0,30,25,1,0,5,0.833333333
2020020051,17,60:15:00,0.0,24,22,2,1,2,0.916666667
2020020051,29,59:46:00,0.0,27,24,2,0,3,0.888888889
2020020052,18,39:31:00,0.0,17,16,0,1,1,0.941176471
2020020052,18,19:44,0.0,10,8,0,1,2,0.8
2020020052,12,60:00:00,0.0,38,36,0,1,2,0.947368421
2020020053,9,62:20:00,0.0,28,24,4,0,4,0.857142857
2020020053,52,61:15:00,0.0,41,38,10,1,3,0.926829268
2020020054,26,58:05:00,0.0,24,21,5,0,3,0.875
2020020054,21,59:59:00,0.0,25,23,3,1,2,0.92
2020020055,19,65:00:00,0.0,38,37,12,1,1,0.973684211
2020020055,28,64:47:00,0.0,23,22,3,0,1,0.956521739
2020020056,10,58:44:00,0.0,21,19,3,0,2,0.904761905
2020020056,22,60:00:00,0.0,26,25,7,3,1,0.961538462
2020020057,23,65:00:00,0.0,36,31,0,2,5,0.861111111
2020020057,8,65:00:00,0.0,28,23,5,0,5,0.821428571
2020020058,54,59:55:00,0.0,23,21,0,1,2,0.913043478
2020020058,53,60:00:00,0.0,29,24,11,0,5,0.827586207
2020020059,24,57:54:00,0.0,32,29,6,1,3,0.90625
2020020059,30,60:00:00,0.0,24,22,3,1,2,0.916666667
2020020060,6,65:00:00,0.0,26,22,1,0,4,0.846153846
2020020060,4,65:00:00,0.0,43,39,6,1,4,0.906976744
2020020061,2,59:47:00,0.0,31,30,1,1,1,0.967741935
2020020061,1,60:00:00,0.0,35,31,3,1,4,0.885714286
2020020062,12,62:27:00,0.0,37,33,4,0,4,0.891891892
2020020062,13,62:29:00,0.0,35,32,6,2,3,0.914285714
2020020063,29,61:56:00,0.0,37,34,2,1,3,0.918918919
2020020063,14,61:54:00,0.0,25,23,1,0,2,0.92
2020020064,9,20:00,0.0,3,3,1,0,0,1.0
2020020064,9,40:00:00,0.0,26,22,8,1,4,0.846153846
2020020064,52,59:56:00,0.0,29,28,6,2,1,0.965517241
2020020065,23,59:24:00,0.0,42,35,12,1,7,0.833333333
2020020065,8,59:46:00,0.0,17,14,3,1,3,0.823529412
2020020066,26,60:00:00,0.0,26,24,2,2,2,0.923076923
2020020066,21,58:05:00,0.0,26,23,5,1,3,0.884615385
2020020067,15,64:57:00,0.0,27,24,4,1,3,0.888888889
2020020067,7,65:00:00,0.0,32,29,3,1,3,0.90625
2020020068,5,65:00:00,0.0,34,31,4,0,3,0.911764706
2020020068,3,64:53:00,0.0,28,25,1,1,3,0.892857143
2020020069,16,59:48:00,0.0,31,30,9,0,1,0.967741935
2020020069,17,59:34:00,0.0,27,24,5,1,3,0.888888889
2020020070,10,59:51:00,0.0,32,30,3,0,2,0.9375
2020020070,22,58:14:00,0.0,28,25,4,0,3,0.892857143
2020020071,30,20:00,0.0,12,11,3,1,1,0.916666667
2020020071,30,40:00:00,0.0,17,17,2,1,0,1.0
2020020071,28,59:02:00,0.0,27,25,3,1,2,0.925925926
2020020072,25,59:50:00,0.0,34,34,14,0,0,1.0
2020020072,18,20:00,0.0,8,6,2,0,2,0.75
2020020072,18,39:57:00,0.0,20,15,4,1,5,0.75
2020020073,53,60:00:00,0.0,31,29,2,3,2,0.935483871
2020020073,54,59:47:00,0.0,25,21,5,1,4,0.84
2020020074,24,61:12:00,0.0,32,29,8,1,3,0.90625
2020020074,21,61:26:00,0.0,38,36,10,1,2,0.947368421
2020020075,6,60:00:00,0.0,17,16,3,0,1,0.941176471
2020020075,4,60:00:00,0.0,26,20,3,1,6,0.769230769
2020020076,12,60:00:00,0.0,23,21,6,1,2,0.913043478
2020020076,13,57:24:00,0.0,26,22,2,0,4,0.846153846
2020020077,29,60:00:00,0.0,32,30,1,0,2,0.9375
2020020077,14,59:52:00,0.0,27,23,1,2,4,0.851851852
2020020078,19,59:52:00,0.0,23,21,4,0,2,0.913043478
2020020078,26,58:26:00,0.0,29,26,2,1,3,0.896551724
2020020079,52,60:00:00,0.0,21,18,2,0,3,0.857142857
2020020079,9,59:28:00,0.0,37,32,4,0,5,0.864864865
2020020080,23,58:41:00,0.0,32,28,2,2,4,0.875
2020020080,8,60:00:00,0.0,25,23,4,2,2,0.92
2020020081,1,60:00:00,0.0,28,28,6,0,0,1.0
2020020081,2,57:50:00,0.0,24,22,2,0,2,0.916666667
2020020082,15,65:00:00,0.0,48,45,12,1,3,0.9375
2020020082,7,65:00:00,0.0,31,28,6,0,3,0.903225806
2020020083,5,60:00:00,0.0,26,24,3,0,2,0.923076923
2020020083,3,58:39:00,0.0,19,16,0,0,3,0.842105263
2020020084,16,60:00:00,0.0,27,25,8,1,2,0.925925926
2020020084,17,59:52:00,0.0,35,29,4,1,6,0.828571429
2020020085,19,57:06:00,0.0,34,29,6,1,5,0.852941176
2020020085,26,59:17:00,0.0,31,28,4,2,3,0.903225806
2020020086,52,60:00:00,0.0,38,34,6,0,4,0.894736842
2020020086,22,59:41:00,0.0,38,35,1,0,3,0.921052632
2020020087,20,57:49:00,0.0,32,29,3,2,3,0.90625
2020020087,10,60:00:00,0.0,33,31,4,0,2,0.939393939
2020020088,30,58:23:00,0.0,35,31,3,2,4,0.885714286
2020020088,28,59:36:00,0.0,29,26,2,2,3,0.896551724
2020020089,25,60:00:00,0.0,17,15,4,0,2,0.882352941
2020020089,18,58:50:00,0.0,22,19,4,0,3,0.863636364
2020020090,53,59:28:00,0.0,27,26,1,0,1,0.962962963
2020020090,54,60:00:00,0.0,16,16,2,0,0,1.0
2020020091,24,59:32:00,0.0,33,32,7,0,1,0.96969697
2020020091,21,58:41:00,0.0,14,12,3,0,2,0.857142857
2020020092,23,60:00:00,0.0,36,35,8,0,1,0.972222222
2020020092,9,59:54:00,0.0,35,28,1,0,7,0.8
2020020093,6,64:47:00,0.0,30,28,6,0,2,0.933333333
2020020093,5,64:46:00,0.0,36,33,2,6,3,0.916666667
2020020094,7,60:00:00,0.0,30,28,7,0,2,0.933333333
2020020094,3,57:41:00,0.0,24,21,7,0,3,0.875
2020020095,1,58:04:00,0.0,30,26,9,0,4,0.866666667
2020020095,4,60:00:00,0.0,26,23,4,0,3,0.884615385
2020020096,15,60:00:00,0.0,34,32,3,0,2,0.941176471
2020020096,2,59:38:00,0.0,37,34,4,0,3,0.918918919
2020020097,12,58:32:00,0.0,31,28,5,1,3,0.903225806
2020020097,14,59:59:00,0.0,36,34,3,0,2,0.944444444
2020020098,29,65:00:00,0.0,31,28,2,1,3,0.903225806
2020020098,13,62:43:00,0.0,22,19,9,0,3,0.863636364
2020020099,18,61:57:00,0.0,20,18,1,0,2,0.9
2020020099,16,61:57:00,0.0,39,36,8,0,3,0.923076923
2020020100,52,60:00:00,0.0,26,22,0,4,4,0.846153846
2020020100,22,59:13:00,0.0,32,27,9,0,5,0.84375
2020020101,20,58:21:00,0.0,21,17,3,0,4,0.80952381
2020020101,10,59:33:00,0.0,26,23,1,0,3,0.884615385
2020020102,30,58:10:00,0.0,21,19,8,0,2,0.904761905
2020020102,26,60:00:00,0.0,33,32,4,0,1,0.96969697
2020020103,25,61:32:00,0.0,21,20,5,0,1,0.952380952
2020020103,17,61:23:00,0.0,22,20,5,1,2,0.909090909
2020020104,21,59:59:00,0.0,30,27,10,1,3,0.9
2020020104,28,25:47:00,0.0,19,14,1,0,5,0.736842105
2020020104,28,34:12:00,0.0,23,21,8,1,2,0.913043478
2020020105,53,57:33:00,0.0,24,23,1,0,1,0.958333333
2020020105,24,60:00:00,0.0,31,31,3,0,0,1.0
2020020106,54,65:00:00,0.0,25,21,3,0,4,0.84
2020020106,19,65:00:00,0.0,46,42,10,0,4,0.913043478
2020020107,18,64:43:00,0.0,30,29,2,0,1,0.966666667
2020020107,16,64:58:00,0.0,42,41,8,0,1,0.976190476
2020020108,23,60:00:00,0.0,43,42,12,1,1,0.976744186
2020020108,9,59:01:00,0.0,35,30,6,0,5,0.857142857
2020020109,6,60:00:00,0.0,17,16,3,1,1,0.941176471
2020020109,5,60:00:00,2.0,20,16,0,3,4,0.8
2020020110,7,62:47:00,0.0,39,36,10,0,3,0.923076923
2020020110,3,62:47:00,0.0,25,23,1,1,2,0.92
2020020111,1,57:21:00,0.0,17,14,0,0,3,0.823529412
2020020111,4,60:00:00,0.0,34,33,6,0,1,0.970588235
2020020112,15,60:00:00,0.0,30,27,1,1,3,0.9
2020020112,2,57:19:00,0.0,22,17,5,0,5,0.772727273
2020020113,12,61:12:00,0.0,32,32,3,1,0,1.0
2020020113,14,60:55:00,0.0,35,34,3,0,1,0.971428571
2020020114,29,64:47:00,0.0,35,33,1,1,2,0.942857143
2020020114,13,65:00:00,0.0,31,29,1,1,2,0.935483871
2020020115,8,60:00:00,0.0,25,23,5,1,2,0.92
2020020115,20,60:00:00,0.0,21,17,1,0,4,0.80952381
2020020116,22,57:42:00,0.0,27,23,7,2,4,0.851851852
2020020116,10,59:02:00,0.0,29,26,4,1,3,0.896551724
2020020117,23,60:00:00,0.0,37,36,7,1,1,0.972972973
2020020117,9,59:51:00,0.0,25,21,1,1,4,0.84
2020020118,30,58:57:00,2.0,35,32,9,0,3,0.914285714
2020020118,26,57:23:00,0.0,28,23,4,3,5,0.821428571
2020020119,25,59:57:00,0.0,23,20,6,1,3,0.869565217
2020020119,17,19:31,0.0,9,6,2,0,3,0.666666667
2020020119,17,40:00:00,0.0,19,16,0,1,3,0.842105263
2020020120,21,59:52:00,0.0,21,21,4,0,0,1.0
2020020120,28,58:25:00,0.0,38,35,11,3,3,0.921052632
2020020121,53,59:43:00,0.0,16,14,5,1,2,0.875
2020020121,24,58:20:00,2.0,34,31,5,0,3,0.911764706
2020020122,54,59:49:00,0.0,16,15,1,0,1,0.9375
2020020122,19,60:00:00,0.0,35,30,7,1,5,0.857142857
2020020123,16,58:47:00,0.0,27,25,0,2,2,0.925925926
2020020123,29,60:00:00,0.0,32,31,6,1,1,0.96875
2020020124,7,64:57:00,0.0,34,31,9,1,3,0.911764706
2020020124,1,64:57:00,0.0,31,28,7,1,3,0.903225806
2020020125,3,62:16:00,0.0,38,33,4,0,5,0.868421053
2020020125,5,62:26:00,0.0,34,30,7,2,4,0.882352941
2020020126,4,63:04:00,0.0,28,26,4,0,2,0.928571429
2020020126,2,63:16:00,0.0,17,14,0,2,3,0.823529412
2020020127,15,60:28:00,0.0,43,40,2,0,3,0.930232558
2020020127,6,60:03:00,0.0,23,19,1,0,4,0.826086957
2020020128,12,2:47,0.0,0,0,0,0,0,
2020020128,12,57:05:00,0.0,11,10,6,0,1,0.909090909
2020020128,25,28:47:00,0.0,10,10,1,1,0,1.0
2020020128,25,30:19:00,0.0,16,12,4,1,4,0.75
2020020129,14,60:00:00,0.0,26,23,5,1,3,0.884615385
2020020129,18,58:16:00,0.0,33,29,11,3,4,0.878787879
2020020130,17,62:36:00,0.0,26,23,5,0,3,0.884615385
2020020130,13,62:40:00,0.0,27,25,5,1,2,0.925925926
2020020131,8,58:51:00,0.0,32,31,6,0,1,0.96875
2020020131,20,59:56:00,0.0,37,37,3,5,0,1.0
2020020132,52,59:21:00,0.0,38,35,6,1,3,0.921052632
2020020132,23,59:50:00,0.0,24,23,1,0,1,0.958333333
2020020133,22,60:42:00,0.0,29,26,3,0,3,0.896551724
2020020133,10,60:15:00,0.0,31,27,3,0,4,0.870967742
2020020134,30,59:55:00,0.0,33,28,8,0,5,0.848484848
2020020134,21,60:00:00,0.0,20,19,3,2,1,0.95
2020020135,24,57:04:00,0.0,24,21,3,0,3,0.875
2020020135,24,2:06,0.0,6,3,0,0,3,0.5
2020020135,19,60:00:00,0.0,24,23,2,0,1,0.958333333
2020020136,7,58:03:00,0.0,36,32,0,1,4,0.888888889
2020020136,1,60:00:00,0.0,33,30,8,0,3,0.909090909
2020020137,4,64:22:00,0.0,36,33,10,3,3,0.916666667
2020020137,2,63:18:00,0.0,29,25,4,2,4,0.862068966
2020020138,12,64:21:00,0.0,29,26,7,1,3,0.896551724
2020020138,25,64:15:00,0.0,40,37,10,1,3,0.925
2020020139,17,56:57:00,0.0,30,27,4,0,3,0.9
2020020139,13,59:29:00,0.0,34,32,9,1,2,0.941176471
2020020140,16,59:54:00,0.0,33,32,4,2,1,0.96969697
2020020140,29,56:39:00,0.0,36,33,6,2,3,0.916666667
2020020141,22,59:41:00,0.0,38,33,5,0,5,0.868421053
2020020141,9,52:37:00,0.0,22,17,3,1,5,0.772727273
2020020141,9,7:20,0.0,9,6,4,0,3,0.666666667
2020020142,30,60:18:00,0.0,25,22,4,0,3,0.88
2020020142,21,60:06:00,0.0,33,29,5,1,4,0.878787879
2020020143,24,60:00:00,0.0,23,19,1,1,4,0.826086957
2020020143,19,59:33:00,0.0,26,25,2,0,1,0.961538462
2020020144,3,59:12:00,0.0,26,25,7,1,1,0.961538462
2020020144,5,58:03:00,0.0,23,21,6,1,2,0.913043478
2020020145,15,58:36:00,0.0,32,28,3,0,4,0.875
2020020145,6,59:29:00,0.0,26,23,5,1,3,0.884615385
2020020146,14,59:03:00,0.0,31,29,4,0,2,0.935483871
2020020146,18,57:30:00,0.0,27,23,6,0,4,0.851851852
2020020147,8,60:00:00,0.0,29,27,5,0,2,0.931034483
2020020147,23,60:00:00,0.0,40,34,3,1,6,0.85
2020020148,52,64:27:00,0.0,28,25,4,1,3,0.892857143
2020020148,20,65:00:00,0.0,28,25,1,2,3,0.892857143
2020020149,28,59:40:00,0.0,26,23,6,2,3,0.884615385
2020020149,54,60:00:00,0.0,25,24,4,0,1,0.96
2020020150,2,59:41:00,0.0,36,34,5,1,2,0.944444444
2020020150,7,58:23:00,0.0,23,20,1,0,3,0.869565217
2020020151,5,62:48:00,0.0,35,33,3,0,2,0.942857143
2020020151,1,62:50:00,0.0,36,35,5,1,1,0.972222222
2020020152,29,33:40:00,0.0,23,18,3,0,5,0.782608696
2020020152,29,24:37:00,0.0,9,9,0,1,0,1.0
2020020152,25,59:52:00,0.0,26,23,2,1,3,0.884615385
2020020153,16,65:00:00,0.0,41,38,1,0,3,0.926829268
2020020153,12,65:00:00,0.0,33,30,1,0,3,0.909090909
2020020154,19,60:00:00,0.0,35,32,4,2,3,0.914285714
2020020154,53,57:20:00,0.0,29,25,7,1,4,0.862068966
2020020155,8,59:40:00,0.0,39,36,6,0,3,0.923076923
2020020155,23,57:20:00,0.0,32,28,4,0,4,0.875
2020020156,52,60:00:00,0.0,31,29,3,1,2,0.935483871
2020020156,20,58:01:00,0.0,28,25,1,1,3,0.892857143
2020020157,22,60:00:00,0.0,25,23,3,1,2,0.92
2020020157,9,59:54:00,0.0,25,21,2,1,4,0.84
2020020158,21,59:34:00,0.0,28,27,3,5,1,0.964285714
2020020158,30,59:02:00,0.0,31,29,6,0,2,0.935483871
2020020159,4,60:31:00,0.0,35,31,3,2,4,0.885714286
2020020159,6,59:39:00,0.0,25,22,1,1,3,0.88
2020020160,14,60:00:00,0.0,16,15,2,0,1,0.9375
2020020160,17,5:36,0.0,6,3,0,0,3,0.5
2020020160,17,54:08:00,0.0,21,19,2,0,2,0.904761905
2020020161,26,59:09:00,0.0,42,40,2,0,2,0.952380952
2020020161,24,59:59:00,0.0,21,20,5,0,1,0.952380952
2020020162,28,60:00:00,0.0,44,38,7,0,6,0.863636364
2020020162,54,60:00:00,0.0,19,19,1,1,0,1.0
2020020163,2,59:58:00,0.0,18,16,0,0,2,0.888888889
2020020163,7,59:33:00,0.0,45,40,10,0,5,0.888888889
2020020164,3,60:00:00,0.0,33,31,6,0,2,0.939393939
2020020164,15,58:50:00,0.0,30,27,4,0,3,0.9
2020020165,13,64:00:00,0.0,41,35,12,0,6,0.853658537
2020020165,18,22:53,0.0,12,12,0,0,0,1.0
2020020165,18,39:14:00,0.0,24,19,2,0,5,0.791666667
2020020166,5,60:00:00,2.0,30,24,5,0,6,0.8
2020020166,1,20:00,0.0,13,9,0,0,4,0.692307692
2020020166,1,38:52:00,0.0,19,16,2,1,3,0.842105263
2020020167,29,60:00:00,0.0,28,25,2,3,3,0.892857143
2020020167,25,58:34:00,0.0,25,21,3,0,4,0.84
2020020168,16,60:00:00,0.0,34,30,4,1,4,0.882352941
2020020168,12,58:40:00,0.0,34,29,8,1,5,0.852941176
2020020169,19,55:41:00,0.0,29,26,3,1,3,0.896551724
2020020169,53,60:00:00,0.0,43,40,12,0,3,0.930232558
2020020170,8,59:02:00,0.0,22,19,1,1,3,0.863636364
2020020170,9,60:00:00,0.0,38,36,7,2,2,0.947368421
2020020171,10,60:00:00,0.0,19,16,1,0,3,0.842105263
2020020171,23,59:26:00,0.0,37,30,4,3,7,0.810810811
2020020172,52,60:00:00,0.0,24,23,2,0,1,0.958333333
2020020172,20,58:49:00,0.0,26,23,1,1,3,0.884615385
2020020173,21,58:52:00,0.0,24,19,0,1,5,0.791666667
2020020173,30,59:56:00,0.0,32,30,7,0,2,0.9375
2020020174,4,57:38:00,0.0,23,21,4,0,2,0.913043478
2020020174,6,60:00:00,0.0,24,23,5,0,1,0.958333333
2020020175,14,60:00:00,0.0,28,27,3,1,1,0.964285714
2020020175,17,59:02:00,0.0,31,29,9,0,2,0.935483871
2020020176,13,60:00:00,0.0,25,24,0,0,1,0.96
2020020176,18,58:46:00,0.0,36,34,9,0,2,0.944444444
2020020177,54,59:49:00,0.0,29,27,1,1,2,0.931034483
2020020177,26,21:04,0.0,10,6,0,0,4,0.6
2020020177,26,38:56:00,0.0,26,25,9,0,1,0.961538462
2020020178,24,64:59:00,0.0,30,26,2,1,4,0.866666667
2020020178,28,65:00:00,0.0,37,33,3,2,4,0.891891892
2020020179,6,59:39:00,0.0,27,25,3,3,2,0.925925926
2020020179,7,58:05:00,0.0,36,33,7,0,3,0.916666667
2020020180,1,43:57:00,0.0,15,11,0,0,4,0.733333333
2020020180,1,15:56,0.0,4,2,0,0,2,0.5
2020020180,3,54:08:00,0.0,33,32,4,0,1,0.96969697
2020020180,3,5:52,0.0,3,3,0,0,0,1.0
2020020181,2,60:00:00,0.0,31,28,0,0,3,0.903225806
2020020181,5,58:33:00,0.0,26,22,2,0,4,0.846153846
2020020182,19,57:14:00,0.0,28,24,1,0,4,0.857142857
2020020182,21,59:30:00,0.0,34,31,6,0,3,0.911764706
2020020183,9,59:23:00,0.0,32,30,5,1,2,0.9375
2020020183,8,60:00:00,0.0,35,34,7,0,1,0.971428571
2020020184,10,59:58:00,0.0,28,27,5,1,1,0.964285714
2020020184,23,59:57:00,0.0,31,26,5,0,5,0.838709677
2020020185,20,60:00:00,0.0,32,28,6,0,4,0.875
2020020185,22,56:47:00,0.0,28,22,4,0,6,0.785714286
2020020186,30,60:00:00,0.0,31,31,5,2,0,1.0
2020020186,53,59:25:00,0.0,26,23,0,2,3,0.884615385
2020020187,24,64:23:00,0.0,27,26,0,0,1,0.962962963
2020020187,28,65:00:00,0.0,33,32,10,0,1,0.96969697
2020020188,15,22:45,0.0,8,6,1,0,2,0.75
2020020188,15,36:36:00,0.0,14,10,0,1,4,0.714285714
2020020188,4,60:00:00,0.0,37,33,0,3,4,0.891891892
2020020189,13,59:28:00,0.0,38,35,0,1,3,0.921052632
2020020189,17,60:00:00,0.0,37,36,0,0,1,0.972972973
2020020190,29,57:21:00,0.0,26,20,1,0,6,0.769230769
2020020190,12,59:45:00,0.0,22,17,2,1,5,0.772727273
2020020191,19,59:56:00,0.0,32,31,5,1,1,0.96875
2020020191,21,60:00:00,0.0,20,16,0,0,4,0.8
2020020192,30,60:00:00,0.0,30,28,6,1,2,0.933333333
2020020192,53,60:00:00,0.0,22,17,1,2,5,0.772727273
2020020193,25,62:54:00,0.0,35,33,6,2,2,0.942857143
2020020193,16,62:56:00,0.0,31,30,5,0,1,0.967741935
2020020194,54,60:00:00,0.0,32,29,11,0,3,0.90625
2020020194,26,58:28:00,0.0,33,29,4,1,4,0.878787879
2020020195,6,64:54:00,0.0,23,21,3,0,2,0.913043478
2020020195,7,60:06:00,0.0,31,29,0,3,2,0.935483871
2020020195,7,4:54,0.0,3,3,0,0,0,1.0
2020020196,3,58:50:00,0.0,30,28,2,0,2,0.933333333
2020020196,2,60:00:00,0.0,30,30,4,0,0,1.0
2020020197,29,60:00:00,0.0,24,22,0,0,2,0.916666667
2020020197,12,58:15:00,0.0,22,19,0,0,3,0.863636364
2020020198,18,57:54:00,0.0,33,31,4,1,2,0.939393939
2020020198,14,60:00:00,0.0,24,23,7,1,1,0.958333333
2020020199,9,58:11:00,0.0,34,32,5,0,2,0.941176471
2020020199,22,60:00:00,0.0,28,27,5,0,1,0.964285714
2020020200,10,59:29:00,0.0,32,31,4,0,1,0.96875
2020020200,23,56:51:00,0.0,19,16,1,1,3,0.842105263
2020020201,1,60:00:00,0.0,42,40,2,0,2,0.952380952
2020020201,5,57:49:00,0.0,35,32,0,0,3,0.914285714
2020020202,15,59:42:00,0.0,30,29,3,1,1,0.966666667
2020020202,4,60:00:00,0.0,32,26,4,1,6,0.8125
2020020203,13,60:00:00,0.0,32,31,4,0,1,0.96875
2020020203,17,58:11:00,0.0,22,20,0,1,2,0.909090909
2020020204,18,59:49:00,0.0,30,24,5,0,6,0.8
2020020204,14,60:00:00,0.0,33,32,5,1,1,0.96969697
2020020205,9,23:53,0.0,13,10,0,0,3,0.769230769
2020020205,9,34:54:00,0.0,9,9,2,0,0,1.0
2020020205,22,60:00:00,0.0,42,40,1,0,2,0.952380952
2020020206,20,60:00:00,0.0,27,25,2,1,2,0.925925926
2020020206,52,58:41:00,0.0,29,26,1,1,3,0.896551724
2020020207,30,60:55:00,0.0,31,28,3,0,3,0.903225806
2020020207,19,61:50:00,0.0,38,34,3,0,4,0.894736842
2020020208,25,62:15:00,0.0,29,27,3,0,2,0.931034483
2020020208,16,62:13:00,0.0,35,34,3,3,1,0.971428571
2020020209,21,59:45:00,0.0,31,28,6,0,3,0.903225806
2020020209,53,6:04,0.0,10,6,0,0,4,0.6
2020020209,53,53:38:00,0.0,28,23,1,3,5,0.821428571
2020020210,54,60:00:00,2.0,23,19,1,0,4,0.826086957
2020020210,24,57:59:00,0.0,31,26,5,1,5,0.838709677
2020020211,26,64:49:00,0.0,40,37,5,3,3,0.925
2020020211,28,63:27:00,0.0,27,24,5,0,3,0.888888889
2020020212,3,60:36:00,0.0,32,29,3,1,3,0.90625
2020020212,6,60:16:00,0.0,35,33,5,3,2,0.942857143
2020020213,8,58:53:00,0.0,23,20,4,0,3,0.869565217
2020020213,10,60:00:00,0.0,35,33,2,2,2,0.942857143
2020020214,7,60:00:00,0.0,30,24,4,0,6,0.8
2020020214,15,60:00:00,0.0,23,23,1,0,0,1.0
2020020215,2,65:00:00,0.0,35,32,1,1,3,0.914285714
2020020215,5,64:12:00,0.0,29,26,0,1,3,0.896551724
2020020216,4,63:30:00,0.0,32,29,3,1,3,0.90625
2020020216,1,64:39:00,0.0,36,33,0,4,3,0.916666667
2020020217,13,60:00:00,0.0,21,19,3,0,2,0.904761905
2020020217,14,57:38:00,0.0,28,24,1,0,4,0.857142857
2020020218,16,59:27:00,0.0,43,37,2,0,6,0.860465116
2020020218,29,60:00:00,0.0,26,21,2,3,5,0.807692308
2020020219,18,59:37:00,0.0,26,24,2,1,2,0.923076923
2020020219,17,59:09:00,0.0,23,20,2,2,3,0.869565217
2020020220,8,60:00:00,0.0,31,28,7,0,3,0.903225806
2020020220,22,60:00:00,0.0,38,38,2,1,0,1.0
2020020221,52,60:00:00,0.0,42,41,2,1,1,0.976190476
2020020221,9,20:00,0.0,11,9,0,0,2,0.818181818
2020020221,9,40:00:00,0.0,15,12,2,0,3,0.8
2020020222,23,57:16:00,0.0,26,23,5,0,3,0.884615385
2020020222,20,60:00:00,0.0,34,33,9,0,1,0.970588235
2020020223,30,60:00:00,0.0,37,37,5,0,0,1.0
2020020223,19,56:34:00,0.0,11,9,2,1,2,0.818181818
2020020224,25,58:42:00,0.0,31,27,5,2,4,0.870967742
2020020224,12,60:00:00,0.0,37,34,8,0,3,0.918918919
2020020225,21,60:00:00,0.0,37,35,3,1,2,0.945945946
2020020225,53,57:58:00,0.0,19,16,2,0,3,0.842105263
2020020226,54,58:43:00,0.0,28,27,2,1,1,0.964285714
2020020226,24,60:00:00,0.0,21,21,3,1,0,1.0
2020020227,26,60:00:00,0.0,31,29,3,1,2,0.935483871
2020020227,28,9:11,0.0,5,5,0,0,0,1.0
2020020227,28,50:49:00,0.0,26,20,4,0,6,0.769230769
2020020228,3,58:52:00,0.0,30,29,6,3,1,0.966666667
2020020228,6,60:00:00,0.0,21,21,5,1,0,1.0
2020020229,7,57:59:00,0.0,33,29,3,1,4,0.878787879
2020020229,15,60:00:00,0.0,33,30,2,0,3,0.909090909
2020020230,2,60:00:00,0.0,30,28,3,0,2,0.933333333
2020020230,6,57:11:00,0.0,42,38,3,3,4,0.904761905
2020020231,4,60:00:00,0.0,25,23,1,0,2,0.92
2020020231,1,58:16:00,0.0,31,27,4,3,4,0.870967742
2020020232,13,60:00:00,0.0,28,22,2,1,6,0.785714286
2020020232,14,60:00:00,0.0,34,33,9,2,1,0.970588235
2020020233,16,60:35:00,0.0,31,29,1,0,2,0.935483871
2020020233,29,60:35:00,0.0,31,28,3,0,3,0.903225806
2020020234,18,39:43:00,0.0,24,21,4,0,3,0.875
2020020234,18,19:32,0.0,6,5,1,0,1,0.833333333
2020020234,17,59:52:00,0.0,23,21,0,0,2,0.913043478
2020020235,10,58:28:00,0.0,25,23,0,0,2,0.92
2020020235,8,60:00:00,0.0,22,21,1,0,1,0.954545455
2020020236,52,59:49:00,0.0,29,27,1,0,2,0.931034483
2020020236,9,60:00:00,0.0,31,30,1,1,1,0.967741935
2020020237,23,60:00:00,0.0,19,18,1,0,1,0.947368421
2020020237,20,58:41:00,0.0,45,43,3,2,2,0.955555556
2020020238,25,63:29:00,0.0,21,18,2,2,3,0.857142857
2020020238,12,64:58:00,2.0,29,26,2,2,3,0.896551724
2020020239,53,61:49:00,0.0,35,30,4,0,5,0.857142857
2020020239,19,61:49:00,0.0,36,32,2,1,4,0.888888889
2020020240,26,57:53:00,0.0,23,20,2,0,3,0.869565217
2020020240,30,60:00:00,0.0,42,40,9,0,2,0.952380952
2020020241,28,59:15:00,0.0,33,29,0,0,4,0.878787879
2020020241,24,60:00:00,0.0,35,34,4,0,1,0.971428571
2020020242,5,60:00:00,0.0,31,28,6,0,3,0.903225806
2020020242,15,59:19:00,0.0,36,32,3,3,4,0.888888889
2020020243,54,59:58:00,0.0,30,30,0,0,0,1.0
2020020243,21,58:27:00,0.0,24,23,4,0,1,0.958333333
2020020244,6,58:15:00,0.0,25,24,3,0,1,0.96
2020020244,1,59:39:00,0.0,40,40,5,1,0,1.0
2020020245,7,58:02:00,0.0,29,26,3,0,3,0.896551724
2020020245,2,60:00:00,0.0,21,20,1,0,1,0.952380952
2020020246,17,64:43:00,0.0,24,21,4,1,3,0.875
2020020246,16,64:43:00,0.0,29,27,1,1,2,0.931034483
2020020247,10,61:46:00,0.0,31,25,1,1,6,0.806451613
2020020247,9,61:47:00,0.0,38,33,2,3,5,0.868421053
2020020248,22,35:40:00,0.0,13,11,0,0,2,0.846153846
2020020248,22,22:31,0.0,11,7,2,0,4,0.636363636
2020020248,52,60:00:00,0.0,45,40,2,3,5,0.888888889
2020020249,23,59:09:00,0.0,27,23,4,1,4,0.851851852
2020020249,20,60:23:00,0.0,33,30,4,3,3,0.909090909
2020020250,25,63:50:00,0.0,20,17,4,0,3,0.85
2020020250,18,65:00:00,0.0,38,35,4,3,3,0.921052632
2020020251,53,60:00:00,0.0,24,24,4,1,0,1.0
2020020251,19,58:55:00,0.0,19,18,3,1,1,0.947368421
2020020252,28,60:00:00,0.0,28,26,0,1,2,0.928571429
2020020252,24,58:22:00,0.0,29,26,3,1,3,0.896551724
2020020253,7,57:07:00,0.0,23,21,3,1,2,0.913043478
2020020253,2,60:00:00,0.0,20,20,1,1,0,1.0
2020020254,3,58:16:00,0.0,36,33,7,2,3,0.916666667
2020020254,4,59:58:00,0.0,35,33,5,1,2,0.942857143
2020020255,12,60:00:00,0.0,40,37,4,1,3,0.925
2020020255,29,40:00:00,0.0,25,20,0,0,5,0.8
2020020255,29,20:00,0.0,9,7,0,2,2,0.777777778
2020020256,14,57:48:00,0.0,21,15,5,0,6,0.714285714
2020020256,13,59:43:00,0.0,31,27,2,0,4,0.870967742
2020020257,5,57:52:00,0.0,42,39,13,4,3,0.928571429
2020020257,15,60:00:00,0.0,27,26,7,1,1,0.962962963
2020020258,25,65:00:00,0.0,22,19,1,1,3,0.863636364
2020020258,18,65:00:00,0.0,30,27,4,0,3,0.9
2020020259,54,59:35:00,0.0,25,22,0,1,3,0.88
2020020259,21,60:00:00,0.0,29,27,1,2,2,0.931034483
2020020260,26,60:00:00,0.0,28,28,3,0,0,1.0
2020020260,30,58:20:00,0.0,28,25,3,0,3,0.892857143
2020020261,17,58:45:00,0.0,25,24,1,1,1,0.96
2020020261,16,60:00:00,0.0,29,29,10,0,0,1.0
2020020262,10,60:00:00,0.0,28,27,1,1,1,0.964285714
2020020262,9,58:18:00,0.0,28,26,2,2,2,0.928571429
2020020263,20,47:47:00,0.0,29,24,2,1,5,0.827586207
2020020263,20,12:13,0.0,4,4,0,0,0,1.0
2020020263,23,60:00:00,0.0,36,35,4,0,1,0.972222222
2020020264,22,60:00:00,0.0,35,33,9,1,2,0.942857143
2020020264,52,58:57:00,0.0,30,27,12,3,3,0.9
2020020265,6,57:55:00,0.0,26,23,2,0,3,0.884615385
2020020265,1,60:00:00,0.0,27,25,1,3,2,0.925925926
2020020266,4,63:57:00,0.0,33,31,8,1,2,0.939393939
2020020266,3,64:59:00,0.0,22,20,4,0,2,0.909090909
2020020267,5,60:00:00,0.0,32,31,6,0,1,0.96875
2020020267,2,59:51:00,0.0,36,33,11,0,3,0.916666667
2020020268,29,60:00:00,0.0,32,32,0,0,0,1.0
2020020268,18,59:39:00,0.0,21,19,0,0,2,0.904761905
2020020269,19,62:34:00,0.0,32,30,1,0,2,0.9375
2020020269,28,64:00:00,0.0,45,42,6,0,3,0.933333333
2020020270,10,60:00:00,0.0,37,34,4,2,3,0.918918919
2020020270,9,12:00,0.0,5,4,2,0,1,0.8
2020020270,9,48:00:00,0.0,26,20,3,1,6,0.769230769
2020020271,25,58:37:00,0.0,18,17,5,1,1,0.944444444
2020020271,14,59:48:00,0.0,28,28,3,1,0,1.0
2020020272,53,65:00:00,0.0,29,27,5,0,2,0.931034483
2020020272,26,64:55:00,0.0,22,20,2,1,2,0.909090909
2020020273,24,59:03:00,0.0,27,24,6,0,3,0.888888889
2020020273,30,58:55:00,0.0,17,16,1,2,1,0.941176471
2020020274,12,60:00:00,0.0,29,26,3,0,3,0.896551724
2020020274,16,58:23:00,0.0,37,33,9,2,4,0.891891892
2020020275,17,20:00,0.0,13,9,0,0,4,0.692307692
2020020275,17,39:50:00,0.0,26,23,1,2,3,0.884615385
2020020275,13,60:00:00,0.0,32,30,5,1,2,0.9375
2020020276,20,58:19:00,0.0,25,23,1,1,2,0.92
2020020276,22,59:41:00,0.0,21,20,3,0,1,0.952380952
2020020277,23,57:56:00,0.0,30,29,5,2,1,0.966666667
2020020277,52,59:58:00,0.0,29,29,5,0,0,1.0
2020020278,1,58:46:00,0.0,29,26,0,1,3,0.896551724
2020020278,7,60:00:00,0.0,27,25,3,0,2,0.925925926
2020020279,15,58:36:00,0.0,23,20,3,0,3,0.869565217
2020020279,3,60:00:00,0.0,27,26,3,2,1,0.962962963
2020020280,12,62:02:00,0.0,27,25,1,0,2,0.925925926
2020020280,16,62:02:00,0.0,37,36,1,1,1,0.972972973
2020020281,5,60:00:00,0.0,35,33,2,0,2,0.942857143
2020020281,2,58:24:00,0.0,18,15,1,0,3,0.833333333
2020020282,29,17:13,0.0,6,6,1,0,0,1.0
2020020282,29,42:40:00,0.0,39,35,5,1,4,0.897435897
2020020282,18,59:56:00,0.0,23,21,0,2,2,0.913043478
2020020283,19,58:09:00,0.0,27,22,0,0,5,0.814814815
2020020283,28,60:00:00,0.0,32,28,1,0,4,0.875
2020020284,8,59:03:00,0.0,27,22,1,0,5,0.814814815
2020020284,10,59:42:00,0.0,33,30,3,0,3,0.909090909
2020020285,22,60:00:00,0.0,44,43,10,2,1,0.977272727
2020020285,20,28:17:00,0.0,15,10,2,1,5,0.666666667
2020020285,20,31:43:00,0.0,9,7,2,1,2,0.777777778
2020020286,25,64:04:00,0.0,36,33,4,0,3,0.916666667
2020020286,14,65:00:00,0.0,27,24,5,1,3,0.888888889
2020020287,21,60:00:00,0.0,29,27,4,0,2,0.931034483
2020020287,54,58:29:00,0.0,39,36,10,0,3,0.923076923
2020020288,53,58:04:00,0.0,22,19,1,0,3,0.863636364
2020020288,26,60:00:00,0.0,24,22,6,0,2,0.916666667
2020020289,24,59:44:00,0.0,29,24,2,1,5,0.827586207
2020020289,30,59:50:00,0.0,27,26,3,0,1,0.962962963
2020020290,6,60:00:00,0.0,19,16,2,0,3,0.842105263
2020020290,4,20:00,0.0,12,11,0,2,1,0.916666667
2020020290,4,40:00:00,0.0,23,17,2,0,6,0.739130435
2020020291,15,58:24:00,0.0,24,22,4,0,2,0.916666667
2020020291,3,60:00:00,0.0,29,28,4,1,1,0.965517241
2020020292,17,60:00:00,0.0,39,38,8,0,1,0.974358974
2020020292,13,58:00:00,0.0,27,25,0,0,2,0.925925926
2020020293,9,63:30:00,0.0,32,30,3,0,2,0.9375
2020020293,8,63:30:00,0.0,39,36,9,2,3,0.923076923
2020020294,23,58:30:00,0.0,31,27,4,0,4,0.870967742
2020020294,52,60:27:00,0.0,34,31,6,0,3,0.911764706
2020020295,1,57:33:00,0.0,36,33,3,0,3,0.916666667
2020020295,7,60:00:00,0.0,42,41,4,0,1,0.976190476
2020020296,14,60:00:00,0.0,25,25,2,0,0,1.0
2020020296,12,57:14:00,0.0,27,25,1,1,2,0.925925926
2020020297,19,58:14:00,0.0,30,28,6,1,2,0.933333333
2020020297,26,60:00:00,0.0,31,31,1,1,0,1.0
2020020298,10,57:52:00,0.0,33,30,10,1,3,0.909090909
2020020298,20,59:39:00,0.0,34,34,7,4,0,1.0
2020020299,21,60:00:00,0.0,28,25,4,0,3,0.892857143
2020020299,54,60:00:00,0.0,34,34,2,3,0,1.0
2020020300,53,60:00:00,4.0,28,25,7,2,3,0.892857143
2020020300,24,58:35:00,0.0,25,21,3,0,4,0.84
2020020301,1,55:59:00,0.0,20,18,1,1,2,0.9
2020020301,2,60:00:00,2.0,29,28,7,0,1,0.965517241
2020020302,15,61:43:00,0.0,37,34,4,0,3,0.918918919
2020020302,5,61:43:00,0.0,22,20,0,0,2,0.909090909
2020020303,13,59:20:00,0.0,25,23,4,0,2,0.92
2020020303,25,59:58:00,0.0,43,43,8,1,0,1.0
2020020304,29,65:00:00,0.0,34,29,4,1,5,0.852941176
2020020304,16,64:56:00,0.0,30,25,3,0,5,0.833333333
2020020305,17,57:26:00,0.0,33,31,5,0,2,0.939393939
2020020305,18,60:00:00,0.0,24,24,0,0,0,1.0
2020020306,9,65:00:00,0.0,36,32,2,0,4,0.888888889
2020020306,8,65:00:00,0.0,39,35,10,2,4,0.897435897
2020020307,23,58:28:00,0.0,29,25,2,0,4,0.862068966
2020020307,22,59:29:00,0.0,33,30,3,3,3,0.909090909
2020020308,4,59:45:00,0.0,27,24,6,2,3,0.888888889
2020020308,3,58:08:00,0.0,39,35,11,4,4,0.897435897
2020020309,19,53:12:00,0.0,20,18,0,0,2,0.9
2020020309,26,60:00:00,0.0,36,35,7,0,1,0.972222222
2020020310,10,60:15:00,0.0,22,21,2,1,1,0.954545455
2020020310,20,61:06:00,0.0,39,37,3,1,2,0.948717949
2020020311,53,21:29,0.0,14,14,0,0,0,1.0
2020020311,53,43:14:00,0.0,21,18,4,2,3,0.857142857
2020020311,24,65:00:00,0.0,28,25,3,0,3,0.892857143
2020020312,2,60:00:00,0.0,36,34,0,1,2,0.944444444
2020020312,6,59:48:00,0.0,37,30,3,2,7,0.810810811
2020020313,15,59:55:00,0.0,28,26,4,2,2,0.928571429
2020020313,5,59:04:00,0.0,33,30,2,2,3,0.909090909
2020020314,14,59:57:00,0.0,32,31,5,3,1,0.96875
2020020314,12,58:34:00,0.0,21,19,2,0,2,0.904761905
2020020315,13,60:00:00,0.0,39,37,3,2,2,0.948717949
2020020315,25,59:00:00,0.0,35,32,0,0,3,0.914285714
2020020316,29,59:52:00,0.0,26,25,2,1,1,0.961538462
2020020316,16,59:58:00,0.0,26,26,1,0,0,1.0
2020020317,17,60:00:00,0.0,39,37,3,1,2,0.948717949
2020020317,18,59:45:00,0.0,31,27,2,0,4,0.870967742
2020020318,9,60:00:00,0.0,30,29,0,0,1,0.966666667
2020020318,20,31:47:00,0.0,20,16,0,0,4,0.8
2020020318,20,28:13:00,0.0,11,9,0,0,2,0.818181818
2020020319,52,60:00:00,0.0,21,18,0,0,3,0.857142857
2020020319,8,59:06:00,0.0,29,24,7,0,5,0.827586207
2020020320,23,58:45:00,0.0,33,31,11,1,2,0.939393939
2020020320,22,59:39:00,0.0,32,32,5,2,0,1.0
2020020321,53,58:54:00,0.0,29,26,6,0,3,0.896551724
2020020321,21,59:53:00,0.0,18,16,0,1,2,0.888888889
2020020322,7,60:00:00,0.0,39,36,7,1,3,0.923076923
2020020322,4,59:57:00,0.0,23,23,2,0,0,1.0
2020020323,3,60:00:00,0.0,33,31,5,1,2,0.939393939
2020020323,6,60:00:00,0.0,34,28,3,2,6,0.823529412
2020020324,30,59:48:00,0.0,28,27,3,1,1,0.964285714
2020020324,26,57:30:00,0.0,30,27,4,2,3,0.9
2020020325,24,60:00:00,0.0,31,26,6,0,5,0.838709677
2020020325,54,60:00:00,0.0,24,23,4,3,1,0.958333333
2020020326,28,60:41:00,0.0,26,24,3,0,2,0.923076923
2020020326,19,60:17:00,0.0,20,17,3,0,3,0.85
2020020327,1,59:11:00,0.0,23,19,0,0,4,0.826086957
2020020327,15,60:00:00,0.0,24,22,0,1,2,0.916666667
2020020328,2,64:34:00,0.0,31,27,6,0,4,0.870967742
2020020328,5,64:34:00,0.0,27,24,0,2,3,0.888888889
2020020329,14,59:53:00,0.0,20,20,6,0,0,1.0
2020020329,25,18:53,0.0,5,5,0,1,0,1.0
2020020329,25,41:07:00,0.0,16,11,1,2,5,0.6875
2020020330,13,64:46:00,0.0,33,30,5,5,3,0.909090909
2020020330,12,65:00:00,0.0,31,28,8,0,3,0.903225806
2020020331,16,60:00:00,0.0,32,27,2,0,5,0.84375
2020020331,17,59:17:00,0.0,36,33,0,0,3,0.916666667
2020020332,18,60:00:00,0.0,30,29,6,0,1,0.966666667
2020020332,29,58:28:00,0.0,33,31,2,2,2,0.939393939
2020020333,9,40:00:00,0.0,33,27,3,2,6,0.818181818
2020020333,9,20:00,0.0,5,5,0,0,0,1.0
2020020333,20,59:45:00,0.0,34,31,5,1,3,0.911764706
2020020334,52,60:36:00,0.0,41,40,3,0,1,0.975609756
2020020334,8,60:36:00,0.0,21,19,5,0,2,0.904761905
2020020335,22,60:00:00,0.0,29,25,0,0,4,0.862068966
2020020335,10,60:00:00,0.0,30,30,0,0,0,1.0
2020020336,30,64:33:00,0.0,28,25,2,0,3,0.892857143
2020020336,26,64:23:00,0.0,42,38,12,1,4,0.904761905
2020020337,53,58:45:00,0.0,40,35,4,0,5,0.875
2020020337,21,59:44:00,0.0,25,23,1,0,2,0.92
2020020338,24,63:23:00,0.0,27,24,2,1,3,0.888888889
2020020338,54,63:10:00,0.0,30,28,0,0,2,0.933333333
2020020339,28,59:11:00,0.0,31,24,2,1,7,0.774193548
2020020339,19,29:26:00,0.0,21,19,4,0,2,0.904761905
2020020339,19,30:34:00,2.0,19,15,3,0,4,0.789473684
2020020340,7,60:00:00,0.0,38,35,6,1,3,0.921052632
2020020340,4,60:00:00,0.0,28,28,7,1,0,1.0
2020020341,2,60:00:00,0.0,20,20,6,1,0,1.0
2020020341,5,58:24:00,0.0,30,28,5,1,2,0.933333333
2020020342,3,13:19,0.0,2,1,0,0,1,0.5
2020020342,3,45:25:00,0.0,33,31,0,0,2,0.939393939
2020020342,6,60:00:00,0.0,21,20,3,0,1,0.952380952
2020020343,16,60:00:00,0.0,46,44,1,0,2,0.956521739
2020020343,17,60:00:00,0.0,32,25,1,2,7,0.78125
2020020344,18,60:00:00,0.0,29,28,2,0,1,0.965517241
2020020344,29,58:48:00,0.0,29,26,2,0,3,0.896551724
2020020345,52,58:12:00,0.0,18,15,0,1,3,0.833333333
2020020345,23,59:59:00,0.0,27,27,1,0,0,1.0
2020020346,1,58:13:00,0.0,23,20,2,0,3,0.869565217
2020020346,15,60:00:00,0.0,21,19,3,0,2,0.904761905
2020020347,14,59:43:00,0.0,20,20,0,0,0,1.0
2020020347,25,58:06:00,0.0,27,25,3,1,2,0.925925926
2020020348,13,61:59:00,0.0,31,28,7,3,3,0.903225806
2020020348,12,61:34:00,0.0,46,44,5,2,2,0.956521739
2020020349,9,60:00:00,0.0,28,27,1,0,1,0.964285714
2020020349,20,59:54:00,0.0,35,31,1,4,4,0.885714286
2020020350,22,20:00,0.0,10,7,1,0,3,0.7
2020020350,22,40:00:00,0.0,13,13,1,4,0,1.0
2020020350,10,59:46:00,0.0,31,31,3,0,0,1.0
2020020351,54,60:58:00,0.0,30,26,0,1,4,0.866666667
2020020351,30,62:00:00,0.0,39,34,7,0,5,0.871794872
2020020352,24,57:40:00,0.0,34,30,6,1,4,0.882352941
2020020352,19,59:24:00,0.0,33,29,8,3,4,0.878787879
2020020353,28,60:00:00,0.0,35,33,9,3,2,0.942857143
2020020353,21,59:01:00,0.0,26,21,2,2,5,0.807692308
2020020354,3,59:54:00,0.0,24,22,2,1,2,0.916666667
2020020354,7,58:45:00,0.0,19,16,1,1,3,0.842105263
2020020355,5,60:00:00,0.0,42,40,11,3,2,0.952380952
2020020355,4,59:57:00,0.0,27,22,5,1,5,0.814814815
2020020356,29,60:00:00,0.0,20,19,6,1,1,0.95
2020020356,17,20:00,0.0,9,9,1,0,0,1.0
2020020356,17,40:00:00,0.0,27,23,6,1,4,0.851851852
2020020357,8,59:54:00,0.0,27,26,6,0,1,0.962962963
2020020357,9,59:18:00,0.0,32,30,5,4,2,0.9375
2020020358,52,60:00:00,0.0,33,31,3,3,2,0.939393939
2020020358,23,59:03:00,0.0,38,34,1,1,4,0.894736842
2020020359,6,65:00:00,0.0,28,27,3,0,1,0.964285714
2020020359,15,64:39:00,0.0,19,18,0,0,1,0.947368421
2020020360,22,60:00:00,2.0,32,26,10,0,6,0.8125
2020020360,10,59:51:00,0.0,27,26,0,3,1,0.962962963
2020020361,54,60:00:00,0.0,37,36,7,1,1,0.972972973
2020020361,30,59:12:00,0.0,27,23,3,1,4,0.851851852
2020020362,24,56:58:00,0.0,21,18,0,0,3,0.857142857
2020020362,19,59:39:00,0.0,29,27,4,0,2,0.931034483
2020020363,28,60:00:00,0.0,38,34,9,2,4,0.894736842
2020020363,21,60:00:00,0.0,26,26,4,0,0,1.0
2020020364,3,57:22:00,0.0,36,32,0,0,4,0.888888889
2020020364,1,60:00:00,0.0,39,37,0,2,2,0.948717949
2020020365,12,59:35:00,0.0,35,33,10,0,2,0.942857143
2020020365,17,59:41:00,0.0,31,27,4,2,4,0.870967742
2020020366,5,58:42:00,0.0,35,31,5,2,4,0.885714286
2020020366,4,60:00:00,0.0,29,26,1,0,3,0.896551724
2020020367,16,64:59:00,0.0,34,31,1,0,3,0.911764706
2020020367,14,64:59:00,0.0,37,35,2,1,2,0.945945946
2020020368,18,57:31:00,0.0,38,33,5,0,5,0.868421053
2020020368,13,60:00:00,0.0,35,31,4,0,4,0.885714286
2020020369,8,64:02:00,0.0,27,23,2,0,4,0.851851852
2020020369,52,64:29:00,0.0,36,33,1,2,3,0.916666667
2020020370,20,60:00:00,0.0,32,29,4,2,3,0.90625
2020020370,9,20:00,0.0,11,7,0,0,4,0.636363636
2020020370,9,40:00:00,0.0,18,15,0,2,3,0.833333333
2020020371,23,59:48:00,0.0,32,31,5,1,1,0.96875
2020020371,10,57:30:00,0.0,28,25,0,0,3,0.892857143
2020020372,25,59:38:00,0.0,22,19,2,1,3,0.863636364
2020020372,29,60:00:00,0.0,24,22,3,1,2,0.916666667
2020020373,6,60:00:00,0.0,32,31,8,1,1,0.96875
2020020373,15,24:15:00,0.0,7,6,1,1,1,0.857142857
2020020373,15,35:43:00,0.0,18,14,1,1,4,0.777777778
2020020374,1,59:11:00,0.0,27,22,5,0,5,0.814814815
2020020374,3,59:58:00,0.0,27,24,1,1,3,0.888888889
2020020375,2,60:00:00,0.0,22,20,1,0,2,0.909090909
2020020375,7,60:00:00,0.0,29,24,0,0,5,0.827586207
2020020376,16,64:41:00,0.0,42,39,9,2,3,0.928571429
2020020376,14,65:00:00,0.0,27,24,4,2,3,0.888888889
2020020377,21,62:45:00,0.0,28,26,1,2,2,0.928571429
2020020377,24,62:45:00,0.0,34,31,1,0,3,0.911764706
2020020378,53,60:00:00,0.0,27,22,8,1,5,0.814814815
2020020378,30,59:31:00,0.0,25,24,3,1,1,0.96
2020020379,26,61:04:00,0.0,22,19,2,2,3,0.863636364
2020020379,19,59:29:00,0.0,30,28,7,0,2,0.933333333
2020020380,28,22:16,0.0,8,5,2,1,3,0.625
2020020380,28,38:21:00,0.0,19,17,4,1,2,0.894736842
2020020380,54,61:25:00,0.0,29,25,3,2,4,0.862068966
2020020381,18,59:44:00,0.0,32,26,13,0,6,0.8125
2020020381,13,59:56:00,0.0,30,28,0,2,2,0.933333333
2020020382,8,60:00:00,0.0,29,28,3,0,1,0.965517241
2020020382,52,25:13:00,0.0,9,6,0,0,3,0.666666667
2020020382,52,34:25:00,0.0,19,15,1,0,4,0.789473684
2020020383,22,60:00:00,0.0,36,34,6,0,2,0.944444444
2020020383,20,58:30:00,0.0,33,30,5,0,3,0.909090909
2020020384,23,60:00:00,0.0,39,37,1,0,2,0.948717949
2020020384,10,58:20:00,0.0,31,27,2,2,4,0.870967742
2020020385,25,59:58:00,0.0,21,21,0,1,0,1.0
2020020385,29,10:40,0.0,4,3,1,1,1,0.75
2020020385,29,49:17:00,0.0,22,18,4,0,4,0.818181818
2020020386,21,61:44:00,0.0,27,22,2,0,5,0.814814815
2020020386,24,61:59:00,0.0,33,29,5,1,4,0.878787879
2020020387,53,59:58:00,0.0,34,32,1,1,2,0.941176471
2020020387,30,57:42:00,0.0,30,26,4,2,4,0.866666667
2020020388,26,61:17:00,0.0,25,22,1,0,3,0.88
2020020388,19,61:45:00,0.0,34,30,5,0,4,0.882352941
2020020389,28,60:00:00,0.0,32,28,2,0,4,0.875
2020020389,54,59:51:00,0.0,24,24,1,1,0,1.0
2020020390,6,62:55:00,0.0,32,29,3,0,3,0.90625
2020020390,4,63:08:00,0.0,29,27,3,1,2,0.931034483
2020020391,2,60:00:00,0.0,26,24,1,0,2,0.923076923
2020020391,7,59:45:00,0.0,29,25,0,0,4,0.862068966
2020020392,15,60:00:00,0.0,26,23,3,1,3,0.884615385
2020020392,1,57:15:00,0.0,41,37,3,0,4,0.902439024
2020020393,5,60:00:00,0.0,24,23,1,0,1,0.958333333
2020020393,3,17:14,0.0,6,3,1,0,3,0.5
2020020393,3,42:46:00,0.0,18,16,5,0,2,0.888888889
2020020394,16,60:00:00,0.0,39,33,4,2,6,0.846153846
2020020394,14,60:00:00,0.0,25,22,2,3,3,0.88
2020020395,20,65:00:00,0.0,22,19,3,3,3,0.863636364
2020020395,9,65:00:00,0.0,34,31,10,1,3,0.911764706
2020020396,22,60:00:00,0.0,28,26,1,0,2,0.928571429
2020020396,9,57:34:00,0.0,37,34,4,0,3,0.918918919
2020020397,23,64:20:00,0.0,30,29,2,1,1,0.966666667
2020020397,8,64:52:00,0.0,29,28,4,0,1,0.965517241
2020020398,30,59:48:00,0.0,26,26,4,0,0,1.0
2020020398,54,58:19:00,0.0,21,20,0,1,1,0.952380952
2020020399,21,58:40:00,0.0,14,11,0,1,3,0.785714286
2020020399,53,17:40,0.0,16,16,3,0,0,1.0
2020020399,53,42:20:00,0.0,19,17,1,0,2,0.894736842
2020020400,24,63:00:00,0.0,26,21,0,0,5,0.807692308
2020020400,26,63:00:00,0.0,25,19,2,2,6,0.76
2020020401,2,65:00:00,0.0,33,32,3,1,1,0.96969697
2020020401,6,65:00:00,0.0,27,26,3,0,1,0.962962963
2020020402,4,44:47:00,0.0,12,11,1,0,1,0.916666667
2020020402,4,20:00,0.0,8,5,0,0,3,0.625
2020020402,7,65:00:00,0.0,33,29,2,1,4,0.878787879
2020020403,15,61:04:00,0.0,31,27,3,1,4,0.870967742
2020020403,1,60:46:00,0.0,30,25,2,0,5,0.833333333
2020020404,12,64:15:00,0.0,23,21,5,1,2,0.913043478
2020020404,18,64:25:00,0.0,35,32,6,1,3,0.914285714
2020020405,5,60:00:00,0.0,35,33,2,2,2,0.942857143
2020020405,3,58:25:00,0.0,26,23,4,1,3,0.884615385
2020020406,29,57:59:00,0.0,32,29,2,1,3,0.90625
2020020406,13,59:54:00,0.0,40,38,6,6,2,0.95
2020020407,17,62:17:00,0.0,29,25,4,3,4,0.862068966
2020020407,14,62:17:00,0.0,23,20,2,0,3,0.869565217
2020020408,10,56:33:00,0.0,23,19,1,0,4,0.826086957
2020020408,52,59:58:00,0.0,39,36,1,0,3,0.923076923
2020020409,25,60:00:00,0.0,22,21,1,2,1,0.954545455
2020020409,16,60:00:00,0.0,37,31,5,1,6,0.837837838
2020020410,22,60:00:00,0.0,22,21,1,0,1,0.954545455
2020020410,9,60:00:00,0.0,36,29,5,0,7,0.805555556
2020020411,23,60:00:00,0.0,45,40,6,1,5,0.888888889
2020020411,8,59:15:00,0.0,24,23,2,2,1,0.958333333
2020020412,30,59:26:00,0.0,27,24,2,0,3,0.888888889
2020020412,54,48:21:00,0.0,29,25,6,0,4,0.862068966
2020020412,54,8:15,0.0,2,2,0,0,0,1.0
2020020413,21,64:09:00,0.0,14,13,3,2,1,0.928571429
2020020413,53,64:22:00,0.0,46,44,5,0,2,0.956521739
2020020414,24,59:39:00,0.0,37,32,5,1,5,0.864864865
2020020414,26,60:00:00,0.0,34,33,7,1,1,0.970588235
2020020415,6,60:00:00,0.0,27,27,6,0,0,1.0
2020020415,3,24:52:00,0.0,14,10,0,0,4,0.714285714
2020020415,3,34:44:00,0.0,13,13,0,2,0,1.0
2020020416,7,58:32:00,0.0,26,22,1,0,4,0.846153846
2020020416,5,60:00:00,0.0,23,21,1,0,2,0.913043478
2020020417,2,59:48:00,0.0,22,19,0,1,3,0.863636364
2020020417,1,59:41:00,0.0,33,28,6,1,5,0.848484848
2020020418,4,58:43:00,0.0,21,17,4,0,4,0.80952381
2020020418,15,59:59:00,0.0,33,30,2,1,3,0.909090909
2020020419,12,59:49:00,0.0,33,32,2,0,1,0.96969697
2020020419,18,44:38:00,0.0,23,18,4,0,5,0.782608696
2020020419,18,15:22,0.0,3,3,0,0,0,1.0
2020020420,29,62:48:00,0.0,32,27,4,0,5,0.84375
2020020420,13,61:53:00,0.0,32,28,6,3,4,0.875
2020020421,17,60:00:00,0.0,44,40,7,3,4,0.909090909
2020020421,14,57:42:00,0.0,22,17,5,1,5,0.772727273
2020020422,10,60:59:00,0.0,27,24,1,0,3,0.888888889
2020020422,52,60:53:00,0.0,38,34,1,3,4,0.894736842
2020020423,20,60:00:00,0.0,18,17,3,0,1,0.944444444
2020020423,8,59:23:00,0.0,29,27,6,0,2,0.931034483
2020020424,25,16:56,0.0,8,8,0,1,0,1.0
2020020424,25,40:00:00,0.0,8,4,3,1,4,0.5
2020020424,16,60:00:00,0.0,30,28,5,0,2,0.933333333
2020020425,19,62:20:00,0.0,40,35,5,0,5,0.875
2020020425,54,61:52:00,0.0,23,19,2,1,4,0.826086957
2020020426,22,60:00:00,0.0,25,23,0,0,2,0.92
2020020426,9,60:00:00,0.0,37,31,5,0,6,0.837837838
2020020427,30,59:58:00,0.0,25,25,5,0,0,1.0
2020020427,53,58:00:00,0.0,31,28,9,1,3,0.903225806
2020020428,21,60:00:00,0.0,18,18,5,0,0,1.0
2020020428,26,59:48:00,0.0,45,44,5,4,1,0.977777778
2020020429,24,10:44,0.0,3,2,0,0,1,0.666666667
2020020429,24,49:16:00,0.0,24,19,0,0,5,0.791666667
2020020429,28,60:00:00,0.0,34,34,1,0,0,1.0
2020020430,6,60:00:00,0.0,33,29,8,4,4,0.878787879
2020020430,3,60:00:00,0.0,18,18,5,1,0,1.0
2020020431,7,58:09:00,0.0,32,31,2,2,1,0.96875
2020020431,5,60:00:00,0.0,24,24,1,0,0,1.0
2020020432,1,58:13:00,0.0,29,26,9,0,3,0.896551724
2020020432,2,60:00:00,0.0,28,26,6,2,2,0.928571429
2020020433,4,23:05,0.0,10,7,0,0,3,0.7
2020020433,4,33:40:00,0.0,13,11,3,0,2,0.846153846
2020020433,15,60:00:00,0.0,32,28,3,0,4,0.875
2020020434,14,60:00:00,0.0,31,28,1,0,3,0.903225806
2020020434,18,58:26:00,0.0,27,22,3,0,5,0.814814815
2020020435,13,60:00:00,0.0,32,30,8,0,2,0.9375
2020020435,16,58:50:00,0.0,35,31,3,2,4,0.885714286
2020020436,29,64:55:00,0.0,30,27,0,0,3,0.9
2020020436,25,64:55:00,0.0,26,22,0,0,4,0.846153846
2020020437,19,55:57:00,2.0,25,21,1,0,4,0.84
2020020437,54,59:52:00,0.0,35,34,8,1,1,0.971428571
2020020438,10,59:51:00,0.0,32,27,5,1,5,0.84375
2020020438,52,60:00:00,0.0,22,20,5,0,2,0.909090909
2020020439,20,59:36:00,0.0,25,24,4,0,1,0.96
2020020439,8,57:01:00,0.0,36,33,4,0,3,0.916666667
2020020440,23,59:51:00,0.0,35,34,9,0,1,0.971428571
2020020440,22,58:13:00,0.0,28,26,6,0,2,0.928571429
2020020441,24,57:13:00,0.0,33,30,4,4,3,0.909090909
2020020441,28,59:52:00,0.0,27,26,2,4,1,0.962962963
2020020442,17,56:04:00,0.0,32,30,1,2,2,0.9375
2020020442,12,59:45:00,0.0,26,25,4,2,1,0.961538462
2020020443,9,60:00:00,0.0,36,33,2,0,3,0.916666667
2020020443,10,6:13,0.0,3,1,0,0,2,0.333333333
2020020443,10,49:35:00,0.0,28,26,6,1,2,0.928571429
2020020444,30,60:00:00,0.0,22,21,1,1,1,0.954545455
2020020444,53,57:34:00,0.0,34,31,3,1,3,0.911764706
2020020445,21,60:00:00,0.0,28,27,6,0,1,0.964285714
2020020445,26,59:21:00,0.0,40,37,4,5,3,0.925
2020020446,3,63:12:00,0.0,30,25,5,1,5,0.833333333
2020020446,4,63:47:00,0.0,24,20,4,0,4,0.833333333
2020020447,15,59:47:00,0.0,18,18,3,0,0,1.0
2020020447,2,58:11:00,0.0,33,32,1,0,1,0.96969697
2020020448,14,56:45:00,0.0,25,22,1,1,3,0.88
2020020448,18,60:00:00,0.0,39,38,2,1,1,0.974358974
2020020449,13,59:54:00,0.0,29,26,4,1,3,0.896551724
2020020449,16,58:34:00,0.0,34,30,5,2,4,0.882352941
2020020450,5,59:44:00,0.0,43,42,5,3,1,0.976744186
2020020450,6,59:19:00,0.0,25,22,4,1,3,0.88
2020020451,29,64:24:00,0.0,35,34,3,0,1,0.971428571
2020020451,25,65:00:00,0.0,30,29,1,0,1,0.966666667
2020020452,9,61:23:00,0.0,28,25,0,1,3,0.892857143
2020020452,23,61:40:00,0.0,46,44,3,0,2,0.956521739
2020020453,52,59:06:00,0.0,30,27,4,1,3,0.9
2020020453,8,60:00:00,0.0,36,34,4,0,2,0.944444444
2020020454,20,59:59:00,0.0,31,28,3,2,3,0.903225806
2020020454,22,58:10:00,0.0,27,23,2,0,4,0.851851852
2020020455,54,59:50:00,0.0,24,23,0,1,1,0.958333333
2020020455,28,58:10:00,0.0,36,34,4,0,2,0.944444444
2020020456,26,60:46:00,0.0,19,17,1,0,2,0.894736842
2020020456,19,60:46:00,0.0,27,26,3,0,1,0.962962963
2020020457,1,60:00:00,0.0,35,33,0,3,2,0.942857143
2020020457,7,58:01:00,0.0,27,24,2,0,3,0.888888889
2020020458,15,59:54:00,0.0,22,21,1,0,1,0.954545455
2020020458,2,58:38:00,0.0,22,19,1,0,3,0.863636364
2020020459,5,58:11:00,0.0,33,31,6,0,2,0.939393939
2020020459,6,60:00:00,0.0,35,34,5,2,1,0.971428571
2020020460,17,59:57:00,0.0,37,35,6,2,2,0.945945946
2020020460,12,58:25:00,0.0,27,24,8,1,3,0.888888889
2020020461,24,20:00,0.0,14,11,0,0,3,0.785714286
2020020461,24,40:00:00,0.0,14,12,0,0,2,0.857142857
2020020461,53,60:00:00,0.0,28,27,4,1,1,0.964285714
2020020462,3,59:38:00,0.0,26,26,4,0,0,1.0
2020020462,4,27:30:00,0.0,13,8,3,0,5,0.615384615
2020020462,4,32:30:00,0.0,16,12,1,0,4,0.75
2020020463,9,19:53,0.0,8,8,0,0,0,1.0
2020020463,9,45:07:00,0.0,21,19,2,0,2,0.904761905
2020020463,23,65:00:00,0.0,32,30,3,0,2,0.9375
2020020464,52,60:40:00,0.0,36,33,4,0,3,0.916666667
2020020464,8,60:03:00,0.0,30,26,3,1,4,0.866666667
2020020465,20,59:36:00,0.0,30,23,5,0,7,0.766666667
2020020465,22,59:40:00,0.0,33,30,6,0,3,0.909090909
2020020466,54,60:00:00,0.0,33,29,4,0,4,0.878787879
2020020466,28,58:27:00,0.0,37,32,11,1,5,0.864864865
2020020467,26,59:46:00,0.0,20,19,0,0,1,0.95
2020020467,19,57:58:00,0.0,23,20,3,0,3,0.869565217
2020020468,7,60:00:00,0.0,37,33,7,0,4,0.891891892
2020020468,6,59:48:00,0.0,24,23,2,1,1,0.958333333
2020020469,2,57:53:00,0.0,31,27,5,1,4,0.870967742
2020020469,4,60:00:00,0.0,25,22,5,3,3,0.88
2020020470,12,64:06:00,0.0,28,25,2,2,3,0.892857143
2020020470,29,64:09:00,0.0,27,25,2,0,2,0.925925926
2020020471,14,60:00:00,0.0,21,19,3,0,2,0.904761905
2020020471,16,58:25:00,0.0,22,19,0,1,3,0.863636364
2020020472,13,58:23:00,0.0,27,25,2,1,2,0.925925926
2020020472,18,60:00:00,0.0,41,40,5,0,1,0.975609756
2020020473,17,21:28,0.0,18,16,2,0,2,0.888888889
2020020473,17,38:32:00,0.0,22,22,5,0,0,1.0
2020020473,25,57:32:00,0.0,21,18,3,2,3,0.857142857
2020020474,22,60:00:00,0.0,25,24,1,0,1,0.96
2020020474,52,58:21:00,0.0,21,19,1,0,2,0.904761905
2020020475,21,59:58:00,0.0,20,19,3,0,1,0.95
2020020475,30,60:00:00,0.0,55,50,13,1,5,0.909090909
2020020476,24,60:46:00,0.0,25,23,3,0,2,0.92
2020020476,53,60:47:00,0.0,31,28,3,0,3,0.903225806
2020020477,1,57:22:00,0.0,29,26,0,0,3,0.896551724
2020020477,5,60:00:00,0.0,25,24,1,0,1,0.96
2020020478,15,60:00:00,0.0,33,32,3,0,1,0.96969697
2020020478,3,59:13:00,0.0,18,16,0,0,2,0.888888889
2020020479,8,61:06:00,0.0,28,25,1,1,3,0.892857143
2020020479,23,62:01:00,0.0,31,29,2,2,2,0.935483871
2020020480,10,58:02:00,0.0,18,14,2,2,4,0.777777778
2020020480,20,60:00:00,0.0,27,24,3,1,3,0.888888889
2020020481,26,58:20:00,0.0,33,29,2,1,4,0.878787879
2020020481,54,60:00:00,0.0,25,23,3,0,2,0.92
2020020482,28,65:00:00,0.0,34,33,3,2,1,0.970588235
2020020482,19,65:00:00,0.0,31,30,3,1,1,0.967741935
2020020483,7,57:40:00,0.0,41,39,5,2,2,0.951219512
2020020483,6,60:00:00,0.0,32,32,5,1,0,1.0
2020020484,2,60:00:00,0.0,24,23,3,1,1,0.958333333
2020020484,4,60:00:00,0.0,28,22,1,0,6,0.785714286
2020020485,12,65:00:00,0.0,31,29,3,2,2,0.935483871
2020020485,29,63:07:00,0.0,37,35,3,1,2,0.945945946
2020020486,14,60:00:00,0.0,31,30,7,1,1,0.967741935
2020020486,16,59:48:00,0.0,29,25,3,0,4,0.862068966
2020020487,13,59:29:00,0.0,21,21,3,0,0,1.0
2020020487,18,58:42:00,0.0,48,47,15,2,1,0.979166667
2020020488,17,60:00:00,0.0,33,30,4,1,3,0.909090909
2020020488,25,59:42:00,0.0,21,21,3,3,0,1.0
2020020489,8,65:00:00,0.0,18,14,2,0,4,0.777777778
2020020489,23,65:00:00,0.0,40,36,2,0,4,0.9
2020020490,10,60:00:00,0.0,31,31,5,1,0,1.0
2020020490,20,56:35:00,0.0,33,31,5,4,2,0.939393939
2020020491,22,60:00:00,0.0,31,29,4,1,2,0.935483871
2020020491,52,58:41:00,0.0,36,33,5,2,3,0.916666667
2020020492,21,60:00:00,0.0,31,31,12,0,0,1.0
2020020492,30,60:00:00,0.0,42,36,2,1,6,0.857142857
2020020493,28,59:01:00,2.0,20,16,1,0,4,0.8
2020020493,19,60:00:00,0.0,31,29,2,0,2,0.935483871
2020020494,1,56:36:00,0.0,26,21,4,0,5,0.807692308
2020020494,5,59:55:00,0.0,30,26,3,1,4,0.866666667
2020020495,26,59:54:00,0.0,42,41,9,2,1,0.976190476
2020020495,54,57:35:00,0.0,31,28,2,1,3,0.903225806
2020020496,3,59:57:00,0.0,19,16,2,1,3,0.842105263
2020020496,7,56:23:00,0.0,37,33,6,0,4,0.891891892
2020020496,7,2:53,0.0,2,2,0,0,0,1.0
2020020497,29,59:33:00,0.0,28,25,2,1,3,0.892857143
2020020497,12,59:50:00,0.0,19,19,2,0,0,1.0
2020020498,8,59:56:00,0.0,17,17,2,1,0,1.0
2020020498,22,60:00:00,0.0,32,28,3,0,4,0.875
2020020499,9,60:00:00,0.0,36,35,1,2,1,0.972222222
2020020499,20,58:03:00,0.0,23,21,2,0,2,0.913043478
2020020500,23,60:00:00,0.0,29,25,1,0,4,0.862068966
2020020500,52,60:00:00,0.0,22,22,0,0,0,1.0
2020020501,30,60:00:00,0.0,25,24,2,1,1,0.96
2020020501,24,58:42:00,0.0,23,21,3,0,2,0.913043478
2020020502,53,58:47:00,0.0,34,30,4,0,4,0.882352941
2020020502,21,60:00:00,0.0,25,24,0,0,1,0.96
2020020503,28,60:00:00,0.0,42,41,5,2,1,0.976190476
2020020503,26,58:05:00,0.0,23,21,2,3,2,0.913043478
2020020504,4,57:18:00,0.0,32,28,6,2,4,0.875
2020020504,1,60:00:00,0.0,33,30,8,1,3,0.909090909
2020020505,16,60:00:00,0.0,35,33,4,1,2,0.942857143
2020020505,13,58:24:00,0.0,32,29,2,1,3,0.90625
2020020506,18,59:44:00,0.0,31,31,5,1,0,1.0
2020020506,17,56:30:00,0.0,34,32,0,1,2,0.941176471
2020020507,25,58:06:00,0.0,26,24,2,1,2,0.923076923
2020020507,14,60:00:00,0.0,17,16,3,0,1,0.941176471
2020020508,53,64:42:00,0.0,39,35,7,0,4,0.897435897
2020020508,21,64:26:00,0.0,32,28,6,0,4,0.875
2020020509,5,59:35:00,0.0,28,26,1,1,2,0.928571429
2020020509,7,60:00:00,0.0,42,37,8,1,5,0.880952381
2020020510,8,62:42:00,0.0,35,31,2,0,4,0.885714286
2020020510,22,62:42:00,0.0,28,25,1,0,3,0.892857143
2020020511,9,59:19:00,0.0,29,28,4,2,1,0.965517241
2020020511,20,58:39:00,0.0,30,28,4,1,2,0.933333333
2020020512,23,58:10:00,0.0,35,31,9,0,4,0.885714286
2020020512,52,59:32:00,0.0,39,38,7,0,1,0.974358974
2020020513,30,59:37:00,0.0,30,28,1,1,2,0.933333333
2020020513,24,57:53:00,0.0,26,23,4,0,3,0.884615385
2020020514,28,59:54:00,0.0,44,42,4,2,2,0.954545455
2020020514,26,58:59:00,0.0,28,24,7,0,4,0.857142857
2020020515,6,20:00,0.0,6,6,0,2,0,1.0
2020020515,6,40:21:00,0.0,21,17,2,1,4,0.80952381
2020020515,2,60:21:00,0.0,32,29,4,0,3,0.90625
2020020516,4,37:14:00,0.0,11,8,2,0,3,0.727272727
2020020516,4,22:06,0.0,11,6,1,0,5,0.545454545
2020020516,3,60:00:00,0.0,44,41,6,3,3,0.931818182
2020020517,15,60:00:00,0.0,24,21,3,0,3,0.875
2020020517,1,57:46:00,0.0,22,18,3,0,4,0.818181818
2020020518,29,59:13:00,0.0,33,29,0,1,4,0.878787879
2020020518,12,60:50:00,0.0,36,33,1,0,3,0.916666667
2020020519,16,59:55:00,2.0,41,41,13,0,0,1.0
2020020519,13,58:07:00,0.0,20,18,3,2,2,0.9
2020020520,18,59:16:00,0.0,21,20,4,1,1,0.952380952
2020020520,17,7:39,0.0,7,4,0,0,3,0.571428571
2020020520,17,52:21:00,0.0,23,19,2,1,4,0.826086957
2020020521,9,64:42:00,0.0,41,38,2,1,3,0.926829268
2020020521,10,64:42:00,0.0,31,29,2,2,2,0.935483871
2020020522,25,59:40:00,0.0,27,24,0,2,3,0.888888889
2020020522,14,58:56:00,0.0,41,37,3,0,4,0.902439024
2020020523,21,60:00:00,0.0,19,18,0,1,1,0.947368421
2020020523,54,60:00:00,0.0,32,27,2,0,5,0.84375
2020020524,15,59:40:00,0.0,24,24,5,0,0,1.0
2020020524,1,59:45:00,0.0,31,27,6,0,4,0.870967742
2020020525,19,57:34:00,0.0,22,20,1,0,2,0.909090909
2020020525,24,60:00:00,0.0,34,33,4,0,1,0.970588235
2020020526,8,60:27:00,0.0,22,18,2,0,4,0.818181818
2020020526,22,60:17:00,0.0,29,26,1,1,3,0.896551724
2020020527,20,57:35:00,2.0,29,26,6,0,3,0.896551724
2020020527,52,60:00:00,0.0,27,25,4,2,2,0.925925926
2020020528,53,60:00:00,0.0,22,20,0,0,2,0.909090909
2020020528,28,59:44:00,0.0,28,23,2,0,5,0.821428571
2020020529,6,62:50:00,0.0,18,16,0,0,2,0.888888889
2020020529,2,21:12,0.0,11,10,0,0,1,0.909090909
2020020529,2,40:00:00,0.0,27,25,4,0,2,0.925925926
2020020530,4,59:54:00,0.0,25,24,4,1,1,0.96
2020020530,3,58:33:00,0.0,37,35,3,2,2,0.945945946
2020020531,12,60:00:00,0.0,22,19,4,0,3,0.863636364
2020020531,14,59:13:00,0.0,40,36,9,4,4,0.9
2020020532,5,60:00:00,0.0,36,36,7,1,0,1.0
2020020532,7,58:37:00,0.0,30,27,3,1,3,0.9
2020020533,17,60:00:00,0.0,22,21,1,0,1,0.954545455
2020020533,29,57:13:00,0.0,34,31,4,0,3,0.911764706
2020020534,16,57:14:00,0.0,34,31,0,3,3,0.911764706
2020020534,18,60:00:00,0.0,30,29,3,0,1,0.966666667
2020020535,19,61:42:00,0.0,24,21,1,0,3,0.875
2020020535,24,61:42:00,0.0,40,38,6,0,2,0.95
2020020536,10,60:54:00,0.0,20,17,1,0,3,0.85
2020020536,22,60:48:00,0.0,31,27,6,1,4,0.870967742
2020020537,20,59:58:00,0.0,24,22,3,0,2,0.916666667
2020020537,52,56:19:00,0.0,33,29,3,0,4,0.878787879
2020020538,25,64:43:00,0.0,28,24,3,1,4,0.857142857
2020020538,13,64:31:00,0.0,34,31,3,0,3,0.911764706
2020020539,21,61:56:00,0.0,34,31,12,0,3,0.911764706
2020020539,54,61:56:00,0.0,24,22,6,2,2,0.916666667
2020020540,53,59:45:00,0.0,34,34,6,5,0,1.0
2020020540,28,59:12:00,0.0,26,23,8,0,3,0.884615385
2020020541,6,58:24:00,0.0,29,28,7,1,1,0.965517241
2020020541,1,59:46:00,0.0,40,40,6,3,0,1.0
2020020542,15,59:45:00,0.0,20,16,1,0,4,0.8
2020020542,3,57:59:00,0.0,22,17,2,0,5,0.772727273
2020020543,12,60:00:00,0.0,24,24,0,0,0,1.0
2020020543,14,58:44:00,0.0,27,24,1,2,3,0.888888889
2020020544,17,60:00:00,0.0,17,16,0,0,1,0.941176471
2020020544,29,59:24:00,0.0,27,25,0,1,2,0.925925926
2020020545,16,58:39:00,0.0,31,28,0,1,3,0.903225806
2020020545,18,60:00:00,0.0,29,27,1,0,2,0.931034483
2020020546,8,59:54:00,0.0,14,11,4,0,3,0.785714286
2020020546,9,60:00:00,0.0,23,23,5,0,0,1.0
2020020547,25,57:43:00,0.0,22,19,3,0,3,0.863636364
2020020547,13,59:40:00,0.0,34,33,7,1,1,0.970588235
2020020548,7,60:42:00,0.0,36,32,4,0,4,0.888888889
2020020548,4,60:06:00,0.0,32,29,2,1,3,0.90625
2020020549,5,40:00:00,0.0,20,19,1,0,1,0.95
2020020549,5,20:00,0.0,5,5,1,0,0,1.0
2020020549,2,58:51:00,0.0,22,20,1,0,2,0.909090909
2020020550,19,58:45:00,0.0,18,16,5,0,2,0.888888889
2020020550,53,59:52:00,0.0,25,24,6,3,1,0.96
2020020551,10,60:17:00,0.0,23,20,1,1,3,0.869565217
2020020551,22,60:17:00,0.0,31,29,0,0,2,0.935483871
2020020552,20,40:00:00,0.0,23,19,3,2,4,0.826086957
2020020552,20,20:00,0.0,6,5,0,1,1,0.833333333
2020020552,52,60:00:00,0.0,30,29,10,0,1,0.966666667
2020020553,21,59:52:00,0.0,15,13,3,2,2,0.866666667
2020020553,24,60:00:00,0.0,48,43,13,3,5,0.895833333
2020020554,54,60:00:00,0.0,25,24,1,2,1,0.96
2020020554,26,60:00:00,0.0,24,20,4,1,4,0.833333333
2020020555,28,65:00:00,0.0,25,22,0,0,3,0.88
2020020555,30,65:00:00,0.0,39,36,2,0,3,0.923076923
2020020556,6,64:59:00,0.0,35,31,4,0,4,0.885714286
2020020556,1,65:00:00,0.0,48,44,4,0,4,0.916666667
2020020557,7,60:00:00,0.0,32,31,3,0,1,0.96875
2020020557,4,24:08:00,0.0,10,9,0,2,1,0.9
2020020557,4,35:29:00,0.0,16,12,0,0,4,0.75
2020020558,3,59:45:00,0.0,32,30,5,1,2,0.9375
2020020558,15,58:32:00,0.0,26,22,2,0,4,0.846153846
2020020559,14,57:27:00,0.0,20,18,0,1,2,0.9
2020020559,29,59:29:00,0.0,38,37,2,0,1,0.973684211
2020020560,13,60:00:00,0.0,36,35,6,4,1,0.972222222
2020020560,17,46:05:00,2.0,25,24,4,1,1,0.96
2020020560,17,12:25,0.0,8,5,0,0,3,0.625
2020020561,5,60:00:00,2.0,32,29,6,0,3,0.90625
2020020561,2,26:18:00,0.0,9,5,1,0,4,0.555555556
2020020561,2,32:03:00,0.0,11,10,1,0,1,0.909090909
2020020562,16,60:00:00,0.0,32,31,1,0,1,0.96875
2020020562,12,57:40:00,0.0,16,14,0,0,2,0.875
2020020563,18,61:29:00,0.0,35,33,1,1,2,0.942857143
2020020563,25,61:29:00,0.0,26,23,0,0,3,0.884615385
2020020564,9,59:50:00,0.0,31,30,0,0,1,0.967741935
2020020564,8,60:00:00,0.0,34,29,8,0,5,0.852941176
2020020565,19,64:47:00,0.0,26,23,3,0,3,0.884615385
2020020565,53,63:32:00,0.0,43,40,10,0,3,0.930232558
2020020566,52,58:03:00,0.0,26,23,5,3,3,0.884615385
2020020566,10,60:00:00,0.0,27,26,6,0,1,0.962962963
2020020567,23,63:11:00,0.0,36,30,12,0,6,0.833333333
2020020567,20,63:24:00,0.0,35,30,3,3,5,0.857142857
2020020568,21,40:00:00,0.0,15,15,4,1,0,1.0
2020020568,21,20:00,0.0,7,3,0,1,4,0.428571429
2020020568,24,59:30:00,0.0,35,28,2,1,7,0.8
2020020569,54,58:12:00,0.0,30,26,5,1,4,0.866666667
2020020569,26,60:00:00,0.0,42,40,6,3,2,0.952380952
2020020570,28,60:00:00,0.0,28,26,3,0,2,0.928571429
2020020570,30,57:50:00,0.0,32,29,6,0,3,0.90625
2020020571,6,57:44:00,0.0,22,19,0,0,3,0.863636364
2020020571,5,60:00:00,0.0,31,30,2,0,1,0.967741935
2020020572,7,62:39:00,0.0,47,44,10,1,3,0.936170213
2020020572,3,64:26:00,0.0,23,21,1,0,2,0.913043478
2020020573,2,60:00:00,0.0,22,18,1,2,4,0.818181818
2020020573,15,43:34:00,0.0,24,18,1,0,6,0.75
2020020573,15,16:26,0.0,9,7,0,0,2,0.777777778
2020020574,14,59:59:00,0.0,38,36,3,2,2,0.947368421
2020020574,29,57:13:00,0.0,34,31,3,0,3,0.911764706
2020020575,13,61:25:00,0.0,27,25,2,2,2,0.925925926
2020020575,17,61:16:00,0.0,36,33,11,1,3,0.916666667
2020020576,16,59:35:00,0.0,31,27,2,0,4,0.870967742
2020020576,12,60:00:00,0.0,25,22,8,0,3,0.88
2020020577,18,59:32:00,0.0,30,27,1,0,3,0.9
2020020577,25,59:50:00,0.0,22,21,7,0,1,0.954545455
2020020578,9,60:00:00,0.0,38,34,1,1,4,0.894736842
2020020578,8,60:00:00,0.0,23,22,1,0,1,0.956521739
2020020579,54,65:00:00,0.0,37,35,7,2,2,0.945945946
2020020579,30,64:56:00,0.0,37,35,6,1,2,0.945945946
2020020580,1,64:39:00,0.0,40,38,7,0,2,0.95
2020020580,15,64:39:00,0.0,23,22,0,0,1,0.956521739
2020020581,52,65:00:00,0.0,38,37,6,1,1,0.973684211
2020020581,10,65:00:00,0.0,32,31,3,2,1,0.96875
2020020582,22,60:00:00,0.0,26,24,3,0,2,0.923076923
2020020582,20,58:04:00,0.0,25,22,2,2,3,0.88
2020020583,24,59:05:00,0.0,31,27,1,0,4,0.870967742
2020020583,53,60:00:00,0.0,29,27,3,0,2,0.931034483
2020020584,26,57:51:00,0.0,35,33,5,0,2,0.942857143
2020020584,28,60:00:00,0.0,30,30,2,2,0,1.0
2020020585,6,60:00:00,0.0,28,23,2,1,5,0.821428571
2020020585,5,58:26:00,0.0,27,21,1,0,6,0.777777778
2020020586,7,65:00:00,0.0,30,28,3,1,2,0.933333333
2020020586,3,65:00:00,0.0,29,27,1,0,2,0.931034483
2020020587,2,65:00:00,0.0,32,30,5,2,2,0.9375
2020020587,4,65:00:00,0.0,24,22,1,0,2,0.916666667
2020020588,12,58:25:00,0.0,25,22,2,0,3,0.88
2020020588,25,60:00:00,0.0,43,41,2,0,2,0.953488372
2020020589,14,60:00:00,0.0,26,25,0,0,1,0.961538462
2020020589,17,58:16:00,0.0,29,27,5,1,2,0.931034483
2020020590,13,59:24:00,0.0,46,44,2,1,2,0.956521739
2020020590,29,18:33,0.0,13,12,4,0,1,0.923076923
2020020590,29,39:59:00,0.0,25,22,1,0,3,0.88
2020020591,18,60:00:00,0.0,41,41,3,0,0,1.0
2020020591,16,59:28:00,0.0,21,18,0,3,3,0.857142857
2020020592,8,59:20:00,0.0,31,26,2,4,5,0.838709677
2020020592,9,60:00:00,0.0,38,35,11,0,3,0.921052632
2020020593,22,12:22,0.0,4,0,0,0,4,0.0
2020020593,22,47:38:00,0.0,23,21,3,1,2,0.913043478
2020020593,23,60:00:00,0.0,42,39,5,1,3,0.928571429
2020020594,21,60:00:00,0.0,28,27,5,1,1,0.964285714
2020020594,19,59:42:00,0.0,34,32,8,0,2,0.941176471
2020020595,54,58:33:00,0.0,27,25,2,0,2,0.925925926
2020020595,30,60:00:00,0.0,28,27,4,0,1,0.964285714
2020020596,26,58:14:00,0.0,23,20,2,2,3,0.869565217
2020020596,28,60:00:00,0.0,37,35,2,1,2,0.945945946
2020020597,1,57:45:00,0.0,19,14,2,0,5,0.736842105
2020020597,15,60:00:00,0.0,39,35,7,0,4,0.897435897
2020020598,12,59:45:00,0.0,28,28,0,0,0,1.0
2020020598,25,57:55:00,2.0,38,37,1,0,1,0.973684211
2020020599,14,54:23:00,0.0,17,13,1,0,4,0.764705882
2020020599,17,60:00:00,0.0,28,27,4,0,1,0.964285714
2020020600,13,60:00:00,0.0,32,32,5,0,0,1.0
2020020600,29,55:23:00,0.0,35,32,1,0,3,0.914285714
2020020601,18,60:00:00,0.0,32,30,2,1,2,0.9375
2020020601,16,19:19,0.0,8,8,1,1,0,1.0
2020020601,16,40:41:00,0.0,22,17,3,0,5,0.772727273
2020020602,52,57:40:00,0.0,31,28,4,2,3,0.903225806
2020020602,23,60:00:00,0.0,40,39,9,0,1,0.975
2020020603,20,56:05:00,0.0,30,26,0,0,4,0.866666667
2020020603,10,59:59:00,0.0,34,32,4,0,2,0.941176471
2020020604,24,61:47:00,0.0,31,28,0,0,3,0.903225806
2020020604,53,61:47:00,0.0,20,18,2,0,2,0.9
2020020605,4,60:00:00,0.0,32,30,8,0,2,0.9375
2020020605,6,59:04:00,0.0,23,20,0,1,3,0.869565217
2020020606,19,29:07:00,0.0,19,14,0,0,5,0.736842105
2020020606,19,30:53:00,0.0,14,13,2,0,1,0.928571429
2020020606,54,60:00:00,0.0,32,31,8,1,1,0.96875
2020020607,8,64:02:00,0.0,23,21,5,0,2,0.913043478
2020020607,22,64:02:00,0.0,32,29,0,2,3,0.90625
2020020608,20,59:09:00,0.0,30,25,5,1,5,0.833333333
2020020608,10,59:13:00,0.0,29,26,0,3,3,0.896551724
2020020609,30,57:57:00,0.0,36,31,2,1,5,0.861111111
2020020609,21,60:00:00,0.0,25,21,8,0,4,0.84
2020020610,26,56:50:00,0.0,32,28,9,1,4,0.875
2020020610,53,59:57:00,0.0,38,36,7,1,2,0.947368421
2020020611,1,59:42:00,0.0,17,13,0,1,4,0.764705882
2020020611,7,60:00:00,0.0,30,27,2,1,3,0.9
2020020612,2,59:59:00,0.0,29,29,2,1,0,1.0
2020020612,15,58:12:00,0.0,39,38,4,0,1,0.974358974
2020020613,3,59:53:00,0.0,45,41,5,1,4,0.911111111
2020020613,5,40:00:00,0.0,14,10,1,2,4,0.714285714
2020020613,5,20:00,0.0,11,7,1,0,4,0.636363636
2020020614,4,58:25:00,0.0,25,22,0,0,3,0.88
2020020614,6,59:36:00,0.0,42,40,4,1,2,0.952380952
2020020615,12,60:00:00,0.0,36,34,2,1,2,0.944444444
2020020615,13,59:00:00,0.0,34,31,5,1,3,0.911764706
2020020616,29,60:00:00,2.0,38,36,5,3,2,0.947368421
2020020616,14,55:21:00,0.0,29,26,5,1,3,0.896551724
2020020617,17,65:00:00,0.0,31,29,5,0,2,0.935483871
2020020617,18,65:00:00,0.0,27,25,1,2,2,0.925925926
2020020618,16,60:00:00,0.0,27,25,4,1,2,0.925925926
2020020618,25,58:35:00,0.0,27,24,6,0,3,0.888888889
2020020619,52,59:30:00,0.0,24,24,0,0,0,1.0
2020020619,23,60:00:00,0.0,36,31,4,0,5,0.861111111
2020020620,19,60:00:00,0.0,51,50,10,0,1,0.980392157
2020020620,54,57:21:00,0.0,35,32,2,0,3,0.914285714
2020020621,9,58:31:00,0.0,34,31,8,1,3,0.911764706
2020020621,22,59:48:00,0.0,30,28,2,0,2,0.933333333
2020020622,10,59:54:00,0.0,34,32,0,1,2,0.941176471
2020020622,8,57:32:00,0.0,32,29,3,0,3,0.90625
2020020623,30,59:48:00,0.0,32,29,8,0,3,0.90625
2020020623,21,47:14:00,0.0,18,11,6,1,7,0.611111111
2020020623,21,12:42,0.0,1,0,0,0,1,0.0
2020020624,26,60:00:00,0.0,27,24,3,0,3,0.888888889
2020020624,53,58:25:00,0.0,30,26,3,0,4,0.866666667
2020020625,7,59:08:00,0.0,37,32,5,3,5,0.864864865
2020020625,1,60:00:00,0.0,27,24,4,0,3,0.888888889
2020020626,2,65:00:00,0.0,27,25,3,4,2,0.925925926
2020020626,4,64:14:00,0.0,23,21,5,0,2,0.913043478
2020020627,3,58:55:00,0.0,31,27,6,0,4,0.870967742
2020020627,5,59:18:00,0.0,24,22,3,0,2,0.916666667
2020020628,15,57:45:00,0.0,32,28,3,2,4,0.875
2020020628,6,60:00:00,0.0,33,31,3,2,2,0.939393939
2020020629,12,60:00:00,0.0,24,24,2,2,0,1.0
2020020629,13,59:22:00,0.0,21,19,4,0,2,0.904761905
2020020630,29,5:41,0.0,6,3,0,0,3,0.5
2020020630,29,53:24:00,0.0,24,21,2,0,3,0.875
2020020630,14,60:00:00,0.0,36,32,4,0,4,0.888888889
2020020631,17,59:48:00,0.0,32,25,2,1,7,0.78125
2020020631,18,60:00:00,0.0,26,25,1,0,1,0.961538462
2020020632,16,60:00:00,0.0,34,29,5,1,5,0.852941176
2020020632,25,60:00:00,0.0,39,38,2,1,1,0.974358974
2020020633,8,58:56:00,0.0,26,23,3,0,3,0.884615385
2020020633,52,59:43:00,0.0,38,36,5,0,2,0.947368421
2020020634,20,40:00:00,0.0,21,19,1,0,2,0.904761905
2020020634,23,59:15:00,0.0,28,22,2,1,6,0.785714286
2020020635,7,19:34,0.0,15,15,0,0,0,1.0
2020020635,7,41:17:00,0.0,25,21,5,0,4,0.84
2020020635,1,61:14:00,0.0,32,29,7,0,3,0.90625
2020020636,2,56:44:00,0.0,35,32,0,0,3,0.914285714
2020020636,3,60:00:00,0.0,32,31,0,0,1,0.96875
2020020637,19,60:00:00,0.0,25,24,1,0,1,0.96
2020020637,30,60:00:00,0.0,38,29,2,2,9,0.763157895
2020020638,9,57:17:00,0.0,22,20,1,1,2,0.909090909
2020020638,22,59:39:00,2.0,40,39,2,0,1,0.975
2020020639,54,59:40:00,0.0,26,22,3,0,4,0.846153846
2020020639,53,40:00:00,0.0,32,27,3,1,5,0.84375
2020020639,53,18:25,0.0,4,3,0,0,1,0.75
2020020640,24,59:42:00,0.0,34,33,6,0,1,0.970588235
2020020640,21,60:00:00,0.0,28,28,3,1,0,1.0
2020020641,28,60:00:00,0.0,34,32,7,1,2,0.941176471
2020020641,26,59:11:00,0.0,28,24,3,0,4,0.857142857
2020020642,12,65:00:00,0.0,28,24,2,1,4,0.857142857
2020020642,17,65:00:00,0.0,34,30,0,1,4,0.882352941
2020020643,29,59:01:00,0.0,28,24,6,0,4,0.857142857
2020020643,16,59:02:00,0.0,26,23,0,2,3,0.884615385
2020020644,18,58:16:00,0.0,33,31,5,2,2,0.939393939
2020020644,14,60:00:00,0.0,36,36,7,1,0,1.0
2020020645,8,59:55:00,0.0,25,20,3,1,5,0.8
2020020645,52,59:43:00,0.0,19,19,4,1,0,1.0
2020020646,10,59:52:00,0.0,32,27,0,1,5,0.84375
2020020646,9,58:23:00,0.0,37,32,2,1,5,0.864864865
2020020647,20,60:00:00,0.0,25,24,2,0,1,0.96
2020020647,23,59:49:00,0.0,28,24,3,0,4,0.857142857
2020020648,25,59:43:00,0.0,21,20,3,1,1,0.952380952
2020020648,13,59:37:00,0.0,20,16,2,2,4,0.8
2020020649,28,39:57:00,0.0,19,15,4,1,4,0.789473684
2020020649,28,19:26,0.0,7,7,3,0,0,1.0
2020020649,26,60:00:00,0.0,28,26,5,4,2,0.928571429
2020020650,1,58:03:00,0.0,23,19,3,0,4,0.826086957
2020020650,5,60:00:00,0.0,30,28,6,0,2,0.933333333
2020020651,2,61:13:00,0.0,26,24,2,1,2,0.923076923
2020020651,3,61:13:00,0.0,32,29,2,0,3,0.90625
2020020652,4,59:09:00,0.0,30,26,0,0,4,0.866666667
2020020652,7,59:43:00,0.0,43,40,2,0,3,0.930232558
2020020653,15,60:00:00,0.0,25,24,0,0,1,0.96
2020020653,6,60:00:00,0.0,32,30,1,1,2,0.9375
2020020654,19,64:19:00,0.0,30,28,6,1,2,0.933333333
2020020654,30,64:58:00,0.0,30,27,6,0,3,0.9
2020020655,54,59:50:00,0.0,14,14,2,0,0,1.0
2020020655,53,58:37:00,0.0,29,28,1,0,1,0.965517241
2020020656,24,60:00:00,0.0,37,33,4,0,4,0.891891892
2020020656,21,59:56:00,0.0,25,24,5,0,1,0.96
2020020657,12,58:23:00,0.0,29,27,2,0,2,0.931034483
2020020657,17,59:57:00,0.0,38,37,2,2,1,0.973684211
2020020658,29,61:25:00,0.0,34,30,6,0,4,0.882352941
2020020658,16,61:25:00,0.0,33,30,0,3,3,0.909090909
2020020659,18,60:00:00,0.0,23,21,2,2,2,0.913043478
2020020659,14,60:00:00,2.0,22,15,0,0,7,0.681818182
2020020660,8,60:00:00,0.0,25,23,3,0,2,0.92
2020020660,10,57:48:00,0.0,24,21,1,0,3,0.875
2020020661,9,59:49:00,0.0,26,24,13,0,2,0.923076923
2020020661,52,57:44:00,0.0,24,20,1,2,4,0.833333333
2020020662,22,60:00:00,0.0,25,22,5,0,3,0.88
2020020662,23,57:59:00,0.0,34,30,4,2,4,0.882352941
2020020663,26,58:47:00,0.0,41,37,2,4,4,0.902439024
2020020663,54,60:00:00,0.0,28,26,3,0,2,0.928571429
2020020664,28,59:42:00,0.0,21,17,2,0,4,0.80952381
2020020664,24,60:00:00,0.0,46,46,10,2,0,1.0
2020020665,6,60:00:00,0.0,23,22,3,0,1,0.956521739
2020020665,2,59:00:00,0.0,44,41,7,1,3,0.931818182
2020020666,1,58:05:00,0.0,19,17,0,0,2,0.894736842
2020020666,3,60:00:00,0.0,27,27,4,0,0,1.0
2020020667,15,59:28:00,0.0,23,22,0,1,1,0.956521739
2020020667,7,57:52:00,0.0,21,18,2,0,3,0.857142857
2020020668,5,60:00:00,0.0,22,19,6,0,3,0.863636364
2020020668,4,58:42:00,0.0,27,23,3,1,4,0.851851852
2020020669,10,60:36:00,0.0,28,25,2,2,3,0.892857143
2020020669,20,60:20:00,0.0,26,24,2,1,2,0.923076923
2020020670,25,63:09:00,0.0,31,28,5,0,3,0.903225806
2020020670,13,63:09:00,0.0,26,24,2,0,2,0.923076923
2020020671,8,57:47:00,0.0,33,30,0,1,3,0.909090909
2020020671,20,60:00:00,0.0,27,26,1,0,1,0.962962963
2020020672,9,58:55:00,0.0,35,32,6,2,3,0.914285714
2020020672,52,60:00:00,0.0,29,27,6,1,2,0.931034483
2020020673,22,60:00:00,0.0,41,37,3,3,4,0.902439024
2020020673,23,60:00:00,0.0,32,31,7,2,1,0.96875
2020020674,26,15:25,0.0,8,5,3,0,3,0.625
2020020674,26,44:35:00,0.0,24,21,0,0,3,0.875
2020020674,54,60:00:00,0.0,22,20,2,0,2,0.909090909
2020020675,28,58:43:00,0.0,27,23,5,1,4,0.851851852
2020020675,24,59:33:00,0.0,28,27,7,1,1,0.964285714
2020020676,3,60:00:00,0.0,16,16,1,1,0,1.0
2020020676,1,60:00:00,0.0,33,29,1,0,4,0.878787879
2020020677,15,24:44:00,0.0,8,8,0,0,0,1.0
2020020677,15,32:54:00,0.0,21,17,0,0,4,0.80952381
2020020677,7,60:00:00,0.0,29,27,3,1,2,0.931034483
2020020678,12,59:29:00,0.0,20,19,1,0,1,0.95
2020020678,18,59:34:00,0.0,29,25,4,1,4,0.862068966
2020020679,14,60:54:00,0.0,38,36,10,0,2,0.947368421
2020020679,13,60:48:00,0.0,19,16,1,0,3,0.842105263
2020020680,5,65:00:00,2.0,27,26,2,1,1,0.962962963
2020020680,4,65:00:00,0.0,32,31,1,0,1,0.96875
2020020681,17,60:00:00,0.0,25,24,4,2,1,0.96
2020020681,16,59:42:00,0.0,27,24,0,1,3,0.888888889
2020020682,10,44:45:00,0.0,17,16,3,0,1,0.941176471
2020020682,10,13:49,0.0,6,3,0,0,3,0.5
2020020682,52,59:55:00,0.0,33,31,7,1,2,0.939393939
2020020683,25,59:56:00,0.0,18,17,1,1,1,0.944444444
2020020683,29,60:00:00,0.0,31,27,1,1,4,0.870967742
2020020684,53,58:40:00,0.0,25,23,1,0,2,0.92
2020020684,19,58:36:00,0.0,25,24,5,0,1,0.96
2020020685,6,60:00:00,0.0,25,25,9,2,0,1.0
2020020685,2,59:24:00,0.0,27,25,2,2,2,0.925925926
2020020686,8,60:00:00,0.0,29,28,4,0,1,0.965517241
2020020686,20,58:57:00,0.0,20,18,3,0,2,0.9
2020020687,30,60:00:00,0.0,22,20,1,1,2,0.909090909
2020020687,28,58:07:00,0.0,18,15,5,0,3,0.833333333
2020020688,21,60:00:00,0.0,18,18,4,0,0,1.0
2020020688,26,60:00:00,0.0,37,31,8,1,6,0.837837838
2020020689,24,60:00:00,0.0,51,47,12,1,4,0.921568627
2020020689,54,60:00:00,0.0,16,16,1,2,0,1.0
2020020690,7,57:39:00,0.0,41,38,5,0,3,0.926829268
2020020690,5,59:53:00,0.0,30,28,0,0,2,0.933333333
2020020691,3,60:00:00,0.0,33,30,4,0,3,0.909090909
2020020691,1,58:40:00,0.0,28,24,6,1,4,0.857142857
2020020692,4,57:46:00,0.0,40,35,3,2,5,0.875
2020020692,15,60:00:00,0.0,25,22,11,1,3,0.88
2020020693,12,60:00:00,0.0,28,27,2,0,1,0.964285714
2020020693,18,58:27:00,0.0,47,45,4,0,2,0.957446809
2020020694,14,58:52:00,0.0,31,27,1,0,4,0.870967742
2020020694,13,59:39:00,0.0,31,28,2,0,3,0.903225806
2020020695,17,58:20:00,0.0,26,23,8,2,3,0.884615385
2020020695,16,60:00:00,0.0,29,29,8,0,0,1.0
2020020696,52,57:59:00,0.0,25,22,3,2,3,0.88
2020020696,22,60:00:00,0.0,26,26,5,1,0,1.0
2020020697,23,61:17:00,0.0,39,37,6,1,2,0.948717949
2020020697,10,61:07:00,0.0,24,21,4,3,3,0.875
2020020698,30,60:00:00,0.0,28,26,1,1,2,0.928571429
2020020698,28,40:00:00,0.0,24,19,7,0,5,0.791666667
2020020698,28,20:00,0.0,4,4,0,0,0,1.0
2020020699,25,59:53:00,0.0,22,21,3,2,1,0.954545455
2020020699,29,33:34:00,0.0,16,12,1,0,4,0.75
2020020699,29,26:26:00,0.0,16,15,2,0,1,0.9375
2020020700,53,59:58:00,0.0,22,20,1,0,2,0.909090909
2020020700,19,57:50:00,0.0,29,26,5,0,3,0.896551724
2020020701,6,60:00:00,0.0,33,30,8,4,3,0.909090909
2020020701,15,59:25:00,0.0,27,22,5,1,5,0.814814815
2020020702,1,59:04:00,0.0,25,21,1,1,4,0.84
2020020702,3,2:19,0.0,2,2,1,0,0,1.0
2020020702,3,57:41:00,0.0,28,25,2,2,3,0.892857143
2020020703,4,62:23:00,0.0,28,27,4,0,1,0.964285714
2020020703,2,61:49:00,0.0,30,30,4,1,0,1.0
2020020704,21,60:00:00,0.0,22,21,2,0,1,0.954545455
2020020704,26,60:00:00,0.0,43,38,1,0,5,0.88372093
2020020705,24,58:45:00,0.0,28,24,4,0,4,0.857142857
2020020705,54,60:00:00,0.0,35,33,5,1,2,0.942857143
2020020706,14,62:50:00,0.0,27,25,3,0,2,0.925925926
2020020706,12,62:50:00,0.0,36,33,2,0,3,0.916666667
2020020707,13,60:00:00,0.0,36,34,6,1,2,0.944444444
2020020707,29,58:06:00,0.0,38,35,2,0,3,0.921052632
2020020708,20,59:24:00,0.0,19,16,3,1,3,0.842105263
2020020708,9,60:00:00,0.0,28,26,5,1,2,0.928571429
2020020709,22,60:00:00,0.0,23,22,1,1,1,0.956521739
2020020709,8,20:00,0.0,7,7,2,0,0,1.0
2020020709,8,39:42:00,0.0,28,25,5,0,3,0.892857143
2020020710,23,59:51:00,0.0,40,37,3,1,3,0.925
2020020710,10,55:20:00,0.0,28,23,2,0,5,0.821428571
2020020711,25,64:58:00,0.0,22,20,0,0,2,0.909090909
2020020711,17,65:00:00,0.0,36,34,2,1,2,0.944444444
2020020712,53,59:00:00,0.0,23,19,5,1,4,0.826086957
2020020712,30,59:34:00,0.0,24,22,1,0,2,0.916666667
2020020713,54,65:00:00,0.0,31,29,2,1,2,0.935483871
2020020713,28,65:00:00,0.0,40,38,3,0,2,0.95
2020020714,6,59:46:00,0.0,33,25,13,0,8,0.757575758
2020020714,15,60:00:00,0.0,35,34,3,2,1,0.971428571
2020020715,7,60:00:00,0.0,36,34,3,0,2,0.944444444
2020020715,5,58:46:00,0.0,28,25,4,1,3,0.892857143
2020020716,1,60:00:00,0.0,30,26,1,0,4,0.866666667
2020020716,4,57:26:00,0.0,26,21,1,1,5,0.807692308
2020020717,2,60:00:00,0.0,26,25,6,0,1,0.961538462
2020020717,3,59:58:00,0.0,28,22,3,0,6,0.785714286
2020020718,14,58:00:00,0.0,35,32,4,1,3,0.914285714
2020020718,12,60:00:00,0.0,27,26,2,0,1,0.962962963
2020020719,13,60:00:00,0.0,34,33,1,1,1,0.970588235
2020020719,29,60:00:00,0.0,33,28,3,0,5,0.848484848
2020020720,20,60:00:00,0.0,20,19,3,0,1,0.95
2020020720,9,30:05:00,0.0,23,19,0,0,4,0.826086957
2020020720,9,29:55:00,0.0,13,11,0,1,2,0.846153846
2020020721,22,57:25:00,2.0,31,27,1,1,4,0.870967742
2020020721,8,60:00:00,2.0,25,22,5,1,3,0.88
2020020722,25,60:00:00,2.0,26,24,1,0,2,0.923076923
2020020722,17,34:23:00,0.0,11,11,1,2,0,1.0
2020020722,17,23:36,0.0,12,8,0,0,4,0.666666667
2020020723,21,60:00:00,0.0,27,25,10,1,2,0.925925926
2020020723,19,58:24:00,0.0,39,36,6,0,3,0.923076923
2020020724,26,60:00:00,0.0,25,24,4,1,1,0.96
2020020724,24,60:00:00,0.0,22,18,1,0,4,0.818181818
2020020725,16,62:57:00,0.0,40,36,1,0,4,0.9
2020020725,18,63:00:00,0.0,30,25,2,1,5,0.833333333
2020020726,52,46:09:00,0.0,26,25,2,2,1,0.961538462
2020020726,52,11:59,0.0,6,3,0,0,3,0.5
2020020726,10,59:38:00,0.0,37,34,6,0,3,0.918918919
2020020727,53,59:32:00,0.0,22,19,1,0,3,0.863636364
2020020727,30,60:00:00,0.0,40,39,7,1,1,0.975
2020020728,54,60:00:00,0.0,33,31,4,0,2,0.939393939
2020020728,28,58:39:00,0.0,39,35,3,1,4,0.897435897
2020020729,7,60:00:00,0.0,38,33,3,4,5,0.868421053
2020020729,6,59:59:00,0.0,30,29,5,0,1,0.966666667
2020020730,2,65:00:00,0.0,28,28,2,1,0,1.0
2020020730,15,64:51:00,0.0,26,26,2,0,0,1.0
2020020731,14,60:00:00,0.0,25,24,1,1,1,0.96
2020020731,29,57:15:00,0.0,27,25,4,0,2,0.925925926
2020020732,13,58:43:00,0.0,28,25,2,1,3,0.892857143
2020020732,12,59:48:00,0.0,34,32,11,1,2,0.941176471
2020020733,5,60:00:00,0.0,31,30,6,0,1,0.967741935
2020020733,1,27:32:00,0.0,8,7,0,0,1,0.875
2020020733,1,32:28:00,0.0,15,11,2,0,4,0.733333333
2020020734,17,60:00:00,0.0,46,43,6,0,3,0.934782609
2020020734,25,38:13:00,0.0,13,10,1,0,3,0.769230769
2020020734,25,20:00,0.0,9,6,0,0,3,0.666666667
2020020735,19,59:02:00,0.0,28,25,7,3,3,0.892857143
2020020735,21,60:00:00,0.0,27,25,6,2,2,0.925925926
2020020736,20,60:00:00,0.0,20,18,1,0,2,0.9
2020020736,8,58:18:00,0.0,30,27,1,0,3,0.9
2020020737,23,57:56:00,0.0,24,22,6,3,2,0.916666667
2020020737,9,60:00:00,0.0,31,31,4,0,0,1.0
2020020738,7,59:34:00,0.0,40,36,1,0,4,0.9
2020020738,6,41:14:00,0.0,28,24,2,0,4,0.857142857
2020020738,6,17:19,0.0,5,4,0,0,1,0.8
2020020739,3,60:00:00,0.0,27,26,2,0,1,0.962962963
2020020739,4,60:00:00,0.0,24,20,1,1,4,0.833333333
2020020740,16,57:10:00,0.0,28,25,3,1,3,0.892857143
2020020740,18,60:00:00,0.0,30,29,1,0,1,0.966666667
2020020741,52,60:00:00,0.0,36,34,6,0,2,0.944444444
2020020741,10,59:44:00,0.0,23,20,3,0,3,0.869565217
2020020742,26,58:46:00,0.0,23,20,2,0,3,0.869565217
2020020742,53,60:00:00,0.0,42,40,6,0,2,0.952380952
2020020743,28,30:36:00,0.0,20,16,0,0,4,0.8
2020020743,28,27:05:00,0.0,13,12,3,0,1,0.923076923
2020020743,30,59:52:00,0.0,33,31,4,1,2,0.939393939
2020020744,2,59:52:00,0.0,30,24,0,0,6,0.8
2020020744,15,60:00:00,0.0,24,21,0,0,3,0.875
2020020745,13,59:58:00,0.0,19,16,4,2,3,0.842105263
2020020745,12,60:24:00,0.0,36,32,1,4,4,0.888888889
2020020746,5,60:00:00,0.0,36,34,5,0,2,0.944444444
2020020746,1,58:25:00,0.0,36,33,0,2,3,0.916666667
2020020747,17,60:32:00,0.0,52,50,9,0,2,0.961538462
2020020747,25,60:32:00,0.0,17,16,0,1,1,0.941176471
2020020748,19,59:18:00,0.0,31,28,1,0,3,0.903225806
2020020748,21,58:10:00,0.0,29,25,5,0,4,0.862068966
2020020749,52,58:42:00,0.0,36,33,13,1,3,0.916666667
2020020749,10,60:00:00,0.0,26,25,8,2,1,0.961538462
2020020750,20,60:00:00,0.0,32,30,7,0,2,0.9375
2020020750,8,59:17:00,0.0,33,29,7,1,4,0.878787879
2020020751,23,59:57:00,0.0,28,26,8,1,2,0.928571429
2020020751,9,35:00:00,0.0,20,18,6,2,2,0.9
2020020751,9,24:13:00,2.0,13,12,0,1,1,0.923076923
2020020752,26,60:00:00,0.0,40,36,4,1,4,0.9
2020020752,53,60:00:00,0.0,26,26,3,0,0,1.0
2020020753,28,20:00,0.0,8,5,0,0,3,0.625
2020020753,28,39:52:00,0.0,17,15,0,0,2,0.882352941
2020020753,30,60:00:00,0.0,30,27,0,4,3,0.9
2020020754,3,59:56:00,0.0,34,31,6,0,3,0.911764706
2020020754,7,58:23:00,0.0,28,23,8,2,5,0.821428571
2020020755,4,63:41:00,0.0,20,18,1,1,2,0.9
2020020755,2,63:41:00,0.0,37,36,2,0,1,0.972972973
2020020756,14,60:10:00,0.0,22,19,1,1,3,0.863636364
2020020756,29,42:41:00,0.0,26,23,4,2,3,0.884615385
2020020756,29,17:29,0.0,8,7,3,0,1,0.875
2020020757,5,60:00:00,0.0,30,30,0,1,0,1.0
2020020757,6,58:10:00,0.0,29,28,1,0,1,0.965517241
2020020758,18,59:33:00,0.0,40,39,2,0,1,0.975
2020020758,13,34:46:00,0.0,16,14,2,0,2,0.875
2020020758,13,24:55:00,0.0,11,9,4,0,2,0.818181818
2020020759,9,59:40:00,0.0,26,25,1,0,1,0.961538462
2020020759,23,58:19:00,0.0,27,25,1,1,2,0.925925926
2020020760,52,20:00,0.0,7,7,0,0,0,1.0
2020020760,52,40:00:00,0.0,23,17,3,0,6,0.739130435
2020020760,22,60:00:00,0.0,37,36,5,0,1,0.972972973
2020020761,20,57:18:00,0.0,24,22,1,2,2,0.916666667
2020020761,8,59:53:00,0.0,22,21,1,0,1,0.954545455
2020020762,30,62:25:00,0.0,21,16,1,0,5,0.761904762
2020020762,19,63:43:00,0.0,30,26,0,0,4,0.866666667
2020020763,25,62:44:00,0.0,32,29,4,0,3,0.90625
2020020763,12,62:44:00,0.0,31,27,0,0,4,0.870967742
2020020764,54,58:26:00,0.0,21,19,1,1,2,0.904761905
2020020764,21,60:00:00,0.0,37,36,11,0,1,0.972972973
2020020765,26,60:00:00,0.0,22,21,0,2,1,0.954545455
2020020765,24,58:58:00,0.0,23,21,2,0,2,0.913043478
2020020766,28,60:00:00,0.0,25,21,2,2,4,0.84
2020020766,53,36:11:00,0.0,22,21,6,0,1,0.954545455
2020020766,53,22:26,0.0,11,7,0,1,4,0.636363636
2020020767,1,65:00:00,0.0,34,32,7,0,2,0.941176471
2020020767,2,64:20:00,0.0,31,29,4,0,2,0.935483871
2020020768,3,59:32:00,0.0,37,36,2,0,1,0.972972973
2020020768,7,57:47:00,0.0,41,38,7,0,3,0.926829268
2020020769,4,54:57:00,0.0,27,24,3,2,3,0.888888889
2020020769,15,60:00:00,0.0,37,36,5,0,1,0.972972973
2020020770,5,57:58:00,0.0,31,28,2,0,3,0.903225806
2020020770,6,60:00:00,0.0,26,25,7,0,1,0.961538462
2020020771,29,65:00:00,0.0,41,41,1,1,0,1.0
2020020771,17,65:00:00,0.0,33,33,3,1,0,1.0
2020020772,16,39:48:00,0.0,19,15,3,2,4,0.789473684
2020020772,16,20:00,0.0,11,8,0,0,3,0.727272727
2020020772,14,60:00:00,0.0,40,36,12,1,4,0.9
2020020773,18,58:38:00,0.0,55,49,5,3,6,0.890909091
2020020773,13,20:00,0.0,9,9,0,0,0,1.0
2020020773,13,40:00:00,0.0,21,17,5,0,4,0.80952381
2020020774,25,60:00:00,0.0,30,25,3,1,5,0.833333333
2020020774,12,60:00:00,0.0,28,27,3,1,1,0.964285714
2020020775,8,60:00:00,0.0,29,25,3,3,4,0.862068966
2020020775,10,60:00:00,0.0,33,32,4,4,1,0.96969697
2020020776,9,60:00:00,0.0,22,19,2,1,3,0.863636364
2020020776,23,58:56:00,0.0,32,27,2,3,5,0.84375
2020020777,52,58:32:00,0.0,26,24,3,0,2,0.923076923
2020020777,22,60:00:00,0.0,30,29,2,1,1,0.966666667
2020020778,30,59:37:00,0.0,32,28,1,1,4,0.875
2020020778,19,60:00:00,0.0,29,26,1,0,3,0.896551724
2020020779,54,60:00:00,0.0,37,35,6,2,2,0.945945946
2020020779,21,56:58:00,0.0,25,21,4,0,4,0.84
2020020780,26,59:19:00,0.0,22,19,1,1,3,0.863636364
2020020780,24,60:00:00,0.0,30,28,5,0,2,0.933333333
2020020781,28,60:00:00,0.0,30,28,4,2,2,0.933333333
2020020781,53,58:09:00,0.0,30,27,4,1,3,0.9
2020020782,6,60:00:00,0.0,31,29,3,0,2,0.935483871
2020020782,7,59:21:00,0.0,39,35,7,0,4,0.897435897
2020020783,1,60:00:00,0.0,24,21,1,0,3,0.875
2020020783,4,58:15:00,0.0,18,14,3,0,4,0.777777778
2020020784,3,58:37:00,0.0,26,23,2,1,3,0.884615385
2020020784,2,59:25:00,0.0,25,25,1,0,0,1.0
2020020785,15,60:45:00,0.0,35,30,1,0,5,0.857142857
2020020785,5,62:11:00,0.0,37,33,4,1,4,0.891891892
2020020786,12,60:00:00,0.0,17,16,1,1,1,0.941176471
2020020786,17,56:13:00,0.0,32,29,1,0,3,0.90625
2020020787,16,62:54:00,0.0,39,35,7,1,4,0.897435897
2020020787,13,64:04:00,0.0,27,24,2,2,3,0.888888889
2020020788,18,65:00:00,0.0,26,24,1,0,2,0.923076923
2020020788,25,65:00:00,0.0,20,18,0,0,2,0.9
2020020789,22,57:37:00,0.0,30,27,4,1,3,0.9
2020020789,20,59:46:00,0.0,31,30,3,0,1,0.967741935
2020020790,19,60:00:00,2.0,31,31,4,0,0,1.0
2020020790,30,60:00:00,0.0,27,23,0,0,4,0.851851852
2020020791,8,60:00:00,0.0,22,19,5,0,3,0.863636364
2020020791,52,59:07:00,0.0,34,30,0,0,4,0.882352941
2020020792,10,60:00:00,0.0,16,15,2,0,1,0.9375
2020020792,23,58:03:00,0.0,24,20,0,0,4,0.833333333
2020020793,21,60:00:00,0.0,21,21,6,2,0,1.0
2020020793,28,59:43:00,0.0,35,33,6,1,2,0.942857143
2020020794,53,60:00:00,0.0,25,25,1,0,0,1.0
2020020794,54,59:42:00,0.0,31,29,1,0,2,0.935483871
2020020795,24,59:05:00,0.0,25,23,2,0,2,0.92
2020020795,26,60:00:00,0.0,34,33,10,0,1,0.970588235
2020020796,6,60:00:00,0.0,19,17,1,0,2,0.894736842
2020020796,7,40:00:00,0.0,29,26,4,0,3,0.896551724
2020020796,7,20:00,0.0,14,11,1,1,3,0.785714286
2020020797,2,59:36:00,0.0,28,28,4,1,0,1.0
2020020797,3,60:00:00,0.0,25,22,0,1,3,0.88
2020020798,4,59:34:00,0.0,21,17,1,0,4,0.80952381
2020020798,1,60:00:00,0.0,32,31,3,0,1,0.96875
2020020799,15,60:00:00,0.0,26,23,2,0,3,0.884615385
2020020799,5,60:00:00,0.0,24,24,1,0,0,1.0
2020020800,12,63:55:00,0.0,32,31,2,0,1,0.96875
2020020800,29,64:07:00,0.0,33,31,0,1,2,0.939393939
2020020801,17,65:00:00,0.0,33,33,8,2,0,1.0
2020020801,14,65:00:00,0.0,15,15,1,0,0,1.0
2020020802,16,57:24:00,0.0,42,37,2,0,5,0.880952381
2020020802,13,60:00:00,0.0,35,31,6,1,4,0.885714286
2020020803,19,59:47:00,0.0,20,17,1,0,3,0.85
2020020803,30,60:00:00,0.0,27,20,5,1,7,0.740740741
2020020804,18,63:32:00,0.0,28,28,1,0,0,1.0
2020020804,25,63:32:00,2.0,34,33,7,1,1,0.970588235
2020020805,8,62:10:00,0.0,23,21,1,0,2,0.913043478
2020020805,9,62:25:00,0.0,39,36,0,2,3,0.923076923
2020020806,10,59:56:00,0.0,27,26,2,0,1,0.962962963
2020020806,23,57:47:00,0.0,29,25,0,0,4,0.862068966
2020020807,22,59:40:00,0.0,30,29,5,1,1,0.966666667
2020020807,20,58:46:00,0.0,27,25,7,0,2,0.925925926
2020020808,21,60:00:00,0.0,25,22,2,2,3,0.88
2020020808,28,57:01:00,0.0,44,40,6,0,4,0.909090909
2020020809,53,63:04:00,0.0,34,31,7,4,3,0.911764706
2020020809,54,63:04:00,0.0,21,19,2,0,2,0.904761905
2020020810,24,60:00:00,0.0,25,23,1,0,2,0.92
2020020810,26,60:00:00,0.0,33,27,0,0,6,0.818181818
2020020811,17,58:35:00,0.0,42,40,2,1,2,0.952380952
2020020811,14,58:35:00,0.0,23,22,5,0,1,0.956521739
2020020812,7,60:00:00,0.0,36,34,2,1,2,0.944444444
2020020812,2,58:28:00,0.0,39,36,6,0,3,0.923076923
2020020813,1,59:38:00,0.0,42,39,1,0,3,0.928571429
2020020813,6,60:00:00,0.0,20,20,0,0,0,1.0
2020020814,3,57:50:00,0.0,39,34,8,0,5,0.871794872
2020020814,15,60:00:00,0.0,26,23,7,1,3,0.884615385
2020020815,4,60:00:00,0.0,37,35,5,0,2,0.945945946
2020020815,5,40:00:00,0.0,37,33,2,0,4,0.891891892
2020020815,5,19:27,0.0,7,5,0,3,2,0.714285714
2020020816,12,60:00:00,0.0,17,15,1,0,2,0.882352941
2020020816,16,29:44:00,0.0,18,14,2,0,4,0.777777778
2020020816,16,28:58:00,0.0,19,19,2,3,0,1.0
2020020817,29,63:24:00,0.0,38,34,5,1,4,0.894736842
2020020817,18,63:24:00,0.0,32,29,3,1,3,0.90625
2020020818,19,60:00:00,0.0,20,19,2,0,1,0.95
2020020818,24,58:45:00,0.0,31,29,2,2,2,0.935483871
2020020819,8,63:32:00,0.0,29,27,5,3,2,0.931034483
2020020819,10,64:43:00,0.0,23,20,6,1,3,0.869565217
2020020820,9,60:00:00,0.0,29,28,13,1,1,0.965517241
2020020820,52,59:12:00,0.0,18,16,5,0,2,0.888888889
2020020821,30,59:41:00,0.0,32,27,3,0,5,0.84375
2020020821,54,59:01:00,0.0,32,26,0,0,6,0.8125
2020020822,53,57:53:00,0.0,26,23,1,0,3,0.884615385
2020020822,26,40:00:00,0.0,19,17,1,0,2,0.894736842
2020020822,26,20:00,0.0,15,15,0,0,0,1.0
2020020823,28,60:41:00,0.0,31,26,4,0,5,0.838709677
2020020823,21,60:28:00,0.0,27,23,1,0,4,0.851851852
2020020824,7,65:00:00,0.0,48,45,2,0,3,0.9375
2020020824,2,65:00:00,0.0,31,28,0,0,3,0.903225806
2020020825,1,62:02:00,0.0,36,33,2,1,3,0.916666667
2020020825,6,62:41:00,0.0,21,17,3,0,4,0.80952381
2020020826,4,59:10:00,0.0,30,24,2,1,6,0.8
2020020826,5,60:00:00,0.0,33,30,1,1,3,0.909090909
2020020827,12,60:00:00,0.0,30,27,2,1,3,0.9
2020020827,16,58:59:00,0.0,26,22,7,0,4,0.846153846
2020020828,14,60:00:00,0.0,32,29,5,3,3,0.90625
2020020828,13,57:33:00,0.0,23,19,5,1,4,0.826086957
2020020829,23,58:02:00,0.0,31,27,0,0,4,0.870967742
2020020829,22,60:00:00,0.0,23,20,2,0,3,0.869565217
2020020830,3,58:31:00,0.0,34,31,11,0,3,0.911764706
2020020830,15,59:57:00,0.0,21,19,4,3,2,0.904761905
2020020831,29,60:00:00,0.0,32,30,0,0,2,0.9375
2020020831,18,58:14:00,2.0,26,23,3,1,3,0.884615385
2020020832,19,64:52:00,0.0,35,33,5,0,2,0.942857143
2020020832,24,65:00:00,0.0,26,24,4,1,2,0.923076923
2020020833,9,60:02:00,0.0,33,30,5,2,3,0.909090909
2020020833,10,59:26:00,0.0,28,24,3,5,4,0.857142857
2020020834,20,59:53:00,0.0,19,15,0,2,4,0.789473684
2020020834,52,59:26:00,0.0,32,32,9,2,0,1.0
2020020835,30,61:53:00,0.0,34,31,4,1,3,0.911764706
2020020835,54,61:49:00,0.0,28,26,4,0,2,0.928571429
2020020836,53,59:21:00,0.0,21,18,2,0,3,0.857142857
2020020836,26,60:00:00,0.0,30,28,5,0,2,0.933333333
2020020837,28,60:00:00,0.0,32,30,2,0,2,0.9375
2020020837,21,57:34:00,0.0,33,30,8,1,3,0.909090909
2020020838,6,60:00:00,0.0,15,15,0,1,0,1.0
2020020838,3,59:55:00,0.0,34,30,4,0,4,0.882352941
2020020839,2,58:28:00,0.0,25,23,1,1,2,0.92
2020020839,1,60:00:00,0.0,33,32,5,1,1,0.96969697
2020020840,15,58:47:00,0.0,28,25,4,0,3,0.892857143
2020020840,4,59:52:00,0.0,30,28,1,0,2,0.933333333
2020020841,13,60:00:00,0.0,30,30,6,2,0,1.0
2020020841,14,60:00:00,0.0,30,26,8,1,4,0.866666667
2020020842,5,60:00:00,0.0,23,19,6,0,4,0.826086957
2020020842,7,60:00:00,0.0,34,26,1,0,8,0.764705882
2020020843,16,60:00:00,0.0,39,37,0,0,2,0.948717949
2020020843,25,57:38:00,0.0,25,21,4,0,4,0.84
2020020844,23,59:54:00,0.0,27,23,2,0,4,0.851851852
2020020844,22,60:00:00,0.0,29,28,7,0,1,0.965517241
2020020845,29,58:42:00,0.0,34,31,2,0,3,0.911764706
2020020845,17,59:51:00,0.0,24,22,0,0,2,0.916666667
2020020846,18,59:53:00,0.0,30,30,6,0,0,1.0
2020020846,12,60:00:00,0.0,27,22,5,0,5,0.814814815
2020020847,10,58:16:00,0.0,21,19,2,0,2,0.904761905
2020020847,8,20:00,0.0,15,11,0,0,4,0.733333333
2020020847,8,40:00:00,0.0,20,19,4,0,1,0.95
2020020848,52,60:00:00,0.0,23,20,7,0,3,0.869565217
2020020848,9,58:27:00,0.0,46,42,8,1,4,0.913043478
2020020849,20,59:53:00,0.0,17,17,0,1,0,1.0
2020020849,22,60:00:00,0.0,32,27,8,2,5,0.84375
2020020850,30,60:07:00,0.0,25,22,2,2,3,0.88
2020020850,24,60:17:00,0.0,36,32,3,0,4,0.888888889
2020020851,54,64:22:00,0.0,25,22,3,1,3,0.88
2020020851,19,64:42:00,0.0,35,31,2,0,4,0.885714286
2020020852,26,58:28:00,0.0,37,34,7,0,3,0.918918919
2020020852,21,59:57:00,0.0,17,15,0,0,2,0.882352941
2020020853,28,58:09:00,0.0,33,29,2,0,4,0.878787879
2020020853,53,60:00:00,0.0,28,26,4,0,2,0.928571429
2020020854,6,58:47:00,0.0,23,18,2,3,5,0.782608696
2020020854,3,11:10,0.0,9,7,1,0,2,0.777777778
2020020854,3,48:50:00,0.0,30,28,2,0,2,0.933333333
2020020855,2,60:00:00,0.0,24,23,1,0,1,0.958333333
2020020855,1,60:00:00,0.0,27,22,2,0,5,0.814814815
2020020856,15,61:15:00,0.0,29,28,1,2,1,0.965517241
2020020856,4,64:00:00,0.0,40,38,8,0,2,0.95
2020020857,13,60:00:00,0.0,29,28,5,4,1,0.965517241
2020020857,14,60:00:00,0.0,35,30,5,1,5,0.857142857
2020020858,5,60:00:00,0.0,29,29,2,1,0,1.0
2020020858,7,58:02:00,0.0,23,22,3,0,1,0.956521739
2020020859,29,64:39:00,0.0,37,33,1,0,4,0.891891892
2020020859,17,64:37:00,0.0,36,31,0,2,5,0.861111111
2020020860,16,64:30:00,0.0,50,45,6,1,5,0.9
2020020860,25,63:35:00,0.0,23,19,9,0,4,0.826086957
2020020861,18,59:45:00,0.0,22,21,0,1,1,0.954545455
2020020861,12,59:01:00,0.0,29,27,6,0,2,0.931034483
2020020862,10,60:00:00,0.0,23,21,2,2,2,0.913043478
2020020862,8,57:46:00,0.0,26,23,0,0,3,0.884615385
2020020863,52,59:38:00,0.0,22,19,1,0,3,0.863636364
2020020863,9,60:00:00,0.0,29,27,2,0,2,0.931034483
2020020864,23,59:55:00,0.0,40,38,4,0,2,0.95
2020020864,20,57:42:00,0.0,23,20,0,0,3,0.869565217
2020020865,30,62:46:00,0.0,22,19,2,1,3,0.863636364
2020020865,24,61:48:00,0.0,25,21,5,0,4,0.84
2020020866,54,60:00:00,0.0,21,20,5,1,1,0.952380952
2020020866,19,58:57:00,0.0,28,25,2,1,3,0.892857143
2020020867,26,58:03:00,0.0,30,27,9,0,3,0.9
2020020867,21,59:53:00,0.0,18,16,3,0,2,0.888888889
2020020868,28,61:24:00,0.0,32,27,0,1,5,0.84375
2020020868,53,62:30:00,0.0,48,44,5,0,4,0.916666667
2020030111,5,76:30:00,0.0,41,37,2,2,4,0.902439024
2020030111,2,76:30:00,2.0,42,39,3,0,3,0.928571429
2020030112,5,60:00:00,0.0,38,37,1,1,1,0.973684211
2020030112,2,58:15:00,0.0,45,43,1,0,2,0.955555556
2020030113,2,58:05:00,0.0,27,22,2,0,5,0.814814815
2020030113,5,60:00:00,0.0,30,26,3,0,4,0.866666667
2020030114,2,60:00:00,0.0,30,29,0,1,1,0.966666667
2020030114,5,60:00:00,0.0,26,22,1,0,4,0.846153846
2020030115,5,80:51:00,0.0,28,25,1,0,3,0.892857143
2020030115,2,80:51:00,0.0,50,48,4,1,2,0.96
2020030116,2,60:00:00,0.0,37,34,1,2,3,0.918918919
2020030116,5,58:46:00,0.0,24,19,3,0,5,0.791666667
2020030121,15,51:31:00,0.0,22,21,3,0,1,0.954545455
2020030121,15,13:10,0.0,4,3,1,0,1,0.75
2020030121,6,64:41:00,0.0,32,29,2,4,3,0.90625
2020030122,15,60:39:00,0.0,48,44,3,1,4,0.916666667
2020030122,6,60:39:00,0.0,39,36,8,0,3,0.923076923
2020030123,6,85:48:00,0.0,37,35,5,2,2,0.945945946
2020030123,15,85:45:00,0.0,43,40,8,4,3,0.930232558
2020030124,6,60:00:00,0.0,20,19,5,0,1,0.95
2020030124,15,56:22:00,0.0,37,33,3,2,4,0.891891892
2020030125,15,58:48:00,0.0,19,16,4,1,3,0.842105263
2020030125,6,60:00:00,0.0,41,40,7,0,1,0.975609756
2020030131,12,59:36:00,0.0,24,22,2,1,2,0.916666667
2020030131,18,59:15:00,0.0,37,33,7,1,4,0.891891892
2020030132,12,60:00:00,0.0,32,32,10,0,0,1.0
2020030132,18,58:44:00,0.0,30,28,1,7,2,0.933333333
2020030133,18,94:54:00,0.0,56,52,4,1,4,0.928571429
2020030133,12,94:54:00,0.0,54,49,14,1,5,0.907407407
2020030134,18,96:10:00,0.0,61,58,6,0,3,0.950819672
2020030134,12,95:29:00,0.0,43,39,3,1,4,0.906976744
2020030135,12,62:03:00,0.0,25,23,1,0,2,0.92
2020030135,18,62:03:00,0.0,37,34,4,0,3,0.918918919
2020030136,18,61:06:00,0.0,31,27,2,0,4,0.870967742
2020030136,12,61:06:00,0.0,27,24,3,0,3,0.888888889
2020030141,13,59:26:00,0.0,40,35,3,2,5,0.875
2020030141,14,59:37:00,0.0,39,35,6,0,4,0.897435897
2020030142,13,58:34:00,0.0,28,26,2,2,2,0.928571429
2020030142,14,60:00:00,0.0,33,32,3,0,1,0.96969697
2020030143,14,65:56:00,0.0,47,41,3,1,6,0.872340426
2020030143,13,40:00:00,0.0,22,17,0,1,5,0.772727273
2020030143,13,25:56:00,0.0,9,9,0,0,0,1.0
2020030144,14,60:00:00,0.0,41,39,15,0,2,0.951219512
2020030144,13,31:10:00,0.0,12,11,2,1,1,0.916666667
2020030144,13,27:15:00,0.0,14,9,1,0,5,0.642857143
2020030145,13,59:37:00,0.0,37,36,5,0,1,0.972972973
2020030145,14,58:06:00,0.0,37,34,8,0,3,0.918918919
2020030146,14,60:00:00,0.0,29,29,4,0,0,1.0
2020030146,13,56:43:00,0.0,23,20,0,0,3,0.869565217
2020030151,21,60:00:00,0.0,23,22,4,2,1,0.956521739
2020030151,19,59:08:00,0.0,49,46,5,0,3,0.93877551
2020030152,21,60:00:00,0.0,35,32,4,0,3,0.914285714
2020030152,19,58:57:00,0.0,33,29,0,1,4,0.878787879
2020030153,19,57:04:00,0.0,25,21,5,0,4,0.84
2020030153,21,59:58:00,0.0,32,31,3,1,1,0.96875
2020030154,19,58:43:00,0.0,32,29,1,0,3,0.90625
2020030154,21,60:00:00,0.0,20,18,2,1,2,0.9
2020030161,54,62:49:00,0.0,30,29,2,1,1,0.966666667
2020030161,30,63:20:00,0.0,42,42,6,1,0,1.0
2020030162,54,60:00:00,0.0,35,34,3,0,1,0.971428571
2020030162,30,58:44:00,0.0,28,25,2,0,3,0.892857143
2020030163,30,58:51:00,0.0,39,35,13,2,4,0.897435897
2020030163,54,59:25:00,0.0,16,14,1,0,2,0.875
2020030164,30,57:21:00,0.0,17,14,1,0,3,0.823529412
2020030164,54,60:00:00,0.0,35,35,5,0,0,1.0
2020030165,54,58:43:00,0.0,13,10,0,0,3,0.769230769
2020030165,30,60:00:00,0.0,40,38,5,0,2,0.95
2020030166,30,60:00:00,0.0,23,23,2,0,0,1.0
2020030166,54,60:00:00,0.0,24,21,1,0,3,0.875
2020030167,54,60:00:00,0.0,20,18,2,0,2,0.9
2020030167,30,58:11:00,0.0,33,28,2,1,5,0.848484848
2020030171,10,57:45:00,0.0,30,28,11,0,2,0.933333333
2020030171,8,60:00:00,0.0,36,35,7,0,1,0.972222222
2020030172,10,59:31:00,0.0,23,22,1,3,1,0.956521739
2020030172,8,55:25:00,0.0,33,29,7,0,4,0.878787879
2020030173,8,58:05:00,0.0,29,27,5,1,2,0.931034483
2020030173,10,60:00:00,0.0,29,28,0,2,1,0.965517241
2020030174,8,58:41:00,0.0,27,24,0,1,3,0.888888889
2020030174,10,59:55:00,0.0,32,32,6,1,0,1.0
2020030175,10,60:59:00,0.0,30,26,1,0,4,0.866666667
2020030175,8,60:59:00,0.0,35,32,1,1,3,0.914285714
2020030176,8,75:15:00,0.0,43,41,4,0,2,0.953488372
2020030176,10,75:15:00,0.0,31,28,4,2,3,0.903225806
2020030177,10,57:26:00,0.0,22,20,0,0,2,0.909090909
2020030177,8,60:00:00,0.0,31,30,4,0,1,0.967741935
2020030181,22,59:45:00,0.0,20,18,0,0,2,0.9
2020030181,52,60:00:00,0.0,33,32,1,0,1,0.96969697
2020030182,22,64:06:00,0.0,36,35,2,2,1,0.972222222
2020030182,52,64:06:00,0.0,38,38,3,1,0,1.0
2020030183,52,69:13:00,0.0,48,44,7,1,4,0.916666667
2020030183,22,69:13:00,0.0,37,32,4,0,5,0.864864865
2020030184,52,106:48:00,0.0,40,37,8,1,3,0.925
2020030184,22,106:44:00,0.0,43,39,4,1,4,0.906976744
2020030211,6,59:58:00,0.0,22,20,3,0,2,0.909090909
2020030211,2,58:14:00,0.0,39,35,3,0,4,0.897435897
2020030212,6,74:48:00,0.0,39,35,5,0,4,0.897435897
2020030212,2,74:48:00,0.0,42,39,0,1,3,0.928571429
2020030213,2,63:36:00,0.0,41,39,8,0,2,0.951219512
2020030213,6,63:36:00,0.0,29,28,5,0,1,0.965517241
2020030214,2,60:00:00,0.0,29,28,4,5,1,0.965517241
2020030214,6,58:54:00,0.0,32,30,3,1,2,0.9375
2020030215,6,18:34,0.0,3,2,0,0,1,0.666666667
2020030215,6,40:00:00,0.0,16,12,1,0,4,0.75
2020030215,2,60:00:00,0.0,44,40,5,2,4,0.909090909
2020030216,2,60:00:00,0.0,25,23,1,0,2,0.92
2020030216,6,59:26:00,0.0,27,23,0,0,4,0.851851852
2020030221,12,58:54:00,0.0,30,28,0,1,2,0.933333333
2020030221,14,60:00:00,0.0,38,37,6,2,1,0.973684211
2020030222,12,58:31:00,0.0,15,13,0,1,2,0.866666667
2020030222,14,59:50:00,0.0,32,31,3,0,1,0.96875
2020030223,14,65:57:00,0.0,27,24,2,0,3,0.888888889
2020030223,12,65:57:00,0.0,37,35,5,0,2,0.945945946
2020030224,14,60:00:00,0.0,25,21,0,1,4,0.84
2020030224,12,57:14:00,0.0,26,20,6,1,6,0.769230769
2020030225,12,56:58:00,0.0,25,23,0,2,2,0.92
2020030225,14,60:00:00,0.0,29,29,3,1,0,1.0
2020030231,21,60:00:00,0.0,25,24,4,2,1,0.96
2020030231,54,59:45:00,0.0,37,30,10,1,7,0.810810811
2020030232,21,62:07:00,0.0,41,39,2,3,2,0.951219512
2020030232,54,62:07:00,0.0,25,22,10,0,3,0.88
2020030233,54,60:00:00,0.0,20,18,2,0,2,0.9
2020030233,21,58:07:00,0.0,43,40,4,1,3,0.930232558
2020030234,54,59:37:00,0.0,18,17,0,0,1,0.944444444
2020030234,21,60:00:00,0.0,35,30,6,0,5,0.857142857
2020030235,21,60:50:00,0.0,25,22,0,1,3,0.88
2020030235,54,60:50:00,0.0,30,28,0,1,2,0.933333333
2020030236,54,59:46:00,0.0,33,30,0,1,3,0.909090909
2020030236,21,56:52:00,0.0,22,17,1,0,5,0.772727273
2020030241,52,58:51:00,0.0,32,28,6,0,4,0.875
2020030241,8,60:00:00,0.0,30,27,6,1,3,0.9
2020030242,52,57:55:00,0.0,24,23,0,0,1,0.958333333
2020030242,8,60:00:00,0.0,30,30,2,0,0,1.0
2020030243,8,60:00:00,0.0,27,26,1,0,1,0.962962963
2020030243,52,59:13:00,0.0,32,28,3,1,4,0.875
2020030244,8,61:37:00,0.0,16,14,3,0,2,0.875
2020030244,52,61:39:00,0.0,42,39,5,0,3,0.928571429
2020030311,54,59:59:00,0.0,29,28,1,1,1,0.965517241
2020030311,8,55:59:00,0.0,30,26,3,2,4,0.866666667
2020030312,54,58:27:00,0.0,23,20,0,2,3,0.869565217
2020030312,8,60:00:00,0.0,31,29,2,0,2,0.935483871
2020030313,8,72:53:00,0.0,45,43,10,1,2,0.955555556
2020030313,54,72:53:00,0.0,27,24,0,2,3,0.888888889
2020030314,8,61:18:00,0.0,21,19,1,1,2,0.904761905
2020030314,54,61:03:00,0.0,28,27,2,0,1,0.964285714
2020030315,54,58:16:00,0.0,25,22,2,0,3,0.88
2020030315,8,60:00:00,0.0,27,26,2,1,1,0.962962963
2020030316,8,61:36:00,0.0,39,37,2,1,2,0.948717949
2020030316,54,61:39:00,0.0,32,29,2,3,3,0.90625
2020030321,14,57:54:00,0.0,31,29,5,0,2,0.935483871
2020030321,2,60:00:00,0.0,31,30,3,4,1,0.967741935
2020030322,14,59:09:00,0.0,26,24,6,1,2,0.923076923
2020030322,2,6:50,0.0,6,6,1,0,0,1.0
2020030322,2,50:46:00,0.0,27,23,6,1,4,0.851851852
2020030323,2,58:13:00,0.0,25,23,1,0,2,0.92
2020030323,14,60:00:00,0.0,28,27,1,0,1,0.964285714
2020030324,2,60:00:00,0.0,30,28,0,1,2,0.933333333
2020030324,14,58:32:00,0.0,30,27,4,1,3,0.9
2020030325,14,60:00:00,0.0,21,21,3,1,0,1.0
2020030325,2,44:33:00,0.0,26,21,8,0,5,0.807692308
2020030325,2,15:27,0.0,16,13,0,0,3,0.8125
2020030326,2,60:52:00,0.0,24,22,5,0,2,0.916666667
2020030326,14,60:36:00,0.0,28,25,3,0,3,0.892857143
2020030327,14,60:00:00,0.0,18,18,3,0,0,1.0
2020030327,2,57:24:00,0.0,31,30,0,0,1,0.967741935
2020030411,14,60:00:00,0.0,19,18,1,1,1,0.947368421
2020030411,8,60:00:00,0.0,27,22,3,0,5,0.814814815
2020030412,14,59:59:00,0.0,43,42,4,1,1,0.976744186
2020030412,8,58:09:00,0.0,23,20,5,0,3,0.869565217
2020030413,8,59:30:00,0.0,29,24,0,0,5,0.827586207
2020030413,14,60:00:00,0.0,35,32,2,0,3,0.914285714
2020030414,8,63:57:00,0.0,34,32,9,1,2,0.941176471
2020030414,14,63:57:00,0.0,21,18,3,2,3,0.857142857
2020030415,14,60:00:00,0.0,22,22,1,0,0,1.0
2020030415,8,58:14:00,0.0,30,29,4,4,1,0.966666667
2021010001,10,55:37:00,,14,13,2,0,1,0.928571429
2021010001,10,4:23,,3,3,0,0,0,1.0
2021010001,8,33:38:00,,21,18,5,0,3,0.857142857
2021010001,8,26:22:00,,11,10,2,0,1,0.909090909
2021010002,19,20:00,,10,10,2,0,0,1.0
2021010002,19,39:53:00,,21,19,0,0,2,0.904761905
2021010002,30,30:25:00,,8,6,1,0,2,0.75
2021010002,30,28:04:00,,21,18,0,0,3,0.857142857
2021010003,13,40:00:00,,19,17,5,0,2,0.894736842
2021010003,13,20:46,,11,9,0,0,2,0.818181818
2021010003,18,20:35,,15,11,4,1,4,0.733333333
2021010003,18,40:00:00,,21,20,5,0,1,0.952380952
2021010004,15,39:39:00,,14,12,1,0,2,0.857142857
2021010004,15,25:00:00,,9,9,1,1,0,1.0
2021010004,6,30:11:00,,19,18,6,1,1,0.947368421
2021010004,6,34:49:00,,12,11,2,1,1,0.916666667
2021010005,13,59:41:00,,30,29,6,1,1,0.966666667
2021010005,13,,,0,0,0,0,0,
2021010005,18,58:00:00,,30,27,1,2,3,0.9
2021010005,18,,,0,0,0,0,0,
2021010006,3,27:16:00,,8,7,0,1,1,0.875
2021010006,3,32:44:00,,15,12,3,0,3,0.8
2021010006,2,27:16:00,,15,15,4,0,0,1.0
2021010006,2,32:44:00,,13,13,1,1,0,1.0
2021010007,52,60:23:00,,27,24,8,1,3,0.888888889
2021010007,52,,,0,0,0,0,0,
2021010007,9,30:31:00,,19,17,3,4,2,0.894736842
2021010007,9,29:54:00,,14,14,3,0,0,1.0
2021010008,24,29:55:00,,14,13,6,0,1,0.928571429
2021010008,24,30:05:00,,13,11,3,0,2,0.846153846
2021010008,28,29:49:00,,10,8,2,2,2,0.8
2021010008,28,30:02:00,,17,14,1,0,3,0.823529412
2021010009,20,29:58:00,,26,24,5,0,2,0.923076923
2021010009,20,30:02:00,,23,21,11,0,2,0.913043478
2021010009,22,29:58:00,,7,7,1,0,0,1.0
2021010009,22,30:02:00,,8,8,2,0,0,1.0
2021010010,55,31:01:00,,7,5,0,5,2,0.714285714
2021010010,55,28:59:00,,8,7,0,7,1,0.875
2021010010,23,20:00,,11,9,0,9,2,0.818181818
2021010010,23,40:00:00,,27,24,0,24,3,0.888888889
2021010011,54,,,0,0,0,0,0,
2021010011,54,59:51:00,,28,24,2,0,4,0.857142857
2021010011,28,,,0,0,0,0,0,
2021010011,28,59:46:00,,23,21,5,1,2,0.913043478
2021010012,8,29:46:00,,15,15,0,2,0,1.0
2021010012,8,30:14:00,,22,20,0,2,2,0.909090909
2021010012,10,28:48:00,,8,7,3,0,1,0.875
2021010012,10,29:46:00,,12,9,3,1,3,0.75
2021010013,5,27:11:00,,13,12,5,0,1,0.923076923
2021010013,5,31:34:00,,9,8,3,0,1,0.888888889
2021010013,29,31:55:00,,20,20,7,0,0,1.0
2021010013,29,28:05:00,,8,8,0,0,0,1.0
2021010014,19,41:43:00,,11,11,3,0,0,1.0
2021010014,19,20:00,,13,12,6,0,1,0.923076923
2021010014,25,21:43,,13,12,1,0,1,0.923076923
2021010014,25,40:00:00,,16,15,3,0,1,0.9375
2021010015,53,40:00:00,,19,18,5,1,1,0.947368421
2021010015,53,20:00,,17,17,0,1,0,1.0
2021010015,26,23:35,,9,8,4,0,1,0.888888889
2021010015,26,34:40:00,,15,14,6,0,1,0.933333333
2021010016,23,60:00:00,,28,26,0,26,2,0.928571429
2021010016,20,30:03:00,,15,12,0,12,3,0.8
2021010016,20,29:57:00,,15,14,0,14,1,0.933333333
2021010017,3,30:21:00,,12,11,4,1,1,0.916666667
2021010017,3,29:15:00,,16,15,2,0,1,0.9375
2021010017,6,30:21:00,,13,11,1,0,2,0.846153846
2021010017,6,28:16:00,,8,7,1,0,1,0.875
2021010018,4,20:22,,11,9,1,0,2,0.818181818
2021010018,4,40:00:00,,18,17,4,2,1,0.944444444
2021010018,2,30:24:00,,11,10,4,0,1,0.909090909
2021010018,2,29:45:00,,16,15,4,1,1,0.9375
2021010019,29,25:00:00,,14,11,1,0,3,0.785714286
2021010019,29,38:27:00,,15,14,1,0,1,0.933333333
2021010019,7,33:56:00,,17,16,1,1,1,0.941176471
2021010019,7,29:56:00,,15,12,4,0,3,0.8
2021010020,12,60:00:00,,37,36,3,0,1,0.972972973
2021010020,12,,,0,0,0,0,0,
2021010020,14,58:17:00,,32,29,1,1,3,0.90625
2021010020,14,,,0,0,0,0,0,
2021010021,22,29:52:00,,16,16,1,1,0,1.0
2021010021,22,30:07:00,,18,18,4,0,0,1.0
2021010021,55,20:00,,10,9,2,0,1,0.9
2021010021,55,39:58:00,,23,18,3,3,5,0.782608696
2021010022,54,,,0,0,0,0,0,
2021010022,54,60:00:00,,22,19,8,0,3,0.863636364
2021010022,21,28:16:00,,13,11,1,2,2,0.846153846
2021010022,21,30:03:00,,16,14,2,0,2,0.875
2021010023,28,19:14,,12,11,3,0,1,0.916666667
2021010023,28,40:00:00,,21,18,3,2,3,0.857142857
2021010023,26,31:55:00,,23,22,7,0,1,0.956521739
2021010023,26,28:05:00,,15,13,2,2,2,0.866666667
2021010024,15,19:02,,8,6,0,0,2,0.75
2021010024,15,39:56:00,,15,12,2,1,3,0.8
2021010024,1,40:00:00,,17,13,0,1,4,0.764705882
2021010024,1,20:00,,10,10,0,0,0,1.0
2021010025,29,19:55,,12,11,1,0,1,0.916666667
2021010025,29,39:52:00,,26,25,0,3,1,0.961538462
2021010025,19,29:55:00,,19,16,1,0,3,0.842105263
2021010025,19,29:33:00,,14,13,1,0,1,0.928571429
2021010026,9,40:00:00,,25,22,3,3,3,0.88
2021010026,9,20:00,,7,6,2,0,1,0.857142857
2021010026,10,,,0,0,0,0,0,
2021010026,10,60:00:00,,19,19,4,2,0,1.0
2021010027,25,65:00:00,,28,25,2,0,3,0.892857143
2021010027,25,,,0,0,0,0,0,
2021010027,13,63:23:00,,38,35,3,0,3,0.921052632
2021010027,13,,,0,0,0,0,0,
2021010028,52,,,0,0,0,0,0,
2021010028,52,59:27:00,,18,17,1,0,1,0.944444444
2021010028,22,32:14:00,,19,16,2,0,3,0.842105263
2021010028,22,27:22:00,,9,7,0,0,2,0.777777778
2021010029,16,65:00:00,,33,30,4,1,3,0.909090909
2021010029,16,,,0,0,0,0,0,
2021010029,17,30:14:00,,15,12,6,0,3,0.8
2021010029,17,34:35:00,,24,24,4,0,0,1.0
2021010030,20,,,0,0,0,0,0,
2021010030,20,64:32:00,,21,18,0,0,3,0.857142857
2021010030,55,40:00:00,,11,9,3,0,2,0.818181818
2021010030,55,25:00:00,,11,10,2,0,1,0.909090909
2021010031,24,55:40:00,,25,21,4,4,4,0.84
2021010031,24,,,0,0,0,0,0,
2021010031,53,40:00:00,,16,15,2,1,1,0.9375
2021010031,53,20:00,,14,14,9,1,0,1.0
2021010032,14,29:28:00,,14,11,1,0,3,0.785714286
2021010032,14,30:32:00,,17,14,0,0,3,0.823529412
2021010032,18,29:28:00,,7,6,0,0,1,0.857142857
2021010032,18,30:32:00,,17,16,3,0,1,0.941176471
2021010033,6,60:00:00,,18,16,2,1,2,0.888888889
2021010033,6,,,0,0,0,0,0,
2021010033,4,29:14:00,,13,12,3,1,1,0.923076923
2021010033,4,30:42:00,,11,8,2,0,3,0.727272727
2021010034,17,28:08:00,,13,13,1,0,0,1.0
2021010034,17,31:52:00,,19,17,3,0,2,0.894736842
2021010034,7,59:43:00,,31,26,10,0,5,0.838709677
2021010034,7,,,0,0,0,0,0,
2021010035,21,31:09:00,,15,12,2,2,3,0.8
2021010035,21,28:51:00,,20,19,6,0,1,0.95
2021010035,30,30:53:00,,24,22,4,2,2,0.916666667
2021010035,30,27:47:00,,8,5,0,1,3,0.625
2021010036,26,60:00:00,,19,18,0,18,1,0.947368421
2021010036,54,20:00,,4,3,0,3,1,0.75
2021010036,54,39:32:00,,20,18,0,18,2,0.9
2021010037,24,30:07:00,,16,14,0,1,2,0.875
2021010037,24,29:09:00,,16,15,1,1,1,0.9375
2021010037,28,,,0,0,0,0,0,
2021010037,28,60:00:00,,25,24,2,0,1,0.96
2021010038,7,18:06,,6,6,0,0,0,1.0
2021010038,7,40:00:00,,20,18,4,0,2,0.9
2021010038,5,30:30:00,,11,11,2,1,0,1.0
2021010038,5,29:30:00,,21,20,0,0,1,0.952380952
2021010039,1,60:00:00,,25,24,3,2,1,0.96
2021010039,1,,,0,0,0,0,0,
2021010039,3,31:21:00,,20,16,2,0,4,0.8
2021010039,3,28:39:00,,14,11,1,0,3,0.785714286
2021010040,13,20:00,,16,14,2,0,2,0.875
2021010040,13,40:00:00,,12,11,0,0,1,0.916666667
2021010040,25,,,0,0,0,0,0,
2021010040,25,58:16:00,,35,30,3,2,5,0.857142857
2021010041,14,,,0,0,0,0,0,
2021010041,14,59:48:00,,44,39,8,2,5,0.886363636
2021010041,12,58:38:00,,25,18,2,1,7,0.72
2021010041,12,,,0,0,0,0,0,
2021010042,9,59:07:00,,27,25,3,0,2,0.925925926
2021010042,9,0:53,,0,0,0,0,0,
2021010042,8,39:59:00,,29,23,6,0,6,0.793103448
2021010042,8,19:38,,5,4,0,1,1,0.8
2021010043,16,33:01:00,,17,15,4,0,2,0.882352941
2021010043,16,26:38:00,,22,19,3,0,3,0.863636364
2021010043,19,20:00,,7,6,0,0,1,0.857142857
2021010043,19,39:54:00,,20,18,2,1,2,0.9
2021010044,20,40:00:00,,15,14,1,0,1,0.933333333
2021010044,20,20:00,,7,7,3,0,0,1.0
2021010044,23,58:42:00,,30,27,5,0,3,0.9
2021010044,23,,,0,0,0,0,0,
2021010045,54,,,0,0,0,0,0,
2021010045,54,60:00:00,,38,38,7,0,0,1.0
2021010045,26,60:00:00,,28,24,3,2,4,0.857142857
2021010045,26,,,0,0,0,0,0,
2021010046,55,39:53:00,,17,16,0,16,1,0.941176471
2021010046,55,22:11,,9,9,0,9,0,1.0
2021010046,22,63:02:00,,41,39,0,39,2,0.951219512
2021010047,53,39:59:00,,16,14,2,2,2,0.875
2021010047,53,19:37,,11,10,0,0,1,0.909090909
2021010047,24,,,0,0,0,0,0,
2021010047,24,58:22:00,,31,27,3,0,4,0.870967742
2021010048,8,60:00:00,,20,19,7,2,1,0.95
2021010048,8,,,0,0,0,0,0,
2021010048,9,39:57:00,,18,17,5,1,1,0.944444444
2021010048,9,18:59,,5,4,0,0,1,0.8
2021010049,4,,,0,0,0,0,0,
2021010049,4,59:53:00,,22,21,1,0,1,0.954545455
2021010049,15,,,0,0,0,0,0,
2021010049,15,58:01:00,,31,28,4,1,3,0.903225806
2021010050,22,59:50:00,,34,31,0,0,3,0.911764706
2021010050,22,,,0,0,0,0,0,
2021010050,52,58:51:00,,27,23,3,0,4,0.851851852
2021010050,52,,,0,0,0,0,0,
2021010051,6,61:38:00,,19,15,0,3,4,0.789473684
2021010051,6,,,0,0,0,0,0,
2021010051,3,40:00:00,,25,22,5,0,3,0.88
2021010051,3,21:38,,11,11,0,0,0,1.0
2021010052,17,31:34:00,,8,8,0,0,0,1.0
2021010052,17,28:02:00,,12,11,5,1,1,0.916666667
2021010052,29,,,0,0,0,0,0,
2021010052,29,59:38:00,,23,18,1,0,5,0.782608696
2021010053,2,40:00:00,,11,11,0,11,0,1.0
2021010053,2,23:15,,7,5,0,5,2,0.714285714
2021010053,1,20:00,,16,15,0,15,1,0.9375
2021010053,1,43:36:00,,22,22,0,22,0,1.0
2021010054,18,,,0,0,0,0,0,
2021010054,18,60:00:00,,17,16,7,0,1,0.941176471
2021010054,14,59:49:00,,27,21,4,3,6,0.777777778
2021010054,14,,,0,0,0,0,0,
2021010055,19,20:00,,5,4,0,4,1,0.8
2021010055,19,40:00:00,,17,13,0,13,4,0.764705882
2021010055,16,60:00:00,,32,31,0,31,1,0.96875
2021010056,55,60:00:00,,13,9,0,9,4,0.692307692
2021010056,20,60:00:00,,22,21,0,21,1,0.954545455
2021010057,5,59:55:00,,26,25,2,2,1,0.961538462
2021010057,5,,,0,0,0,0,0,
2021010057,17,24:45:00,,9,8,1,0,1,0.888888889
2021010057,17,35:15:00,,23,19,2,1,4,0.826086957
2021010058,23,40:00:00,,10,9,1,0,1,0.9
2021010058,23,20:00,,8,7,0,1,1,0.875
2021010058,52,,,0,0,0,0,0,
2021010058,52,58:07:00,,33,30,12,0,3,0.909090909
2021010059,4,,,0,0,0,0,0,
2021010059,4,59:49:00,,25,24,3,0,1,0.96
2021010059,6,60:50:00,,36,34,11,0,2,0.944444444
2021010059,6,,,0,0,0,0,0,
2021010060,7,58:05:00,,30,25,1,0,5,0.833333333
2021010060,7,,,0,0,0,0,0,
2021010060,29,20:00,,10,8,0,0,2,0.8
2021010060,29,39:57:00,,18,17,0,0,1,0.944444444
2021010061,1,39:47:00,,16,15,1,0,1,0.9375
2021010061,1,20:00,,5,5,0,0,0,1.0
2021010061,15,57:22:00,,25,22,2,1,3,0.88
2021010061,15,,,0,0,0,0,0,
2021010062,9,58:31:00,,26,24,5,3,2,0.923076923
2021010062,9,,,0,0,0,0,0,
2021010062,10,60:00:00,,27,26,5,0,1,0.962962963
2021010062,10,,,0,0,0,0,0,
2021010063,17,57:52:00,,33,28,3,0,5,0.848484848
2021010063,17,,,0,0,0,0,0,
2021010063,16,59:56:00,,40,36,10,0,4,0.9
2021010063,16,,,0,0,0,0,0,
2021010064,30,60:00:00,,16,15,3,1,1,0.9375
2021010064,30,,,0,0,0,0,0,
2021010064,21,57:17:00,,32,29,3,0,3,0.90625
2021010064,21,,,0,0,0,0,0,
2021010065,22,59:56:00,,29,26,3,0,3,0.896551724
2021010065,22,,,0,0,0,0,0,
2021010065,20,58:58:00,,35,31,4,0,4,0.885714286
2021010065,20,,,0,0,0,0,0,
2021010066,28,,,0,0,0,0,0,
2021010066,28,65:00:00,,25,23,3,0,2,0.92
2021010066,24,,,0,0,0,0,0,
2021010066,24,65:00:00,,44,42,12,0,2,0.954545455
2021010067,10,59:50:00,,22,20,5,1,2,0.909090909
2021010067,10,,,0,0,0,0,0,
2021010067,8,,,0,0,0,0,0,
2021010067,8,60:00:00,,44,38,8,1,6,0.863636364
2021010068,5,64:25:00,,27,23,1,1,4,0.851851852
2021010068,5,,,0,0,0,0,0,
2021010068,7,30:15:00,,18,17,3,0,1,0.944444444
2021010068,7,34:45:00,,22,19,0,0,3,0.863636364
2021010069,12,62:49:00,,34,31,0,2,3,0.911764706
2021010069,12,,,0,0,0,0,0,
2021010069,18,,,0,0,0,0,0,
2021010069,18,62:49:00,,42,40,1,0,2,0.952380952
2021010070,2,59:45:00,,24,24,0,24,0,1.0
2021010070,4,60:00:00,,30,27,0,27,3,0.9
2021010071,14,58:32:00,,28,25,0,25,3,0.892857143
2021010071,13,60:00:00,,30,28,0,28,2,0.933333333
2021010072,25,,,0,0,0,0,0,
2021010072,25,60:00:00,,28,27,5,0,1,0.964285714
2021010072,19,,,0,0,0,0,0,
2021010072,19,58:22:00,,28,26,8,1,2,0.928571429
2021010073,21,29:16:00,,17,13,2,0,4,0.764705882
2021010073,21,29:49:00,,20,18,5,0,2,0.9
2021010073,54,60:00:00,,38,34,1,3,4,0.894736842
2021010073,54,,,0,0,0,0,0,
2021010074,23,59:50:00,,25,21,11,0,4,0.84
2021010074,23,,,0,0,0,0,0,
2021010074,55,59:25:00,,38,38,12,3,0,1.0
2021010074,55,,,0,0,0,0,0,
2021010075,26,57:54:00,,19,16,2,0,3,0.842105263
2021010075,26,,,0,0,0,0,0,
2021010075,53,60:00:00,,39,38,5,1,1,0.974358974
2021010075,53,,,0,0,0,0,0,
2021010076,6,,,0,0,0,0,0,
2021010076,6,61:33:00,,30,26,5,0,4,0.866666667
2021010076,15,61:37:00,,36,33,4,2,3,0.916666667
2021010076,15,,,0,0,0,0,0,
2021010077,3,60:00:00,,34,32,4,2,2,0.941176471
2021010077,3,,,0,0,0,0,0,
2021010077,1,60:00:00,,32,26,2,0,6,0.8125
2021010077,1,,,0,0,0,0,0,
2021010078,29,,,0,0,0,0,0,
2021010078,29,59:33:00,,22,20,2,0,2,0.909090909
2021010078,17,,,0,0,0,0,0,
2021010078,17,60:00:00,,37,33,6,1,4,0.891891892
2021010079,52,,,0,0,0,0,0,
2021010079,52,60:00:00,,18,16,2,1,2,0.888888889
2021010079,20,,,0,0,0,0,0,
2021010079,20,59:04:00,,40,37,6,0,3,0.925
2021010080,30,60:59:00,,20,17,4,1,3,0.85
2021010080,30,,,0,0,0,0,0,
2021010080,19,62:19:00,,35,31,6,1,4,0.885714286
2021010080,19,,,0,0,0,0,0,
2021010081,24,,,0,0,0,0,0,
2021010081,24,59:29:00,,28,23,3,0,5,0.821428571
2021010081,26,,,0,0,0,0,0,
2021010081,26,60:00:00,,42,39,6,0,3,0.928571429
2021010082,8,,,0,0,0,0,0,
2021010082,8,64:35:00,,32,28,10,1,4,0.875
2021010082,9,64:49:00,,22,18,2,2,4,0.818181818
2021010082,9,,,0,0,0,0,0,
2021010084,14,59:56:00,,23,21,2,0,2,0.913043478
2021010084,14,,,0,0,0,0,0,
2021010084,13,40:00:00,,20,17,0,1,3,0.85
2021010084,13,20:00,,6,3,0,0,3,0.5
2021010085,17,60:00:00,,24,22,1,0,2,0.916666667
2021010085,17,,,0,0,0,0,0,
2021010085,5,59:36:00,,36,33,7,2,3,0.916666667
2021010085,5,,,0,0,0,0,0,
2021010086,30,62:34:00,,29,27,2,0,2,0.931034483
2021010086,30,,,0,0,0,0,0,
2021010086,16,,,0,0,0,0,0,
2021010086,16,62:34:00,,31,28,3,0,3,0.903225806
2021010087,25,59:46:00,,27,26,9,0,1,0.962962963
2021010087,25,,,0,0,0,0,0,
2021010087,21,,,0,0,0,0,0,
2021010087,21,59:07:00,,29,26,13,0,3,0.896551724
2021010088,22,59:55:00,,39,37,14,1,2,0.948717949
2021010088,22,,,0,0,0,0,0,
2021010088,23,,,0,0,0,0,0,
2021010088,23,57:15:00,,42,39,16,1,3,0.928571429
2021010089,54,,,0,0,0,0,0,
2021010089,54,60:00:00,,29,26,4,0,3,0.896551724
2021010089,53,,,0,0,0,0,0,
2021010089,53,60:00:00,,26,25,6,1,1,0.961538462
2021010090,15,60:00:00,,25,22,2,0,3,0.88
2021010090,15,,,0,0,0,0,0,
2021010090,4,,,0,0,0,0,0,
2021010090,4,59:04:00,,32,28,0,1,4,0.875
2021010091,19,,,0,0,0,0,0,
2021010091,19,60:00:00,,20,17,7,0,3,0.85
2021010091,29,,,0,0,0,0,0,
2021010091,29,60:00:00,,29,22,0,0,7,0.75862069
2021010092,20,60:00:00,,23,22,3,0,1,0.956521739
2021010092,20,,,0,0,0,0,0,
2021010092,52,,,0,0,0,0,0,
2021010092,52,59:32:00,,23,20,3,1,3,0.869565217
2021010093,7,,,0,0,0,0,0,
2021010093,7,60:00:00,,19,18,1,0,1,0.947368421
2021010093,17,,,0,0,0,0,0,
2021010093,17,58:51:00,,37,35,0,0,2,0.945945946
2021010094,18,20:00,,13,11,2,0,2,0.846153846
2021010094,18,39:48:00,,24,23,7,0,1,0.958333333
2021010094,12,58:07:00,,17,13,0,1,4,0.764705882
2021010094,12,,,0,0,0,0,0,
2021010095,13,,,0,0,0,0,0,
2021010095,13,56:33:00,,29,25,6,0,4,0.862068966
2021010095,14,,,0,0,0,0,0,
2021010095,14,59:57:00,,47,45,1,2,2,0.957446809
2021010096,10,,,0,0,0,0,0,
2021010096,10,60:00:00,,19,18,2,0,1,0.947368421
2021010096,9,30:51:00,,16,13,2,1,3,0.8125
2021010096,9,29:09:00,,15,14,2,0,1,0.933333333
2021010097,29,,,0,0,0,0,0,
2021010097,29,61:18:00,,28,24,6,0,4,0.857142857
2021010097,5,,,0,0,0,0,0,
2021010097,5,61:18:00,,29,26,6,1,3,0.896551724
2021010098,21,59:45:00,,20,18,2,2,2,0.9
2021010098,21,,,0,0,0,0,0,
2021010098,25,19:26,,10,9,1,0,1,0.9
2021010098,25,40:00:00,,20,18,6,2,2,0.9
2021010099,2,60:51:00,,22,17,0,17,5,0.772727273
2021010099,3,61:46:00,,32,28,0,28,4,0.875
2021010100,28,59:57:00,,25,25,2,0,0,1.0
2021010100,28,,,0,0,0,0,0,
2021010100,54,,,0,0,0,0,0,
2021010100,54,60:00:00,,34,30,5,1,4,0.882352941
2021010101,16,60:00:00,,26,25,1,1,1,0.961538462
2021010101,16,,,0,0,0,0,0,
2021010101,30,60:00:00,,37,32,3,0,5,0.864864865
2021010101,30,,,0,0,0,0,0,
2021010102,23,56:17:00,,18,15,3,1,3,0.833333333
2021010102,23,,,0,0,0,0,0,
2021010102,22,20:00,,11,11,1,0,0,1.0
2021010102,22,40:00:00,,17,15,2,0,2,0.882352941
2021010103,26,64:58:00,,28,25,6,0,3,0.892857143
2021010103,26,,,0,0,0,0,0,
2021010103,24,64:51:00,,32,29,3,0,3,0.90625
2021010103,24,,,0,0,0,0,0,
2021010104,25,60:00:00,,17,14,0,14,3,0.823529412
2021010104,53,57:30:00,,33,28,0,28,5,0.848484848
2021020001,14,57:54:00,0.0,32,29,0,0,3,0.90625
2021020001,5,60:00:00,0.0,28,26,1,0,2,0.928571429
2021020002,54,59:44:00,0.0,31,28,3,0,3,0.903225806
2021020002,55,58:39:00,0.0,30,26,7,1,4,0.866666667
2021020003,10,60:00:00,0.0,32,31,6,1,1,0.96875
2021020003,8,58:43:00,0.0,30,28,5,0,2,0.933333333
2021020004,15,60:00:00,0.0,24,23,8,0,1,0.958333333
2021020004,3,59:34:00,0.0,27,22,6,0,5,0.814814815
2021020005,21,60:00:00,0.0,34,32,3,4,2,0.941176471
2021020005,16,56:34:00,0.0,36,32,6,1,4,0.888888889
2021020006,22,65:00:00,0.0,38,36,9,0,2,0.947368421
2021020006,23,65:00:00,0.0,34,32,3,2,2,0.941176471
2021020007,7,59:57:00,0.0,31,30,8,1,1,0.967741935
2021020007,8,60:00:00,0.0,36,31,10,1,5,0.861111111
2021020008,9,60:00:00,0.0,48,46,11,0,2,0.958333333
2021020008,10,40:00:00,0.0,26,23,3,0,3,0.884615385
2021020008,10,19:27,0.0,10,10,1,0,0,1.0
2021020009,17,62:43:00,0.0,48,41,7,5,7,0.854166667
2021020009,14,62:07:00,0.0,26,20,5,1,6,0.769230769
2021020010,13,61:19:00,2.0,47,43,18,1,4,0.914893617
2021020010,5,61:25:00,0.0,39,34,4,2,5,0.871794872
2021020011,3,61:38:00,0.0,26,23,3,1,3,0.884615385
2021020011,25,13:31,0.0,6,6,5,0,0,1.0
2021020011,25,48:07:00,0.0,27,25,2,0,2,0.925925926
2021020012,12,60:00:00,0.0,28,25,0,2,3,0.892857143
2021020012,2,57:58:00,0.0,40,35,6,2,5,0.875
2021020013,29,60:00:00,0.0,38,36,4,1,2,0.947368421
2021020013,53,59:41:00,0.0,26,18,0,1,8,0.692307692
2021020014,18,59:06:00,0.0,25,22,1,0,3,0.88
2021020014,55,59:59:00,0.0,30,27,6,0,3,0.9
2021020015,24,60:00:00,4.0,34,33,12,1,1,0.970588235
2021020015,52,58:44:00,0.0,22,18,8,0,4,0.818181818
2021020016,26,59:43:00,0.0,25,23,1,0,2,0.92
2021020016,54,20:00,0.0,16,14,0,2,2,0.875
2021020016,54,40:00:00,0.0,31,27,0,0,4,0.870967742
2021020017,1,60:57:00,0.0,27,24,5,1,3,0.888888889
2021020017,16,58:07:00,0.0,29,25,3,1,4,0.862068966
2021020018,4,63:27:00,0.0,39,35,3,0,4,0.897435897
2021020018,23,64:10:00,0.0,35,31,8,1,4,0.885714286
2021020019,24,59:55:00,0.0,43,41,8,1,2,0.953488372
2021020019,30,59:27:00,0.0,29,28,9,2,1,0.965517241
2021020020,6,59:48:00,0.0,28,27,11,1,1,0.964285714
2021020020,25,58:15:00,0.0,39,37,3,3,2,0.948717949
2021020021,7,65:00:00,0.0,21,20,4,0,1,0.952380952
2021020021,53,65:00:00,0.0,33,32,2,1,1,0.96969697
2021020022,10,60:00:00,0.0,21,20,0,1,1,0.952380952
2021020022,9,57:29:00,0.0,29,26,9,0,3,0.896551724
2021020023,8,58:38:00,0.0,23,21,3,1,2,0.913043478
2021020023,3,59:23:00,0.0,32,31,5,2,1,0.96875
2021020024,17,59:58:00,0.0,41,40,5,0,1,0.975609756
2021020024,23,57:48:00,0.0,20,18,1,1,2,0.9
2021020025,13,60:00:00,0.0,30,29,8,0,1,0.966666667
2021020025,2,60:00:00,0.0,29,24,0,0,5,0.827586207
2021020026,5,59:45:00,0.0,20,18,5,1,2,0.9
2021020026,16,11:25,0.0,10,6,2,0,4,0.6
2021020026,16,48:22:00,0.0,16,15,0,0,1,0.9375
2021020027,15,64:45:00,0.0,24,22,0,0,2,0.916666667
2021020027,14,64:45:00,0.0,33,32,7,0,1,0.96969697
2021020028,29,62:16:00,0.0,20,19,0,0,1,0.95
2021020028,55,62:16:00,0.0,25,23,0,0,2,0.92
2021020029,18,59:07:00,0.0,31,29,3,1,2,0.935483871
2021020029,12,60:00:00,0.0,40,38,9,3,2,0.95
2021020030,21,56:26:00,0.0,27,23,4,1,4,0.851851852
2021020030,19,60:00:00,0.0,32,29,3,1,3,0.90625
2021020031,22,60:00:00,0.0,47,45,10,2,2,0.957446809
2021020031,20,58:55:00,0.0,32,28,4,2,4,0.875
2021020032,26,58:09:00,0.0,30,27,3,0,3,0.9
2021020032,30,60:00:00,0.0,31,29,4,0,2,0.935483871
2021020033,28,60:00:00,0.0,23,20,2,2,3,0.869565217
2021020033,52,58:12:00,0.0,31,27,7,2,4,0.870967742
2021020034,9,60:00:00,0.0,34,32,0,2,2,0.941176471
2021020034,25,58:45:00,0.0,27,24,1,1,3,0.888888889
2021020035,10,63:48:00,0.0,23,21,2,0,2,0.913043478
2021020035,3,63:48:00,0.0,41,40,8,0,1,0.975609756
2021020036,4,60:00:00,0.0,24,23,5,1,1,0.958333333
2021020036,55,28:49:00,0.0,20,15,0,0,5,0.75
2021020036,55,31:11:00,0.0,7,6,1,0,1,0.857142857
2021020037,20,63:23:00,0.0,27,24,1,0,3,0.888888889
2021020037,24,63:26:00,0.0,43,41,6,1,2,0.953488372
2021020038,53,36:17:00,0.0,21,15,4,1,6,0.714285714
2021020038,53,23:43,0.0,12,11,0,1,1,0.916666667
2021020038,19,60:00:00,0.0,26,22,7,0,4,0.846153846
2021020039,7,60:00:00,0.0,34,32,6,0,2,0.941176471
2021020039,23,59:16:00,0.0,42,38,10,1,4,0.904761905
2021020040,8,59:58:00,0.0,25,20,7,0,5,0.8
2021020040,28,60:00:00,0.0,21,21,4,1,0,1.0
2021020041,17,59:54:00,0.0,23,22,2,0,1,0.956521739
2021020041,29,58:35:00,0.0,43,41,5,1,2,0.953488372
2021020042,14,57:45:00,0.0,31,28,5,1,3,0.903225806
2021020042,13,59:31:00,0.0,31,30,9,0,1,0.967741935
2021020043,1,60:00:00,0.0,29,27,6,0,2,0.931034483
2021020043,55,58:32:00,0.0,32,29,6,0,3,0.90625
2021020044,5,65:00:00,0.0,29,28,0,0,1,0.965517241
2021020044,25,65:00:00,0.0,28,27,0,0,1,0.964285714
2021020045,15,60:00:00,0.0,27,24,7,0,3,0.888888889
2021020045,21,57:44:00,0.0,39,34,5,1,5,0.871794872
2021020046,16,59:54:00,0.0,29,25,5,2,4,0.862068966
2021020046,2,60:00:00,0.0,40,39,6,3,1,0.975
2021020047,18,59:34:00,0.0,26,25,2,1,1,0.961538462
2021020047,26,57:58:00,0.0,31,29,4,0,2,0.935483871
2021020048,30,61:46:00,0.0,30,25,4,2,5,0.833333333
2021020048,52,63:20:00,0.0,44,38,3,1,6,0.863636364
2021020049,22,27:42:00,0.0,21,20,1,0,1,0.952380952
2021020049,22,31:04:00,0.0,15,11,0,2,4,0.733333333
2021020049,24,57:41:00,0.0,36,31,5,1,5,0.861111111
2021020050,4,60:00:00,0.0,40,37,0,2,3,0.925
2021020050,6,59:29:00,0.0,24,19,0,1,5,0.791666667
2021020051,54,58:49:00,0.0,37,35,4,1,2,0.945945946
2021020051,19,60:00:00,0.0,43,42,3,0,1,0.976744186
2021020052,8,57:28:00,0.0,32,29,1,1,3,0.90625
2021020052,12,60:00:00,0.0,28,27,5,0,1,0.964285714
2021020053,9,58:08:00,0.0,24,22,3,1,2,0.916666667
2021020053,28,60:00:00,0.0,31,30,3,2,1,0.967741935
2021020054,17,59:41:00,0.0,28,26,1,2,2,0.928571429
2021020054,20,60:00:00,0.0,33,33,0,1,0,1.0
2021020055,13,60:00:00,0.0,31,30,0,0,1,0.967741935
2021020055,21,59:21:00,0.0,37,34,7,0,3,0.918918919
2021020056,1,60:00:00,0.0,27,23,2,0,4,0.851851852
2021020056,15,60:00:00,0.0,26,25,1,1,1,0.961538462
2021020057,29,61:49:00,0.0,36,34,5,1,2,0.944444444
2021020057,2,61:49:00,0.0,32,29,5,0,3,0.90625
2021020058,16,58:18:00,0.0,24,21,5,3,3,0.875
2021020058,23,60:00:00,0.0,30,29,7,1,1,0.966666667
2021020059,18,57:12:00,0.0,29,27,8,1,2,0.931034483
2021020059,3,59:33:00,0.0,29,28,5,0,1,0.965517241
2021020060,52,60:00:00,0.0,39,38,5,0,1,0.974358974
2021020060,24,58:32:00,0.0,26,22,4,1,4,0.846153846
2021020061,53,60:00:00,0.0,31,26,1,3,5,0.838709677
2021020061,22,60:00:00,0.0,28,27,3,0,1,0.964285714
2021020062,7,58:55:00,0.0,25,22,2,1,3,0.88
2021020062,6,60:00:00,0.0,36,35,4,1,1,0.972222222
2021020063,10,58:43:00,0.0,30,26,4,0,4,0.866666667
2021020063,28,60:00:00,0.0,33,30,4,1,3,0.909090909
2021020064,25,64:06:00,0.0,45,43,10,2,2,0.955555556
2021020064,26,64:15:00,0.0,23,20,3,3,3,0.869565217
2021020065,54,58:36:00,0.0,32,28,8,1,4,0.875
2021020065,22,59:57:00,0.0,39,36,5,0,3,0.923076923
2021020066,8,60:00:00,0.0,27,26,5,1,1,0.962962963
2021020066,17,29:59:00,0.0,17,12,2,0,5,0.705882353
2021020066,17,29:35:00,0.0,6,6,0,0,0,1.0
2021020067,9,54:17:00,0.0,23,22,8,1,1,0.956521739
2021020067,9,4:16,0.0,3,1,0,0,2,0.333333333
2021020067,3,60:00:00,0.0,28,26,2,0,2,0.928571429
2021020068,14,64:42:00,2.0,27,24,4,3,3,0.888888889
2021020068,21,65:00:00,0.0,32,29,5,1,3,0.90625
2021020069,1,62:33:00,0.0,25,24,0,0,1,0.96
2021020069,7,63:09:00,0.0,39,37,2,0,2,0.948717949
2021020070,4,58:30:00,0.0,30,27,3,2,3,0.9
2021020070,13,59:57:00,0.0,29,27,5,1,2,0.931034483
2021020071,5,59:58:00,0.0,29,28,7,1,1,0.965517241
2021020071,10,20:00,0.0,12,10,1,1,2,0.833333333
2021020071,10,40:00:00,0.0,21,16,3,1,5,0.761904762
2021020072,15,42:46:00,0.0,14,13,1,0,1,0.928571429
2021020072,15,20:00,0.0,13,10,2,1,3,0.769230769
2021020072,20,62:46:00,0.0,25,22,3,1,3,0.88
2021020073,29,60:00:00,0.0,33,28,5,3,5,0.848484848
2021020073,12,59:59:00,0.0,28,27,2,4,1,0.964285714
2021020074,19,59:53:00,0.0,35,32,2,3,3,0.914285714
2021020074,26,60:00:00,0.0,40,33,7,2,7,0.825
2021020075,30,64:47:00,0.0,24,21,4,0,3,0.875
2021020075,24,64:47:00,0.0,36,32,7,1,4,0.888888889
2021020076,52,60:00:00,0.0,30,26,7,0,4,0.866666667
2021020076,18,56:53:00,0.0,29,23,3,1,6,0.793103448
2021020077,53,59:58:00,0.0,24,21,1,0,3,0.875
2021020077,2,60:00:00,0.0,26,26,0,1,0,1.0
2021020078,55,58:58:00,0.0,25,22,3,0,3,0.88
2021020078,23,59:40:00,0.0,31,29,4,0,2,0.935483871
2021020079,6,60:00:00,0.0,26,23,5,1,3,0.884615385
2021020079,28,25:41:00,0.0,14,10,0,1,4,0.714285714
2021020079,28,32:42:00,0.0,20,20,4,0,0,1.0
2021020080,16,60:00:00,0.0,37,31,5,0,6,0.837837838
2021020080,17,60:00:00,0.0,35,32,15,2,3,0.914285714
2021020081,30,55:57:00,0.0,29,24,8,1,5,0.827586207
2021020081,18,59:28:00,0.0,35,33,8,0,2,0.942857143
2021020082,54,57:39:00,0.0,26,24,4,0,2,0.923076923
2021020082,2,60:00:00,0.0,42,42,4,2,0,1.0
2021020083,7,59:58:00,0.0,36,35,2,0,1,0.972222222
2021020083,14,57:04:00,0.0,23,20,3,1,3,0.869565217
2021020084,9,15:43,0.0,16,12,0,0,4,0.75
2021020084,9,41:12:00,0.0,15,12,1,0,3,0.8
2021020084,15,60:00:00,0.0,37,32,6,0,5,0.864864865
2021020085,13,60:00:00,0.0,21,18,3,0,3,0.857142857
2021020085,53,20:00,0.0,11,10,1,0,1,0.909090909
2021020085,53,39:08:00,0.0,29,26,4,1,3,0.896551724
2021020086,3,59:55:00,0.0,37,32,1,1,5,0.864864865
2021020086,20,59:30:00,0.0,29,28,4,2,1,0.965517241
2021020087,12,60:00:00,0.0,25,24,2,0,1,0.96
2021020087,10,57:46:00,0.0,35,32,3,0,3,0.914285714
2021020088,29,60:00:00,0.0,32,31,7,2,1,0.96875
2021020088,25,58:09:00,0.0,25,22,8,0,3,0.88
2021020089,19,60:00:00,0.0,34,34,10,1,0,1.0
2021020089,26,59:35:00,0.0,34,32,5,1,2,0.941176471
2021020090,1,44:26:00,0.0,22,20,1,2,2,0.909090909
2021020090,1,12:10,0.0,7,4,1,0,3,0.571428571
2021020090,20,59:46:00,0.0,30,27,4,0,3,0.9
2021020091,5,58:27:00,0.0,29,26,1,1,3,0.896551724
2021020091,14,60:00:00,0.0,29,28,6,0,1,0.965517241
2021020092,18,60:00:00,0.0,29,28,6,0,1,0.965517241
2021020092,28,58:46:00,0.0,25,23,0,1,2,0.92
2021020093,21,58:39:00,0.0,28,26,7,0,2,0.928571429
2021020093,54,60:00:00,0.0,27,26,2,0,1,0.962962963
2021020094,23,58:46:00,0.0,30,27,3,1,3,0.9
2021020094,30,60:00:00,0.0,24,22,6,0,2,0.916666667
2021020095,24,59:10:00,0.0,25,21,2,1,4,0.84
2021020095,52,59:38:00,0.0,35,32,6,1,3,0.914285714
2021020096,55,60:00:00,0.0,24,23,3,1,1,0.958333333
2021020096,8,60:00:00,0.0,26,21,6,0,5,0.807692308
2021020097,13,60:00:00,0.0,31,30,5,0,1,0.967741935
2021020097,6,57:16:00,0.0,26,23,0,1,3,0.884615385
2021020098,15,61:12:00,0.0,25,22,2,2,3,0.88
2021020098,17,61:36:00,0.0,28,26,4,0,2,0.928571429
2021020099,16,61:58:00,0.0,40,37,8,1,3,0.925
2021020099,10,61:58:00,0.0,29,27,4,2,2,0.931034483
2021020100,25,61:59:00,0.0,21,18,2,0,3,0.857142857
2021020100,54,60:42:00,0.0,34,32,0,0,2,0.941176471
2021020101,22,58:07:00,0.0,33,29,5,2,4,0.878787879
2021020101,4,60:00:00,0.0,37,34,7,0,3,0.918918919
2021020102,14,60:00:00,0.0,25,24,1,2,1,0.96
2021020102,53,60:00:00,0.0,28,23,7,0,5,0.821428571
2021020103,5,60:00:00,0.0,35,31,4,1,4,0.885714286
2021020103,20,60:00:00,0.0,45,45,8,1,0,1.0
2021020104,12,60:00:00,0.0,33,33,1,1,0,1.0
2021020104,6,58:02:00,0.0,23,21,3,0,2,0.913043478
2021020105,19,58:11:00,10.0,42,38,6,0,4,0.904761905
2021020105,21,60:00:00,0.0,18,15,0,0,3,0.833333333
2021020106,23,58:19:00,0.0,28,26,4,0,2,0.928571429
2021020106,4,59:13:00,0.0,28,27,9,1,1,0.964285714
2021020107,24,64:16:00,0.0,29,25,0,0,4,0.862068966
2021020107,7,64:16:00,0.0,37,34,0,2,3,0.918918919
2021020108,26,58:15:00,0.0,31,28,5,0,3,0.903225806
2021020108,52,60:00:00,0.0,32,30,0,1,2,0.9375
2021020109,28,58:44:00,0.0,31,28,4,4,3,0.903225806
2021020109,8,60:00:00,0.0,45,45,13,1,0,1.0
2021020110,55,60:00:00,0.0,31,30,5,2,1,0.967741935
2021020110,30,58:20:00,0.0,36,34,5,1,2,0.944444444
2021020111,17,63:13:00,0.0,33,30,3,1,3,0.909090909
2021020111,13,63:29:00,0.0,30,28,5,1,2,0.933333333
2021020112,3,60:00:00,0.0,31,31,2,1,0,1.0
2021020112,29,59:36:00,0.0,37,33,7,1,4,0.891891892
2021020113,15,59:21:00,0.0,16,16,2,1,0,1.0
2021020113,53,59:01:00,0.0,31,30,7,1,1,0.967741935
2021020114,12,60:00:00,0.0,26,23,7,0,3,0.884615385
2021020114,16,60:00:00,0.0,35,29,6,4,6,0.828571429
2021020115,25,56:32:00,0.0,24,20,1,0,4,0.833333333
2021020115,9,60:00:00,0.0,39,38,2,1,1,0.974358974
2021020116,54,65:00:00,0.0,38,34,6,0,4,0.894736842
2021020116,24,65:00:00,0.0,42,38,0,0,4,0.904761905
2021020117,6,65:00:00,0.0,35,33,0,1,2,0.942857143
2021020117,13,65:00:00,0.0,33,31,5,0,2,0.939393939
2021020118,10,60:00:00,0.0,31,27,1,1,4,0.870967742
2021020118,17,58:32:00,0.0,38,33,0,0,5,0.868421053
2021020119,5,58:56:00,0.0,40,36,0,5,4,0.9
2021020119,1,60:00:00,0.0,35,33,8,0,2,0.942857143
2021020120,19,59:42:00,0.0,25,25,2,2,0,1.0
2021020120,16,58:24:00,0.0,37,36,1,3,1,0.972972973
2021020121,18,64:18:00,0.0,36,34,5,2,2,0.944444444
2021020121,2,65:00:00,0.0,23,21,6,0,2,0.913043478
2021020122,21,59:58:00,0.0,30,29,3,0,1,0.966666667
2021020122,30,59:27:00,0.0,30,27,5,0,3,0.9
2021020123,20,59:57:00,0.0,20,20,3,0,0,1.0
2021020123,4,59:06:00,0.0,35,32,6,1,3,0.914285714
2021020124,23,55:52:00,0.0,34,32,3,0,2,0.941176471
2021020124,22,60:00:00,0.0,30,29,4,0,1,0.966666667
2021020125,26,60:00:00,0.0,28,26,4,0,2,0.928571429
2021020125,8,60:00:00,0.0,38,33,3,2,5,0.868421053
2021020126,28,61:07:00,0.0,35,34,0,0,1,0.971428571
2021020126,52,61:07:00,0.0,36,34,2,0,2,0.944444444
2021020127,1,65:00:00,0.0,26,23,2,0,3,0.884615385
2021020127,29,65:00:00,0.0,39,36,4,0,3,0.923076923
2021020128,12,60:00:00,0.0,23,22,5,0,1,0.956521739
2021020128,53,58:25:00,0.0,39,37,8,1,2,0.948717949
2021020129,24,59:46:00,0.0,18,16,2,1,2,0.888888889
2021020129,8,58:14:00,0.0,25,22,5,0,3,0.88
2021020130,26,59:23:00,0.0,24,22,1,1,2,0.916666667
2021020130,7,59:25:00,0.0,34,31,8,2,3,0.911764706
2021020131,55,58:19:00,0.0,17,15,0,0,2,0.882352941
2021020131,3,60:00:00,0.0,32,31,8,0,1,0.96875
2021020132,14,60:00:00,0.0,33,31,6,3,2,0.939393939
2021020132,15,58:45:00,0.0,26,23,6,1,3,0.884615385
2021020133,16,59:53:00,0.0,30,29,6,0,1,0.966666667
2021020133,9,60:00:00,0.0,31,26,7,0,5,0.838709677
2021020134,22,59:35:00,0.0,29,27,6,0,2,0.931034483
2021020134,55,59:50:00,0.0,23,18,6,0,5,0.782608696
2021020135,10,60:00:00,0.0,26,26,2,0,0,1.0
2021020135,54,60:00:00,0.0,33,29,2,2,4,0.878787879
2021020136,8,60:00:00,0.0,22,22,0,0,0,1.0
2021020136,17,58:11:00,0.0,40,38,1,0,2,0.95
2021020137,4,60:00:00,0.0,29,29,0,1,0,1.0
2021020137,53,59:45:00,0.0,33,31,6,0,2,0.939393939
2021020138,30,62:02:00,0.0,28,24,6,2,4,0.857142857
2021020138,9,61:37:00,0.0,43,38,1,3,5,0.88372093
2021020139,52,65:00:00,0.0,27,24,1,1,3,0.888888889
2021020139,25,64:49:00,0.0,35,32,3,0,3,0.914285714
2021020140,20,60:57:00,0.0,22,19,0,2,3,0.863636364
2021020140,18,61:37:00,0.0,40,38,6,0,2,0.95
2021020141,23,61:26:00,0.0,25,23,5,5,2,0.92
2021020141,3,62:22:00,0.0,36,33,13,0,3,0.916666667
2021020142,24,60:00:00,0.0,28,28,3,3,0,1.0
2021020142,1,60:00:00,0.0,27,23,4,3,4,0.851851852
2021020143,28,60:00:00,0.0,28,25,0,0,3,0.892857143
2021020143,7,57:30:00,0.0,27,22,1,2,5,0.814814815
2021020144,16,57:14:00,0.0,32,28,6,3,4,0.875
2021020144,12,59:46:00,0.0,30,27,5,1,3,0.9
2021020145,21,60:14:00,0.0,37,32,0,1,5,0.864864865
2021020145,29,61:12:00,0.0,32,28,9,0,4,0.875
2021020146,22,60:00:00,0.0,33,31,4,1,2,0.939393939
2021020146,18,59:35:00,0.0,29,25,3,4,4,0.862068966
2021020147,26,64:42:00,0.0,35,33,1,3,2,0.942857143
2021020147,19,63:41:00,0.0,35,33,6,0,2,0.942857143
2021020148,6,60:00:00,0.0,15,14,1,1,1,0.933333333
2021020148,17,60:00:00,0.0,37,32,4,1,5,0.864864865
2021020149,10,61:19:00,0.0,25,24,1,0,1,0.96
2021020149,14,62:43:00,0.0,34,32,4,1,2,0.941176471
2021020150,8,40:00:00,0.0,25,20,0,0,5,0.8
2021020150,8,18:17,0.0,10,10,8,0,0,1.0
2021020150,2,60:00:00,0.0,38,36,3,1,2,0.947368421
2021020151,9,58:40:00,0.0,38,34,3,1,4,0.894736842
2021020151,54,59:53:00,0.0,39,38,2,2,1,0.974358974
2021020152,13,41:55:00,0.0,29,25,2,1,4,0.862068966
2021020152,13,20:00,0.0,13,13,3,0,0,1.0
2021020152,15,25:31:00,0.0,18,15,1,1,3,0.833333333
2021020152,15,36:22:00,0.0,15,13,3,0,2,0.866666667
2021020153,5,61:43:00,0.0,38,36,1,1,2,0.947368421
2021020153,4,61:54:00,0.0,36,33,2,0,3,0.916666667
2021020154,20,62:37:00,2.0,28,24,3,1,4,0.857142857
2021020154,25,62:59:00,0.0,33,30,4,1,3,0.909090909
2021020155,28,59:22:00,0.0,27,23,4,0,4,0.851851852
2021020155,19,60:00:00,0.0,26,23,8,0,3,0.884615385
2021020156,55,60:00:00,0.0,21,19,3,0,2,0.904761905
2021020156,7,58:33:00,0.0,37,33,6,2,4,0.891891892
2021020157,52,60:00:00,0.0,18,17,2,1,1,0.944444444
2021020157,16,60:00:00,0.0,33,28,2,0,5,0.848484848
2021020158,22,63:27:00,0.0,25,20,3,0,5,0.8
2021020158,3,63:27:00,0.0,39,33,2,1,6,0.846153846
2021020159,23,57:59:00,0.0,28,25,3,2,3,0.892857143
2021020159,18,60:00:00,0.0,28,26,3,0,2,0.928571429
2021020160,24,59:24:00,0.0,29,28,1,0,1,0.965517241
2021020160,53,59:16:00,0.0,31,28,6,1,3,0.903225806
2021020161,26,60:40:00,0.0,23,21,2,0,2,0.913043478
2021020161,1,59:46:00,0.0,29,26,5,1,3,0.896551724
2021020162,7,62:45:00,0.0,33,29,4,0,4,0.878787879
2021020162,17,62:45:00,0.0,32,29,2,0,3,0.90625
2021020163,10,59:39:00,0.0,44,42,3,1,2,0.954545455
2021020163,6,58:34:00,0.0,35,31,5,1,4,0.885714286
2021020164,8,58:23:00,0.0,16,13,0,0,3,0.8125
2021020164,54,60:00:00,0.0,38,36,8,0,2,0.947368421
2021020165,9,59:32:00,0.0,32,28,2,1,4,0.875
2021020165,14,60:00:00,0.0,27,24,3,0,3,0.888888889
2021020166,13,59:51:00,0.0,32,30,5,0,2,0.9375
2021020166,12,45:20:00,0.0,27,23,2,3,4,0.851851852
2021020166,12,12:22,0.0,4,4,0,0,0,1.0
2021020167,5,64:45:00,0.0,40,36,3,0,4,0.9
2021020167,30,61:19:00,0.0,39,35,4,0,4,0.897435897
2021020168,15,57:51:00,0.0,32,30,1,1,2,0.9375
2021020168,4,59:57:00,0.0,32,31,10,0,1,0.96875
2021020169,29,60:00:00,0.0,36,34,5,1,2,0.944444444
2021020169,21,59:32:00,0.0,41,38,9,4,3,0.926829268
2021020170,52,57:46:00,0.0,31,29,1,0,2,0.935483871
2021020170,2,60:00:00,0.0,24,24,0,0,0,1.0
2021020171,20,60:00:00,0.0,22,22,6,0,0,1.0
2021020171,3,60:00:00,0.0,37,31,5,1,6,0.837837838
2021020172,53,59:01:00,0.0,29,27,5,0,2,0.931034483
2021020172,53,0:59,0.0,2,0,0,0,2,0.0
2021020172,55,58:50:00,0.0,22,17,0,0,5,0.772727273
2021020173,28,64:53:00,0.0,28,26,3,0,2,0.928571429
2021020173,1,65:00:00,0.0,27,25,3,3,2,0.925925926
2021020174,17,59:25:00,0.0,40,38,2,2,2,0.95
2021020174,54,55:56:00,0.0,29,25,1,2,4,0.862068966
2021020175,16,60:19:00,0.0,21,20,0,0,1,0.952380952
2021020175,18,60:37:00,0.0,32,30,8,0,2,0.9375
2021020176,30,59:36:00,0.0,21,19,0,0,2,0.904761905
2021020176,2,58:39:00,0.0,37,34,6,1,3,0.918918919
2021020177,23,60:00:00,0.0,28,25,2,0,3,0.892857143
2021020177,25,59:18:00,0.0,35,30,6,0,5,0.857142857
2021020178,24,60:00:00,0.0,35,34,3,0,1,0.971428571
2021020178,19,55:34:00,0.0,26,23,3,0,3,0.884615385
2021020179,10,59:34:00,0.0,28,24,2,1,4,0.857142857
2021020179,26,60:00:00,0.0,34,33,4,1,1,0.970588235
2021020180,3,59:56:00,0.0,45,42,3,0,3,0.933333333
2021020180,13,58:37:00,0.0,18,14,1,4,4,0.777777778
2021020181,15,60:00:00,0.0,28,25,3,2,3,0.892857143
2021020181,7,58:52:00,0.0,30,25,3,3,5,0.833333333
2021020182,6,59:54:00,0.0,27,25,8,2,2,0.925925926
2021020182,9,58:02:00,0.0,36,33,2,1,3,0.916666667
2021020183,8,63:39:00,0.0,34,31,7,0,3,0.911764706
2021020183,26,63:34:00,0.0,35,33,6,1,2,0.942857143
2021020184,17,60:00:00,0.0,33,31,5,1,2,0.939393939
2021020184,22,58:20:00,0.0,38,35,4,0,3,0.921052632
2021020185,14,63:26:00,0.0,31,29,9,1,2,0.935483871
2021020185,12,63:26:00,0.0,18,17,1,0,1,0.944444444
2021020186,1,60:00:00,0.0,38,35,1,1,3,0.921052632
2021020186,13,58:28:00,0.0,30,24,5,0,6,0.8
2021020187,16,64:47:00,2.0,44,42,1,0,2,0.954545455
2021020187,5,65:00:00,0.0,32,30,7,2,2,0.9375
2021020188,52,64:57:00,0.0,33,31,0,2,2,0.939393939
2021020188,19,65:00:00,0.0,41,39,2,0,2,0.951219512
2021020189,20,59:16:00,0.0,24,22,2,2,2,0.916666667
2021020189,28,60:00:00,0.0,38,37,6,0,1,0.973684211
2021020190,23,63:01:00,2.0,30,27,1,1,3,0.9
2021020190,24,63:28:00,0.0,43,41,6,2,2,0.953488372
2021020191,54,60:00:00,0.0,27,25,4,0,2,0.925925926
2021020191,55,56:21:00,0.0,23,19,1,2,4,0.826086957
2021020192,4,59:49:00,0.0,33,30,6,1,3,0.909090909
2021020192,10,59:47:00,0.0,36,36,4,1,0,1.0
2021020193,25,58:15:00,0.0,21,18,1,0,3,0.857142857
2021020193,18,60:00:00,0.0,27,25,4,0,2,0.925925926
2021020194,53,20:00,0.0,8,8,0,0,0,1.0
2021020194,53,39:13:00,0.0,22,17,1,0,5,0.772727273
2021020194,30,59:58:00,0.0,26,24,4,1,2,0.923076923
2021020195,6,57:52:00,0.0,28,23,4,3,5,0.821428571
2021020195,22,60:00:00,0.0,29,26,6,0,3,0.896551724
2021020196,8,59:42:00,0.0,26,24,4,0,2,0.923076923
2021020196,20,58:41:00,0.0,27,24,4,1,3,0.888888889
2021020197,9,57:31:00,0.0,36,34,5,0,2,0.944444444
2021020197,26,60:00:00,0.0,34,34,4,1,0,1.0
2021020198,17,57:40:00,0.0,29,27,6,3,2,0.931034483
2021020198,15,60:00:00,0.0,21,21,0,1,0,1.0
2021020199,1,59:53:00,0.0,42,42,4,1,0,1.0
2021020199,2,60:00:00,0.0,34,30,4,1,4,0.882352941
2021020200,5,65:00:00,0.0,38,36,7,0,2,0.947368421
2021020200,13,65:00:00,0.0,31,29,8,2,2,0.935483871
2021020201,19,62:01:00,0.0,27,23,0,0,4,0.851851852
2021020201,18,62:01:00,0.0,36,33,0,0,3,0.916666667
2021020202,52,60:00:00,0.0,27,26,0,1,1,0.962962963
2021020202,28,58:48:00,0.0,33,30,4,0,3,0.909090909
2021020203,21,60:00:00,0.0,22,21,3,1,1,0.954545455
2021020203,23,40:00:00,0.0,26,20,2,1,6,0.769230769
2021020203,23,20:00,0.0,9,8,3,0,1,0.888888889
2021020204,54,60:00:00,0.0,26,24,9,2,2,0.923076923
2021020204,30,57:10:00,0.0,35,32,2,4,3,0.914285714
2021020205,55,57:49:00,0.0,34,29,0,0,5,0.852941176
2021020205,24,60:00:00,0.0,25,21,1,0,4,0.84
2021020206,7,60:00:00,0.0,35,33,3,0,2,0.942857143
2021020206,22,57:48:00,0.0,23,20,1,0,3,0.869565217
2021020207,10,62:30:00,0.0,31,30,1,1,1,0.967741935
2021020207,20,62:32:00,0.0,37,35,5,0,2,0.945945946
2021020208,12,56:49:00,0.0,28,26,4,1,2,0.928571429
2021020208,4,60:00:00,0.0,40,39,9,3,1,0.975
2021020209,29,58:54:00,0.0,28,24,0,0,4,0.857142857
2021020209,15,60:00:00,0.0,29,26,3,0,3,0.896551724
2021020210,16,59:43:00,0.0,23,22,3,1,1,0.956521739
2021020210,53,58:32:00,0.0,29,27,10,0,2,0.931034483
2021020211,7,59:48:00,0.0,26,21,1,2,5,0.807692308
2021020211,10,60:00:00,0.0,27,23,2,0,4,0.851851852
2021020212,9,60:00:00,0.0,31,28,5,0,3,0.903225806
2021020212,5,56:55:00,0.0,23,18,2,0,5,0.782608696
2021020213,17,61:32:00,0.0,37,35,9,0,2,0.945945946
2021020213,8,19:12,0.0,8,8,3,0,0,1.0
2021020213,8,42:29:00,0.0,25,22,0,2,3,0.88
2021020214,14,61:45:00,0.0,28,26,0,0,2,0.928571429
2021020214,13,62:13:00,0.0,24,21,1,0,3,0.875
2021020215,1,58:30:00,0.0,35,31,3,2,4,0.885714286
2021020215,6,60:00:00,2.0,29,27,1,0,2,0.931034483
2021020216,12,59:56:00,0.0,29,27,8,0,2,0.931034483
2021020216,19,57:09:00,0.0,24,21,1,2,3,0.875
2021020217,29,57:27:00,0.0,41,36,7,1,5,0.87804878
2021020217,3,53:15:00,0.0,34,31,3,0,3,0.911764706
2021020217,3,6:45,0.0,2,2,0,0,0,1.0
2021020218,18,60:00:00,0.0,23,22,5,0,1,0.956521739
2021020218,53,60:00:00,0.0,24,20,2,3,4,0.833333333
2021020219,25,59:55:00,0.0,33,32,8,0,2,0.96969697
2021020219,4,58:36:00,0.0,30,26,5,0,4,0.866666667
2021020220,52,60:32:00,0.0,29,27,2,3,2,0.931034483
2021020220,26,60:32:00,0.0,23,20,0,0,3,0.869565217
2021020221,21,60:00:00,0.0,30,28,3,1,2,0.933333333
2021020221,28,59:54:00,0.0,30,25,7,0,5,0.833333333
2021020222,54,59:33:00,0.0,43,39,6,4,4,0.906976744
2021020222,23,60:00:00,2.0,39,32,8,4,7,0.820512821
2021020223,55,55:58:00,0.0,21,18,2,0,3,0.857142857
2021020223,30,60:00:00,0.0,30,28,5,0,2,0.933333333
2021020224,6,59:50:00,0.0,29,27,0,2,2,0.931034483
2021020224,8,59:27:00,0.0,40,36,4,1,4,0.9
2021020225,9,59:52:00,0.0,33,29,5,2,4,0.878787879
2021020225,20,60:00:00,0.0,27,27,9,1,0,1.0
2021020226,3,64:59:00,0.0,27,24,0,1,3,0.888888889
2021020226,1,48:38:00,0.0,33,30,2,0,3,0.909090909
2021020226,1,16:22,0.0,8,8,0,0,0,1.0
2021020227,15,59:39:00,0.0,25,24,1,1,1,0.96
2021020227,5,59:45:00,0.0,32,26,2,0,6,0.8125
2021020228,19,60:00:00,0.0,32,27,0,2,5,0.84375
2021020228,22,60:00:00,0.0,39,35,9,0,4,0.897435897
2021020229,24,59:35:00,0.0,27,26,4,1,1,0.962962963
2021020229,23,58:29:00,0.0,37,33,4,0,4,0.891891892
2021020230,14,60:00:00,0.0,26,25,2,0,1,0.961538462
2021020230,2,60:00:00,0.0,28,24,5,1,4,0.857142857
2021020231,29,60:00:00,0.0,27,24,2,0,3,0.888888889
2021020231,17,58:56:00,0.0,37,33,6,0,4,0.891891892
2021020232,10,60:00:00,0.0,24,24,2,1,0,1.0
2021020232,18,57:44:00,0.0,33,31,5,1,2,0.939393939
2021020233,13,60:00:00,0.0,28,27,1,1,1,0.964285714
2021020233,2,19:40,0.0,17,13,0,0,4,0.764705882
2021020233,2,40:00:00,0.0,19,17,5,0,2,0.894736842
2021020234,1,65:00:00,0.0,23,21,0,0,2,0.913043478
2021020234,9,65:00:00,0.0,24,22,0,0,2,0.916666667
2021020235,3,60:00:00,0.0,33,31,1,0,2,0.939393939
2021020235,8,59:34:00,0.0,34,31,2,0,3,0.911764706
2021020236,4,60:30:00,0.0,34,33,4,3,1,0.970588235
2021020236,20,60:45:00,0.0,43,41,4,2,2,0.953488372
2021020237,5,58:41:00,0.0,19,17,3,0,2,0.894736842
2021020237,7,60:00:00,0.0,46,45,6,7,1,0.97826087
2021020238,19,57:55:00,0.0,23,20,2,2,3,0.869565217
2021020238,53,60:00:00,0.0,36,34,6,1,2,0.944444444
2021020239,25,60:00:00,0.0,30,28,0,0,2,0.933333333
2021020239,17,58:58:00,0.0,29,25,1,0,4,0.862068966
2021020240,30,56:16:00,0.0,21,17,4,0,4,0.80952381
2021020240,28,60:00:00,0.0,27,26,1,0,1,0.962962963
2021020241,52,60:00:00,0.0,34,32,7,0,2,0.941176471
2021020241,22,39:09:00,0.0,26,22,4,1,4,0.846153846
2021020241,22,19:02,0.0,8,8,2,0,0,1.0
2021020242,54,57:20:00,0.0,42,38,3,1,4,0.904761905
2021020242,12,60:00:00,0.0,23,21,3,0,2,0.913043478
2021020243,24,64:14:00,0.0,30,28,0,1,2,0.933333333
2021020243,15,64:14:00,0.0,31,28,1,0,3,0.903225806
2021020244,23,58:21:00,0.0,29,26,7,1,3,0.896551724
2021020244,21,60:00:00,0.0,34,32,2,0,2,0.941176471
2021020245,26,59:31:00,0.0,37,36,5,0,1,0.972972973
2021020245,15,59:49:00,0.0,34,34,5,0,0,1.0
2021020246,55,56:47:00,0.0,18,15,0,0,3,0.833333333
2021020246,16,60:00:00,0.0,33,31,1,0,2,0.939393939
2021020247,7,40:00:00,0.0,23,18,0,1,5,0.782608696
2021020247,7,20:00,0.0,10,10,0,0,0,1.0
2021020247,20,60:00:00,0.0,27,27,3,1,0,1.0
2021020248,10,60:00:00,0.0,28,27,0,2,1,0.964285714
2021020248,3,58:25:00,0.0,30,28,0,0,2,0.933333333
2021020249,8,40:00:00,0.0,31,26,0,1,5,0.838709677
2021020249,8,20:00,0.0,12,11,0,0,1,0.916666667
2021020249,5,60:00:00,0.0,24,24,0,1,0,1.0
2021020250,9,58:34:00,0.0,34,31,5,2,3,0.911764706
2021020250,18,60:00:00,0.0,29,27,5,2,2,0.931034483
2021020251,13,60:00:00,0.0,46,45,9,0,1,0.97826087
2021020251,1,28:15:00,0.0,27,23,2,0,4,0.851851852
2021020251,1,29:48:00,0.0,14,14,0,1,0,1.0
2021020252,4,63:15:00,0.0,32,29,1,0,3,0.90625
2021020252,14,65:00:00,0.0,30,27,2,0,3,0.9
2021020253,19,60:00:00,0.0,27,26,0,1,1,0.962962963
2021020253,28,60:00:00,0.0,48,44,12,0,4,0.916666667
2021020254,30,59:11:00,0.0,38,36,12,1,2,0.947368421
2021020254,25,6:08,0.0,0,0,0,0,0,
2021020254,25,53:32:00,0.0,26,19,6,1,7,0.730769231
2021020255,22,64:42:00,0.0,47,46,10,2,1,0.978723404
2021020255,52,65:00:00,0.0,32,31,5,1,1,0.96875
2021020256,53,65:00:00,0.0,46,42,3,1,4,0.913043478
2021020256,29,64:01:00,0.0,29,25,2,0,4,0.862068966
2021020257,54,60:00:00,0.0,28,26,1,3,2,0.928571429
2021020257,17,40:00:00,0.0,22,18,2,0,4,0.818181818
2021020257,17,20:00,0.0,10,9,0,0,1,0.9
2021020258,24,58:00:00,0.0,31,29,2,0,2,0.935483871
2021020258,12,59:48:00,0.0,32,31,2,1,1,0.96875
2021020259,23,59:29:00,0.0,39,37,0,0,2,0.948717949
2021020259,52,57:57:00,0.0,29,26,3,0,3,0.896551724
2021020260,55,34:09:00,0.0,17,14,1,0,3,0.823529412
2021020260,55,25:33:00,0.0,13,9,4,0,4,0.692307692
2021020260,21,60:00:00,0.0,28,25,8,0,3,0.892857143
2021020261,10,58:26:00,0.0,31,29,3,2,2,0.935483871
2021020261,5,60:00:00,0.0,26,26,3,0,0,1.0
2021020262,8,59:58:00,0.0,36,33,1,0,3,0.916666667
2021020262,18,29:06:00,0.0,9,9,0,0,0,1.0
2021020262,18,30:08:00,0.0,19,14,0,0,5,0.736842105
2021020263,9,58:39:00,0.0,33,31,5,0,2,0.939393939
2021020263,3,60:00:00,0.0,30,29,5,0,1,0.966666667
2021020264,14,57:27:00,0.0,26,22,2,0,4,0.846153846
2021020264,1,60:00:00,0.0,34,31,3,1,3,0.911764706
2021020265,13,60:00:00,0.0,39,35,1,0,4,0.897435897
2021020265,30,54:51:00,0.0,36,32,1,0,4,0.888888889
2021020266,2,58:46:00,0.0,29,26,7,0,3,0.896551724
2021020266,20,60:00:00,0.0,36,34,8,0,2,0.944444444
2021020267,4,60:00:00,0.0,44,39,7,1,5,0.886363636
2021020267,6,60:00:00,0.0,31,29,4,1,2,0.935483871
2021020268,25,60:00:00,0.0,36,35,10,2,1,0.972222222
2021020268,19,57:55:00,0.0,32,29,8,1,3,0.90625
2021020269,22,59:48:00,0.0,31,29,2,1,2,0.935483871
2021020269,16,59:56:00,0.0,33,28,3,1,5,0.848484848
2021020270,53,60:25:00,0.0,34,33,6,0,1,0.970588235
2021020270,17,60:23:00,0.0,29,27,1,0,2,0.931034483
2021020271,54,60:00:00,0.0,29,27,7,2,2,0.931034483
2021020271,29,57:47:00,0.0,35,32,5,1,3,0.914285714
2021020272,26,58:08:00,0.0,20,15,1,2,5,0.75
2021020272,12,60:00:00,0.0,43,39,4,1,4,0.906976744
2021020273,28,58:34:00,0.0,20,17,2,0,3,0.85
2021020273,15,60:00:00,0.0,22,22,6,1,0,1.0
2021020274,6,60:00:00,0.0,32,28,5,3,4,0.875
2021020274,20,60:00:00,0.0,28,28,5,0,0,1.0
2021020275,14,65:00:00,0.0,32,28,3,2,4,0.875
2021020275,30,60:55:00,0.0,24,20,1,1,4,0.833333333
2021020276,2,60:00:00,0.0,40,37,2,3,3,0.925
2021020276,10,59:54:00,0.0,20,20,3,0,0,1.0
2021020277,3,20:00,0.0,4,4,1,0,0,1.0
2021020277,3,39:10:00,0.0,18,14,1,0,4,0.777777778
2021020277,7,58:59:00,0.0,36,31,0,0,5,0.861111111
2021020278,23,58:22:00,0.0,24,23,4,1,1,0.958333333
2021020278,16,59:57:00,0.0,40,40,13,1,0,1.0
2021020279,26,63:09:00,0.0,27,25,3,0,2,0.925925926
2021020279,53,62:45:00,0.0,38,37,7,1,1,0.973684211
2021020280,55,59:44:00,0.0,39,37,10,0,2,0.948717949
2021020280,15,57:42:00,0.0,30,26,3,2,4,0.866666667
2021020281,7,20:55,0.0,12,8,1,0,4,0.666666667
2021020281,7,38:30:00,0.0,15,14,1,0,1,0.933333333
2021020281,29,60:00:00,0.0,33,29,1,3,4,0.878787879
2021020282,19,60:00:00,0.0,34,32,3,0,2,0.941176471
2021020282,54,60:00:00,0.0,31,26,1,0,5,0.838709677
2021020283,18,59:52:00,0.0,31,29,4,2,2,0.935483871
2021020283,24,58:07:00,0.0,35,32,11,0,3,0.914285714
2021020284,52,59:50:00,0.0,35,33,1,3,2,0.942857143
2021020284,5,60:00:00,0.0,31,30,4,0,1,0.967741935
2021020285,21,2:25,0.0,1,1,0,0,0,1.0
2021020285,21,57:31:00,0.0,20,15,4,0,5,0.75
2021020285,9,58:50:00,0.0,39,33,9,0,6,0.846153846
2021020286,28,61:23:00,0.0,23,22,2,1,1,0.956521739
2021020286,12,61:42:00,0.0,27,25,1,0,2,0.925925926
2021020287,14,59:37:00,0.0,34,34,0,4,0,1.0
2021020287,4,60:00:00,0.0,35,31,1,0,4,0.885714286
2021020288,25,59:56:00,0.0,22,21,1,2,1,0.954545455
2021020288,22,60:00:00,0.0,33,29,6,0,4,0.878787879
2021020289,20,60:00:00,0.0,21,19,0,0,2,0.904761905
2021020289,16,58:39:00,0.0,37,34,0,1,3,0.918918919
2021020290,7,40:00:00,0.0,25,24,4,0,1,0.96
2021020290,7,20:00,0.0,22,18,3,1,4,0.818181818
2021020290,6,60:00:00,0.0,25,24,1,0,1,0.96
2021020291,17,60:00:00,0.0,37,35,5,0,2,0.945945946
2021020291,19,58:16:00,0.0,22,19,0,2,3,0.863636364
2021020292,13,62:39:00,0.0,33,32,4,1,1,0.96969697
2021020292,4,62:25:00,0.0,45,43,1,2,2,0.955555556
2021020293,1,64:24:00,0.0,27,25,5,0,2,0.925925926
2021020293,30,65:00:00,0.0,42,40,9,0,2,0.952380952
2021020294,2,60:00:00,0.0,21,17,4,3,4,0.80952381
2021020294,3,60:00:00,0.0,21,20,7,2,1,0.952380952
2021020295,5,59:37:00,0.0,37,36,0,2,1,0.972972973
2021020295,23,58:45:00,0.0,36,33,8,1,3,0.916666667
2021020296,15,59:52:00,0.0,28,25,4,1,3,0.892857143
2021020296,8,60:00:00,0.0,34,28,0,0,6,0.823529412
2021020297,29,60:00:00,2.0,36,36,7,0,0,1.0
2021020297,52,59:41:00,0.0,31,29,5,2,2,0.935483871
2021020298,18,59:27:00,0.0,34,30,4,3,4,0.882352941
2021020298,54,60:00:00,0.0,28,26,4,0,2,0.928571429
2021020299,21,44:58:00,0.0,20,19,1,5,1,0.95
2021020299,21,14:11,0.0,6,5,1,0,1,0.833333333
2021020299,24,60:00:00,0.0,36,31,11,1,5,0.861111111
2021020300,53,59:14:00,0.0,43,39,7,2,4,0.906976744
2021020300,22,59:40:00,0.0,27,24,4,1,3,0.888888889
2021020301,26,60:00:00,0.0,38,32,7,1,6,0.842105263
2021020301,10,59:42:00,0.0,32,30,2,1,2,0.9375
2021020302,28,60:00:00,0.0,29,26,7,0,3,0.896551724
2021020302,9,59:13:00,0.0,27,23,4,1,4,0.851851852
2021020303,55,59:29:00,0.0,36,35,4,2,1,0.972222222
2021020303,12,58:10:00,0.0,22,20,4,0,2,0.909090909
2021020304,6,57:57:00,0.0,30,26,3,1,4,0.866666667
2021020304,3,59:58:00,0.0,36,34,8,0,2,0.944444444
2021020305,7,60:00:00,0.0,26,25,1,0,1,0.961538462
2021020305,8,60:00:00,0.0,39,35,4,2,4,0.897435897
2021020306,14,59:43:00,0.0,17,17,2,0,0,1.0
2021020306,55,59:56:00,0.0,26,23,3,0,3,0.884615385
2021020307,2,58:13:00,0.0,30,29,1,0,1,0.966666667
2021020307,5,59:57:00,0.0,25,25,2,2,0,1.0
2021020308,4,60:00:00,0.0,36,30,3,0,6,0.833333333
2021020308,12,60:00:00,0.0,23,20,1,3,3,0.869565217
2021020309,15,60:00:00,0.0,22,19,1,0,3,0.863636364
2021020309,13,11:46,0.0,7,6,1,0,1,0.857142857
2021020309,13,45:09:00,0.0,22,19,2,0,3,0.863636364
2021020310,29,59:41:00,0.0,41,39,5,0,2,0.951219512
2021020310,23,58:17:00,0.0,20,17,0,0,3,0.85
2021020311,16,61:27:00,0.0,25,23,1,0,2,0.92
2021020311,19,61:27:00,0.0,27,24,2,0,3,0.888888889
2021020312,18,60:00:00,0.0,25,23,0,1,2,0.92
2021020312,1,59:29:00,0.0,30,27,2,0,3,0.9
2021020313,25,52:20:00,0.0,33,32,1,1,1,0.96969697
2021020313,25,7:22,0.0,4,4,0,1,0,1.0
2021020313,21,55:37:00,0.0,22,19,6,1,3,0.863636364
2021020314,30,60:00:00,0.0,31,30,7,3,1,0.967741935
2021020314,52,37:11:00,0.0,24,21,10,0,3,0.875
2021020314,52,22:49,0.0,14,10,0,0,4,0.714285714
2021020315,24,60:00:00,0.0,34,34,12,2,0,1.0
2021020315,9,59:36:00,0.0,33,29,6,1,4,0.878787879
2021020316,28,29:16:00,0.0,16,16,2,0,0,1.0
2021020316,28,30:44:00,0.0,17,13,3,1,4,0.764705882
2021020316,10,60:00:00,2.0,35,34,2,0,1,0.971428571
2021020317,17,60:26:00,0.0,28,26,0,0,2,0.928571429
2021020317,7,60:11:00,0.0,41,38,6,0,3,0.926829268
2021020318,13,59:24:00,0.0,26,23,2,0,3,0.884615385
2021020318,55,60:00:00,0.0,34,33,1,2,1,0.970588235
2021020319,5,58:00:00,0.0,31,28,6,0,3,0.903225806
2021020319,8,59:29:00,0.0,50,47,6,0,3,0.94
2021020320,19,60:00:00,0.0,27,24,3,2,3,0.888888889
2021020320,29,60:00:00,0.0,33,27,5,1,6,0.818181818
2021020321,21,59:01:00,0.0,28,26,4,0,2,0.928571429
2021020321,18,60:00:00,0.0,35,29,5,3,6,0.828571429
2021020322,20,59:14:00,0.0,27,24,8,1,3,0.888888889
2021020322,52,60:00:00,0.0,36,34,6,0,2,0.944444444
2021020323,53,58:52:00,0.0,29,26,1,1,3,0.896551724
2021020323,25,60:00:00,0.0,27,25,5,0,2,0.925925926
2021020324,54,57:47:00,0.0,30,27,6,1,3,0.9
2021020324,22,60:00:00,0.0,38,36,2,1,2,0.947368421
2021020325,26,60:00:00,0.0,32,30,5,2,2,0.9375
2021020325,9,59:08:00,0.0,36,33,13,1,3,0.916666667
2021020326,6,60:00:00,0.0,38,36,10,1,2,0.947368421
2021020326,23,57:56:00,0.0,42,39,4,0,3,0.928571429
2021020327,1,60:00:00,0.0,25,23,3,0,2,0.92
2021020327,4,58:07:00,0.0,34,30,4,1,4,0.882352941
2021020328,3,58:06:00,0.0,28,26,4,4,2,0.928571429
2021020328,2,59:46:00,0.0,30,29,3,2,1,0.966666667
2021020329,12,57:39:00,0.0,24,21,3,1,3,0.875
2021020329,15,60:00:00,0.0,32,30,3,2,2,0.9375
2021020330,16,57:32:00,0.0,21,20,1,0,1,0.952380952
2021020330,28,60:00:00,0.0,29,29,2,0,0,1.0
2021020331,30,60:00:00,0.0,30,28,6,2,2,0.933333333
2021020331,14,57:08:00,0.0,36,33,6,0,3,0.916666667
2021020332,24,59:30:00,0.0,30,26,2,0,4,0.866666667
2021020332,10,59:56:00,0.0,40,39,1,2,1,0.975
2021020333,7,58:40:00,0.0,31,25,0,1,6,0.806451613
2021020333,55,60:00:00,0.0,36,32,8,0,4,0.888888889
2021020334,8,59:03:00,0.0,42,40,1,0,2,0.952380952
2021020334,23,59:37:00,0.0,34,33,3,0,1,0.970588235
2021020335,52,57:40:00,0.0,15,14,0,2,1,0.933333333
2021020335,53,60:00:00,0.0,46,46,7,0,0,1.0
2021020336,20,65:00:00,0.0,22,21,0,0,1,0.954545455
2021020336,5,65:00:00,0.0,32,31,0,0,1,0.96875
2021020337,6,58:32:00,0.0,16,14,0,2,2,0.875
2021020337,17,59:54:00,0.0,42,41,7,0,1,0.976190476
2021020338,13,59:53:00,0.0,27,23,2,2,4,0.851851852
2021020338,15,59:45:00,0.0,51,46,8,1,5,0.901960784
2021020339,1,59:17:00,0.0,30,26,4,1,4,0.866666667
2021020339,28,60:00:00,0.0,34,32,1,0,2,0.941176471
2021020340,4,64:59:00,0.0,31,28,5,0,3,0.903225806
2021020340,2,65:00:00,0.0,34,31,5,0,3,0.911764706
2021020341,19,64:36:00,0.0,33,30,7,1,3,0.909090909
2021020341,14,65:00:00,0.0,33,30,5,1,3,0.909090909
2021020342,18,59:38:00,0.0,27,27,3,1,0,1.0
2021020342,29,47:08:00,0.0,28,25,8,0,3,0.892857143
2021020342,29,12:52,0.0,9,6,1,0,3,0.666666667
2021020343,25,60:00:00,0.0,40,39,2,1,1,0.975
2021020343,12,59:55:00,0.0,16,13,1,2,3,0.8125
2021020344,30,59:25:00,0.0,31,29,1,2,2,0.935483871
2021020344,53,60:00:00,0.0,37,32,5,0,5,0.864864865
2021020345,26,64:50:00,0.0,36,33,5,0,4,0.916666667
2021020345,24,64:56:00,0.0,34,30,3,0,4,0.882352941
2021020346,10,60:00:00,0.0,31,28,4,0,3,0.903225806
2021020346,21,60:00:00,0.0,41,33,1,1,8,0.804878049
2021020347,9,59:47:00,0.0,35,29,4,2,6,0.828571429
2021020347,23,60:00:00,0.0,21,19,4,1,2,0.904761905
2021020348,17,64:44:00,0.0,24,21,2,0,3,0.875
2021020348,55,64:45:00,0.0,26,23,4,0,3,0.884615385
2021020349,3,59:57:00,0.0,34,33,13,1,1,0.970588235
2021020349,4,58:16:00,0.0,27,24,1,0,3,0.888888889
2021020350,22,60:00:00,0.0,34,32,4,0,2,0.941176471
2021020350,5,58:43:00,0.0,21,17,3,1,4,0.80952381
2021020351,24,60:00:00,0.0,39,34,10,2,5,0.871794872
2021020351,54,58:06:00,0.0,33,28,1,2,5,0.848484848
2021020352,8,59:03:00,0.0,33,30,7,3,3,0.909090909
2021020352,21,59:57:00,0.0,20,19,1,1,1,0.95
2021020353,14,59:29:00,0.0,28,26,5,0,2,0.928571429
2021020353,19,56:44:00,0.0,35,31,2,1,4,0.885714286
2021020354,13,28:44:00,0.0,19,19,9,1,0,1.0
2021020354,13,31:13:00,0.0,12,8,0,0,4,0.666666667
2021020354,7,58:15:00,0.0,43,38,6,1,5,0.88372093
2021020355,2,60:39:00,0.0,35,33,6,0,2,0.942857143
2021020355,28,60:39:00,0.0,25,24,0,1,1,0.96
2021020356,15,65:00:00,0.0,28,25,3,0,3,0.892857143
2021020356,16,65:00:00,0.0,28,25,1,0,3,0.892857143
2021020357,12,59:02:00,0.0,20,17,2,0,3,0.85
2021020357,9,60:00:00,0.0,49,47,14,1,2,0.959183673
2021020358,18,57:12:00,0.0,33,31,7,0,2,0.939393939
2021020358,6,59:18:00,0.0,42,42,5,1,0,1.0
2021020359,25,60:00:00,0.0,22,20,1,1,2,0.909090909
2021020359,29,58:03:00,0.0,37,34,0,4,3,0.918918919
2021020360,30,60:00:00,0.0,31,29,5,0,2,0.935483871
2021020360,1,59:44:00,0.0,38,33,6,0,5,0.868421053
2021020361,26,58:18:00,0.0,32,29,8,0,3,0.90625
2021020361,20,59:54:00,0.0,42,40,3,2,2,0.952380952
2021020362,3,45:06:00,0.0,19,19,1,0,0,1.0
2021020362,3,14:52,0.0,9,9,1,0,0,1.0
2021020362,28,59:07:00,0.0,27,26,3,0,1,0.962962963
2021020363,52,60:00:00,0.0,37,33,3,1,4,0.891891892
2021020363,1,19:50,0.0,8,6,0,0,2,0.75
2021020363,1,40:00:00,0.0,32,26,5,0,6,0.8125
2021020364,53,60:00:00,0.0,32,25,5,1,7,0.78125
2021020364,54,60:00:00,0.0,30,29,5,0,1,0.966666667
2021020365,24,65:00:00,0.0,36,33,1,0,3,0.916666667
2021020365,20,65:00:00,0.0,34,31,2,0,3,0.911764706
2021020366,55,60:00:00,0.0,32,29,3,2,3,0.90625
2021020366,22,58:05:00,0.0,34,30,6,0,4,0.882352941
2021020367,6,61:31:00,0.0,25,22,2,0,3,0.88
2021020367,14,61:31:00,0.0,39,37,1,1,2,0.948717949
2021020368,9,60:51:00,0.0,31,26,2,1,5,0.838709677
2021020368,21,22:49,0.0,15,12,2,0,3,0.8
2021020368,21,37:22:00,0.0,19,17,1,0,2,0.894736842
2021020369,17,63:33:00,0.0,23,20,0,1,3,0.869565217
2021020369,2,63:15:00,0.0,30,26,5,0,4,0.866666667
2021020370,13,64:18:00,0.0,25,22,3,3,3,0.88
2021020370,19,65:00:00,0.0,51,48,3,1,3,0.941176471
2021020371,3,60:00:00,0.0,27,25,3,1,2,0.925925926
2021020371,16,57:35:00,0.0,31,28,8,1,3,0.903225806
2021020372,15,59:49:00,0.0,18,17,0,3,1,0.944444444
2021020372,29,59:42:00,0.0,31,29,1,0,2,0.935483871
2021020373,12,60:00:00,0.0,34,32,4,0,2,0.941176471
2021020373,7,49:57:00,0.0,25,19,0,2,6,0.76
2021020373,7,10:03,0.0,4,4,0,0,0,1.0
2021020374,18,64:48:00,0.0,23,20,8,1,3,0.869565217
2021020374,8,64:48:00,0.0,44,40,10,0,4,0.909090909
2021020375,30,64:58:00,0.0,42,39,5,1,3,0.928571429
2021020375,10,64:51:00,0.0,40,37,8,2,3,0.925
2021020376,23,57:59:00,0.0,44,40,10,1,4,0.909090909
2021020376,5,60:00:00,0.0,23,22,4,0,1,0.956521739
2021020377,2,63:42:00,0.0,26,24,6,0,2,0.923076923
2021020377,16,65:00:00,0.0,24,22,5,0,2,0.916666667
2021020378,4,31:26:00,0.0,12,10,0,1,2,0.833333333
2021020378,4,28:34:00,0.0,15,10,0,0,5,0.666666667
2021020378,14,60:00:00,0.0,39,38,0,0,1,0.974358974
2021020379,29,60:00:00,0.0,34,30,0,0,4,0.882352941
2021020379,28,58:59:00,0.0,29,24,0,0,5,0.827586207
2021020380,52,60:00:00,0.0,35,32,7,0,3,0.914285714
2021020380,10,60:00:00,0.0,41,35,5,3,6,0.853658537
2021020381,22,60:00:00,0.0,40,35,4,1,5,0.875
2021020381,26,59:47:00,0.0,22,21,4,0,1,0.954545455
2021020382,54,60:00:00,0.0,25,23,3,1,2,0.92
2021020382,20,57:05:00,0.0,28,25,4,1,3,0.892857143
2021020383,4,60:00:00,0.0,50,43,10,0,7,0.86
2021020383,21,59:24:00,0.0,32,27,3,0,5,0.84375
2021020384,15,65:00:00,0.0,34,31,0,0,3,0.911764706
2021020384,24,65:00:00,0.0,29,26,2,0,3,0.896551724
2021020385,25,60:00:00,0.0,19,18,0,0,1,0.947368421
2021020385,53,60:00:00,0.0,27,23,4,1,4,0.851851852
2021020386,23,59:52:00,0.0,31,31,2,0,0,1.0
2021020386,26,60:00:00,0.0,30,26,3,1,4,0.866666667
2021020387,55,5:07,0.0,4,1,0,0,3,0.25
2021020387,55,54:53:00,0.0,27,24,0,1,3,0.888888889
2021020387,5,60:00:00,0.0,29,28,2,0,1,0.965517241
2021020388,7,57:59:00,0.0,23,21,0,0,2,0.913043478
2021020388,24,60:00:00,0.0,25,25,5,0,0,1.0
2021020389,10,60:00:00,0.0,32,28,3,1,4,0.875
2021020389,29,17:06,0.0,10,10,0,0,0,1.0
2021020389,29,39:35:00,0.0,30,25,2,0,5,0.833333333
2021020390,8,59:50:00,0.0,27,24,3,0,3,0.888888889
2021020390,14,59:20:00,0.0,23,21,1,0,2,0.913043478
2021020391,9,58:21:00,0.0,27,22,5,1,5,0.814814815
2021020391,2,59:38:00,0.0,33,30,13,0,3,0.909090909
2021020392,17,57:07:00,0.0,32,28,2,0,4,0.875
2021020392,18,60:00:00,0.0,16,14,1,1,2,0.875
2021020393,16,59:40:00,0.0,29,24,2,1,5,0.827586207
2021020393,3,60:00:00,0.0,26,24,5,0,2,0.923076923
2021020394,19,54:28:00,0.0,37,34,8,0,3,0.918918919
2021020394,19,6:25,0.0,3,3,0,0,0,1.0
2021020394,13,60:53:00,0.0,30,26,4,3,4,0.866666667
2021020395,52,56:55:00,0.0,34,30,5,0,4,0.882352941
2021020395,12,60:00:00,0.0,18,16,4,0,2,0.888888889
2021020396,22,59:56:00,0.0,26,22,2,1,4,0.846153846
2021020396,30,59:57:00,0.0,39,38,9,3,1,0.974358974
2021020397,28,60:00:00,0.0,43,40,6,0,3,0.930232558
2021020397,20,59:04:00,0.0,26,22,1,3,4,0.846153846
2021020398,1,59:52:00,0.0,25,25,2,0,0,1.0
2021020398,4,57:01:00,0.0,26,24,2,0,2,0.923076923
2021020399,3,59:42:00,0.0,39,32,3,2,7,0.820512821
2021020399,21,1:33,0.0,1,1,0,0,0,1.0
2021020399,21,58:26:00,0.0,29,26,2,2,3,0.896551724
2021020400,23,64:45:00,0.0,36,35,6,0,1,0.972222222
2021020400,6,65:00:00,0.0,32,31,2,1,1,0.96875
2021020401,54,32:15:00,0.0,13,12,0,0,1,0.923076923
2021020401,54,27:38:00,0.0,10,7,0,1,3,0.7
2021020401,25,58:33:00,0.0,45,40,4,1,5,0.888888889
2021020402,10,58:36:00,0.0,26,22,3,0,4,0.846153846
2021020402,14,59:59:00,0.0,38,35,0,2,3,0.921052632
2021020403,8,57:14:00,0.0,25,23,2,0,2,0.92
2021020403,16,59:37:00,0.0,30,30,3,1,0,1.0
2021020404,2,59:48:00,0.0,29,25,3,0,4,0.862068966
2021020404,18,60:00:00,0.0,21,18,2,0,3,0.857142857
2021020405,29,65:00:00,0.0,26,25,0,0,1,0.961538462
2021020405,24,64:37:00,0.0,34,33,4,1,1,0.970588235
2021020406,19,60:00:00,0.0,31,29,1,0,2,0.935483871
2021020406,17,16:25,0.0,7,5,0,1,2,0.714285714
2021020406,17,40:00:00,0.0,18,15,4,0,3,0.833333333
2021020407,20,64:07:00,0.0,26,24,3,3,2,0.923076923
2021020407,12,64:07:00,0.0,27,26,5,1,1,0.962962963
2021020408,22,57:43:00,0.0,30,27,1,0,3,0.9
2021020408,6,60:00:00,0.0,43,41,8,2,2,0.953488372
2021020409,26,60:00:00,0.0,27,27,8,0,0,1.0
2021020409,25,57:25:00,0.0,39,37,7,1,2,0.948717949
2021020410,28,59:05:00,0.0,25,22,2,0,3,0.88
2021020410,30,59:31:00,0.0,35,33,5,0,2,0.942857143
2021020411,55,59:56:00,0.0,33,30,3,0,3,0.909090909
2021020411,52,60:00:00,0.0,25,25,2,0,0,1.0
2021020412,7,58:48:00,0.0,31,29,3,0,2,0.935483871
2021020412,3,60:00:00,0.0,37,36,3,0,1,0.972972973
2021020413,1,55:30:00,0.0,27,24,4,0,3,0.888888889
2021020413,18,60:00:00,0.0,31,29,4,1,2,0.935483871
2021020414,15,57:51:00,0.0,32,29,2,1,3,0.90625
2021020414,5,60:00:00,0.0,31,29,4,0,2,0.935483871
2021020415,21,60:00:00,0.0,40,37,13,1,3,0.925
2021020415,17,10:49,0.0,7,4,0,0,3,0.571428571
2021020415,17,47:54:00,0.0,39,36,5,1,3,0.923076923
2021020416,53,56:44:00,0.0,23,20,2,1,3,0.869565217
2021020416,13,59:48:00,0.0,23,22,8,0,1,0.956521739
2021020417,23,64:56:00,0.0,37,34,3,0,3,0.918918919
2021020417,52,65:00:00,0.0,36,33,3,0,3,0.916666667
2021020418,54,57:30:00,0.0,25,21,2,1,4,0.84
2021020418,4,60:00:00,0.0,44,41,8,0,3,0.931818182
2021020419,7,65:00:00,0.0,42,40,7,0,2,0.952380952
2021020419,15,64:47:00,0.0,31,29,0,1,2,0.935483871
2021020420,10,60:00:00,0.0,35,31,5,0,4,0.885714286
2021020420,16,58:47:00,0.0,26,21,2,0,5,0.807692308
2021020421,9,59:46:00,0.0,25,25,5,0,0,1.0
2021020421,14,59:25:00,0.0,22,19,6,0,3,0.863636364
2021020422,2,59:54:00,0.0,32,30,4,1,2,0.9375
2021020422,1,56:23:00,0.0,29,25,0,0,4,0.862068966
2021020423,5,59:55:00,0.0,33,33,4,0,0,1.0
2021020423,24,40:00:00,0.0,16,15,2,1,1,0.9375
2021020423,24,18:12,0.0,13,13,0,0,0,1.0
2021020424,19,60:00:00,0.0,23,22,4,0,1,0.956521739
2021020424,8,60:00:00,0.0,37,33,5,0,4,0.891891892
2021020425,20,58:54:00,0.0,27,23,1,1,4,0.851851852
2021020425,6,60:00:00,0.0,42,40,10,2,2,0.952380952
2021020426,22,57:37:00,0.0,31,28,4,0,3,0.903225806
2021020426,12,60:00:00,0.0,23,22,4,0,1,0.956521739
2021020427,53,57:09:00,0.0,34,29,4,0,5,0.852941176
2021020427,4,60:00:00,0.0,32,29,1,0,3,0.90625
2021020428,26,59:57:00,0.0,31,30,3,1,1,0.967741935
2021020428,30,58:12:00,2.0,37,35,10,1,2,0.945945946
2021020429,28,60:00:00,0.0,35,34,7,1,1,0.971428571
2021020429,25,58:14:00,0.0,25,23,1,0,2,0.92
2021020430,55,60:38:00,0.0,28,23,2,0,5,0.821428571
2021020430,29,60:55:00,0.0,32,28,0,1,4,0.875
2021020431,3,58:26:00,0.0,24,23,3,0,1,0.958333333
2021020431,18,60:00:00,0.0,32,32,5,0,0,1.0
2021020432,19,63:46:00,0.0,39,36,0,0,3,0.923076923
2021020432,24,63:58:00,0.0,25,23,4,1,2,0.92
2021020433,21,60:00:00,0.0,31,29,9,0,2,0.935483871
2021020433,13,57:41:00,0.0,26,23,2,1,3,0.884615385
2021020434,23,60:00:00,0.0,29,28,2,0,1,0.965517241
2021020434,12,58:00:00,0.0,26,24,3,0,2,0.923076923
2021020435,54,60:00:00,0.0,27,23,9,0,4,0.851851852
2021020435,30,57:57:00,0.0,35,30,5,0,5,0.857142857
2021020436,16,59:27:00,0.0,33,30,5,1,3,0.909090909
2021020436,20,60:00:00,0.0,24,22,0,1,2,0.916666667
2021020437,6,57:17:00,0.0,25,21,0,1,4,0.84
2021020437,54,60:00:00,0.0,24,23,3,0,1,0.958333333
2021020438,17,60:00:00,0.0,34,33,0,1,1,0.970588235
2021020438,2,57:57:00,0.0,39,37,5,1,2,0.948717949
2021020439,14,63:18:00,0.0,30,28,1,1,2,0.933333333
2021020439,26,63:13:00,0.0,30,27,6,0,3,0.9
2021020440,13,60:00:00,0.0,38,30,4,2,8,0.789473684
2021020440,9,60:00:00,0.0,35,33,9,1,2,0.942857143
2021020441,4,60:00:00,0.0,27,26,6,0,1,0.962962963
2021020441,1,40:00:00,0.0,22,17,0,0,5,0.772727273
2021020441,1,20:00,0.0,8,7,0,1,1,0.875
2021020442,5,60:00:00,0.0,30,28,1,1,2,0.933333333
2021020442,8,60:00:00,0.0,31,26,6,0,5,0.838709677
2021020443,18,65:00:00,0.0,21,19,3,0,2,0.904761905
2021020443,20,64:25:00,0.0,27,26,2,0,2,0.962962963
2021020444,25,58:48:00,0.0,29,25,3,1,4,0.862068966
2021020444,19,60:00:00,0.0,34,33,5,2,1,0.970588235
2021020445,30,60:00:00,0.0,39,37,5,1,2,0.948717949
2021020445,12,57:49:00,0.0,27,24,4,0,3,0.888888889
2021020446,52,58:26:00,0.0,27,23,2,0,4,0.851851852
2021020446,7,60:00:00,0.0,36,34,3,1,2,0.944444444
2021020447,21,59:37:00,0.0,28,26,3,0,2,0.928571429
2021020447,3,56:45:00,0.0,31,27,9,0,4,0.870967742
2021020448,22,59:23:00,0.0,25,20,4,1,5,0.8
2021020448,10,60:00:00,0.0,36,35,4,2,1,0.972222222
2021020449,23,59:34:00,0.0,23,20,1,1,3,0.869565217
2021020449,29,59:12:00,0.0,39,35,3,0,4,0.897435897
2021020450,28,58:02:00,0.0,29,27,0,0,2,0.931034483
2021020450,55,60:00:00,0.0,34,33,2,0,1,0.970588235
2021020451,16,61:21:00,0.0,46,42,4,3,4,0.913043478
2021020451,15,59:34:00,0.0,28,23,2,3,5,0.821428571
2021020452,53,58:50:00,0.0,30,27,1,0,3,0.9
2021020452,3,60:00:00,0.0,31,29,3,0,2,0.935483871
2021020453,24,60:00:00,0.0,20,19,2,1,1,0.95
2021020453,55,40:00:00,0.0,18,15,0,0,3,0.833333333
2021020453,55,20:00,0.0,6,5,0,0,1,0.833333333
2021020454,8,65:00:00,0.0,39,37,4,1,2,0.948717949
2021020454,4,64:44:00,0.0,40,38,7,0,2,0.95
2021020455,14,60:00:00,0.0,26,25,3,0,1,0.961538462
2021020455,9,58:45:00,0.0,27,25,5,0,2,0.925925926
2021020456,13,57:51:00,0.0,31,27,5,0,4,0.870967742
2021020456,26,60:00:00,2.0,42,41,6,1,1,0.976190476
2021020457,1,58:55:00,0.0,29,25,3,1,4,0.862068966
2021020457,54,0:15,0.0,0,0,0,0,0,
2021020457,54,59:32:00,10.0,26,23,3,0,3,0.884615385
2021020458,2,60:00:00,0.0,41,40,2,1,1,0.975609756
2021020458,6,58:21:00,0.0,27,25,5,4,2,0.925925926
2021020459,12,60:00:00,0.0,26,23,3,3,3,0.884615385
2021020459,17,58:27:00,0.0,32,28,1,1,4,0.875
2021020460,18,60:00:00,0.0,26,24,5,0,2,0.923076923
2021020460,21,58:21:00,0.0,34,30,4,0,4,0.882352941
2021020461,30,65:00:00,0.0,40,38,6,0,2,0.95
2021020461,7,64:24:00,0.0,32,30,5,0,2,0.9375
2021020462,20,60:00:00,0.0,48,46,6,6,2,0.958333333
2021020462,10,59:58:00,0.0,26,21,3,2,5,0.807692308
2021020463,22,60:00:00,0.0,38,36,6,1,2,0.947368421
2021020463,29,19:39,0.0,15,15,0,0,0,1.0
2021020463,29,39:56:00,2.0,29,25,6,1,4,0.862068966
2021020464,28,59:51:00,0.0,29,25,2,0,4,0.862068966
2021020464,23,60:00:00,0.0,36,34,2,2,2,0.944444444
2021020465,3,64:58:00,0.0,30,28,2,0,2,0.933333333
2021020465,54,65:00:00,0.0,29,27,3,0,2,0.931034483
2021020466,5,62:53:00,0.0,21,19,1,0,2,0.904761905
2021020466,7,62:53:00,0.0,48,45,9,0,3,0.9375
2021020467,16,60:58:00,0.0,31,28,3,1,3,0.903225806
2021020467,18,60:58:00,0.0,19,17,2,0,2,0.894736842
2021020468,19,60:00:00,0.0,27,26,2,1,1,0.962962963
2021020468,25,59:42:00,0.0,33,30,1,3,3,0.909090909
2021020469,52,59:14:00,0.0,37,34,5,1,3,0.918918919
2021020469,15,60:00:00,0.0,42,40,7,0,2,0.952380952
2021020470,24,61:36:00,0.0,27,21,5,0,6,0.777777778
2021020470,53,62:09:00,0.0,37,32,5,1,5,0.864864865
2021020471,8,58:54:00,0.0,41,37,0,0,4,0.902439024
2021020471,6,60:00:00,0.0,26,23,7,1,3,0.884615385
2021020472,17,60:00:00,0.0,33,31,0,2,2,0.939393939
2021020472,1,60:00:00,0.0,30,25,1,0,5,0.833333333
2021020473,4,61:04:00,0.0,31,28,1,1,3,0.903225806
2021020473,9,61:35:00,0.0,38,34,3,1,4,0.894736842
2021020474,12,59:58:00,0.0,33,32,1,1,1,0.96969697
2021020474,26,59:56:00,0.0,33,28,3,1,5,0.848484848
2021020475,25,61:06:00,0.0,23,20,1,0,3,0.869565217
2021020475,16,61:57:00,0.0,39,35,12,0,4,0.897435897
2021020476,30,57:57:00,0.0,34,30,1,0,4,0.882352941
2021020476,13,60:00:00,0.0,26,24,6,0,2,0.923076923
2021020477,21,60:00:00,0.0,38,36,6,0,2,0.947368421
2021020477,14,56:46:00,0.0,47,44,3,3,3,0.936170213
2021020478,20,60:00:00,0.0,20,18,0,0,2,0.9
2021020478,29,60:00:00,0.0,41,36,4,0,6,0.87804878
2021020479,23,60:00:00,0.0,53,51,5,5,2,0.962264151
2021020479,10,58:31:00,0.0,24,21,4,0,3,0.875
2021020480,55,58:26:00,0.0,40,36,5,2,4,0.9
2021020480,22,60:00:00,0.0,17,14,1,1,3,0.823529412
2021020481,9,62:42:00,0.0,33,30,0,1,3,0.909090909
2021020481,6,62:42:00,0.0,31,29,2,0,2,0.935483871
2021020482,1,57:38:00,0.0,22,19,0,0,3,0.863636364
2021020482,5,60:00:00,0.0,19,17,6,1,2,0.894736842
2021020483,2,65:00:00,0.0,34,31,2,0,3,0.911764706
2021020483,54,64:19:00,0.0,32,29,3,1,3,0.90625
2021020484,15,58:13:00,0.0,24,21,2,2,3,0.875
2021020484,26,60:00:00,0.0,35,33,7,1,2,0.942857143
2021020485,12,59:55:00,0.0,31,28,5,0,3,0.903225806
2021020485,18,57:19:00,0.0,29,25,4,0,4,0.862068966
2021020486,52,59:58:00,0.0,28,26,5,2,2,0.928571429
2021020486,19,57:39:00,2.0,34,30,5,1,4,0.882352941
2021020487,23,59:49:00,0.0,36,35,5,0,1,0.972222222
2021020487,53,59:34:00,0.0,29,24,3,2,5,0.827586207
2021020488,55,20:00,0.0,11,8,2,0,3,0.727272727
2021020488,55,40:00:00,0.0,14,11,3,0,3,0.785714286
2021020488,10,59:53:00,0.0,25,23,5,0,2,0.92
2021020489,7,60:16:00,0.0,34,30,2,0,4,0.882352941
2021020489,29,60:16:00,0.0,27,24,4,1,3,0.888888889
2021020490,17,57:40:00,0.0,30,26,5,1,4,0.866666667
2021020490,21,60:00:00,0.0,34,32,4,0,2,0.941176471
2021020491,2,65:00:00,0.0,27,25,2,1,2,0.925925926
2021020491,8,65:00:00,0.0,32,30,7,1,2,0.9375
2021020492,25,59:43:00,0.0,23,19,2,1,4,0.826086957
2021020492,30,52:31:00,0.0,28,22,5,0,6,0.785714286
2021020493,22,60:00:00,0.0,30,27,5,2,3,0.9
2021020493,24,60:00:00,0.0,41,34,8,1,7,0.829268293
2021020494,6,60:00:00,0.0,43,37,11,5,6,0.860465116
2021020494,12,60:00:00,0.0,34,34,6,0,0,1.0
2021020495,9,50:49:00,0.0,31,27,2,3,4,0.870967742
2021020495,9,8:53,0.0,4,4,0,0,0,1.0
2021020495,19,59:49:00,0.0,20,18,1,2,2,0.9
2021020496,4,59:45:00,0.0,24,20,3,0,4,0.833333333
2021020496,15,60:00:00,0.0,33,30,6,0,3,0.909090909
2021020497,5,26:23:00,0.0,17,16,3,0,1,0.941176471
2021020497,5,33:26:00,0.0,19,14,1,0,5,0.736842105
2021020497,1,60:00:00,0.0,38,37,2,0,1,0.973684211
2021020498,16,59:43:00,0.0,23,20,0,0,3,0.869565217
2021020498,13,60:00:00,0.0,24,22,6,0,2,0.916666667
2021020499,18,59:05:00,0.0,42,38,10,2,4,0.904761905
2021020499,52,60:00:00,0.0,36,34,5,1,2,0.944444444
2021020500,20,59:46:00,2.0,28,26,7,3,2,0.928571429
2021020500,24,28:05:00,0.0,20,16,5,0,4,0.8
2021020500,24,31:28:00,0.0,22,21,7,0,1,0.954545455
2021020501,54,58:12:00,0.0,19,15,3,0,4,0.789473684
2021020501,14,0:03,0.0,0,0,0,0,0,
2021020501,14,59:57:00,0.0,41,38,4,1,3,0.926829268
2021020502,28,60:57:00,0.0,27,22,3,0,5,0.814814815
2021020502,23,62:16:00,0.0,28,24,5,0,4,0.857142857
2021020503,55,58:49:00,0.0,25,22,1,0,3,0.88
2021020503,53,60:00:00,0.0,36,34,6,0,2,0.944444444
2021020504,7,58:43:00,0.0,35,31,4,1,4,0.885714286
2021020504,21,60:00:00,0.0,32,29,2,0,3,0.90625
2021020505,3,59:51:00,0.0,23,19,0,0,4,0.826086957
2021020505,8,60:00:00,0.0,27,24,2,0,3,0.888888889
2021020506,25,63:10:00,0.0,34,31,1,1,3,0.911764706
2021020506,52,61:55:00,0.0,35,31,9,0,4,0.885714286
2021020507,26,58:22:00,0.0,27,24,4,1,3,0.888888889
2021020507,22,60:00:00,0.0,32,30,9,0,2,0.9375
2021020508,6,59:41:00,0.0,29,28,2,1,1,0.965517241
2021020508,21,59:43:00,0.0,45,40,10,0,5,0.888888889
2021020509,10,59:36:00,0.0,33,28,3,0,5,0.848484848
2021020509,19,60:00:00,0.0,37,34,1,0,3,0.918918919
2021020510,9,59:52:00,0.0,45,42,8,1,3,0.933333333
2021020510,12,57:14:00,0.0,31,27,5,0,4,0.870967742
2021020511,13,57:00:00,0.0,32,27,6,0,5,0.84375
2021020511,18,60:00:00,0.0,48,44,4,1,4,0.916666667
2021020512,1,41:26:00,0.0,19,13,0,0,6,0.684210526
2021020512,1,18:34,0.0,7,6,0,0,1,0.857142857
2021020512,8,60:00:00,0.0,37,33,3,0,4,0.891891892
2021020513,2,60:00:00,0.0,27,26,5,0,1,0.962962963
2021020513,15,59:31:00,0.0,26,21,0,2,5,0.807692308
2021020514,5,60:31:00,0.0,27,23,5,0,4,0.851851852
2021020514,4,60:31:00,0.0,34,29,4,3,5,0.852941176
2021020515,29,60:00:00,0.0,36,33,1,0,3,0.916666667
2021020515,7,59:00:00,0.0,38,32,7,0,6,0.842105263
2021020516,16,65:00:00,0.0,29,29,4,0,0,1.0
2021020516,25,65:00:00,0.0,34,34,4,0,0,1.0
2021020517,30,59:40:00,0.0,34,30,8,1,4,0.882352941
2021020517,17,55:23:00,0.0,24,18,1,2,6,0.75
2021020518,20,60:00:00,0.0,23,22,0,0,1,0.956521739
2021020518,55,58:13:00,0.0,37,35,0,0,2,0.945945946
2021020519,53,58:53:00,0.0,32,28,1,1,4,0.875
2021020519,14,59:40:00,0.0,19,16,0,1,3,0.842105263
2021020520,23,24:20:00,0.0,14,9,6,0,5,0.642857143
2021020520,23,35:40:00,0.0,11,9,0,0,2,0.818181818
2021020520,24,59:48:00,0.0,20,16,3,1,4,0.8
2021020521,54,62:18:00,0.0,31,27,2,0,4,0.870967742
2021020521,26,62:18:00,0.0,24,21,1,1,3,0.875
2021020522,28,2:11,0.0,2,2,0,0,0,1.0
2021020522,28,57:49:00,0.0,39,36,7,1,3,0.923076923
2021020522,22,59:46:00,0.0,20,20,5,0,0,1.0
2021020523,6,58:55:00,0.0,24,21,4,2,3,0.875
2021020523,5,60:00:00,0.0,45,43,2,0,2,0.955555556
2021020524,7,59:44:00,0.0,33,30,3,1,3,0.909090909
2021020524,2,58:23:00,0.0,39,35,4,2,4,0.897435897
2021020525,3,65:00:00,0.0,33,31,4,0,2,0.939393939
2021020525,17,65:00:00,0.0,39,37,0,2,2,0.948717949
2021020526,15,57:46:00,0.0,26,22,2,0,4,0.846153846
2021020526,9,60:00:00,0.0,34,33,6,0,1,0.970588235
2021020527,12,60:16:00,0.0,31,28,5,1,3,0.903225806
2021020527,13,58:33:00,0.0,18,16,2,2,2,0.888888889
2021020528,29,60:20:00,0.0,42,39,5,3,3,0.928571429
2021020528,10,59:50:00,0.0,30,26,1,2,4,0.866666667
2021020529,19,58:55:00,0.0,27,22,1,0,5,0.814814815
2021020529,1,60:00:00,0.0,31,27,4,1,4,0.870967742
2021020530,25,59:51:00,0.0,23,20,0,1,3,0.869565217
2021020530,18,58:24:00,0.0,27,23,9,0,4,0.851851852
2021020531,52,60:00:00,0.0,27,27,3,1,0,1.0
2021020531,30,57:13:00,0.0,28,27,8,0,1,0.964285714
2021020532,20,59:31:00,0.0,28,27,3,2,1,0.964285714
2021020532,22,58:05:00,0.0,29,26,6,2,3,0.896551724
2021020533,53,59:38:00,0.0,39,34,5,1,5,0.871794872
2021020533,26,60:00:00,0.0,23,20,2,1,3,0.869565217
2021020534,23,60:00:00,0.0,27,25,4,1,2,0.925925926
2021020534,55,59:15:00,0.0,45,41,6,2,4,0.911111111
2021020535,54,57:32:00,0.0,25,23,3,0,2,0.92
2021020535,21,59:59:00,0.0,29,29,2,1,0,1.0
2021020536,24,65:00:00,0.0,43,40,13,1,3,0.930232558
2021020536,28,65:00:00,0.0,29,26,7,0,3,0.896551724
2021020537,14,58:10:00,0.0,31,27,3,1,4,0.870967742
2021020537,8,60:22:00,0.0,37,32,11,3,5,0.864864865
2021020538,16,56:38:00,0.0,36,30,6,1,6,0.833333333
2021020538,29,60:00:00,0.0,32,28,2,2,4,0.875
2021020539,26,22:47,0.0,15,10,3,0,5,0.666666667
2021020539,26,37:13:00,0.0,12,11,4,1,1,0.916666667
2021020539,54,59:59:00,0.0,27,24,6,0,3,0.888888889
2021020540,28,65:00:00,0.0,46,39,8,3,7,0.847826087
2021020540,53,64:51:00,0.0,27,20,3,0,7,0.740740741
2021020541,7,58:25:00,0.0,42,38,1,0,4,0.904761905
2021020541,1,60:00:00,0.0,22,19,0,0,3,0.863636364
2021020542,10,60:00:00,0.0,46,45,8,0,1,0.97826087
2021020542,5,58:58:00,0.0,29,25,1,2,4,0.862068966
2021020543,9,56:27:00,0.0,37,35,6,1,2,0.945945946
2021020543,6,59:31:00,0.0,30,30,2,0,0,1.0
2021020544,13,60:00:00,0.0,33,30,5,0,3,0.909090909
2021020544,3,57:44:00,0.0,32,28,1,1,4,0.875
2021020545,2,60:00:00,0.0,39,37,8,0,2,0.948717949
2021020545,17,40:00:00,0.0,16,13,2,0,3,0.8125
2021020545,17,15:44,0.0,10,8,0,0,2,0.8
2021020546,15,60:00:00,0.0,20,17,1,0,3,0.85
2021020546,18,59:16:00,0.0,36,32,13,1,4,0.888888889
2021020547,19,59:36:00,0.0,28,26,3,0,2,0.928571429
2021020547,22,57:03:00,0.0,33,29,8,0,4,0.878787879
2021020548,52,58:49:00,0.0,23,21,0,1,2,0.913043478
2021020548,16,59:45:00,0.0,32,31,2,1,1,0.96875
2021020549,21,57:56:00,0.0,19,16,1,0,3,0.842105263
2021020549,25,60:00:00,0.0,47,46,9,1,1,0.978723404
2021020550,24,60:26:00,0.0,37,35,5,0,2,0.945945946
2021020550,23,60:26:00,0.0,23,22,2,1,1,0.956521739
2021020551,55,62:03:00,0.0,22,19,2,1,3,0.863636364
2021020551,4,62:04:00,0.0,36,34,4,1,2,0.944444444
2021020552,13,60:00:00,0.0,42,39,5,1,3,0.928571429
2021020552,14,39:58:00,0.0,27,21,1,0,6,0.777777778
2021020552,14,20:00,0.0,10,7,1,1,3,0.7
2021020553,2,59:14:00,0.0,37,36,7,1,1,0.972972973
2021020553,7,58:04:00,0.0,32,28,2,0,4,0.875
2021020554,12,60:00:00,0.0,26,26,6,3,0,1.0
2021020554,8,59:45:00,0.0,38,34,8,1,4,0.894736842
2021020555,29,64:36:00,0.0,34,31,4,0,3,0.911764706
2021020555,18,64:57:00,0.0,29,26,7,0,3,0.896551724
2021020556,26,65:00:00,0.0,18,17,0,1,1,0.944444444
2021020556,23,65:00:00,0.0,35,34,1,0,1,0.971428571
2021020557,28,63:49:00,0.0,25,23,3,1,2,0.92
2021020557,4,64:29:00,0.0,46,43,9,2,3,0.934782609
2021020558,55,58:03:00,2.0,39,34,10,2,5,0.871794872
2021020558,20,60:00:00,0.0,22,18,4,0,4,0.818181818
2021020559,9,58:44:00,0.0,43,42,4,2,1,0.976744186
2021020559,5,60:00:00,0.0,26,26,2,2,0,1.0
2021020560,17,58:19:00,0.0,26,24,5,1,2,0.923076923
2021020560,15,60:00:00,0.0,20,19,3,2,1,0.95
2021020561,14,64:17:00,0.0,23,20,8,0,3,0.869565217
2021020561,3,65:00:00,0.0,28,25,5,1,3,0.892857143
2021020562,1,62:15:00,0.0,37,32,2,0,5,0.864864865
2021020562,22,62:55:00,0.0,41,35,3,0,6,0.853658537
2021020563,25,58:44:00,0.0,29,26,3,1,3,0.896551724
2021020563,21,60:00:00,0.0,23,23,3,0,0,1.0
2021020564,20,59:36:00,0.0,23,22,3,0,1,0.956521739
2021020564,52,59:45:00,0.0,30,28,5,1,2,0.933333333
2021020565,54,59:59:00,0.0,16,15,0,0,1,0.9375
2021020565,24,60:00:00,0.0,45,42,14,0,3,0.933333333
2021020566,6,60:34:00,0.0,22,19,5,1,3,0.863636364
2021020566,7,60:34:00,0.0,41,37,8,0,4,0.902439024
2021020567,10,59:52:00,0.0,23,23,0,3,0,1.0
2021020567,9,60:00:00,0.0,40,34,9,1,6,0.85
2021020568,13,59:56:00,0.0,31,29,5,1,2,0.935483871
2021020568,8,59:39:00,0.0,48,43,8,0,5,0.895833333
2021020569,2,63:49:00,0.0,19,17,0,0,2,0.894736842
2021020569,22,63:52:00,0.0,29,26,4,0,3,0.896551724
2021020570,29,40:00:00,0.0,33,31,5,2,2,0.939393939
2021020570,29,19:08,0.0,15,11,0,0,4,0.733333333
2021020570,12,39:56:00,0.0,9,8,3,0,1,0.888888889
2021020570,12,20:00,0.0,9,6,0,0,3,0.666666667
2021020571,18,60:00:00,0.0,38,37,12,0,1,0.973684211
2021020571,16,39:53:00,0.0,18,15,3,0,3,0.833333333
2021020571,16,20:00,0.0,7,4,3,0,3,0.571428571
2021020572,30,40:00:00,0.0,28,22,2,2,6,0.785714286
2021020572,30,12:15,0.0,4,4,1,0,0,1.0
2021020572,19,60:00:00,2.0,33,29,1,1,4,0.878787879
2021020573,26,60:00:00,0.0,37,34,7,0,3,0.918918919
2021020573,4,58:07:00,0.0,33,28,5,2,5,0.848484848
2021020574,55,59:29:00,0.0,34,30,4,0,4,0.882352941
2021020574,23,60:00:00,0.0,32,30,5,0,2,0.9375
2021020575,17,59:25:00,0.0,37,32,5,2,5,0.864864865
2021020575,6,60:00:00,2.0,24,23,4,1,1,0.958333333
2021020576,3,60:00:00,0.0,38,38,9,2,0,1.0
2021020576,14,59:58:00,0.0,21,17,3,0,4,0.80952381
2021020577,5,59:40:00,0.0,27,22,0,1,5,0.814814815
2021020577,28,38:32:00,0.0,21,20,3,0,1,0.952380952
2021020577,28,20:00,0.0,17,11,0,0,6,0.647058824
2021020578,15,62:56:00,0.0,37,33,1,2,4,0.891891892
2021020578,1,62:56:00,0.0,30,27,1,1,3,0.9
2021020579,16,59:18:00,0.0,41,37,13,1,4,0.902439024
2021020579,20,60:00:00,0.0,31,30,4,1,1,0.967741935
2021020580,21,60:00:00,0.0,31,29,4,2,2,0.935483871
2021020580,24,59:33:00,0.0,35,32,4,2,3,0.914285714
2021020581,53,60:00:00,0.0,33,32,2,0,1,0.96969697
2021020581,25,58:48:00,0.0,26,24,4,1,2,0.923076923
2021020582,54,61:10:00,0.0,37,32,5,1,5,0.864864865
2021020582,52,61:43:00,0.0,46,42,3,0,4,0.913043478
2021020583,10,62:38:00,0.0,31,28,0,2,3,0.903225806
2021020583,12,62:51:00,0.0,32,28,6,0,4,0.875
2021020584,9,60:00:00,0.0,43,40,9,3,3,0.930232558
2021020584,30,58:58:00,0.0,34,30,11,2,4,0.882352941
2021020585,3,59:42:00,0.0,34,33,3,1,1,0.970588235
2021020585,22,60:00:00,2.0,28,24,5,0,4,0.857142857
2021020586,6,60:00:00,0.0,26,23,0,2,3,0.884615385
2021020586,1,58:49:00,0.0,34,29,1,1,5,0.852941176
2021020587,8,25:18:00,0.0,14,10,2,0,4,0.714285714
2021020587,8,31:44:00,0.0,8,8,1,0,0,1.0
2021020587,15,60:00:00,0.0,44,42,3,3,2,0.954545455
2021020588,17,59:51:00,0.0,26,24,5,1,2,0.923076923
2021020588,28,20:00,0.0,7,5,0,0,2,0.714285714
2021020588,28,40:00:00,0.0,24,20,4,2,4,0.833333333
2021020589,13,60:00:00,0.0,49,47,4,1,2,0.959183673
2021020589,20,60:00:00,0.0,45,39,3,2,6,0.866666667
2021020590,29,60:00:00,0.0,36,29,5,1,7,0.805555556
2021020590,14,60:00:00,0.0,22,20,0,0,2,0.909090909
2021020591,16,62:38:00,0.0,33,29,4,0,4,0.878787879
2021020591,21,62:38:00,0.0,31,28,2,0,3,0.903225806
2021020592,53,58:18:00,0.0,48,46,18,0,2,0.958333333
2021020592,52,60:00:00,0.0,27,26,2,1,1,0.962962963
2021020593,54,55:44:00,0.0,26,23,1,1,3,0.884615385
2021020593,18,60:00:00,0.0,43,41,5,0,2,0.953488372
2021020594,24,60:00:00,0.0,29,28,0,4,1,0.965517241
2021020594,4,57:26:00,0.0,29,26,3,0,3,0.896551724
2021020595,55,58:46:00,0.0,35,31,1,0,4,0.885714286
2021020595,2,60:00:00,0.0,25,23,0,0,2,0.92
2021020596,10,59:28:00,0.0,30,28,2,1,2,0.933333333
2021020596,22,58:40:00,0.0,32,29,2,0,3,0.90625
2021020597,5,33:49:00,0.0,16,13,1,0,3,0.8125
2021020597,5,25:55:00,0.0,13,13,0,1,0,1.0
2021020597,19,58:43:00,0.0,41,36,5,0,5,0.87804878
2021020598,23,43:41:00,0.0,15,14,2,1,1,0.933333333
2021020598,23,16:19,0.0,12,7,0,0,5,0.583333333
2021020598,2,60:00:00,0.0,37,34,3,0,3,0.918918919
2021020599,6,58:39:00,0.0,30,27,11,2,3,0.9
2021020599,30,59:16:00,0.0,38,36,8,1,2,0.947368421
2021020600,7,57:54:00,0.0,21,18,0,2,3,0.857142857
2021020600,28,60:00:00,0.0,39,37,6,2,2,0.948717949
2021020601,8,60:00:00,0.0,37,35,4,0,2,0.945945946
2021020601,10,60:00:00,0.0,24,19,1,0,5,0.791666667
2021020602,14,60:00:00,0.0,27,26,8,0,1,0.962962963
2021020602,20,60:00:00,0.0,33,29,7,0,4,0.878787879
2021020603,1,60:00:00,0.0,32,31,5,2,1,0.96875
2021020603,29,58:08:00,0.0,27,25,2,0,2,0.925925926
2021020604,4,60:00:00,0.0,32,26,1,1,6,0.8125
2021020604,5,59:52:00,2.0,20,18,1,0,2,0.9
2021020605,25,65:00:00,0.0,42,37,5,3,5,0.880952381
2021020605,13,62:47:00,0.0,36,31,2,0,5,0.861111111
2021020606,21,59:48:00,0.0,35,34,9,0,1,0.971428571
2021020606,52,60:00:00,0.0,42,35,2,0,7,0.833333333
2021020607,53,60:00:00,0.0,36,32,7,1,4,0.888888889
2021020607,16,58:29:00,0.0,25,20,3,1,5,0.8
2021020608,54,60:00:00,0.0,20,19,3,0,1,0.95
2021020608,3,60:00:00,0.0,35,30,3,0,5,0.857142857
2021020609,24,65:00:00,0.0,36,33,4,0,3,0.916666667
2021020609,17,65:00:00,0.0,27,24,1,1,3,0.888888889
2021020610,26,58:06:00,0.0,19,16,1,1,3,0.842105263
2021020610,18,60:00:00,0.0,48,46,7,1,2,0.958333333
2021020611,55,60:00:00,0.0,14,12,0,1,2,0.857142857
2021020611,9,59:35:00,0.0,28,25,10,0,3,0.892857143
2021020612,12,60:00:00,0.0,39,36,4,1,3,0.923076923
2021020612,20,60:00:00,0.0,37,31,4,2,6,0.837837838
2021020613,19,60:00:00,0.0,27,26,3,0,1,0.962962963
2021020613,15,40:00:00,0.0,16,12,0,0,4,0.75
2021020613,15,19:06,0.0,7,7,2,0,0,1.0
2021020614,8,58:18:00,0.0,32,27,0,0,5,0.84375
2021020614,7,60:00:00,0.0,32,29,4,0,3,0.90625
2021020621,52,59:41:00,0.0,23,20,2,2,3,0.869565217
2021020621,55,58:31:00,0.0,28,24,2,0,4,0.857142857
2021020623,22,60:00:00,0.0,38,37,5,0,1,0.973684211
2021020623,2,58:16:00,0.0,36,33,3,2,3,0.916666667
2021020625,23,45:00:00,0.0,17,14,0,1,3,0.823529412
2021020625,23,20:00,0.0,14,14,2,0,0,1.0
2021020625,9,65:00:00,0.0,37,34,2,1,3,0.918918919
2021020629,19,58:48:00,0.0,27,26,4,1,1,0.962962963
2021020629,25,59:31:00,0.0,31,29,3,3,2,0.935483871
2021020630,8,59:52:00,0.0,42,40,3,0,2,0.952380952
2021020630,29,60:00:00,0.0,31,30,1,3,1,0.967741935
2021020631,1,50:21:00,0.0,30,24,1,1,6,0.8
2021020631,1,9:39,0.0,2,2,0,1,0,1.0
2021020631,14,60:00:00,0.0,25,22,2,0,3,0.88
2021020632,15,32:03:00,0.0,15,12,0,1,3,0.8
2021020632,15,27:53:00,0.0,16,12,3,0,4,0.75
2021020632,6,59:58:00,0.0,30,27,2,1,3,0.9
2021020633,52,60:00:00,0.0,36,33,2,0,3,0.916666667
2021020633,30,56:57:00,0.0,30,25,3,2,5,0.833333333
2021020634,21,60:00:00,0.0,26,23,4,0,3,0.884615385
2021020634,55,58:02:00,0.0,35,31,2,1,4,0.885714286
2021020635,22,58:55:00,0.0,25,20,1,1,5,0.8
2021020635,9,59:15:00,0.0,37,33,6,0,4,0.891891892
2021020636,26,60:00:00,0.0,23,22,2,0,1,0.956521739
2021020636,3,58:09:00,0.0,38,36,7,2,2,0.947368421
2021020637,7,20:00,0.0,9,7,1,0,2,0.777777778
2021020637,7,39:34:00,0.0,27,23,0,2,4,0.851851852
2021020637,14,60:00:00,0.0,18,17,4,1,1,0.944444444
2021020638,13,60:00:00,0.0,44,42,10,0,2,0.954545455
2021020638,23,58:00:00,0.0,26,21,4,0,5,0.807692308
2021020639,4,64:42:00,0.0,31,27,5,0,4,0.870967742
2021020639,12,64:26:00,0.0,41,38,1,1,3,0.926829268
2021020640,29,59:04:00,0.0,19,16,3,1,3,0.842105263
2021020640,16,59:43:00,0.0,26,24,3,2,2,0.923076923
2021020641,18,62:31:00,0.0,44,40,4,2,4,0.909090909
2021020641,21,63:01:00,0.0,32,27,6,0,5,0.84375
2021020642,20,60:00:00,0.0,21,19,2,0,2,0.904761905
2021020642,2,60:00:00,0.0,29,24,0,0,5,0.827586207
2021020643,54,65:00:00,0.0,18,15,1,1,3,0.833333333
2021020643,10,65:00:00,0.0,34,31,4,0,3,0.911764706
2021020644,24,58:48:00,0.0,33,30,5,1,3,0.909090909
2021020644,5,60:00:00,0.0,26,25,2,0,1,0.961538462
2021020645,28,60:53:00,0.0,19,17,0,0,2,0.894736842
2021020645,17,61:00:00,0.0,40,37,4,1,3,0.925
2021020646,8,60:34:00,0.0,46,43,12,0,3,0.934782609
2021020646,6,60:34:00,0.0,28,26,3,2,2,0.928571429
2021020647,25,59:59:00,0.0,25,23,3,0,2,0.92
2021020647,55,58:44:00,0.0,24,20,2,0,4,0.833333333
2021020648,22,46:17:00,0.0,15,12,2,0,3,0.8
2021020648,22,13:38,0.0,7,3,0,0,4,0.428571429
2021020648,30,60:00:00,0.0,33,30,5,0,3,0.909090909
2021020649,53,60:00:00,0.0,46,45,11,2,1,0.97826087
2021020649,10,57:25:00,0.0,18,16,4,1,2,0.888888889
2021020650,6,59:40:00,0.0,27,25,3,1,2,0.925925926
2021020650,4,56:11:00,0.0,36,33,5,0,3,0.916666667
2021020651,17,58:02:00,0.0,31,29,3,1,2,0.935483871
2021020651,52,60:00:00,0.0,33,33,8,0,0,1.0
2021020652,14,59:57:00,0.0,26,24,1,0,2,0.923076923
2021020652,23,58:49:00,0.0,20,17,2,0,3,0.85
2021020653,2,60:00:00,0.0,32,30,4,2,2,0.9375
2021020653,1,57:41:00,0.0,25,22,5,0,3,0.88
2021020654,12,45:03:00,0.0,32,28,1,0,4,0.875
2021020654,12,14:57,0.0,3,1,0,0,2,0.333333333
2021020654,29,60:00:00,0.0,31,31,0,1,0,1.0
2021020655,16,62:02:00,0.0,29,27,3,0,2,0.931034483
2021020655,8,62:24:00,0.0,31,28,5,1,3,0.903225806
2021020656,19,60:00:00,0.0,32,31,7,1,1,0.96875
2021020656,55,58:18:00,2.0,27,25,7,0,2,0.925925926
2021020657,18,58:06:00,0.0,20,17,4,1,3,0.85
2021020657,7,59:57:00,2.0,30,29,4,1,1,0.966666667
2021020658,20,59:54:00,0.0,34,30,3,1,4,0.882352941
2021020658,9,60:00:00,0.0,28,27,2,0,1,0.964285714
2021020659,26,60:00:00,0.0,29,27,0,0,2,0.931034483
2021020659,5,60:00:00,0.0,45,39,7,1,6,0.866666667
2021020660,28,58:56:00,0.0,30,28,1,1,2,0.933333333
2021020660,3,60:00:00,0.0,37,37,2,0,0,1.0
2021020661,13,59:40:00,0.0,30,29,1,1,1,0.966666667
2021020661,25,26:03:00,0.0,17,13,0,0,4,0.764705882
2021020661,25,33:56:00,0.0,22,19,1,1,3,0.863636364
2021020662,30,60:00:00,0.0,42,39,3,0,3,0.928571429
2021020662,24,17:55,0.0,13,12,0,0,1,0.923076923
2021020662,24,42:05:00,0.0,29,23,0,0,6,0.793103448
2021020663,21,64:45:00,0.0,26,23,2,2,3,0.884615385
2021020663,53,65:00:00,0.0,47,44,8,0,3,0.936170213
2021020664,22,60:00:00,0.0,28,24,3,0,4,0.857142857
2021020664,54,60:00:00,0.0,28,28,4,0,0,1.0
2021020665,6,61:35:00,0.0,29,26,3,1,3,0.896551724
2021020665,18,61:41:00,0.0,44,40,4,1,4,0.909090909
2021020666,8,60:00:00,0.0,34,27,0,3,7,0.794117647
2021020666,1,59:50:00,0.0,31,30,7,0,1,0.967741935
2021020667,17,58:43:00,0.0,22,22,6,3,0,1.0
2021020667,7,59:59:00,0.0,39,35,9,1,4,0.897435897
2021020668,14,60:00:00,0.0,20,19,2,3,1,0.95
2021020668,25,58:33:00,0.0,28,26,4,0,2,0.928571429
2021020669,13,60:00:00,0.0,30,28,3,1,2,0.933333333
2021020669,29,46:32:00,0.0,36,31,1,1,5,0.861111111
2021020669,29,13:28,0.0,15,11,0,1,4,0.733333333
2021020670,2,58:03:00,0.0,35,34,3,1,1,0.971428571
2021020670,15,60:00:00,0.0,23,23,7,0,0,1.0
2021020671,4,57:35:00,0.0,27,24,3,0,3,0.888888889
2021020671,3,59:56:00,0.0,28,26,1,0,2,0.928571429
2021020672,12,60:00:00,0.0,31,30,5,0,1,0.967741935
2021020672,23,59:59:00,0.0,33,29,2,4,4,0.878787879
2021020673,16,60:00:00,0.0,37,37,3,3,0,1.0
2021020673,24,59:06:00,0.0,35,33,4,1,2,0.942857143
2021020674,19,57:23:00,0.0,40,34,3,0,6,0.85
2021020674,10,59:36:00,0.0,25,20,2,0,5,0.8
2021020675,52,57:48:00,0.0,32,28,1,0,4,0.875
2021020675,9,60:00:00,0.0,24,22,0,0,2,0.916666667
2021020676,20,60:00:00,0.0,28,28,4,0,0,1.0
2021020676,54,60:00:00,0.0,33,27,2,1,6,0.818181818
2021020677,53,60:00:00,0.0,32,27,4,1,5,0.84375
2021020677,21,60:00:00,0.0,20,20,2,0,0,1.0
2021020678,28,60:37:00,0.0,27,25,0,4,2,0.925925926
2021020678,5,60:37:00,0.0,41,40,9,0,1,0.975609756
2021020679,55,58:47:00,0.0,21,19,0,1,2,0.904761905
2021020679,26,60:00:00,0.0,18,17,2,1,1,0.944444444
2021020680,15,58:18:00,0.0,31,28,1,1,3,0.903225806
2021020680,23,60:00:00,0.0,33,31,4,1,2,0.939393939
2021020681,52,58:32:00,0.0,39,36,8,2,3,0.923076923
2021020681,22,60:00:00,0.0,24,22,2,1,2,0.916666667
2021020682,7,62:07:00,0.0,35,32,0,1,3,0.914285714
2021020682,17,62:07:00,0.0,28,26,5,1,2,0.928571429
2021020683,10,50:49:00,0.0,20,19,4,1,1,0.95
2021020683,10,9:10,0.0,9,6,0,0,3,0.666666667
2021020683,1,59:36:00,0.0,32,27,3,2,5,0.84375
2021020684,2,60:00:00,0.0,27,26,3,2,1,0.962962963
2021020684,4,57:51:00,0.0,30,27,1,2,3,0.9
2021020685,19,60:00:00,0.0,35,32,7,1,3,0.914285714
2021020685,18,57:41:00,0.0,29,24,3,2,5,0.827586207
2021020686,21,29:26:00,0.0,13,12,2,0,1,0.923076923
2021020686,21,35:34:00,0.0,27,25,2,1,2,0.925925926
2021020686,30,64:54:00,0.0,38,35,7,0,3,0.921052632
2021020687,53,60:00:00,0.0,26,24,2,4,2,0.923076923
2021020687,8,40:00:00,0.0,16,12,2,1,4,0.75
2021020687,8,19:15,0.0,6,6,4,0,0,1.0
2021020688,54,58:39:00,0.0,36,32,7,2,4,0.888888889
2021020688,5,60:00:00,0.0,26,23,2,0,3,0.884615385
2021020689,28,60:00:00,0.0,41,39,4,0,2,0.951219512
2021020689,26,60:00:00,0.0,17,11,0,1,6,0.647058824
2021020690,55,64:20:00,0.0,27,25,10,4,2,0.925925926
2021020690,16,65:00:00,0.0,37,35,8,0,2,0.945945946
2021020691,6,40:00:00,0.0,22,20,3,0,2,0.909090909
2021020691,6,20:00,0.0,12,7,0,0,5,0.583333333
2021020691,12,60:00:00,0.0,32,31,6,0,1,0.96875
2021020692,9,59:37:00,0.0,31,29,4,0,2,0.935483871
2021020692,7,60:00:00,0.0,44,43,8,0,1,0.977272727
2021020693,2,59:35:00,0.0,25,25,7,3,0,1.0
2021020693,29,59:45:00,0.0,33,27,2,1,6,0.818181818
2021020694,4,56:49:00,0.0,33,28,5,2,5,0.848484848
2021020694,17,59:57:00,0.0,24,21,7,2,3,0.875
2021020695,15,60:03:00,0.0,33,30,6,1,3,0.909090909
2021020695,52,59:55:00,0.0,31,27,2,0,4,0.870967742
2021020696,18,58:00:00,0.0,24,21,6,1,3,0.875
2021020696,23,59:43:00,0.0,32,31,3,0,1,0.96875
2021020697,25,44:07:00,0.0,19,14,0,2,5,0.736842105
2021020697,25,11:23,0.0,3,3,1,0,0,1.0
2021020697,8,59:42:00,0.0,51,48,23,1,3,0.941176471
2021020698,20,60:00:00,0.0,29,28,4,1,1,0.965517241
2021020698,13,59:56:00,0.0,31,26,3,0,5,0.838709677
2021020699,22,59:55:00,0.0,30,26,3,1,4,0.866666667
2021020699,16,60:00:00,0.0,41,40,12,0,1,0.975609756
2021020700,26,58:34:00,0.0,24,19,2,0,5,0.791666667
2021020700,14,60:00:00,0.0,36,32,6,2,4,0.888888889
2021020701,1,56:53:00,0.0,17,13,4,0,4,0.764705882
2021020701,53,60:00:00,0.0,36,35,4,2,1,0.972222222
2021020702,3,60:00:00,0.0,38,35,5,2,3,0.921052632
2021020702,10,58:30:00,0.0,26,21,3,0,5,0.807692308
2021020703,24,58:40:00,0.0,27,26,3,4,1,0.962962963
2021020703,21,59:52:00,0.0,34,34,4,0,0,1.0
2021020704,6,60:00:00,0.0,17,14,2,0,3,0.823529412
2021020704,15,59:22:00,0.0,33,30,5,2,4,0.909090909
2021020705,7,57:58:00,0.0,47,42,2,1,5,0.893617021
2021020705,25,59:54:00,0.0,24,20,0,0,4,0.833333333
2021020706,4,57:41:00,0.0,29,27,4,2,2,0.931034483
2021020706,29,60:00:00,0.0,34,33,2,1,1,0.970588235
2021020707,5,59:53:00,0.0,43,39,4,1,4,0.906976744
2021020707,9,14:22,0.0,7,5,0,0,2,0.714285714
2021020707,9,44:40:00,0.0,26,23,4,0,3,0.884615385
2021020708,18,60:00:00,0.0,38,36,8,3,2,0.947368421
2021020708,52,57:13:00,0.0,22,18,3,1,4,0.818181818
2021020709,22,60:00:00,0.0,28,22,4,0,6,0.785714286
2021020709,13,60:00:00,0.0,40,40,7,2,0,1.0
2021020710,54,61:29:00,0.0,27,24,3,1,3,0.888888889
2021020710,8,61:50:00,0.0,53,49,1,1,4,0.924528302
2021020711,26,57:56:00,0.0,26,23,3,2,3,0.884615385
2021020711,21,60:00:00,0.0,41,40,4,0,1,0.975609756
2021020712,55,60:00:00,0.0,25,23,7,3,2,0.92
2021020712,28,58:27:00,0.0,17,14,2,1,3,0.823529412
2021020713,17,62:05:00,0.0,32,27,3,0,5,0.84375
2021020713,25,62:22:00,2.0,28,24,4,2,4,0.857142857
2021020714,2,59:33:00,0.0,17,17,0,0,0,1.0
2021020714,53,60:00:00,0.0,35,31,6,0,4,0.885714286
2021020715,12,60:00:00,0.0,23,20,2,0,3,0.869565217
2021020715,3,59:34:00,0.0,35,29,0,0,6,0.828571429
2021020716,29,59:29:00,0.0,30,26,9,0,4,0.866666667
2021020716,5,20:00,0.0,12,10,0,1,2,0.833333333
2021020716,5,40:00:00,0.0,15,15,1,1,0,1.0
2021020717,16,31:33:00,0.0,13,9,0,0,4,0.692307692
2021020717,16,27:55:00,0.0,17,16,3,0,1,0.941176471
2021020717,30,60:00:00,0.0,36,35,5,0,1,0.972222222
2021020718,23,65:00:00,0.0,34,33,4,1,1,0.970588235
2021020718,13,64:57:00,0.0,28,27,4,0,1,0.964285714
2021020719,24,59:45:00,0.0,33,32,9,0,1,0.96969697
2021020719,14,59:19:00,0.0,34,30,2,5,4,0.882352941
2021020720,55,59:58:00,0.0,31,26,5,2,5,0.838709677
2021020720,19,60:00:00,0.0,27,27,6,1,0,1.0
2021020721,6,59:45:00,2.0,24,22,3,0,2,0.916666667
2021020721,52,58:26:00,0.0,32,29,2,4,3,0.90625
2021020722,7,60:00:00,0.0,33,30,11,0,3,0.909090909
2021020722,4,18:00,0.0,8,4,0,0,4,0.5
2021020722,4,42:00:00,0.0,16,14,2,0,2,0.875
2021020723,10,60:00:00,0.0,29,27,2,0,2,0.931034483
2021020723,2,58:05:00,0.0,36,33,7,0,3,0.916666667
2021020724,1,59:54:00,0.0,32,28,1,1,4,0.875
2021020724,12,60:00:00,0.0,38,31,0,1,7,0.815789474
2021020725,3,59:59:00,0.0,29,26,6,0,3,0.896551724
2021020725,53,18:18,0.0,7,6,4,1,1,0.857142857
2021020725,53,41:33:00,0.0,20,14,0,0,6,0.7
2021020726,15,61:13:00,0.0,22,20,2,0,2,0.909090909
2021020726,9,61:13:00,0.0,33,30,7,1,3,0.909090909
2021020727,18,59:24:00,0.0,29,28,7,0,1,0.965517241
2021020727,17,57:56:00,0.0,24,21,1,1,3,0.875
2021020728,30,63:12:00,0.0,36,33,3,1,3,0.916666667
2021020728,16,64:22:00,0.0,44,40,9,0,4,0.909090909
2021020729,21,60:42:00,0.0,30,28,5,3,2,0.933333333
2021020729,8,61:16:00,0.0,46,43,5,1,3,0.934782609
2021020730,22,60:00:00,0.0,47,44,6,0,3,0.936170213
2021020730,20,58:54:00,0.0,30,26,2,0,4,0.866666667
2021020731,28,47:28:00,0.0,18,15,4,0,3,0.833333333
2021020731,28,12:32,0.0,13,9,0,0,4,0.692307692
2021020731,14,60:00:00,0.0,28,27,4,0,1,0.964285714
2021020732,1,58:28:00,0.0,37,34,4,0,3,0.918918919
2021020732,26,60:00:00,0.0,25,23,1,2,2,0.92
2021020733,5,65:00:00,0.0,29,27,0,4,2,0.931034483
2021020733,52,65:00:00,0.0,38,36,6,0,2,0.947368421
2021020734,29,57:57:00,0.0,33,31,4,3,2,0.939393939
2021020734,9,60:00:00,0.0,36,35,5,2,1,0.972222222
2021020735,23,57:21:00,0.0,17,14,0,0,3,0.823529412
2021020735,19,59:46:00,0.0,39,38,8,0,1,0.974358974
2021020736,55,59:57:00,0.0,31,28,4,1,3,0.903225806
2021020736,13,57:42:00,0.0,28,24,3,0,4,0.857142857
2021020737,6,56:56:00,0.0,27,22,3,2,5,0.814814815
2021020737,24,60:00:00,0.0,26,23,2,0,3,0.884615385
2021020738,3,64:27:00,0.0,36,34,6,1,2,0.944444444
2021020738,26,65:00:00,0.0,30,28,13,0,2,0.933333333
2021020739,4,58:16:00,0.0,35,33,0,0,2,0.942857143
2021020739,25,60:00:00,0.0,28,27,0,0,1,0.964285714
2021020740,15,58:45:00,0.0,29,28,9,0,1,0.965517241
2021020740,54,60:00:00,0.0,34,34,8,1,0,1.0
2021020741,30,40:00:00,0.0,15,14,0,0,1,0.933333333
2021020741,30,20:00,0.0,6,5,0,2,1,0.833333333
2021020741,8,40:00:00,0.0,32,27,5,1,5,0.84375
2021020741,8,20:00,0.0,7,4,0,0,3,0.571428571
2021020742,21,59:50:00,0.0,24,24,0,1,0,1.0
2021020742,16,56:37:00,0.0,29,27,4,0,2,0.931034483
2021020743,20,60:00:00,0.0,21,20,5,1,1,0.952380952
2021020743,19,20:00,0.0,13,13,0,0,0,1.0
2021020743,19,40:00:00,0.0,35,28,6,0,7,0.8
2021020744,9,59:48:00,0.0,32,32,10,2,0,1.0
2021020744,7,59:47:00,0.0,47,43,7,4,5,0.914893617
2021020745,1,39:11:00,0.0,24,23,3,0,1,0.958333333
2021020745,1,20:00,0.0,7,4,0,0,3,0.571428571
2021020745,25,60:00:00,0.0,37,36,0,1,1,0.972972973
2021020746,2,60:00:00,0.0,17,14,0,1,3,0.823529412
2021020746,4,57:31:00,0.0,33,29,6,1,4,0.878787879
2021020747,5,60:00:00,0.0,16,13,1,1,3,0.8125
2021020747,53,59:57:00,0.0,36,30,2,0,6,0.833333333
2021020748,12,63:49:00,0.0,29,26,1,2,3,0.896551724
2021020748,54,63:49:00,0.0,30,26,1,0,4,0.866666667
2021020749,52,59:03:00,0.0,32,27,4,0,5,0.84375
2021020749,13,59:45:00,0.0,35,32,7,1,3,0.914285714
2021020750,23,64:15:00,0.0,50,47,8,1,3,0.94
2021020750,22,64:20:00,0.0,27,25,1,1,2,0.925925926
2021020751,55,57:05:00,0.0,27,23,7,0,4,0.851851852
2021020751,18,59:31:00,0.0,35,33,3,1,2,0.942857143
2021020752,10,64:58:00,0.0,20,18,1,0,3,0.9
2021020752,24,64:48:00,0.0,44,41,6,0,3,0.931818182
2021020753,17,38:27:00,0.0,21,18,1,0,3,0.857142857
2021020753,17,20:00,0.0,16,12,0,0,4,0.75
2021020753,16,60:00:00,0.0,33,28,1,1,5,0.848484848
2021020754,15,57:44:00,0.0,29,26,0,0,3,0.896551724
2021020754,28,60:00:00,0.0,33,32,7,1,1,0.96969697
2021020755,29,60:00:00,0.0,62,56,10,0,6,0.903225806
2021020755,20,60:00:00,2.0,23,23,3,0,0,1.0
2021020756,21,61:08:00,0.0,32,29,8,1,3,0.90625
2021020756,6,63:01:00,0.0,41,37,5,0,4,0.902439024
2021020757,8,20:00,0.0,9,6,2,1,3,0.666666667
2021020757,8,37:55:00,0.0,15,13,3,0,2,0.866666667
2021020757,24,60:00:00,0.0,40,36,0,3,4,0.9
2021020758,9,65:00:00,0.0,29,27,5,0,2,0.931034483
2021020758,12,65:00:00,0.0,39,37,3,1,2,0.948717949
2021020759,14,60:00:00,0.0,33,31,4,0,2,0.939393939
2021020759,1,57:23:00,0.0,35,32,1,5,3,0.914285714
2021020760,13,59:53:00,0.0,25,24,4,0,1,0.96
2021020760,54,59:21:00,0.0,30,28,1,1,2,0.933333333
2021020761,2,58:03:00,0.0,29,27,5,0,2,0.931034483
2021020761,26,60:00:00,0.0,25,23,1,1,2,0.92
2021020762,5,61:13:00,0.0,29,27,7,0,2,0.931034483
2021020762,55,61:17:00,0.0,24,23,3,0,1,0.958333333
2021020763,29,60:00:00,0.0,36,33,4,0,3,0.916666667
2021020763,3,57:44:00,0.0,18,14,1,0,4,0.777777778
2021020764,19,59:33:00,0.0,29,28,3,3,1,0.965517241
2021020764,20,60:00:00,0.0,28,23,3,1,5,0.821428571
2021020765,52,59:57:00,0.0,33,28,0,3,5,0.848484848
2021020765,23,60:00:00,0.0,34,33,8,0,1,0.970588235
2021020766,22,64:53:00,0.0,30,28,0,0,2,0.933333333
2021020766,18,65:00:00,0.0,46,44,5,3,2,0.956521739
2021020767,3,58:57:00,0.0,34,31,0,0,3,0.911764706
2021020767,30,60:00:00,0.0,27,25,6,0,2,0.925925926
2021020768,5,64:57:00,0.0,32,30,2,2,2,0.9375
2021020768,17,65:00:00,0.0,38,36,7,0,2,0.947368421
2021020769,16,58:25:00,0.0,25,21,0,3,4,0.84
2021020769,21,60:00:00,0.0,43,39,4,1,4,0.906976744
2021020770,25,20:00,0.0,2,2,0,0,0,1.0
2021020770,25,40:00:00,0.0,27,22,1,1,5,0.814814815
2021020770,15,59:27:00,0.0,29,29,7,0,0,1.0
2021020771,53,57:31:00,0.0,37,35,12,0,2,0.945945946
2021020771,6,60:00:00,0.0,31,30,7,1,1,0.967741935
2021020772,8,20:00,0.0,8,7,0,1,1,0.875
2021020772,8,40:00:00,0.0,16,10,0,0,6,0.625
2021020772,22,60:00:00,0.0,23,21,1,0,2,0.913043478
2021020773,9,57:28:00,0.0,20,18,1,0,2,0.9
2021020773,24,59:45:00,0.0,45,44,9,0,1,0.977777778
2021020774,17,59:02:00,0.0,35,30,0,1,5,0.857142857
2021020774,10,59:51:00,0.0,35,31,0,1,4,0.885714286
2021020775,14,64:50:00,0.0,27,25,2,0,2,0.925925926
2021020775,54,64:37:00,0.0,29,27,7,0,2,0.931034483
2021020776,13,61:08:00,0.0,34,30,1,1,4,0.882352941
2021020776,28,61:07:00,0.0,50,45,4,0,5,0.9
2021020777,2,58:16:00,0.0,30,28,1,0,2,0.933333333
2021020777,55,59:56:00,0.0,19,19,1,0,0,1.0
2021020778,4,62:22:00,0.0,40,37,8,3,3,0.925
2021020778,26,60:29:00,0.0,36,32,5,1,4,0.888888889
2021020779,12,59:24:00,0.0,25,24,2,1,1,0.96
2021020779,1,57:41:00,0.0,23,21,3,0,2,0.913043478
2021020780,19,58:34:00,0.0,23,20,1,2,3,0.869565217
2021020780,52,59:35:00,0.0,29,28,6,1,1,0.965517241
2021020781,20,60:29:00,0.0,15,15,0,1,0,1.0
2021020781,23,60:23:00,0.0,32,31,7,1,1,0.96875
2021020782,53,56:20:00,0.0,35,32,8,0,3,0.914285714
2021020782,7,60:00:00,0.0,28,27,3,0,1,0.964285714
2021020783,8,48:30:00,0.0,28,26,2,0,2,0.928571429
2021020783,8,9:31,0.0,7,4,0,0,3,0.571428571
2021020783,29,59:49:00,0.0,35,32,3,3,3,0.914285714
2021020784,2,57:13:00,0.0,21,17,1,0,4,0.80952381
2021020784,30,60:00:00,0.0,43,40,11,0,3,0.930232558
2021020785,3,60:00:00,0.0,42,40,7,1,2,0.952380952
2021020785,55,58:57:00,0.0,24,21,1,1,3,0.875
2021020786,5,59:38:00,0.0,38,34,6,0,4,0.894736842
2021020786,26,59:48:00,0.0,26,23,3,3,3,0.884615385
2021020787,12,60:00:00,0.0,28,27,1,2,1,0.964285714
2021020787,28,58:34:00,0.0,29,27,1,0,2,0.931034483
2021020788,19,60:00:00,0.0,16,15,0,0,1,0.9375
2021020788,16,60:00:00,0.0,31,26,1,2,5,0.838709677
2021020789,25,59:44:00,0.0,26,25,1,1,1,0.961538462
2021020789,6,32:21:00,0.0,14,12,1,0,2,0.857142857
2021020789,6,27:39:00,0.0,15,11,0,0,4,0.733333333
2021020790,21,60:00:00,0.0,31,30,5,0,1,0.967741935
2021020790,7,57:49:00,0.0,35,32,7,2,3,0.914285714
2021020791,9,64:22:00,0.0,39,37,4,0,2,0.948717949
2021020791,22,64:02:00,0.0,31,28,0,0,3,0.903225806
2021020792,17,62:11:00,0.0,15,14,0,0,1,0.933333333
2021020792,24,62:11:00,0.0,28,26,2,0,2,0.928571429
2021020793,29,20:00,0.0,15,14,0,1,1,0.933333333
2021020793,29,40:00:00,0.0,25,18,2,0,7,0.72
2021020793,13,60:00:00,0.0,36,32,5,1,4,0.888888889
2021020794,16,59:31:00,0.0,31,29,5,0,2,0.935483871
2021020794,23,60:00:00,0.0,21,20,3,0,1,0.952380952
2021020795,6,59:43:00,0.0,27,25,8,1,2,0.925925926
2021020795,55,57:38:00,0.0,26,23,3,0,3,0.884615385
2021020796,8,61:26:00,0.0,27,25,2,2,2,0.925925926
2021020796,19,61:50:00,0.0,30,27,6,2,3,0.9
2021020797,14,62:45:00,0.0,21,19,4,1,2,0.904761905
2021020797,28,62:45:00,0.0,32,29,3,0,3,0.90625
2021020798,1,40:00:00,0.0,28,22,2,1,6,0.785714286
2021020798,1,20:00,0.0,8,7,0,0,1,0.875
2021020798,10,60:00:00,0.0,32,31,4,1,1,0.96875
2021020799,2,60:00:00,0.0,27,26,0,1,1,0.962962963
2021020799,9,60:00:00,0.0,30,26,3,0,4,0.866666667
2021020800,3,59:32:00,0.0,36,34,3,2,2,0.944444444
2021020800,13,57:16:00,0.0,34,30,1,0,4,0.882352941
2021020801,4,60:00:00,0.0,33,32,3,1,1,0.96969697
2021020801,52,59:51:00,0.0,35,33,11,1,2,0.942857143
2021020802,5,64:11:00,0.0,32,28,6,1,4,0.875
2021020802,15,57:34:00,0.0,45,43,10,0,2,0.955555556
2021020802,15,6:43,0.0,2,1,0,0,1,0.5
2021020803,18,60:00:00,0.0,32,30,2,0,2,0.9375
2021020803,23,57:22:00,0.0,28,24,2,1,4,0.857142857
2021020804,25,58:38:00,0.0,40,36,2,1,4,0.9
2021020804,20,39:59:00,0.0,23,20,6,0,3,0.869565217
2021020804,20,20:00,0.0,5,5,1,0,0,1.0
2021020805,21,64:50:00,0.0,24,22,2,0,2,0.916666667
2021020805,53,64:15:00,0.0,40,38,9,3,2,0.95
2021020806,54,60:00:00,0.0,32,30,2,0,2,0.9375
2021020806,7,59:39:00,0.0,35,30,8,1,5,0.857142857
2021020807,17,58:36:00,0.0,43,40,4,0,3,0.930232558
2021020807,26,60:00:00,0.0,25,22,0,2,3,0.88
2021020808,15,53:55:00,0.0,22,21,0,1,1,0.954545455
2021020808,15,5:07,0.0,4,1,0,0,3,0.25
2021020808,22,60:00:00,0.0,27,24,0,0,3,0.888888889
2021020809,16,52:02:00,0.0,30,25,1,0,5,0.833333333
2021020809,16,7:58,0.0,5,5,0,0,0,1.0
2021020809,30,60:00:00,0.0,30,30,3,0,0,1.0
2021020810,53,57:28:00,0.0,50,46,5,0,4,0.92
2021020810,20,60:00:00,0.0,28,26,2,0,2,0.928571429
2021020811,17,60:00:00,0.0,34,32,8,0,2,0.941176471
2021020811,4,58:27:00,0.0,23,20,2,0,3,0.869565217
2021020812,14,60:00:00,0.0,30,27,0,4,3,0.9
2021020812,22,58:13:00,0.0,22,18,4,0,4,0.818181818
2021020813,25,60:54:00,0.0,22,20,1,4,2,0.909090909
2021020813,52,60:40:00,0.0,39,36,9,1,3,0.923076923
2021020814,53,57:08:00,0.0,35,32,4,0,3,0.914285714
2021020814,26,60:00:00,0.0,19,17,2,0,2,0.894736842
2021020815,10,59:38:00,0.0,30,29,4,2,1,0.966666667
2021020815,30,57:55:00,0.0,24,22,1,2,2,0.916666667
2021020816,13,56:13:00,0.0,27,22,1,3,5,0.814814815
2021020816,29,60:00:00,0.0,42,39,4,1,3,0.928571429
2021020817,1,58:54:00,0.0,34,31,6,0,3,0.911764706
2021020817,5,60:00:00,0.0,30,28,2,1,2,0.933333333
2021020818,3,60:00:00,0.0,37,36,6,0,1,0.972972973
2021020818,15,58:37:00,0.0,21,17,0,1,4,0.80952381
2021020819,18,65:00:00,0.0,28,27,4,1,1,0.964285714
2021020819,25,65:00:00,0.0,20,19,4,0,1,0.95
2021020820,23,60:00:00,0.0,30,29,1,2,1,0.966666667
2021020820,20,38:14:00,0.0,21,18,4,0,3,0.857142857
2021020820,20,21:46,0.0,17,13,4,1,4,0.764705882
2021020821,28,65:00:00,0.0,47,44,4,0,3,0.936170213
2021020821,2,64:39:00,0.0,28,25,0,1,3,0.892857143
2021020822,55,60:04:00,0.0,39,36,9,3,3,0.923076923
2021020822,6,60:33:00,0.0,27,25,4,2,2,0.925925926
2021020823,12,60:00:00,0.0,19,19,0,0,0,1.0
2021020823,29,60:00:00,0.0,50,46,6,0,4,0.92
2021020824,16,60:00:00,0.0,36,31,1,1,5,0.861111111
2021020824,1,58:33:00,0.0,35,29,3,2,6,0.828571429
2021020825,19,60:00:00,0.0,38,35,5,1,3,0.921052632
2021020825,7,59:48:00,0.0,22,18,6,1,4,0.818181818
2021020826,21,60:00:00,0.0,29,26,4,2,3,0.896551724
2021020826,52,60:00:00,0.0,42,36,7,1,6,0.857142857
2021020827,53,60:00:00,0.0,44,43,4,2,1,0.977272727
2021020827,54,59:17:00,0.0,31,29,4,0,2,0.935483871
2021020828,24,34:17:00,0.0,20,16,2,1,4,0.8
2021020828,24,22:56,0.0,12,12,4,0,0,1.0
2021020828,26,60:00:00,2.0,25,24,3,1,1,0.96
2021020829,10,60:00:00,0.0,20,20,4,0,0,1.0
2021020829,17,60:00:00,0.0,36,33,4,2,3,0.916666667
2021020830,9,58:45:00,0.0,32,30,3,0,2,0.9375
2021020830,8,59:59:00,0.0,27,26,5,1,1,0.962962963
2021020831,13,56:21:00,0.0,22,18,0,0,4,0.818181818
2021020831,22,60:00:00,0.0,47,44,9,3,3,0.936170213
2021020832,4,60:00:00,0.0,28,27,4,0,1,0.964285714
2021020832,15,57:58:00,0.0,22,20,0,1,2,0.909090909
2021020833,5,59:57:00,0.0,27,27,7,1,0,1.0
2021020833,3,58:15:00,0.0,26,25,3,0,1,0.961538462
2021020834,18,58:07:00,0.0,33,30,6,1,3,0.909090909
2021020834,14,60:00:00,0.0,28,26,4,0,2,0.928571429
2021020835,20,60:00:00,0.0,25,22,2,0,3,0.88
2021020835,30,57:27:00,0.0,33,28,4,2,5,0.848484848
2021020836,54,58:14:00,0.0,21,18,1,0,3,0.857142857
2021020836,21,60:00:00,0.0,36,34,2,2,2,0.944444444
2021020837,26,60:00:00,0.0,28,26,6,1,2,0.928571429
2021020837,2,59:17:00,0.0,34,31,8,1,4,0.911764706
2021020838,28,60:00:00,0.0,37,34,6,1,3,0.918918919
2021020838,6,60:00:00,0.0,16,15,3,0,1,0.9375
2021020839,3,58:24:00,0.0,33,29,3,0,4,0.878787879
2021020839,23,60:00:00,0.0,33,31,5,0,2,0.939393939
2021020840,12,60:00:00,0.0,30,29,5,2,1,0.966666667
2021020840,22,57:47:00,0.0,29,27,5,3,2,0.931034483
2021020841,29,59:26:00,0.0,40,37,6,0,3,0.925
2021020841,5,60:00:00,0.0,34,32,6,1,2,0.941176471
2021020842,16,60:00:00,0.0,35,31,8,2,4,0.885714286
2021020842,19,60:00:00,0.0,30,30,2,0,0,1.0
2021020843,25,59:45:00,0.0,40,38,1,4,2,0.95
2021020843,7,58:12:00,0.0,31,27,2,0,4,0.870967742
2021020844,53,59:04:00,0.0,37,33,0,0,4,0.891891892
2021020844,52,60:00:00,0.0,29,26,0,0,3,0.896551724
2021020845,24,60:00:00,0.0,22,18,3,1,4,0.818181818
2021020845,2,60:00:00,0.0,34,34,3,0,0,1.0
2021020846,28,60:00:00,0.0,40,39,1,2,1,0.975
2021020846,55,56:48:00,0.0,24,21,4,1,3,0.875
2021020847,1,60:00:00,0.0,38,36,1,1,2,0.947368421
2021020847,23,33:41:00,0.0,19,18,4,0,1,0.947368421
2021020847,23,26:19:00,0.0,14,8,0,0,6,0.571428571
2021020848,4,58:09:00,0.0,24,22,1,0,2,0.916666667
2021020848,19,60:00:00,0.0,26,25,2,0,1,0.961538462
2021020849,15,20:00,0.0,10,7,0,0,3,0.7
2021020849,15,38:45:00,0.0,17,16,0,4,1,0.941176471
2021020849,10,60:00:00,0.0,33,30,5,1,3,0.909090909
2021020850,26,32:40:00,0.0,19,14,1,0,5,0.736842105
2021020850,26,27:18:00,0.0,13,11,0,0,2,0.846153846
2021020850,6,60:00:00,0.0,34,34,3,1,0,1.0
2021020851,17,64:21:00,0.0,30,27,0,0,3,0.9
2021020851,12,64:52:00,0.0,41,37,7,0,4,0.902439024
2021020852,14,59:44:00,0.0,27,25,10,0,2,0.925925926
2021020852,9,60:00:00,0.0,22,17,6,0,5,0.772727273
2021020853,4,59:18:00,0.0,31,29,5,0,2,0.935483871
2021020853,22,60:00:00,2.0,39,39,5,3,0,1.0
2021020854,29,60:00:00,0.0,33,30,4,1,3,0.909090909
2021020854,1,57:51:00,0.0,31,27,4,2,4,0.870967742
2021020855,30,56:42:00,0.0,26,22,2,1,4,0.846153846
2021020855,20,60:00:00,0.0,33,32,5,1,1,0.96969697
2021020856,52,60:00:00,0.0,35,31,8,2,4,0.885714286
2021020856,8,45:29:00,0.0,23,16,3,1,7,0.695652174
2021020856,8,14:11,0.0,7,6,1,1,1,0.857142857
2021020857,21,60:00:00,0.0,31,28,3,1,3,0.903225806
2021020857,2,58:25:00,0.0,42,38,5,0,4,0.904761905
2021020858,54,60:00:00,0.0,17,16,0,0,1,0.941176471
2021020858,28,36:38:00,0.0,20,18,2,0,2,0.9
2021020858,28,20:00,0.0,11,10,0,0,1,0.909090909
2021020859,24,60:00:00,0.0,34,31,2,0,3,0.911764706
2021020859,6,59:48:00,0.0,28,24,1,0,4,0.857142857
2021020860,10,60:00:00,0.0,31,26,1,0,5,0.838709677
2021020860,7,60:00:00,0.0,30,29,3,1,1,0.966666667
2021020861,3,60:00:00,0.0,32,29,5,0,3,0.90625
2021020861,19,58:01:00,0.0,28,24,2,0,4,0.857142857
2021020862,25,60:00:00,0.0,31,28,2,0,3,0.903225806
2021020862,26,58:24:00,0.0,43,39,4,0,4,0.906976744
2021020863,55,60:00:00,0.0,22,19,0,0,3,0.863636364
2021020863,18,58:58:00,0.0,31,27,0,3,4,0.870967742
2021020864,14,58:43:00,0.0,39,35,6,0,4,0.897435897
2021020864,5,60:00:00,0.0,21,20,1,0,1,0.952380952
2021020865,13,59:51:00,0.0,18,18,3,6,0,1.0
2021020865,9,60:00:00,0.0,48,45,21,0,3,0.9375
2021020866,2,58:07:00,0.0,38,34,2,0,4,0.894736842
2021020866,23,60:00:00,0.0,27,24,0,0,3,0.888888889
2021020867,4,57:18:00,0.0,38,33,2,1,5,0.868421053
2021020867,30,60:00:00,0.0,30,26,5,0,4,0.866666667
2021020868,15,60:00:00,0.0,36,36,6,1,0,1.0
2021020868,12,60:00:00,0.0,33,29,7,0,4,0.878787879
2021020869,16,62:23:00,0.0,32,29,2,0,3,0.90625
2021020869,22,61:38:00,0.0,32,28,2,1,4,0.875
2021020870,20,60:00:00,2.0,35,30,7,1,5,0.857142857
2021020870,8,61:00:00,0.0,34,30,6,1,4,0.882352941
2021020871,53,60:00:00,0.0,43,42,5,0,1,0.976744186
2021020871,21,58:42:00,0.0,29,27,4,1,2,0.931034483
2021020872,54,57:37:00,0.0,35,31,1,1,4,0.885714286
2021020872,6,60:00:00,0.0,36,34,4,2,2,0.944444444
2021020873,7,60:00:00,0.0,33,29,0,2,4,0.878787879
2021020873,30,58:35:00,0.0,37,33,10,1,4,0.891891892
2021020874,14,59:40:00,0.0,23,22,3,0,1,0.956521739
2021020874,17,59:00:00,0.0,37,35,8,0,2,0.945945946
2021020875,3,60:00:00,0.0,33,32,9,1,1,0.96969697
2021020875,1,59:18:00,0.0,32,29,3,1,3,0.90625
2021020876,12,63:14:00,0.0,24,22,2,0,2,0.916666667
2021020876,5,62:56:00,0.0,42,39,6,1,3,0.928571429
2021020877,29,63:54:00,0.0,43,39,3,1,4,0.906976744
2021020877,26,64:00:00,0.0,29,26,3,0,3,0.896551724
2021020878,52,64:07:00,0.0,34,30,7,1,4,0.882352941
2021020878,25,64:30:00,0.0,42,39,9,4,3,0.928571429
2021020879,24,58:25:00,0.0,35,30,4,1,5,0.857142857
2021020879,54,60:00:00,0.0,24,20,3,0,4,0.833333333
2021020880,10,57:22:00,0.0,28,23,1,0,5,0.821428571
2021020880,23,60:00:00,0.0,38,34,1,0,4,0.894736842
2021020881,13,60:00:00,0.0,25,23,2,0,2,0.92
2021020881,17,31:01:00,0.0,23,18,2,2,5,0.782608696
2021020881,17,28:59:00,0.0,16,15,0,0,1,0.9375
2021020882,2,60:00:00,0.0,31,30,3,0,1,0.967741935
2021020882,19,57:26:00,0.0,20,18,4,3,2,0.9
2021020883,4,60:00:00,0.0,29,26,1,0,3,0.896551724
2021020883,16,58:47:00,0.0,27,23,5,0,4,0.851851852
2021020884,15,60:00:00,0.0,31,29,7,0,2,0.935483871
2021020884,55,58:35:00,0.0,24,20,5,2,4,0.833333333
2021020885,29,63:33:00,0.0,32,28,0,0,4,0.875
2021020885,6,64:57:00,0.0,24,20,4,0,4,0.833333333
2021020886,21,21:27,2.0,15,12,2,2,3,0.8
2021020886,21,39:10:00,0.0,22,21,0,0,1,0.954545455
2021020886,20,60:37:00,0.0,36,33,1,0,3,0.916666667
2021020887,22,59:43:00,2.0,28,24,3,2,4,0.857142857
2021020887,8,60:00:00,0.0,30,28,4,2,2,0.933333333
2021020888,53,60:00:00,0.0,46,41,7,4,5,0.891304348
2021020888,9,57:56:00,0.0,31,23,3,1,8,0.741935484
2021020889,28,46:07:00,0.0,28,22,2,1,6,0.785714286
2021020889,28,13:53,0.0,8,6,1,1,2,0.75
2021020889,18,60:00:00,0.0,20,20,3,0,0,1.0
2021020890,7,59:21:00,0.0,30,29,0,0,1,0.966666667
2021020890,26,60:00:00,0.0,19,19,0,2,0,1.0
2021020891,1,61:12:00,0.0,21,19,1,1,2,0.904761905
2021020891,19,61:12:00,0.0,33,30,4,0,3,0.909090909
2021020892,12,60:00:00,0.0,30,28,4,0,2,0.933333333
2021020892,55,57:21:00,0.0,33,30,6,2,3,0.909090909
2021020893,16,60:00:00,0.0,32,26,4,1,6,0.8125
2021020893,14,59:58:00,0.0,27,24,10,0,3,0.888888889
2021020894,30,22:28,0.0,3,3,0,0,0,1.0
2021020894,30,29:52:00,0.0,21,17,2,1,4,0.80952381
2021020894,25,60:00:00,0.0,35,32,2,0,3,0.914285714
2021020895,52,57:17:00,0.0,22,18,3,0,4,0.818181818
2021020895,3,59:53:00,0.0,46,45,14,2,1,0.97826087
2021020896,54,60:00:00,0.0,40,39,5,1,1,0.975
2021020896,9,59:54:00,0.0,42,40,3,0,2,0.952380952
2021020897,24,60:14:00,0.0,22,20,3,2,2,0.909090909
2021020897,28,60:14:00,0.0,36,33,2,3,3,0.916666667
2021020898,6,61:53:00,0.0,28,25,1,1,3,0.892857143
2021020898,26,60:11:00,0.0,32,30,2,1,2,0.9375
2021020899,7,59:10:00,0.0,31,25,6,1,6,0.806451613
2021020899,13,60:00:00,0.0,30,29,9,0,1,0.966666667
2021020900,2,57:00:00,0.0,49,44,2,4,5,0.897959184
2021020900,21,60:00:00,0.0,36,32,4,0,4,0.888888889
2021020901,29,57:17:00,0.0,33,28,1,0,5,0.848484848
2021020901,10,60:00:00,0.0,35,31,4,0,4,0.885714286
2021020902,10,60:00:00,0.0,30,26,4,0,4,0.866666667
2021020902,55,57:57:00,0.0,31,26,5,1,5,0.838709677
2021020903,17,3:45,0.0,3,1,0,0,2,0.333333333
2021020903,17,56:15:00,0.0,27,20,0,0,7,0.740740741
2021020903,53,60:00:00,0.0,28,26,5,0,2,0.928571429
2021020904,1,59:29:00,0.0,26,23,4,0,3,0.884615385
2021020904,21,57:53:00,0.0,42,38,2,0,4,0.904761905
2021020905,4,60:00:00,0.0,48,47,13,0,1,0.979166667
2021020905,54,58:15:00,0.0,21,19,3,1,2,0.904761905
2021020906,5,57:34:00,0.0,29,25,4,2,4,0.862068966
2021020906,13,60:00:00,0.0,35,32,6,0,3,0.914285714
2021020907,16,58:41:00,0.0,32,29,3,0,3,0.90625
2021020907,24,20:00,0.0,13,8,2,1,5,0.615384615
2021020907,24,39:24:00,0.0,19,16,2,0,3,0.842105263
2021020908,19,59:09:00,0.0,27,24,0,0,3,0.888888889
2021020908,9,60:00:00,0.0,23,22,2,0,1,0.956521739
2021020909,18,60:00:00,0.0,23,22,1,1,1,0.956521739
2021020909,25,58:37:00,0.0,31,29,4,0,2,0.935483871
2021020910,30,60:00:00,0.0,25,23,0,0,2,0.92
2021020910,3,60:00:00,0.0,28,23,1,0,5,0.821428571
2021020911,52,60:00:00,0.0,24,20,6,0,4,0.833333333
2021020911,14,58:10:00,0.0,31,26,7,0,5,0.838709677
2021020912,20,58:29:00,0.0,26,22,4,0,4,0.846153846
2021020912,15,60:00:00,0.0,35,31,0,0,4,0.885714286
2021020913,22,63:27:00,0.0,32,29,9,0,3,0.90625
2021020913,15,60:58:00,0.0,40,36,11,0,4,0.9
2021020914,23,59:56:00,0.0,25,22,8,0,3,0.88
2021020914,8,59:31:00,0.0,32,28,7,0,4,0.875
2021020915,6,59:59:00,0.0,25,22,3,0,3,0.88
2021020915,16,58:46:00,0.0,36,32,3,2,4,0.888888889
2021020916,7,60:00:00,0.0,31,30,2,0,1,0.967741935
2021020916,54,58:38:00,0.0,23,21,3,1,2,0.913043478
2021020917,10,31:57:00,0.0,12,8,1,0,4,0.666666667
2021020917,10,30:20:00,0.0,11,10,0,0,1,0.909090909
2021020917,53,62:17:00,0.0,38,34,0,0,4,0.894736842
2021020918,9,62:34:00,0.0,33,30,2,1,3,0.909090909
2021020918,55,62:34:00,0.0,27,23,1,0,4,0.851851852
2021020919,17,64:35:00,2.0,40,36,1,2,5,0.9
2021020919,30,65:00:00,2.0,34,29,3,0,5,0.852941176
2021020920,13,59:36:00,0.0,37,34,10,0,3,0.918918919
2021020920,4,59:34:00,0.0,36,31,2,0,5,0.861111111
2021020921,1,58:11:00,0.0,30,28,0,1,2,0.933333333
2021020921,52,60:00:00,0.0,34,33,5,0,1,0.970588235
2021020922,2,65:00:00,0.0,47,43,1,0,4,0.914893617
2021020922,5,64:28:00,0.0,37,33,3,2,4,0.891891892
2021020923,12,59:59:00,0.0,36,36,6,1,0,1.0
2021020923,21,57:42:00,0.0,36,35,4,1,1,0.972222222
2021020924,19,59:00:00,0.0,29,27,4,2,2,0.931034483
2021020924,3,20:04,0.0,17,13,5,0,4,0.764705882
2021020924,3,39:45:00,0.0,18,16,0,0,2,0.888888889
2021020925,18,60:00:00,0.0,28,27,3,1,1,0.964285714
2021020925,24,58:18:00,0.0,29,26,1,0,3,0.896551724
2021020926,20,60:00:00,0.0,31,30,3,1,1,0.967741935
2021020926,14,60:00:00,0.0,32,28,6,0,4,0.875
2021020927,26,61:13:00,0.0,30,26,5,2,4,0.866666667
2021020927,28,60:22:00,0.0,36,33,5,3,3,0.916666667
2021020928,2,60:00:00,0.0,29,27,0,3,2,0.931034483
2021020928,52,59:40:00,0.0,37,33,5,0,4,0.891891892
2021020929,5,59:18:00,0.0,42,40,3,1,2,0.952380952
2021020929,54,59:31:00,0.0,32,28,7,3,4,0.875
2021020930,29,63:51:00,2.0,38,36,5,0,2,0.947368421
2021020930,30,64:42:00,0.0,28,26,2,3,2,0.928571429
2021020931,23,60:42:00,0.0,34,30,1,0,4,0.882352941
2021020931,15,60:42:00,0.0,26,23,1,0,3,0.884615385
2021020932,6,60:00:00,0.0,29,27,4,3,2,0.931034483
2021020932,53,59:12:00,0.0,40,37,3,0,3,0.925
2021020933,8,65:00:00,0.0,34,32,5,2,3,0.941176471
2021020933,55,65:00:00,0.0,33,30,4,1,3,0.909090909
2021020934,9,60:00:00,0.0,28,22,5,0,6,0.785714286
2021020934,16,59:58:00,0.0,23,20,3,1,3,0.869565217
2021020935,1,64:14:00,0.0,34,33,5,0,1,0.970588235
2021020935,24,65:00:00,0.0,40,39,1,4,1,0.975
2021020936,12,60:00:00,0.0,29,28,3,1,1,0.965517241
2021020936,4,57:39:00,0.0,35,33,1,1,2,0.942857143
2021020937,18,59:17:00,0.0,33,28,6,1,5,0.848484848
2021020937,19,60:00:00,0.0,35,31,3,0,4,0.885714286
2021020938,25,58:12:00,0.0,28,22,1,0,6,0.785714286
2021020938,3,60:00:00,0.0,33,29,4,0,4,0.878787879
2021020939,20,60:00:00,0.0,19,19,1,2,0,1.0
2021020939,17,58:17:00,0.0,43,40,3,0,3,0.930232558
2021020940,22,59:21:00,0.0,32,31,9,3,1,0.96875
2021020940,14,58:57:00,0.0,48,45,15,2,3,0.9375
2021020941,28,60:00:00,0.0,29,29,3,0,0,1.0
2021020941,26,60:00:00,0.0,27,22,0,0,5,0.814814815
2021020942,7,60:00:00,0.0,36,34,5,2,2,0.944444444
2021020942,10,58:29:00,0.0,37,33,6,2,4,0.891891892
2021020943,2,60:00:00,0.0,42,39,4,0,3,0.928571429
2021020943,24,58:27:00,0.0,29,25,4,1,4,0.862068966
2021020944,4,62:10:00,0.0,35,31,5,1,4,0.885714286
2021020944,8,61:37:00,0.0,30,27,7,0,3,0.9
2021020945,5,60:00:00,0.0,43,41,1,2,2,0.953488372
2021020945,12,58:34:00,0.0,20,18,2,1,2,0.9
2021020946,29,60:00:00,0.0,27,23,3,0,4,0.851851852
2021020946,54,57:56:00,0.0,37,32,6,1,5,0.864864865
2021020947,19,62:16:00,0.0,37,33,2,1,4,0.891891892
2021020947,52,61:43:00,0.0,31,28,2,1,3,0.903225806
2021020948,30,58:00:00,0.0,23,19,3,2,4,0.826086957
2021020948,18,59:47:00,0.0,28,26,2,0,2,0.928571429
2021020949,21,60:00:00,0.0,46,46,5,0,0,1.0
2021020949,20,58:00:00,0.0,31,29,1,0,2,0.935483871
2021020950,23,58:23:00,0.0,31,29,4,0,2,0.935483871
2021020950,14,60:00:00,0.0,36,35,8,1,1,0.972222222
2021020951,26,63:17:00,0.0,32,30,6,0,2,0.9375
2021020951,13,64:45:00,0.0,37,35,7,0,2,0.945945946
2021020952,9,59:09:00,0.0,14,10,3,0,4,0.714285714
2021020952,53,60:00:00,0.0,43,40,4,0,3,0.930232558
2021020953,10,60:00:00,0.0,35,35,9,0,0,1.0
2021020953,25,58:53:00,0.0,39,36,5,3,3,0.923076923
2021020954,8,39:35:00,0.0,11,10,1,0,1,0.909090909
2021020954,8,20:00,0.0,7,3,0,0,4,0.428571429
2021020954,53,60:00:00,0.0,39,36,1,0,3,0.923076923
2021020955,3,60:24:00,0.0,23,20,4,0,3,0.869565217
2021020955,24,60:55:00,0.0,38,34,3,0,4,0.894736842
2021020956,15,65:00:00,0.0,32,29,1,0,3,0.90625
2021020956,2,64:51:00,0.0,32,29,0,1,3,0.90625
2021020957,16,61:40:00,0.0,48,46,7,1,2,0.958333333
2021020957,6,61:33:00,0.0,20,19,2,0,1,0.95
2021020958,18,59:51:00,0.0,36,35,5,0,1,0.972222222
2021020958,5,59:27:00,0.0,24,21,6,2,3,0.875
2021020959,52,60:00:00,0.0,38,35,5,1,3,0.921052632
2021020959,54,28:51:00,0.0,10,7,2,1,3,0.7
2021020959,54,31:09:00,0.0,13,9,0,0,4,0.692307692
2021020960,22,60:00:00,0.0,35,30,0,0,5,0.857142857
2021020960,17,4:35,0.0,6,3,0,0,3,0.5
2021020960,17,54:02:00,0.0,25,22,6,1,3,0.88
2021020961,23,60:00:00,0.0,35,32,4,1,3,0.914285714
2021020961,1,31:09:00,0.0,10,8,0,2,2,0.8
2021020961,1,28:51:00,0.0,21,17,0,0,4,0.80952381
2021020962,26,60:00:00,0.0,27,24,1,2,3,0.888888889
2021020962,21,60:00:00,0.0,23,23,6,0,0,1.0
2021020963,28,60:54:00,0.0,34,31,4,1,3,0.911764706
2021020963,13,61:11:00,0.0,26,24,10,0,2,0.923076923
2021020964,9,58:34:00,2.0,38,35,7,0,3,0.921052632
2021020964,29,60:00:00,0.0,31,30,0,0,1,0.967741935
2021020965,30,60:00:00,0.0,26,24,0,3,2,0.923076923
2021020965,6,58:57:00,0.0,33,30,2,1,3,0.909090909
2021020966,20,60:00:00,0.0,33,30,3,0,3,0.909090909
2021020966,1,29:46:00,0.0,20,19,0,3,1,0.95
2021020966,1,29:31:00,0.0,19,15,0,0,4,0.789473684
2021020967,55,59:54:00,0.0,42,38,8,0,4,0.904761905
2021020967,14,60:00:00,0.0,25,24,5,0,1,0.96
2021020968,10,60:00:00,0.0,36,34,5,2,2,0.944444444
2021020968,12,57:05:00,0.0,21,18,0,5,3,0.857142857
2021020969,8,63:51:00,0.0,35,31,7,1,4,0.885714286
2021020969,25,64:50:00,0.0,31,28,7,1,3,0.903225806
2021020970,4,60:00:00,0.0,34,30,3,2,4,0.882352941
2021020970,18,58:47:00,0.0,33,28,5,0,5,0.848484848
2021020971,29,21:20,0.0,9,6,0,0,3,0.666666667
2021020971,29,38:24:00,0.0,23,21,4,0,3,0.913043478
2021020971,15,60:00:00,0.0,41,39,12,3,2,0.951219512
2021020972,19,65:00:00,0.0,45,43,11,1,2,0.955555556
2021020972,5,65:00:00,0.0,25,23,7,0,2,0.92
2021020973,22,60:00:00,0.0,28,27,0,2,1,0.964285714
2021020973,7,60:00:00,0.0,36,30,3,1,6,0.833333333
2021020974,23,57:39:00,0.0,35,34,1,1,1,0.971428571
2021020974,17,60:00:00,0.0,43,43,4,1,0,1.0
2021020975,54,59:53:00,0.0,36,33,1,0,3,0.916666667
2021020975,13,58:43:00,0.0,32,28,8,0,4,0.875
2021020976,26,59:56:00,0.0,29,29,6,7,0,1.0
2021020976,28,58:16:00,0.0,26,24,8,1,2,0.923076923
2021020977,9,60:00:00,0.0,29,28,9,2,1,0.965517241
2021020977,4,56:42:00,0.0,35,33,2,1,2,0.942857143
2021020978,12,64:57:00,0.0,40,37,2,1,3,0.925
2021020978,15,65:00:00,0.0,20,17,4,0,3,0.85
2021020979,52,59:03:00,0.0,44,41,5,1,3,0.931818182
2021020979,6,59:53:00,0.0,29,27,6,1,2,0.931034483
2021020980,20,63:07:00,0.0,34,33,3,1,1,0.970588235
2021020980,7,62:53:00,0.0,24,24,1,1,0,1.0
2021020981,24,60:00:00,2.0,42,39,4,1,3,0.928571429
2021020981,13,60:00:00,0.0,17,17,1,1,0,1.0
2021020982,28,57:08:00,0.0,28,24,0,5,4,0.857142857
2021020982,21,60:00:00,0.0,28,25,6,1,3,0.892857143
2021020983,8,60:00:00,0.0,30,29,4,0,1,0.966666667
2021020983,9,60:00:00,0.0,27,22,2,0,5,0.814814815
2021020984,14,59:00:00,0.0,27,25,3,1,2,0.925925926
2021020984,3,60:00:00,0.0,29,28,4,0,1,0.965517241
2021020985,2,60:00:00,0.0,39,37,4,1,2,0.948717949
2021020985,25,58:27:00,0.0,24,21,1,1,3,0.875
2021020986,29,13:54,0.0,7,5,0,0,2,0.714285714
2021020986,29,46:06:00,0.0,21,19,2,0,2,0.904761905
2021020986,19,56:24:00,0.0,27,22,4,1,5,0.814814815
2021020987,18,59:35:00,0.0,41,38,8,1,3,0.926829268
2021020987,10,56:20:00,2.0,33,28,7,2,5,0.848484848
2021020988,30,59:49:00,0.0,22,21,3,1,1,0.954545455
2021020988,16,57:32:00,0.0,33,31,6,0,2,0.939393939
2021020989,22,60:00:00,0.0,28,25,3,0,3,0.892857143
2021020989,1,59:24:00,0.0,39,34,4,2,5,0.871794872
2021020990,23,40:00:00,0.0,29,25,2,0,4,0.862068966
2021020990,23,20:00,0.0,15,14,5,0,1,0.933333333
2021020990,20,60:00:00,0.0,25,23,3,0,2,0.92
2021020991,53,59:15:00,0.0,48,45,7,1,3,0.9375
2021020991,5,59:51:00,0.0,21,20,1,1,1,0.952380952
2021020992,54,60:00:00,0.0,39,38,7,0,1,0.974358974
2021020992,26,58:35:00,0.0,23,19,2,1,4,0.826086957
2021020993,55,59:50:00,0.0,23,21,1,2,2,0.913043478
2021020993,17,58:25:00,0.0,41,38,8,0,3,0.926829268
2021020994,4,59:57:00,0.0,27,26,0,1,1,0.962962963
2021020994,2,57:46:00,0.0,37,35,6,0,2,0.945945946
2021020995,15,58:01:00,0.0,23,20,0,0,3,0.869565217
2021020995,25,60:00:00,0.0,38,36,7,1,2,0.947368421
2021020996,12,58:57:00,0.0,17,16,2,0,1,0.941176471
2021020996,3,60:00:00,0.0,44,44,7,3,0,1.0
2021020997,16,58:10:00,0.0,31,26,3,0,5,0.838709677
2021020997,52,60:00:00,0.0,36,32,0,0,4,0.888888889
2021020998,23,60:44:00,0.0,29,26,1,2,3,0.896551724
2021020998,7,60:48:00,0.0,32,30,4,0,2,0.9375
2021020999,28,60:00:00,0.0,25,23,6,2,2,0.92
2021020999,53,59:00:00,0.0,28,25,5,2,3,0.892857143
2021021000,6,60:00:00,2.0,25,24,6,2,1,0.96
2021021000,8,17:11,0.0,7,5,0,0,2,0.714285714
2021021000,8,42:49:00,0.0,34,31,5,1,3,0.911764706
2021021001,30,59:41:00,0.0,28,28,3,0,0,1.0
2021021001,54,57:04:00,0.0,35,33,5,0,2,0.942857143
2021021002,21,60:52:00,0.0,25,23,3,1,2,0.92
2021021002,22,60:35:00,0.0,31,28,8,1,3,0.903225806
2021021003,24,59:15:00,0.0,30,25,4,2,5,0.833333333
2021021003,18,0:44,0.0,1,1,0,0,0,1.0
2021021003,18,58:42:00,0.0,28,25,4,0,3,0.892857143
2021021004,17,60:00:00,0.0,33,30,2,0,3,0.909090909
2021021004,4,59:37:00,0.0,29,25,0,1,4,0.862068966
2021021005,1,60:00:00,0.0,35,31,1,1,4,0.885714286
2021021005,3,40:00:00,0.0,24,19,1,0,5,0.791666667
2021021005,3,19:33,0.0,7,5,0,0,2,0.714285714
2021021006,2,60:00:00,0.0,27,26,5,0,1,0.962962963
2021021006,6,58:19:00,0.0,28,25,2,0,3,0.892857143
2021021007,5,60:00:00,0.0,27,26,7,2,1,0.962962963
2021021007,29,60:00:00,0.0,37,32,5,2,5,0.864864865
2021021008,15,57:08:00,0.0,37,33,7,0,4,0.891891892
2021021008,19,59:50:00,0.0,21,19,0,0,2,0.904761905
2021021009,12,60:00:00,0.0,29,27,1,0,2,0.931034483
2021021009,14,57:47:00,0.0,41,38,6,0,3,0.926829268
2021021010,25,59:59:00,0.0,25,22,4,0,3,0.88
2021021010,22,58:42:00,0.0,27,23,2,0,4,0.851851852
2021021011,52,59:29:00,0.0,42,42,4,2,0,1.0
2021021011,54,60:00:00,0.0,26,22,1,0,4,0.846153846
2021021012,20,58:05:00,2.0,38,34,8,1,4,0.894736842
2021021012,28,60:00:00,0.0,31,28,1,0,3,0.903225806
2021021013,26,60:00:00,0.0,25,24,1,0,1,0.96
2021021013,18,59:22:00,0.0,34,29,3,0,5,0.852941176
2021021014,7,65:00:00,0.0,26,23,2,3,3,0.884615385
2021021014,5,65:00:00,0.0,33,30,5,1,3,0.909090909
2021021015,10,60:00:00,0.0,22,20,2,1,2,0.909090909
2021021015,1,58:22:00,0.0,31,28,2,1,3,0.903225806
2021021016,21,58:15:00,0.0,26,24,3,1,2,0.923076923
2021021016,23,60:00:00,0.0,33,32,8,0,1,0.96969697
2021021017,53,57:55:00,0.0,39,35,5,1,4,0.897435897
2021021017,55,59:52:00,0.0,26,24,4,0,2,0.923076923
2021021018,24,59:00:00,0.0,27,24,2,2,3,0.888888889
2021021018,16,60:00:00,0.0,29,27,0,0,2,0.931034483
2021021019,6,60:00:00,2.0,24,22,2,1,2,0.916666667
2021021019,14,58:52:00,0.0,39,36,7,0,3,0.923076923
2021021020,8,56:45:00,0.0,42,38,3,3,4,0.904761905
2021021020,13,60:00:00,0.0,31,28,2,3,3,0.903225806
2021021021,2,59:38:00,0.0,24,24,0,0,0,1.0
2021021021,9,58:11:00,0.0,26,24,2,0,2,0.923076923
2021021022,12,65:00:00,0.0,15,12,0,0,3,0.8
2021021022,25,65:00:00,0.0,47,44,2,0,3,0.936170213
2021021023,19,59:04:00,0.0,26,22,3,2,4,0.846153846
2021021023,4,60:00:00,0.0,28,26,4,1,2,0.928571429
2021021024,30,60:25:00,0.0,28,26,3,0,2,0.928571429
2021021024,23,60:28:00,0.0,36,33,4,1,3,0.916666667
2021021025,22,60:00:00,2.0,30,28,4,2,2,0.933333333
2021021025,28,59:49:00,0.0,40,36,1,0,4,0.9
2021021026,54,59:41:00,0.0,36,35,8,0,1,0.972222222
2021021026,18,60:00:00,0.0,50,44,6,1,6,0.88
2021021027,26,64:53:00,0.0,31,28,1,0,3,0.903225806
2021021027,16,65:00:00,0.0,46,43,3,1,3,0.934782609
2021021028,7,65:00:00,0.0,40,37,1,0,3,0.925
2021021028,15,65:00:00,0.0,23,20,1,0,3,0.869565217
2021021029,3,60:00:00,2.0,21,20,2,0,1,0.952380952
2021021029,5,4:19,0.0,3,3,0,1,0,1.0
2021021029,5,55:41:00,0.0,30,25,2,1,5,0.833333333
2021021030,52,60:21:00,0.0,36,33,4,0,3,0.916666667
2021021030,29,58:43:00,0.0,33,29,2,0,4,0.878787879
2021021031,21,59:42:00,0.0,31,28,2,0,3,0.903225806
2021021031,4,60:00:00,0.0,51,45,6,1,6,0.882352941
2021021032,20,60:00:00,0.0,18,16,4,1,2,0.888888889
2021021032,53,58:43:00,0.0,33,29,4,1,4,0.878787879
2021021033,24,59:07:00,2.0,27,23,4,3,4,0.851851852
2021021033,55,60:00:00,0.0,27,24,2,1,3,0.888888889
2021021034,6,60:00:00,0.0,27,24,4,0,3,0.888888889
2021021034,2,60:00:00,0.0,44,38,5,1,6,0.863636364
2021021035,8,59:56:00,0.0,51,49,5,1,2,0.960784314
2021021035,10,58:47:00,0.0,17,14,1,1,3,0.823529412
2021021036,9,65:00:00,0.0,49,46,0,0,3,0.93877551
2021021036,13,64:10:00,0.0,22,19,4,0,3,0.863636364
2021021037,17,62:32:00,0.0,36,34,8,1,2,0.944444444
2021021037,14,62:28:00,0.0,27,26,8,0,1,0.962962963
2021021038,15,59:40:00,0.0,38,35,3,3,3,0.921052632
2021021038,1,57:29:00,0.0,22,18,2,0,4,0.818181818
2021021039,19,58:29:00,0.0,26,21,2,2,5,0.807692308
2021021039,12,60:00:00,0.0,32,30,3,0,2,0.9375
2021021040,25,59:16:00,0.0,30,27,3,1,3,0.9
2021021040,23,60:00:00,0.0,36,35,6,1,1,0.972222222
2021021041,30,60:03:00,0.0,25,23,0,2,2,0.92
2021021041,29,61:24:00,0.0,38,35,5,0,3,0.921052632
2021021042,20,59:46:00,0.0,31,26,3,1,5,0.838709677
2021021042,22,25:06:00,0.0,12,7,0,0,5,0.583333333
2021021042,22,34:34:00,2.0,26,22,4,0,4,0.846153846
2021021043,54,62:05:00,0.0,34,30,0,0,4,0.882352941
2021021043,16,62:05:00,0.0,34,29,1,0,5,0.852941176
2021021044,26,59:56:00,0.0,25,23,0,0,2,0.92
2021021044,55,60:00:00,0.0,27,23,3,0,4,0.851851852
2021021045,28,60:00:00,0.0,28,27,5,1,1,0.964285714
2021021045,24,59:26:00,0.0,24,20,2,2,4,0.833333333
2021021046,10,60:00:00,0.0,36,34,8,0,2,0.944444444
2021021046,13,55:51:00,0.0,24,20,2,0,4,0.833333333
2021021047,1,65:00:00,0.0,33,31,9,1,2,0.939393939
2021021047,8,64:46:00,0.0,32,30,1,0,2,0.9375
2021021048,2,40:00:00,0.0,20,18,3,0,2,0.9
2021021048,2,20:00,0.0,14,12,1,0,2,0.857142857
2021021048,14,60:00:00,0.0,24,23,7,1,1,0.958333333
2021021049,3,62:02:00,0.0,17,13,0,0,4,0.764705882
2021021049,7,62:02:00,0.0,31,26,5,0,5,0.838709677
2021021050,5,60:00:00,0.0,35,33,7,4,2,0.942857143
2021021050,17,22:11,0.0,13,9,4,0,4,0.692307692
2021021050,17,37:49:00,0.0,22,15,3,0,7,0.681818182
2021021051,18,59:57:00,0.0,23,19,4,0,4,0.826086957
2021021051,4,59:00:00,0.0,35,30,5,0,5,0.857142857
2021021052,30,60:09:00,0.0,42,40,5,1,2,0.952380952
2021021052,21,60:01:00,0.0,29,26,6,0,3,0.896551724
2021021053,52,64:50:00,0.0,29,28,0,0,1,0.965517241
2021021053,53,64:50:00,0.0,40,38,1,0,2,0.95
2021021054,15,20:00,0.0,6,5,0,1,1,0.833333333
2021021054,15,40:00:00,0.0,23,18,1,0,5,0.782608696
2021021054,12,60:00:00,0.0,26,25,6,1,1,0.961538462
2021021055,16,59:46:00,0.0,37,31,0,0,6,0.837837838
2021021055,7,60:00:00,0.0,21,16,3,2,5,0.761904762
2021021056,19,59:49:00,0.0,36,35,2,0,1,0.972222222
2021021056,23,58:14:00,0.0,28,25,1,2,3,0.892857143
2021021057,22,60:00:00,0.0,32,31,5,0,1,0.96875
2021021057,53,20:00,0.0,7,6,0,0,1,0.857142857
2021021057,53,40:00:00,0.0,35,30,11,1,5,0.857142857
2021021058,26,59:41:00,0.0,38,32,5,1,6,0.842105263
2021021058,55,60:00:00,0.0,37,36,0,0,1,0.972972973
2021021059,6,40:00:00,0.0,25,19,3,2,6,0.76
2021021059,6,18:04,0.0,7,7,1,1,0,1.0
2021021059,10,7:44,0.0,4,3,0,0,1,0.75
2021021059,10,52:16:00,0.0,26,23,3,0,3,0.884615385
2021021060,14,60:52:00,0.0,19,16,2,0,3,0.842105263
2021021060,12,60:49:00,0.0,32,28,3,1,4,0.875
2021021061,13,59:03:00,0.0,24,20,1,2,4,0.833333333
2021021061,8,59:18:00,0.0,45,39,3,2,6,0.866666667
2021021062,5,57:25:00,0.0,26,23,2,2,3,0.884615385
2021021062,3,60:00:00,0.0,24,22,3,0,2,0.916666667
2021021063,29,57:43:00,0.0,29,25,4,0,4,0.862068966
2021021063,2,60:00:00,0.0,45,42,5,0,3,0.933333333
2021021064,18,60:00:00,0.0,37,36,9,2,1,0.972972973
2021021064,9,57:38:00,0.0,31,28,3,4,3,0.903225806
2021021065,30,59:45:00,0.0,33,32,6,0,1,0.96969697
2021021065,4,60:00:00,0.0,37,33,3,3,4,0.891891892
2021021066,20,58:08:00,0.0,30,28,1,1,2,0.933333333
2021021066,21,59:54:00,0.0,45,44,13,2,1,0.977777778
2021021067,24,58:21:00,0.0,32,29,5,0,3,0.90625
2021021067,25,60:00:00,0.0,28,26,0,0,2,0.928571429
2021021068,7,65:00:00,0.0,27,25,2,0,2,0.925925926
2021021068,52,65:00:00,0.0,37,35,3,1,2,0.945945946
2021021069,17,61:34:00,0.0,34,29,3,1,5,0.852941176
2021021069,3,61:34:00,0.0,26,22,4,1,4,0.846153846
2021021070,22,65:00:00,0.0,41,38,8,0,3,0.926829268
2021021070,26,65:00:00,0.0,33,31,0,0,3,0.939393939
2021021071,23,57:50:00,0.0,24,20,0,0,4,0.833333333
2021021071,19,60:00:00,0.0,25,22,1,0,3,0.88
2021021072,53,60:00:00,0.0,41,39,2,0,2,0.951219512
2021021072,28,59:10:00,0.0,23,19,0,1,4,0.826086957
2021021073,55,57:38:00,0.0,29,27,2,2,2,0.931034483
2021021073,54,60:00:00,0.0,22,22,0,1,0,1.0
2021021074,6,60:00:00,0.0,26,25,2,0,1,0.961538462
2021021074,1,30:59:00,0.0,20,17,1,0,3,0.85
2021021074,1,29:01:00,0.0,20,15,2,1,5,0.75
2021021075,10,59:13:00,0.0,23,20,2,0,3,0.869565217
2021021075,52,58:44:00,0.0,37,31,10,1,6,0.837837838
2021021076,13,60:00:00,0.0,37,37,5,1,0,1.0
2021021076,16,60:00:00,0.0,44,40,3,1,4,0.909090909
2021021077,2,59:39:00,0.0,32,30,3,0,2,0.9375
2021021077,29,57:48:00,0.0,35,31,0,0,4,0.885714286
2021021078,12,60:00:00,0.0,32,32,5,2,0,1.0
2021021078,8,56:32:00,2.0,43,40,8,0,3,0.930232558
2021021079,30,63:55:00,0.0,39,35,3,2,4,0.897435897
2021021079,5,63:52:00,0.0,31,28,4,0,3,0.903225806
2021021080,21,60:00:00,0.0,27,25,3,0,2,0.925925926
2021021080,28,59:51:00,0.0,46,42,8,1,4,0.913043478
2021021081,20,65:00:00,0.0,32,30,5,1,2,0.9375
2021021081,26,65:00:00,0.0,28,26,4,0,2,0.928571429
2021021082,24,60:53:00,0.0,35,32,2,1,3,0.914285714
2021021082,25,60:53:00,0.0,23,21,4,0,2,0.913043478
2021021083,7,60:00:00,0.0,25,22,0,1,3,0.88
2021021083,18,57:55:00,0.0,35,31,4,0,4,0.885714286
2021021084,17,58:49:00,0.0,31,27,1,1,4,0.870967742
2021021084,9,60:00:00,0.0,29,27,6,0,2,0.931034483
2021021085,14,60:00:00,0.0,23,21,3,2,2,0.913043478
2021021085,16,57:21:00,0.0,42,38,5,1,4,0.904761905
2021021086,3,59:18:00,0.0,18,15,4,2,3,0.833333333
2021021086,2,60:00:00,0.0,27,27,2,2,0,1.0
2021021087,22,61:11:00,0.0,36,31,4,0,5,0.861111111
2021021087,19,47:41:00,0.0,27,25,2,1,2,0.925925926
2021021087,19,13:30,0.0,13,9,0,0,4,0.692307692
2021021088,53,50:18:00,0.0,28,26,6,0,2,0.928571429
2021021088,53,9:42,0.0,9,6,0,0,3,0.666666667
2021021088,24,60:00:00,0.0,22,22,0,1,0,1.0
2021021089,55,58:55:00,0.0,24,21,1,0,3,0.875
2021021089,54,60:00:00,0.0,28,26,4,1,2,0.928571429
2021021090,6,59:42:00,0.0,24,22,2,1,2,0.916666667
2021021090,29,57:25:00,0.0,40,37,1,0,3,0.925
2021021091,14,65:00:00,0.0,31,27,1,0,4,0.870967742
2021021091,8,65:00:00,0.0,41,37,8,1,4,0.902439024
2021021092,1,61:45:00,0.0,41,34,5,0,7,0.829268293
2021021092,13,20:38,0.0,6,6,0,0,0,1.0
2021021092,13,40:00:00,0.0,25,19,4,1,6,0.76
2021021093,4,60:00:00,0.0,28,22,2,1,6,0.785714286
2021021093,10,60:00:00,0.0,32,29,1,0,3,0.90625
2021021094,12,56:35:00,0.0,19,16,3,0,3,0.842105263
2021021094,30,59:58:00,0.0,38,37,3,0,1,0.973684211
2021021095,18,57:55:00,0.0,27,24,2,0,3,0.888888889
2021021095,15,60:00:00,0.0,34,33,3,0,1,0.970588235
2021021096,52,57:52:00,0.0,38,35,8,6,3,0.921052632
2021021096,26,60:00:00,0.0,27,25,10,1,2,0.925925926
2021021097,21,60:00:00,0.0,40,38,0,0,2,0.95
2021021097,5,58:28:00,0.0,38,35,0,0,3,0.921052632
2021021098,20,59:20:00,0.0,23,19,1,0,4,0.826086957
2021021098,19,60:00:00,0.0,43,39,3,0,4,0.906976744
2021021099,28,20:00,0.0,14,10,0,0,4,0.714285714
2021021099,28,38:40:00,0.0,15,14,3,1,1,0.933333333
2021021099,25,59:58:00,0.0,28,24,0,1,4,0.857142857
2021021100,7,59:19:00,0.0,40,35,2,0,5,0.875
2021021100,13,60:00:00,0.0,29,26,2,0,3,0.896551724
2021021101,9,59:59:00,0.0,32,30,5,0,2,0.9375
2021021101,17,59:04:00,0.0,34,31,6,1,3,0.911764706
2021021102,1,57:01:00,0.0,29,25,0,1,4,0.862068966
2021021102,2,60:00:00,0.0,30,27,2,0,3,0.9
2021021103,3,64:33:00,0.0,26,23,5,0,3,0.884615385
2021021103,4,65:00:00,0.0,46,43,6,1,3,0.934782609
2021021104,15,59:02:00,0.0,18,14,2,0,4,0.777777778
2021021104,30,60:00:00,0.0,26,25,2,1,1,0.961538462
2021021105,16,64:45:00,0.0,35,32,0,0,3,0.914285714
2021021105,53,64:41:00,0.0,31,29,3,0,2,0.935483871
2021021106,23,62:05:00,0.0,30,27,3,1,3,0.9
2021021106,54,62:05:00,0.0,28,27,5,2,2,0.964285714
2021021107,24,60:00:00,2.0,46,40,3,0,6,0.869565217
2021021107,22,60:00:00,0.0,32,31,0,0,1,0.96875
2021021108,55,60:00:00,0.0,30,29,0,0,1,0.966666667
2021021108,25,58:48:00,0.0,28,25,0,5,3,0.892857143
2021021109,14,60:00:00,0.0,39,33,2,2,6,0.846153846
2021021109,10,60:00:00,0.0,34,32,2,0,2,0.941176471
2021021110,29,60:54:00,0.0,37,34,3,1,3,0.918918919
2021021110,6,60:44:00,0.0,22,20,5,2,2,0.909090909
2021021111,19,60:00:00,0.0,22,21,1,0,1,0.954545455
2021021111,53,60:00:00,0.0,29,24,1,2,5,0.827586207
2021021112,26,57:45:00,0.0,33,30,7,1,3,0.909090909
2021021112,20,59:37:00,0.0,29,27,8,1,2,0.931034483
2021021113,7,60:00:00,0.0,34,32,5,3,2,0.941176471
2021021113,12,56:04:00,0.0,22,18,2,1,4,0.818181818
2021021114,8,59:51:00,0.0,31,26,4,1,5,0.838709677
2021021114,9,59:46:00,0.0,30,27,4,0,3,0.9
2021021115,17,59:48:00,0.0,50,47,8,4,3,0.94
2021021115,6,57:03:00,0.0,28,24,6,1,4,0.857142857
2021021116,13,40:43:00,0.0,21,19,5,0,2,0.904761905
2021021116,13,21:57,0.0,14,10,2,0,4,0.714285714
2021021116,10,25:26:00,0.0,26,22,1,1,4,0.846153846
2021021116,10,37:12:00,0.0,23,20,2,1,3,0.869565217
2021021117,1,58:26:00,0.0,17,14,0,0,3,0.823529412
2021021117,3,60:00:00,0.0,21,20,0,0,1,0.952380952
2021021118,4,57:47:00,0.0,29,26,2,1,3,0.896551724
2021021118,29,60:00:00,0.0,49,47,9,0,2,0.959183673
2021021119,5,58:48:00,0.0,31,26,5,1,5,0.838709677
2021021119,21,59:21:00,0.0,45,42,5,0,4,0.933333333
2021021120,18,59:47:00,0.0,49,47,12,1,2,0.959183673
2021021120,30,55:25:00,0.0,32,27,7,0,5,0.84375
2021021121,25,59:55:00,0.0,21,19,0,1,2,0.904761905
2021021121,2,57:56:00,0.0,40,37,1,1,3,0.925
2021021122,28,60:31:00,0.0,24,22,0,0,2,0.916666667
2021021122,22,60:22:00,0.0,32,31,2,1,1,0.96875
2021021123,15,58:56:00,0.0,28,25,1,5,3,0.892857143
2021021123,14,57:34:00,2.0,28,24,7,0,4,0.857142857
2021021124,19,59:59:00,0.0,29,28,0,3,1,0.965517241
2021021124,55,58:46:00,0.0,35,32,10,0,3,0.914285714
2021021125,52,57:27:00,0.0,34,32,9,0,2,0.941176471
2021021125,17,59:21:00,0.0,33,32,4,1,1,0.96969697
2021021126,54,60:00:00,0.0,31,26,2,1,5,0.838709677
2021021126,23,60:00:00,0.0,34,33,6,0,1,0.970588235
2021021127,24,59:43:00,2.0,27,24,0,0,3,0.888888889
2021021127,20,60:00:00,0.0,28,26,3,0,2,0.928571429
2021021128,9,60:00:00,0.0,33,32,0,0,1,0.96969697
2021021128,1,60:00:00,0.0,24,20,0,0,4,0.833333333
2021021129,3,60:00:00,0.0,30,30,5,1,0,1.0
2021021129,5,57:11:00,0.0,23,21,0,0,2,0.913043478
2021021130,12,60:00:00,0.0,21,18,3,0,3,0.857142857
2021021130,7,59:04:00,0.0,31,27,6,2,4,0.870967742
2021021131,29,60:00:00,0.0,31,27,4,3,4,0.870967742
2021021131,4,59:27:00,0.0,27,26,2,4,1,0.962962963
2021021132,16,58:32:00,0.0,31,29,0,1,2,0.935483871
2021021132,55,60:00:00,0.0,29,29,4,1,0,1.0
2021021133,25,62:10:00,0.0,41,37,7,1,4,0.902439024
2021021133,10,61:35:00,0.0,18,15,3,0,3,0.833333333
2021021134,53,59:57:00,0.0,32,27,2,3,5,0.84375
2021021134,23,60:00:00,0.0,28,27,5,1,1,0.964285714
2021021135,26,58:52:00,0.0,30,27,3,4,3,0.9
2021021135,22,60:00:00,0.0,33,31,6,0,2,0.939393939
2021021136,28,10:26,0.0,5,5,1,0,0,1.0
2021021136,28,48:43:00,0.0,35,32,6,0,3,0.914285714
2021021136,20,60:00:00,0.0,33,31,3,1,2,0.939393939
2021021137,14,63:13:00,0.0,37,35,3,2,2,0.945945946
2021021137,6,63:37:00,0.0,29,28,10,0,1,0.965517241
2021021138,13,60:00:00,0.0,22,19,7,1,3,0.863636364
2021021138,7,59:34:00,0.0,43,39,3,2,4,0.906976744
2021021139,12,58:07:00,0.0,21,19,3,1,2,0.904761905
2021021139,2,59:45:00,0.0,21,20,4,1,1,0.952380952
2021021140,19,61:27:00,0.0,38,35,2,1,3,0.921052632
2021021140,30,61:27:00,0.0,28,24,2,1,4,0.857142857
2021021141,52,60:30:00,0.0,37,32,6,2,5,0.864864865
2021021141,21,62:42:00,0.0,43,39,2,1,4,0.906976744
2021021142,10,60:00:00,0.0,26,24,3,3,2,0.923076923
2021021142,8,13:32,0.0,15,14,0,0,1,0.933333333
2021021142,8,44:48:00,0.0,25,23,6,1,2,0.92
2021021143,17,63:19:00,0.0,33,28,6,0,5,0.848484848
2021021143,29,63:19:00,0.0,38,34,4,3,4,0.894736842
2021021144,3,60:00:00,0.0,22,21,0,0,1,0.954545455
2021021144,9,60:00:00,0.0,33,28,0,2,5,0.848484848
2021021145,4,57:03:00,0.0,34,29,3,1,5,0.852941176
2021021145,24,60:00:00,0.0,33,30,4,0,3,0.909090909
2021021146,5,58:35:00,0.0,43,39,7,2,4,0.906976744
2021021146,15,60:00:00,0.0,32,29,3,0,3,0.90625
2021021147,19,60:00:00,0.0,31,30,6,3,1,0.967741935
2021021147,2,60:00:00,0.0,31,25,8,0,6,0.806451613
2021021148,18,58:46:00,0.0,23,21,3,3,2,0.913043478
2021021148,13,59:48:00,0.0,25,24,4,0,1,0.96
2021021149,25,59:23:00,0.0,23,20,2,0,3,0.869565217
2021021149,1,59:58:00,0.0,28,27,4,1,1,0.964285714
2021021150,30,59:36:00,0.0,34,31,7,0,3,0.911764706
2021021150,26,60:00:00,2.0,33,27,2,0,6,0.818181818
2021021151,22,65:00:00,0.0,34,33,4,1,1,0.970588235
2021021151,21,65:00:00,0.0,50,49,10,1,1,0.98
2021021152,23,59:45:00,0.0,37,35,4,5,2,0.945945946
2021021152,28,57:50:00,0.0,38,35,12,3,3,0.921052632
2021021153,54,59:48:00,0.0,30,29,2,0,1,0.966666667
2021021153,53,60:00:00,0.0,39,33,1,0,6,0.846153846
2021021154,55,58:18:00,0.0,28,25,5,0,3,0.892857143
2021021154,20,59:12:00,0.0,28,27,10,1,1,0.964285714
2021021155,9,57:18:00,0.0,25,21,5,0,4,0.84
2021021155,52,60:00:00,0.0,34,31,5,2,3,0.911764706
2021021156,14,60:00:00,0.0,28,28,1,1,0,1.0
2021021156,7,60:00:00,0.0,28,23,1,2,5,0.821428571
2021021157,5,62:21:00,0.0,35,33,3,0,2,0.942857143
2021021157,18,62:05:00,0.0,30,27,2,0,3,0.9
2021021158,15,59:05:00,0.0,30,28,3,1,2,0.933333333
2021021158,6,58:08:00,0.0,32,29,7,1,3,0.90625
2021021159,12,60:00:00,0.0,25,23,2,1,2,0.92
2021021159,24,58:59:00,0.0,42,38,4,2,4,0.904761905
2021021160,16,40:00:00,0.0,20,15,4,0,5,0.75
2021021160,16,17:13,0.0,10,9,0,0,1,0.9
2021021160,25,59:42:00,0.0,40,36,5,0,4,0.9
2021021161,28,57:59:00,0.0,34,31,6,1,3,0.911764706
2021021161,54,60:00:00,0.0,36,35,3,3,1,0.972222222
2021021162,8,59:54:00,0.0,34,31,0,0,3,0.911764706
2021021162,52,60:00:00,0.0,25,23,0,0,2,0.92
2021021163,30,60:00:00,0.0,28,27,3,1,1,0.964285714
2021021163,22,59:24:00,0.0,23,18,5,1,5,0.782608696
2021021164,6,57:54:00,0.0,30,26,8,1,4,0.866666667
2021021164,19,60:00:00,0.0,41,39,3,1,2,0.951219512
2021021165,10,58:35:00,0.0,27,23,3,1,4,0.851851852
2021021165,7,60:00:00,0.0,26,24,4,0,2,0.923076923
2021021166,17,58:50:00,0.0,30,28,4,0,2,0.933333333
2021021166,9,60:00:00,0.0,25,24,3,0,1,0.96
2021021167,13,63:41:00,0.0,24,22,2,0,2,0.916666667
2021021167,24,63:41:00,0.0,55,52,7,0,3,0.945454545
2021021168,3,58:26:00,0.0,24,21,2,1,3,0.875
2021021168,12,59:44:00,0.0,30,28,4,0,2,0.933333333
2021021169,5,60:00:00,0.0,36,33,5,4,3,0.916666667
2021021169,29,6:26,0.0,8,5,0,0,3,0.625
2021021169,29,52:52:00,0.0,42,40,3,2,2,0.952380952
2021021170,15,59:03:00,0.0,21,19,1,1,2,0.904761905
2021021170,4,40:00:00,0.0,27,21,2,0,6,0.777777778
2021021170,4,20:00,0.0,10,7,3,0,3,0.7
2021021171,16,64:57:00,0.0,37,33,2,1,4,0.891891892
2021021171,28,65:00:00,0.0,32,28,3,0,4,0.875
2021021172,18,59:38:00,0.0,32,28,3,0,4,0.875
2021021172,22,59:53:00,0.0,30,30,4,0,0,1.0
2021021173,25,59:53:00,0.0,25,25,5,1,0,1.0
2021021173,14,58:12:00,0.0,29,28,3,3,1,0.965517241
2021021174,20,40:00:00,0.0,15,12,0,0,3,0.8
2021021174,20,20:00,0.0,7,7,2,2,0,1.0
2021021174,55,59:24:00,0.0,30,26,9,2,4,0.866666667
2021021175,23,60:51:00,0.0,45,41,2,1,4,0.911111111
2021021175,54,59:47:00,0.0,27,22,2,0,5,0.814814815
2021021176,53,60:00:00,0.0,38,32,10,1,6,0.842105263
2021021176,1,60:00:00,0.0,21,19,4,0,2,0.904761905
2021021177,4,59:23:00,0.0,33,30,9,0,3,0.909090909
2021021177,3,60:00:00,0.0,28,28,3,2,0,1.0
2021021178,29,60:00:00,0.0,21,20,3,0,1,0.952380952
2021021178,8,59:53:00,0.0,31,26,5,3,5,0.838709677
2021021179,52,59:49:00,0.0,30,27,1,0,3,0.9
2021021179,55,59:02:00,0.0,27,23,1,0,4,0.851851852
2021021180,21,59:27:00,0.0,32,29,3,0,3,0.90625
2021021180,26,10:15,0.0,10,7,1,0,3,0.7
2021021180,26,49:45:00,0.0,25,19,2,1,6,0.76
2021021181,6,38:13:00,0.0,24,21,7,3,3,0.875
2021021181,6,20:00,0.0,8,8,0,0,0,1.0
2021021181,9,60:00:00,0.0,42,40,8,1,2,0.952380952
2021021182,7,59:29:00,0.0,27,22,2,1,5,0.814814815
2021021182,19,59:46:00,0.0,37,35,0,2,2,0.945945946
2021021183,10,60:00:00,0.0,25,22,2,2,3,0.88
2021021183,15,30:37:00,0.0,19,15,4,1,4,0.789473684
2021021183,15,29:23:00,0.0,13,10,0,1,3,0.769230769
2021021184,14,29:39:00,0.0,13,13,1,0,0,1.0
2021021184,14,30:41:00,0.0,13,10,0,0,3,0.769230769
2021021184,24,61:58:00,0.0,31,27,6,1,4,0.870967742
2021021185,5,60:00:00,0.0,39,36,7,0,3,0.923076923
2021021185,2,58:47:00,0.0,26,22,0,0,4,0.846153846
2021021186,12,60:00:00,0.0,22,19,0,1,3,0.863636364
2021021186,17,60:00:00,0.0,46,46,2,1,0,1.0
2021021187,16,58:53:00,0.0,35,31,1,1,4,0.885714286
2021021187,26,60:00:00,0.0,20,18,5,0,2,0.9
2021021188,18,63:18:00,0.0,25,25,1,1,0,1.0
2021021188,28,63:18:00,0.0,41,40,3,0,1,0.975609756
2021021189,25,61:03:00,0.0,27,24,0,1,3,0.888888889
2021021189,30,61:40:00,0.0,36,34,2,0,2,0.944444444
2021021190,21,59:49:00,0.0,27,26,2,1,1,0.962962963
2021021190,1,58:10:00,0.0,30,27,2,0,3,0.9
2021021191,20,28:46:00,0.0,17,13,6,0,4,0.764705882
2021021191,20,30:48:00,0.0,8,6,1,0,2,0.75
2021021191,54,60:00:00,0.0,36,35,4,2,1,0.972222222
2021021192,23,60:00:00,0.0,22,21,2,0,1,0.954545455
2021021192,53,20:00,0.0,5,4,0,0,1,0.8
2021021192,53,40:00:00,0.0,22,16,3,0,6,0.727272727
2021021193,8,58:49:00,0.0,19,17,3,1,2,0.894736842
2021021193,2,60:00:00,0.0,44,44,4,1,0,1.0
2021021194,13,60:00:00,0.0,31,30,10,0,1,0.967741935
2021021194,52,20:00,0.0,17,15,0,0,2,0.882352941
2021021194,52,40:00:00,0.0,26,22,0,6,4,0.846153846
2021021195,22,59:53:00,0.0,39,39,6,0,0,1.0
2021021195,54,60:00:00,0.0,36,32,2,3,4,0.888888889
2021021196,6,60:00:00,0.0,24,23,5,1,1,0.958333333
2021021196,5,57:54:00,0.0,29,27,2,0,2,0.931034483
2021021197,7,59:54:00,0.0,21,18,5,1,3,0.857142857
2021021197,4,57:30:00,0.0,29,25,4,1,4,0.862068966
2021021198,8,60:00:00,0.0,41,33,6,0,8,0.804878049
2021021198,15,60:00:00,0.0,32,28,4,2,4,0.875
2021021199,9,63:26:00,0.0,41,36,6,0,5,0.87804878
2021021199,10,63:26:00,0.0,29,25,1,1,4,0.862068966
2021021200,14,60:00:00,0.0,18,14,2,0,4,0.777777778
2021021200,52,8:05,0.0,5,5,0,0,0,1.0
2021021200,52,51:55:00,0.0,32,25,5,0,7,0.78125
2021021201,3,60:00:00,0.0,20,20,2,2,0,1.0
2021021201,17,60:00:00,2.0,37,33,2,1,4,0.891891892
2021021202,19,60:56:00,0.0,36,31,6,2,5,0.861111111
2021021202,30,60:41:00,0.0,30,24,2,3,6,0.8
2021021203,18,60:00:00,0.0,31,28,5,0,3,0.903225806
2021021203,16,57:28:00,0.0,34,30,2,0,4,0.882352941
2021021204,25,60:00:00,0.0,24,23,3,0,1,0.958333333
2021021204,28,58:31:00,0.0,26,24,3,2,2,0.923076923
2021021205,21,60:00:00,0.0,33,29,3,1,4,0.878787879
2021021205,12,55:19:00,0.0,33,26,3,0,7,0.787878788
2021021205,12,4:31,0.0,4,4,0,0,0,1.0
2021021206,20,60:00:00,0.0,26,25,2,0,1,0.961538462
2021021206,53,43:11:00,0.0,31,24,3,0,7,0.774193548
2021021206,53,16:49,0.0,10,8,0,0,2,0.8
2021021207,22,65:00:00,0.0,41,39,9,0,2,0.951219512
2021021207,23,64:47:00,0.0,33,31,3,0,2,0.939393939
2021021208,26,60:00:00,0.0,22,21,0,3,1,0.954545455
2021021208,29,58:38:00,0.0,38,36,5,2,2,0.947368421
2021021209,55,65:00:00,0.0,26,23,5,0,3,0.884615385
2021021209,1,64:42:00,0.0,26,23,6,0,3,0.884615385
2021021210,17,59:29:00,0.0,39,33,3,0,6,0.846153846
2021021210,13,59:25:00,0.0,34,33,6,1,1,0.970588235
2021021211,2,57:54:00,0.0,23,20,2,0,3,0.869565217
2021021211,10,59:47:00,0.0,28,27,4,0,1,0.964285714
2021021212,4,58:21:00,0.0,39,35,3,1,4,0.897435897
2021021212,7,60:00:00,0.0,35,32,4,0,3,0.914285714
2021021213,18,30:31:00,0.0,13,9,0,0,4,0.692307692
2021021213,18,29:29:00,0.0,20,16,0,0,4,0.8
2021021213,19,60:00:00,0.0,36,33,3,0,3,0.916666667
2021021214,30,60:55:00,0.0,30,26,5,4,4,0.866666667
2021021214,28,61:05:00,0.0,28,23,2,2,5,0.821428571
2021021215,24,60:00:00,0.0,35,31,5,1,4,0.885714286
2021021215,29,59:07:00,0.0,31,26,2,0,5,0.838709677
2021021216,21,58:31:00,0.0,27,24,0,1,3,0.888888889
2021021216,15,60:00:00,0.0,26,24,4,1,2,0.923076923
2021021217,23,60:00:00,0.0,30,28,0,1,2,0.933333333
2021021217,25,30:33:00,0.0,19,15,3,0,4,0.789473684
2021021217,25,27:35:00,0.0,11,10,0,0,1,0.909090909
2021021218,53,59:18:00,0.0,51,46,1,0,5,0.901960784
2021021218,12,60:00:00,0.0,26,23,2,1,3,0.884615385
2021021219,54,57:30:00,0.0,28,25,1,0,3,0.892857143
2021021219,1,60:00:00,0.0,44,42,3,1,2,0.954545455
2021021220,10,60:00:00,0.0,39,37,8,3,2,0.948717949
2021021220,4,59:28:00,0.0,28,24,2,1,4,0.857142857
2021021221,8,59:52:00,0.0,30,28,4,0,2,0.933333333
2021021221,30,60:00:00,0.0,26,26,3,1,0,1.0
2021021222,14,57:53:00,0.0,31,27,1,0,4,0.870967742
2021021222,17,60:00:00,0.0,41,38,3,0,3,0.926829268
2021021223,2,60:20:00,0.0,42,39,5,0,3,0.928571429
2021021223,13,60:10:00,2.0,26,24,0,4,2,0.923076923
2021021224,3,59:35:00,0.0,31,31,0,0,0,1.0
2021021224,52,57:33:00,0.0,33,31,4,1,2,0.939393939
2021021225,19,60:48:00,0.0,35,32,1,0,3,0.914285714
2021021225,6,60:48:00,0.0,22,20,3,0,2,0.909090909
2021021226,24,58:14:00,0.0,28,26,2,0,2,0.928571429
2021021226,26,60:00:00,2.0,30,29,11,0,1,0.966666667
2021021227,28,60:00:00,0.0,24,22,2,0,2,0.916666667
2021021227,29,58:30:00,0.0,28,25,4,1,3,0.892857143
2021021228,7,59:32:00,0.0,27,25,3,0,2,0.925925926
2021021228,9,60:00:00,0.0,24,23,9,0,1,0.958333333
2021021229,22,60:00:00,0.0,36,34,6,0,2,0.944444444
2021021229,25,56:45:00,0.0,49,45,3,0,4,0.918367347
2021021230,53,64:23:00,0.0,40,36,7,0,4,0.9
2021021230,16,64:23:00,0.0,35,32,0,6,3,0.914285714
2021021231,54,41:59:00,0.0,15,13,1,0,2,0.866666667
2021021231,54,20:00,0.0,13,12,0,0,1,0.923076923
2021021231,15,62:09:00,0.0,30,26,2,0,4,0.866666667
2021021232,55,59:58:00,0.0,27,25,1,0,2,0.925925926
2021021232,21,58:46:00,0.0,29,26,3,0,3,0.896551724
2021021233,8,59:55:00,0.0,34,28,5,0,6,0.823529412
2021021233,4,60:00:00,0.0,34,31,1,4,3,0.911764706
2021021234,14,60:00:00,0.0,37,36,7,2,1,0.972972973
2021021234,10,59:50:00,0.0,36,28,7,2,8,0.777777778
2021021235,13,59:58:00,0.0,30,28,4,2,2,0.933333333
2021021235,17,60:00:00,0.0,27,22,6,1,5,0.814814815
2021021236,1,60:00:00,0.0,28,23,1,1,5,0.821428571
2021021236,7,60:00:00,0.0,31,29,7,0,2,0.935483871
2021021237,2,59:33:00,0.0,23,17,1,0,6,0.739130435
2021021237,3,60:00:00,0.0,29,26,2,0,3,0.896551724
2021021238,5,60:00:00,0.0,52,52,6,0,0,1.0
2021021238,6,58:37:00,0.0,31,28,4,2,3,0.903225806
2021021239,12,59:01:00,0.0,22,20,2,0,2,0.909090909
2021021239,52,58:21:00,0.0,45,42,7,1,3,0.933333333
2021021240,30,60:00:00,0.0,24,21,2,2,3,0.875
2021021240,23,59:34:00,0.0,31,26,6,0,5,0.838709677
2021021241,20,59:27:00,0.0,23,21,2,0,2,0.913043478
2021021241,25,59:16:00,0.0,36,33,9,4,3,0.916666667
2021021242,26,60:00:00,0.0,16,15,2,1,1,0.9375
2021021242,16,8:00,0.0,1,1,0,0,0,1.0
2021021242,16,51:55:00,0.0,35,31,8,1,4,0.885714286
2021021243,28,58:14:00,0.0,27,25,5,1,2,0.925925926
2021021243,19,59:58:00,0.0,21,20,2,4,1,0.952380952
2021021244,29,65:00:00,0.0,26,25,5,0,1,0.961538462
2021021244,9,64:59:00,0.0,34,33,1,2,1,0.970588235
2021021245,30,59:41:00,0.0,28,25,3,2,3,0.892857143
2021021245,55,59:54:00,0.0,35,29,8,0,6,0.828571429
2021021246,22,60:00:00,0.0,37,34,17,0,3,0.918918919
2021021246,21,57:03:00,0.0,26,21,2,1,5,0.807692308
2021021247,53,59:04:00,0.0,28,27,6,0,1,0.964285714
2021021247,15,60:00:00,0.0,19,19,0,1,0,1.0
2021021248,6,60:00:00,2.0,31,30,6,1,1,0.967741935
2021021248,3,56:52:00,0.0,35,32,7,2,3,0.914285714
2021021249,7,59:43:00,0.0,22,19,1,1,3,0.863636364
2021021249,2,59:06:00,0.0,35,30,7,0,5,0.857142857
2021021250,9,59:38:00,0.0,48,44,8,2,4,0.916666667
2021021250,8,58:54:00,0.0,26,20,7,0,6,0.769230769
2021021251,17,40:00:00,0.0,23,18,1,0,5,0.782608696
2021021251,17,19:44,0.0,15,13,0,0,2,0.866666667
2021021251,5,60:00:00,0.0,25,23,0,0,2,0.92
2021021252,14,60:00:00,0.0,21,19,5,0,2,0.904761905
2021021252,18,17:52,0.0,9,9,0,0,0,1.0
2021021252,18,42:03:00,0.0,30,24,5,2,6,0.8
2021021253,13,62:26:00,0.0,36,34,4,0,2,0.944444444
2021021253,10,62:26:00,0.0,35,32,2,1,3,0.914285714
2021021254,1,61:39:00,0.0,29,26,1,0,3,0.896551724
2021021254,12,61:33:00,0.0,19,17,4,1,2,0.894736842
2021021255,25,60:00:00,0.0,32,30,3,2,2,0.9375
2021021255,55,58:53:00,0.0,31,28,1,0,3,0.903225806
2021021256,20,60:00:00,0.0,31,28,2,2,3,0.903225806
2021021256,23,56:41:00,0.0,30,25,0,0,5,0.833333333
2021021257,53,60:30:00,0.0,33,28,1,1,5,0.848484848
2021021257,19,60:17:00,0.0,20,16,0,1,4,0.8
2021021258,26,59:50:00,0.0,21,19,3,0,2,0.904761905
2021021258,24,58:25:00,0.0,39,36,10,0,3,0.923076923
2021021259,28,60:00:00,0.0,28,27,3,1,1,0.964285714
2021021259,16,60:00:00,0.0,19,15,2,1,4,0.789473684
2021021260,13,32:59:00,0.0,17,12,3,1,5,0.705882353
2021021260,13,27:01:00,0.0,16,13,4,0,3,0.8125
2021021260,14,60:00:00,0.0,39,35,6,0,4,0.897435897
2021021261,1,57:25:00,0.0,22,21,2,0,1,0.954545455
2021021261,17,59:04:00,0.0,17,17,0,0,0,1.0
2021021262,2,58:51:00,0.0,32,29,0,2,3,0.90625
2021021262,12,32:57:00,0.0,18,17,0,0,1,0.944444444
2021021262,12,27:03:00,0.0,8,7,0,0,1,0.875
2021021263,3,64:19:00,0.0,32,31,1,1,1,0.96875
2021021263,3,0:41,0.0,0,0,0,0,0,
2021021263,6,64:42:00,0.0,34,33,1,1,1,0.970588235
2021021264,4,60:00:00,0.0,38,37,5,2,1,0.973684211
2021021264,5,58:08:00,0.0,42,39,6,1,3,0.928571429
2021021265,15,65:00:00,0.0,30,27,2,1,3,0.9
2021021265,10,63:56:00,0.0,37,34,6,2,3,0.918918919
2021021266,29,60:00:00,0.0,35,33,3,0,2,0.942857143
2021021266,22,58:26:00,0.0,30,26,7,1,4,0.866666667
2021021267,18,64:58:00,2.0,47,43,12,2,5,0.914893617
2021021267,30,64:43:00,0.0,25,21,10,0,4,0.84
2021021268,52,60:00:00,0.0,31,30,0,0,1,0.967741935
2021021268,21,59:58:00,0.0,44,40,3,2,4,0.909090909
2021021269,54,64:53:00,0.0,29,25,3,0,4,0.862068966
2021021269,28,63:34:00,0.0,46,42,6,0,4,0.913043478
2021021270,24,59:58:00,2.0,37,31,4,0,6,0.837837838
2021021270,19,60:00:00,0.0,17,14,0,0,3,0.823529412
2021021271,16,59:43:00,0.0,34,33,12,1,1,0.970588235
2021021271,4,56:37:00,0.0,33,30,12,0,3,0.909090909
2021021272,6,59:55:00,0.0,21,19,1,0,2,0.904761905
2021021272,13,58:02:00,0.0,37,34,6,1,3,0.918918919
2021021273,8,60:00:00,0.0,32,32,4,0,0,1.0
2021021273,7,59:49:00,0.0,28,25,0,0,3,0.892857143
2021021274,9,63:17:00,0.0,41,37,3,0,4,0.902439024
2021021274,1,63:17:00,0.0,34,29,2,0,5,0.852941176
2021021275,17,28:54:00,0.0,14,10,0,0,4,0.714285714
2021021275,17,31:06:00,0.0,25,19,0,0,6,0.76
2021021275,10,15:18,0.0,8,6,0,0,2,0.75
2021021275,10,44:42:00,0.0,25,20,3,0,5,0.8
2021021276,14,60:00:00,0.0,21,20,2,0,1,0.952380952
2021021276,29,60:00:00,0.0,32,28,2,0,4,0.875
2021021277,3,57:20:00,0.0,36,32,8,3,4,0.888888889
2021021277,12,60:00:00,0.0,34,31,4,1,3,0.911764706
2021021278,5,56:17:00,0.0,41,37,5,3,4,0.902439024
2021021278,22,59:32:00,0.0,34,33,8,0,1,0.970588235
2021021279,15,59:53:00,0.0,26,22,4,1,4,0.846153846
2021021279,2,60:00:00,0.0,33,32,5,1,1,0.96969697
2021021280,18,8:33,0.0,5,3,0,0,2,0.6
2021021280,18,53:28:00,0.0,33,30,6,1,3,0.909090909
2021021280,20,61:15:00,0.0,23,19,4,0,4,0.826086957
2021021281,25,65:00:00,0.0,35,33,2,0,2,0.942857143
2021021281,54,65:00:00,0.0,30,28,1,0,2,0.933333333
2021021282,30,56:12:00,0.0,25,21,3,2,4,0.84
2021021282,53,60:00:00,0.0,38,35,5,0,3,0.921052632
2021021283,21,59:54:00,0.0,32,29,4,2,3,0.90625
2021021283,19,56:32:00,0.0,33,29,0,1,4,0.878787879
2021021284,23,60:00:00,0.0,32,30,10,0,2,0.9375
2021021284,55,60:00:00,0.0,27,22,5,1,5,0.814814815
2021021285,28,59:01:00,0.0,30,26,0,0,4,0.866666667
2021021285,24,60:00:00,0.0,33,31,3,0,2,0.939393939
2021021286,16,65:00:00,0.0,40,37,1,0,3,0.925
2021021286,54,65:00:00,0.0,40,37,3,0,3,0.925
2021021287,25,61:32:00,0.0,37,33,5,0,4,0.891891892
2021021287,53,61:41:00,0.0,29,26,8,2,3,0.896551724
2021021288,52,59:46:00,0.0,35,35,10,1,0,1.0
2021021288,4,58:25:00,0.0,26,23,3,2,3,0.884615385
2021021289,55,58:17:00,0.0,27,23,0,2,4,0.851851852
2021021289,26,59:34:00,0.0,40,37,3,0,3,0.925
2021021290,6,59:54:00,0.0,37,37,7,1,0,1.0
2021021290,7,60:00:00,0.0,32,27,8,0,5,0.84375
2021021291,9,60:00:00,0.0,30,26,4,1,4,0.866666667
2021021291,13,60:00:00,0.0,27,27,3,1,0,1.0
2021021292,2,59:46:00,0.0,33,28,2,0,5,0.848484848
2021021292,14,60:00:00,0.0,37,34,1,1,4,0.918918919
2021021293,15,42:40:00,0.0,19,15,2,0,4,0.789473684
2021021293,15,16:46,0.0,7,6,0,1,1,0.857142857
2021021293,29,60:00:00,0.0,33,29,8,0,4,0.878787879
2021021294,12,60:00:00,0.0,30,27,1,0,3,0.9
2021021294,1,12:28,0.0,6,6,0,1,0,1.0
2021021294,1,47:32:00,0.0,30,24,5,1,6,0.8
2021021295,30,60:44:00,0.0,33,31,4,2,2,0.939393939
2021021295,20,60:44:00,0.0,25,22,0,1,3,0.88
2021021296,21,64:41:00,0.0,37,33,1,1,4,0.891891892
2021021296,18,65:00:00,0.0,46,42,7,0,4,0.913043478
2021021297,22,61:32:00,0.0,44,40,0,2,4,0.909090909
2021021297,28,61:37:00,0.0,31,26,7,1,5,0.838709677
2021021298,7,61:46:00,0.0,21,19,2,0,2,0.904761905
2021021298,16,62:07:00,0.0,36,33,4,0,3,0.916666667
2021021299,10,59:34:00,0.0,26,24,3,1,2,0.923076923
2021021299,6,58:53:00,0.0,26,22,1,0,4,0.846153846
2021021300,8,60:00:00,0.0,39,37,2,0,2,0.948717949
2021021300,13,60:00:00,0.0,37,27,2,1,10,0.72972973
2021021301,1,57:49:00,0.0,34,30,0,2,4,0.882352941
2021021301,17,60:00:00,0.0,23,20,0,1,3,0.869565217
2021021302,3,60:00:00,0.0,36,34,4,1,2,0.944444444
2021021302,15,57:38:00,0.0,33,30,2,2,3,0.909090909
2021021303,4,57:58:00,0.0,35,32,7,1,3,0.914285714
2021021303,9,59:34:00,0.0,34,32,3,1,2,0.941176471
2021021304,5,57:17:00,0.0,30,26,2,4,4,0.866666667
2021021304,12,60:00:00,0.0,34,31,1,0,3,0.911764706
2021021305,29,59:48:00,2.0,27,25,10,0,2,0.925925926
2021021305,14,57:12:00,0.0,34,30,4,3,4,0.882352941
2021021306,19,58:38:00,0.0,44,38,2,0,6,0.863636364
2021021306,54,59:38:00,0.0,18,14,0,0,4,0.777777778
2021021307,25,59:52:00,0.0,21,19,3,0,2,0.904761905
2021021307,24,20:00,0.0,5,5,0,0,0,1.0
2021021307,24,20:00,0.0,10,8,0,0,2,0.8
2021021307,24,19:16,0.0,3,2,0,0,1,0.666666667
2021021308,30,59:56:00,0.0,28,27,4,0,1,0.964285714
2021021308,21,58:38:00,0.0,21,18,7,0,3,0.857142857
2021021309,52,59:57:00,0.0,33,32,5,2,1,0.96969697
2021021309,20,58:40:00,0.0,42,40,7,0,2,0.952380952
2021021310,23,64:19:00,0.0,35,33,5,1,2,0.942857143
2021021310,26,64:30:00,0.0,29,26,3,0,3,0.896551724
2021021311,53,53:03:00,0.0,27,27,4,0,0,1.0
2021021311,53,6:57,0.0,6,2,0,0,4,0.333333333
2021021311,18,58:42:00,0.0,27,22,6,0,5,0.814814815
2021021312,55,60:00:00,0.0,24,24,3,0,0,1.0
2021021312,28,57:13:00,0.0,30,28,3,0,2,0.933333333
2021030111,13,58:54:00,0.0,37,34,7,2,3,0.918918919
2021030111,15,60:00:00,0.0,32,30,3,1,2,0.9375
2021030112,13,60:00:00,0.0,27,26,4,2,1,0.962962963
2021030112,15,20:00,0.0,17,17,1,0,0,1.0
2021030112,15,39:49:00,2.0,19,14,2,1,5,0.736842105
2021030113,15,59:40:00,0.0,30,29,4,0,1,0.966666667
2021030113,13,59:31:00,0.0,30,25,5,1,5,0.833333333
2021030114,15,64:57:00,0.0,32,29,5,1,3,0.90625
2021030114,13,63:52:00,2.0,16,14,3,1,2,0.875
2021030115,13,60:00:00,0.0,33,30,3,1,3,0.909090909
2021030115,15,56:43:00,0.0,38,33,3,0,5,0.868421053
2021030116,15,61:34:00,0.0,31,27,2,0,4,0.870967742
2021030116,13,62:46:00,0.0,37,34,4,2,3,0.918918919
2021030121,10,60:00:00,0.0,24,24,8,1,0,1.0
2021030121,14,59:29:00,0.0,32,27,6,1,5,0.84375
2021030122,10,57:21:00,0.0,34,29,6,4,5,0.852941176
2021030122,14,60:00:00,0.0,34,31,8,3,3,0.911764706
2021030123,14,57:58:00,0.0,34,31,9,4,3,0.911764706
2021030123,10,60:00:00,0.0,34,32,4,2,2,0.941176471
2021030124,14,60:00:00,0.0,25,22,1,0,3,0.88
2021030124,10,26:49:00,0.0,16,11,3,0,5,0.6875
2021030124,10,30:46:00,0.0,10,10,2,0,0,1.0
2021030125,10,60:00:00,0.0,35,32,7,1,3,0.914285714
2021030125,14,58:47:00,0.0,25,21,1,1,4,0.84
2021030126,14,78:04:00,0.0,33,30,2,2,3,0.909090909
2021030126,10,78:04:00,0.0,35,31,3,1,4,0.885714286
2021030127,10,58:01:00,0.0,25,23,7,0,2,0.92
2021030127,14,60:00:00,0.0,31,30,7,0,1,0.967741935
2021030131,12,59:50:00,0.0,36,35,6,0,1,0.972222222
2021030131,6,59:06:00,0.0,24,20,2,3,4,0.833333333
2021030132,12,7:47,0.0,6,6,2,0,0,1.0
2021030132,12,52:05:00,2.0,32,30,7,2,2,0.9375
2021030132,6,56:09:00,0.0,33,29,12,2,4,0.878787879
2021030133,6,60:00:00,0.0,27,25,3,3,2,0.925925926
2021030133,12,56:49:00,0.0,28,24,5,3,4,0.857142857
2021030134,6,60:00:00,0.0,26,24,3,1,2,0.923076923
2021030134,12,56:47:00,0.0,27,23,11,0,4,0.851851852
2021030135,12,59:44:00,0.0,34,33,3,2,1,0.970588235
2021030135,6,58:48:00,0.0,37,33,9,2,4,0.891891892
2021030136,6,60:00:00,0.0,25,23,3,0,2,0.92
2021030136,12,59:40:00,0.0,33,29,5,3,4,0.878787879
2021030137,12,60:00:00,0.0,29,27,0,0,2,0.931034483
2021030137,6,57:19:00,0.0,31,28,5,1,3,0.903225806
2021030141,3,105:58:00,0.0,83,79,10,0,4,0.951807229
2021030141,5,89:07:00,0.0,51,48,0,2,3,0.941176471
2021030141,5,16:40,0.0,17,17,0,0,0,1.0
2021030142,3,59:41:00,0.0,41,39,3,0,2,0.951219512
2021030142,5,57:28:00,0.0,40,35,8,2,5,0.875
2021030143,5,59:49:00,0.0,36,32,3,3,4,0.888888889
2021030143,3,20:00,0.0,15,11,1,0,4,0.733333333
2021030143,3,38:57:00,0.0,20,19,1,0,1,0.95
2021030144,5,60:00:00,0.0,24,22,2,0,2,0.916666667
2021030144,3,39:53:00,0.0,30,24,1,1,6,0.8
2021030144,3,20:00,0.0,11,10,2,0,1,0.909090909
2021030145,3,60:00:00,0.0,32,29,3,2,3,0.90625
2021030145,5,58:52:00,0.0,33,29,4,0,4,0.878787879
2021030146,5,59:12:00,0.0,37,33,2,4,4,0.891891892
2021030146,3,60:00:00,0.0,34,31,5,0,3,0.911764706
2021030147,3,64:33:00,0.0,42,39,8,1,3,0.928571429
2021030147,5,64:46:00,0.0,30,26,5,1,4,0.866666667
2021030151,21,59:55:00,0.0,25,23,2,0,2,0.92
2021030151,18,15:04,0.0,13,8,0,1,5,0.615384615
2021030151,18,44:56:00,0.0,32,30,5,1,2,0.9375
2021030152,21,68:31:00,0.0,26,25,2,2,1,0.961538462
2021030152,18,68:31:00,0.0,51,49,8,2,2,0.960784314
2021030153,18,57:59:00,0.0,41,35,6,0,6,0.853658537
2021030153,21,19:03,0.0,10,9,2,0,1,0.9
2021030153,21,40:57:00,0.0,20,18,1,0,2,0.9
2021030154,18,59:25:00,0.0,37,33,3,3,4,0.891891892
2021030154,21,60:00:00,0.0,31,28,0,1,3,0.903225806
2021030161,30,60:00:00,0.0,31,27,8,4,4,0.870967742
2021030161,19,59:05:00,0.0,37,37,11,1,0,1.0
2021030162,30,60:00:00,0.0,34,32,7,2,2,0.941176471
2021030162,19,59:50:00,0.0,27,22,3,2,5,0.814814815
2021030163,19,59:52:00,0.0,32,28,4,0,4,0.875
2021030163,30,59:23:00,0.0,30,29,4,0,1,0.966666667
2021030164,19,60:00:00,0.0,30,28,5,0,2,0.933333333
2021030164,30,59:28:00,0.0,33,29,10,1,4,0.878787879
2021030165,30,57:37:00,0.0,31,27,5,0,4,0.870967742
2021030165,19,60:00:00,0.0,32,30,0,0,2,0.9375
2021030166,19,60:00:00,0.0,26,25,6,2,1,0.961538462
2021030166,30,57:53:00,0.0,26,22,6,4,4,0.846153846
2021030171,20,60:00:00,0.0,16,16,6,0,0,1.0
2021030171,25,59:01:00,0.0,26,25,4,2,1,0.961538462
2021030172,20,58:39:00,0.0,22,21,2,0,1,0.954545455
2021030172,25,60:00:00,0.0,29,29,3,2,0,1.0
2021030173,25,60:00:00,0.0,41,39,13,2,2,0.951219512
2021030173,20,58:06:00,0.0,31,28,3,4,3,0.903225806
2021030174,25,56:50:00,0.0,53,50,5,4,3,0.943396226
2021030174,20,60:00:00,0.0,35,34,6,2,1,0.971428571
2021030175,20,60:00:00,0.0,21,20,2,1,1,0.952380952
2021030175,25,58:59:00,0.0,31,29,3,2,2,0.935483871
2021030176,25,59:50:00,0.0,38,36,3,0,2,0.947368421
2021030176,20,59:30:00,0.0,39,36,2,0,3,0.923076923
2021030177,20,75:09:00,0.0,28,26,1,1,2,0.928571429
2021030177,25,75:09:00,0.0,67,64,8,0,3,0.955223881
2021030181,22,58:26:00,0.0,35,31,10,0,4,0.885714286
2021030181,26,60:00:00,0.0,39,36,10,3,3,0.923076923
2021030182,22,60:00:00,0.0,30,30,8,0,0,1.0
2021030182,26,59:55:00,0.0,36,31,4,1,6,0.861111111
2021030183,26,27:40:00,0.0,17,13,0,0,4,0.764705882
2021030183,26,32:14:00,0.0,20,16,0,0,4,0.8
2021030183,22,60:00:00,0.0,46,44,10,0,2,0.956521739
2021030184,26,60:00:00,0.0,31,31,4,0,0,1.0
2021030184,22,59:35:00,0.0,45,42,5,1,3,0.933333333
2021030185,22,61:12:00,0.0,43,38,10,2,5,0.88372093
2021030185,26,61:12:00,0.0,28,24,1,2,4,0.857142857
2021030186,26,58:55:00,0.0,36,33,2,0,3,0.916666667
2021030186,22,60:00:00,2.0,32,30,7,0,2,0.9375
2021030187,22,60:00:00,0.0,29,29,0,0,0,1.0
2021030187,26,57:03:00,0.0,41,39,4,0,2,0.951219512
2021030211,13,58:03:00,0.0,36,32,11,1,4,0.888888889
2021030211,14,60:00:00,0.0,34,33,6,2,1,0.970588235
2021030212,13,59:53:00,0.0,28,26,4,3,2,0.928571429
2021030212,14,60:00:00,0.0,36,35,8,0,1,0.972222222
2021030213,14,60:00:00,0.0,35,34,5,0,1,0.971428571
2021030213,13,58:30:00,0.0,34,31,4,1,3,0.911764706
2021030214,14,60:00:00,0.0,49,49,10,3,0,1.0
2021030214,13,58:49:00,0.0,25,24,7,0,1,0.96
2021030221,12,63:12:00,0.0,28,27,0,0,1,0.964285714
2021030221,3,63:12:00,0.0,26,24,0,0,2,0.923076923
2021030222,12,59:48:00,0.0,21,21,2,0,0,1.0
2021030222,3,57:18:00,0.0,21,20,5,1,1,0.952380952
2021030223,3,59:56:00,0.0,44,43,7,0,1,0.977272727
2021030223,12,57:55:00,0.0,32,30,2,1,2,0.9375
2021030224,3,60:00:00,0.0,31,30,3,3,1,0.967741935
2021030224,12,59:41:00,0.0,28,24,7,1,4,0.857142857
2021030225,12,60:00:00,0.0,17,16,0,0,1,0.941176471
2021030225,3,57:46:00,0.0,34,31,5,0,3,0.911764706
2021030226,3,59:27:00,2.0,39,37,5,2,2,0.948717949
2021030226,12,23:24,0.0,13,10,0,0,3,0.769230769
2021030226,12,36:36:00,0.0,12,10,0,0,2,0.833333333
2021030227,12,35:37:00,0.0,18,16,1,1,2,0.888888889
2021030227,12,24:04:00,0.0,12,9,0,0,3,0.75
2021030227,3,60:00:00,0.0,39,37,5,0,2,0.948717949
2021030231,21,68:02:00,0.0,25,23,0,1,2,0.92
2021030231,19,68:02:00,0.0,54,51,5,0,3,0.944444444
2021030232,21,56:56:00,0.0,31,28,2,1,3,0.903225806
2021030232,19,60:00:00,0.0,31,30,1,1,1,0.967741935
2021030233,19,51:43:00,0.0,23,19,1,1,4,0.826086957
2021030233,19,6:45,0.0,3,3,0,0,0,1.0
2021030233,21,60:00:00,0.0,31,29,3,0,2,0.935483871
2021030234,19,56:32:00,0.0,36,31,1,1,5,0.861111111
2021030234,21,60:00:00,0.0,20,17,3,0,3,0.85
2021030235,21,63:38:00,0.0,30,25,5,0,5,0.833333333
2021030235,19,62:20:00,0.0,34,30,4,2,4,0.882352941
2021030236,19,59:54:00,0.0,39,36,3,0,3,0.923076923
2021030236,21,60:00:00,0.0,20,18,2,0,2,0.9
2021030241,20,60:00:00,0.0,28,22,3,4,6,0.785714286
2021030241,22,53:07:00,0.0,37,32,3,3,5,0.864864865
2021030241,22,6:05,0.0,10,7,5,0,3,0.7
2021030242,20,56:47:00,0.0,40,35,10,3,5,0.875
2021030242,22,60:00:00,0.0,40,37,5,2,3,0.925
2021030243,22,4:15,0.0,0,0,0,0,0,
2021030243,22,55:45:00,0.0,33,32,7,1,1,0.96969697
2021030243,20,39:53:00,0.0,34,30,10,1,4,0.882352941
2021030243,20,19:56,0.0,7,7,2,0,0,1.0
2021030244,22,60:00:00,0.0,32,29,5,2,3,0.90625
2021030244,20,59:20:00,0.0,25,21,3,1,4,0.84
2021030245,20,65:03:00,0.0,35,30,0,1,5,0.857142857
2021030245,22,65:03:00,0.0,36,32,4,0,4,0.888888889
2021030311,3,60:00:00,0.0,39,37,7,1,2,0.948717949
2021030311,14,60:00:00,0.0,34,28,5,1,6,0.823529412
2021030312,3,59:57:00,0.0,31,29,1,0,2,0.935483871
2021030312,14,57:22:00,0.0,28,25,9,0,3,0.892857143
2021030313,14,60:00:00,0.0,30,28,6,1,2,0.933333333
2021030313,3,59:23:00,0.0,52,49,7,3,3,0.942307692
2021030314,14,60:00:00,0.0,35,34,3,1,1,0.971428571
2021030314,3,56:50:00,0.0,30,27,5,1,3,0.9
2021030315,3,59:12:00,0.0,26,24,6,1,2,0.923076923
2021030315,14,60:00:00,0.0,25,24,2,0,1,0.96
2021030316,14,60:00:00,0.0,21,20,1,0,1,0.952380952
2021030316,3,58:28:00,0.0,31,29,1,0,2,0.935483871
2021030321,21,27:19:00,0.0,16,13,0,0,3,0.8125
2021030321,21,32:41:00,0.0,21,18,5,0,3,0.857142857
2021030321,22,32:07:00,0.0,21,20,0,0,1,0.952380952
2021030321,22,26:20:00,0.0,25,19,2,0,6,0.76
2021030322,21,60:00:00,0.0,24,24,2,0,0,1.0
2021030322,22,60:00:00,0.0,40,36,7,1,4,0.9
2021030323,22,58:30:00,0.0,42,39,16,1,3,0.928571429
2021030323,21,59:41:00,0.0,29,27,3,2,2,0.931034483
2021030324,22,61:19:00,0.0,42,36,1,4,6,0.857142857
2021030324,21,60:56:00,0.0,35,30,6,0,5,0.857142857
2021030411,21,61:23:00,0.0,23,20,3,0,3,0.869565217
2021030411,14,61:07:00,0.0,38,34,5,0,4,0.894736842
2021030412,21,60:00:00,2.0,16,16,7,2,0,1.0
2021030412,14,60:00:00,0.0,30,23,6,0,7,0.766666667
2021030413,14,60:00:00,0.0,39,37,4,3,2,0.948717949
2021030413,21,31:11:00,0.0,22,17,6,1,5,0.772727273
2021030413,21,26:56:00,0.0,11,10,6,0,1,0.909090909
2021030414,14,72:02:00,0.0,37,34,5,2,3,0.918918919
2021030414,21,72:02:00,0.0,39,37,5,0,2,0.948717949
2021030415,21,58:53:00,0.0,29,26,6,0,3,0.896551724
2021030415,14,60:00:00,0.0,37,35,3,1,2,0.945945946
2021030416,14,57:53:00,0.0,30,28,2,0,2,0.933333333
2021030416,21,60:00:00,0.0,23,22,0,1,1,0.956521739
2021040661,90,9:33,,12,10,0,0,2,0.833333333
2021040661,90,10:00,,13,10,0,0,3,0.769230769
2021040661,88,10:00,,7,6,0,0,1,0.857142857
2021040661,88,10:00,,8,5,0,0,3,0.625
2021040662,89,10:00,,9,7,0,0,2,0.777777778
2021040662,89,10:00,,9,6,0,0,3,0.666666667
2021040662,87,9:10,,10,6,0,0,4,0.6
2021040662,87,10:00,,12,9,0,0,3,0.75
2021040663,88,10:00,,9,7,0,0,2,0.777777778
2021040663,88,10:00,,15,14,0,0,1,0.933333333
2021040663,89,10:00,,13,9,0,0,4,0.692307692
2021040663,89,8:00,,5,4,0,0,1,0.8
2022010001,10,20:00,,9,9,6,0,0,1.0
2022010001,10,39:47:00,,11,10,0,1,1,0.909090909
2022010001,9,30:07:00,,19,16,1,0,3,0.842105263
2022010001,9,28:59:00,,11,11,1,2,0,1.0
2022010002,4,29:50:00,,15,14,8,0,1,0.933333333
2022010002,4,29:42:00,,17,17,7,0,0,1.0
2022010002,6,29:57:00,,15,14,7,0,1,0.933333333
2022010002,6,28:20:00,,14,13,2,2,1,0.928571429
2022010003,10,39:40:00,,16,16,1,0,0,1.0
2022010003,10,18:42,,10,7,2,1,3,0.7
2022010003,9,30:38:00,,14,13,0,1,1,0.928571429
2022010003,9,29:22:00,,9,8,2,0,1,0.888888889
2022010004,53,32:22:00,,12,9,0,9,3,0.75
2022010004,53,26:04:00,,13,11,0,11,2,0.846153846
2022010004,19,40:00:00,,12,9,0,9,3,0.75
2022010004,19,20:00,,8,7,0,7,1,0.875
2022010005,5,31:05:00,,13,12,0,0,1,0.923076923
2022010005,5,28:54:00,,15,14,2,0,1,0.933333333
2022010005,29,31:05:00,,13,12,2,0,1,0.923076923
2022010005,29,30:53:00,,21,19,0,0,2,0.904761905
2022010006,15,31:11:00,,11,9,2,0,2,0.818181818
2022010006,15,30:04:00,,17,15,1,0,2,0.882352941
2022010006,7,60:14:00,,27,24,4,0,3,0.888888889
2022010006,7,,,0,0,0,0,0,
2022010007,30,31:10:00,,12,12,0,1,0,1.0
2022010007,30,29:24:00,,13,11,4,0,2,0.846153846
2022010007,21,,,0,0,0,0,0,
2022010007,21,60:48:00,,36,33,4,0,3,0.916666667
2022010008,53,17:17,,6,6,0,6,0,1.0
2022010008,53,40:00:00,,18,15,0,15,3,0.833333333
2022010008,24,60:00:00,,26,24,0,24,2,0.923076923
2022010009,22,25:33:00,,10,10,1,0,0,1.0
2022010009,22,34:27:00,,19,19,3,1,0,1.0
2022010009,52,59:54:00,,26,22,3,2,4,0.846153846
2022010009,52,,,0,0,0,0,0,
2022010010,23,40:00:00,,25,23,11,1,2,0.92
2022010010,23,23:25,,20,19,4,2,1,0.95
2022010010,20,62:46:00,,28,26,9,0,2,0.928571429
2022010010,20,,,0,0,0,0,0,
2022010011,28,,,0,0,0,0,0,
2022010011,28,63:31:00,,45,43,16,3,2,0.955555556
2022010011,26,30:22:00,,13,11,2,1,2,0.846153846
2022010011,26,33:11:00,,18,17,11,3,1,0.944444444
2022010012,29,20:00,,14,13,1,0,1,0.928571429
2022010012,29,39:42:00,,20,20,5,0,0,1.0
2022010012,5,,,0,0,0,0,0,
2022010012,5,59:50:00,,32,27,4,1,5,0.84375
2022010013,20,20:00,,4,4,0,0,0,1.0
2022010013,20,40:00:00,,15,15,4,0,0,1.0
2022010013,23,40:00:00,,24,21,7,4,3,0.875
2022010013,23,20:00,,7,6,2,0,1,0.857142857
2022010014,21,29:58:00,,10,10,2,0,0,1.0
2022010014,21,29:44:00,,13,12,0,0,1,0.923076923
2022010014,54,28:59:00,,16,14,9,0,2,0.875
2022010014,54,29:44:00,,13,13,6,0,0,1.0
2022010015,18,33:14:00,,20,18,0,0,2,0.9
2022010015,18,31:17:00,,12,10,3,0,2,0.833333333
2022010015,13,33:14:00,,13,12,0,0,1,0.923076923
2022010015,13,31:45:00,,12,10,3,0,2,0.833333333
2022010016,8,29:18:00,,13,11,2,2,2,0.846153846
2022010016,8,29:17:00,,18,18,2,1,0,1.0
2022010016,1,31:29:00,,16,15,6,0,1,0.9375
2022010016,1,28:21:00,,5,5,1,0,0,1.0
2022010017,3,31:41:00,,14,14,2,0,0,1.0
2022010017,3,28:19:00,,10,9,3,0,1,0.9
2022010017,2,28:19:00,,15,15,1,2,0,1.0
2022010017,2,31:15:00,,20,16,3,0,4,0.8
2022010018,18,30:04:00,,12,12,2,0,0,1.0
2022010018,18,29:56:00,,13,13,0,1,0,1.0
2022010018,13,29:56:00,,20,19,4,3,1,0.95
2022010018,13,30:04:00,,18,15,0,0,3,0.833333333
2022010019,25,40:00:00,,15,13,0,0,2,0.866666667
2022010019,25,20:00,,13,11,3,0,2,0.846153846
2022010019,19,20:00,,10,10,1,0,0,1.0
2022010019,19,40:00:00,,23,23,2,0,0,1.0
2022010020,55,32:15:00,,13,13,2,2,0,1.0
2022010020,55,27:22:00,,16,16,3,2,0,1.0
2022010020,22,30:00:00,,9,8,1,0,1,0.888888889
2022010020,22,28:27:00,,18,16,7,1,2,0.888888889
2022010021,54,31:30:00,,9,7,0,1,2,0.777777778
2022010021,54,30:13:00,,9,9,1,0,0,1.0
2022010021,26,41:48:00,,23,23,5,0,0,1.0
2022010021,26,20:00,,11,10,2,1,1,0.909090909
2022010022,5,31:29:00,,7,5,0,2,2,0.714285714
2022010022,5,28:24:00,,14,10,0,2,4,0.714285714
2022010022,17,29:19:00,,13,12,5,0,1,0.923076923
2022010022,17,30:36:00,,20,19,8,0,1,0.95
2022010023,1,20:00,,11,11,5,0,0,1.0
2022010023,1,40:00:00,,14,13,2,0,1,0.928571429
2022010023,2,29:55:00,,12,9,0,0,3,0.75
2022010023,2,30:05:00,,14,13,3,2,1,0.928571429
2022010024,6,61:12:00,,26,24,6,0,2,0.923076923
2022010024,6,,,0,0,0,0,0,
2022010024,3,32:46:00,,15,14,0,0,1,0.933333333
2022010024,3,28:26:00,,21,19,0,0,2,0.904761905
2022010025,7,30:02:00,,9,8,0,0,1,0.888888889
2022010025,7,29:58:00,,12,12,2,0,0,1.0
2022010025,4,40:00:00,,14,12,1,0,2,0.857142857
2022010025,4,18:23,,7,7,3,1,0,1.0
2022010026,12,59:43:00,,21,20,2,0,1,0.952380952
2022010026,12,,,0,0,0,0,0,
2022010026,14,60:00:00,,46,41,5,1,5,0.891304348
2022010026,14,,,0,0,0,0,0,
2022010027,25,21:42,,10,9,0,9,1,0.9
2022010027,25,40:00:00,,12,10,0,10,2,0.833333333
2022010027,53,31:35:00,,15,14,0,14,1,0.933333333
2022010027,53,30:07:00,,20,17,0,17,3,0.85
2022010028,52,,,0,0,0,0,0,
2022010028,52,60:00:00,,27,24,5,0,3,0.888888889
2022010028,9,29:48:00,,9,8,1,0,1,0.888888889
2022010028,9,27:44:00,,15,11,1,0,4,0.733333333
2022010029,16,29:42:00,,12,9,2,1,3,0.75
2022010029,16,30:18:00,,10,9,0,1,1,0.9
2022010029,19,40:00:00,,21,20,0,0,1,0.952380952
2022010029,19,20:00,,11,11,1,0,0,1.0
2022010030,21,59:59:00,,26,21,8,2,5,0.807692308
2022010030,21,,,0,0,0,0,0,
2022010030,30,29:44:00,,13,13,2,1,0,1.0
2022010030,30,30:16:00,,28,26,2,0,2,0.928571429
2022010031,55,30:37:00,,10,10,2,2,0,1.0
2022010031,55,29:23:00,,15,15,1,0,0,1.0
2022010031,20,,,0,0,0,0,0,
2022010031,20,57:18:00,,34,32,6,8,2,0.941176471
2022010032,28,,,0,0,0,0,0,
2022010032,28,60:00:00,,30,26,2,0,4,0.866666667
2022010032,24,,,0,0,0,0,0,
2022010032,24,59:34:00,,29,24,5,1,5,0.827586207
2022010033,29,31:24:00,,10,9,0,0,1,0.9
2022010033,29,28:36:00,,13,13,2,0,0,1.0
2022010033,7,,,0,0,0,0,0,
2022010033,7,59:49:00,,31,27,0,1,4,0.870967742
2022010035,10,40:00:00,,16,16,1,0,0,1.0
2022010035,10,19:52,,11,11,2,0,0,1.0
2022010035,8,31:10:00,,15,14,3,0,1,0.933333333
2022010035,8,28:50:00,,14,12,0,1,2,0.857142857
2022010036,4,40:00:00,,15,13,1,0,2,0.866666667
2022010036,4,16:59,,12,11,3,0,1,0.916666667
2022010036,15,20:00,,8,7,0,0,1,0.875
2022010036,15,39:57:00,,13,13,4,2,0,1.0
2022010037,17,31:56:00,,10,8,0,0,2,0.8
2022010037,17,27:54:00,,11,10,3,0,1,0.909090909
2022010037,16,,,0,0,0,0,0,
2022010037,16,60:00:00,,33,31,4,1,2,0.939393939
2022010038,20,40:00:00,,12,12,1,1,0,1.0
2022010038,20,20:00,,9,9,0,0,0,1.0
2022010038,22,31:36:00,,17,16,2,0,1,0.941176471
2022010038,22,26:20:00,,16,14,3,0,2,0.875
2022010039,24,60:00:00,,29,28,4,0,1,0.965517241
2022010039,24,,,0,0,0,0,0,
2022010039,53,60:00:00,,23,20,5,0,3,0.869565217
2022010039,53,,,0,0,0,0,0,
2022010040,54,,,0,0,0,0,0,
2022010040,54,60:00:00,,26,25,5,0,1,0.961538462
2022010040,21,20:00,,10,9,0,1,1,0.9
2022010040,21,40:00:00,,18,12,2,0,6,0.666666667
2022010041,26,59:35:00,,16,14,0,14,2,0.875
2022010041,28,60:00:00,,27,26,0,26,1,0.962962963
2022010042,13,,,0,0,0,0,0,
2022010042,13,59:22:00,,28,23,3,0,5,0.821428571
2022010042,12,40:00:00,,21,20,5,1,1,0.952380952
2022010042,12,20:00,,9,8,1,2,1,0.888888889
2022010043,14,58:44:00,,31,29,1,1,2,0.935483871
2022010043,14,,,0,0,0,0,0,
2022010043,18,60:00:00,,30,30,5,3,0,1.0
2022010043,18,,,0,0,0,0,0,
2022010044,3,40:00:00,,25,22,5,0,3,0.88
2022010044,3,19:35,,10,9,1,1,1,0.9
2022010044,1,,,0,0,0,0,0,
2022010044,1,59:26:00,,17,15,0,1,2,0.882352941
2022010045,8,29:13:00,,14,11,2,0,3,0.785714286
2022010045,8,30:24:00,,11,10,1,1,1,0.909090909
2022010045,52,39:58:00,,10,9,5,1,1,0.9
2022010045,52,20:00,,15,13,4,0,2,0.866666667
2022010046,19,40:00:00,,25,23,2,0,2,0.92
2022010046,19,20:00,,10,10,2,0,0,1.0
2022010046,29,28:25:00,,12,8,0,0,4,0.666666667
2022010046,29,29:34:00,,9,9,0,1,0,1.0
2022010047,25,,,0,0,0,0,0,
2022010047,25,59:52:00,,28,23,3,2,5,0.821428571
2022010047,30,60:00:00,,35,33,11,2,2,0.942857143
2022010047,30,,,0,0,0,0,0,
2022010048,23,24:19:00,,11,8,0,1,3,0.727272727
2022010048,23,40:00:00,,18,17,3,0,1,0.944444444
2022010048,55,33:57:00,,15,15,4,0,0,1.0
2022010048,55,30:19:00,,21,18,4,0,3,0.857142857
2022010049,18,,,0,0,0,0,0,
2022010049,18,60:00:00,,28,27,9,3,1,0.964285714
2022010049,14,,,0,0,0,0,0,
2022010049,14,59:43:00,,28,21,5,3,7,0.75
2022010050,1,57:46:00,,37,35,5,0,2,0.945945946
2022010050,1,,,0,0,0,0,0,
2022010050,3,27:38:00,,15,15,1,0,0,1.0
2022010050,3,32:06:00,,11,10,0,1,1,0.909090909
2022010051,9,59:54:00,,38,33,0,33,5,0.868421053
2022010051,10,60:00:00,,30,27,0,27,3,0.9
2022010052,17,27:24:00,,17,16,4,1,1,0.941176471
2022010052,17,31:30:00,,13,13,0,0,0,1.0
2022010052,15,31:30:00,,9,9,1,0,0,1.0
2022010052,15,28:30:00,,10,10,0,1,0,1.0
2022010053,22,28:48:00,,14,14,1,0,0,1.0
2022010053,22,31:12:00,,8,7,1,0,1,0.875
2022010053,20,,,0,0,0,0,0,
2022010053,20,59:08:00,,38,36,10,2,2,0.947368421
2022010054,24,30:05:00,,18,17,3,0,1,0.944444444
2022010054,24,29:55:00,,13,13,5,0,0,1.0
2022010054,28,,,0,0,0,0,0,
2022010054,28,57:41:00,,31,27,8,0,4,0.870967742
2022010055,54,,,0,0,0,0,0,
2022010055,54,60:00:00,,39,32,2,0,7,0.820512821
2022010055,28,,,0,0,0,0,0,
2022010055,28,60:00:00,,30,27,6,0,3,0.9
2022010056,12,60:00:00,,10,7,1,0,3,0.7
2022010056,12,,,0,0,0,0,0,
2022010056,13,,,0,0,0,0,0,
2022010056,13,59:17:00,,47,43,7,1,4,0.914893617
2022010057,6,,,0,0,0,0,0,
2022010057,6,60:00:00,,21,21,4,3,0,1.0
2022010057,4,39:27:00,,23,20,2,0,3,0.869565217
2022010057,4,20:00,,2,2,0,0,0,1.0
2022010058,7,59:38:00,,33,32,4,2,1,0.96969697
2022010058,7,,,0,0,0,0,0,
2022010058,5,58:28:00,,34,32,10,0,2,0.941176471
2022010058,5,,,0,0,0,0,0,
2022010059,9,20:59,,2,1,0,0,1,0.5
2022010059,9,40:00:00,,14,11,0,1,3,0.785714286
2022010059,8,60:59:00,,34,29,4,1,5,0.852941176
2022010059,8,,,0,0,0,0,0,
2022010060,29,,,0,0,0,0,0,
2022010060,29,60:00:00,,35,34,5,1,1,0.971428571
2022010060,15,,,0,0,0,0,0,
2022010060,15,57:03:00,,20,18,0,0,2,0.9
2022010061,19,59:42:00,,27,22,0,22,5,0.814814815
2022010061,25,60:00:00,,17,15,0,15,2,0.882352941
2022010062,52,,,0,0,0,0,0,
2022010062,52,65:00:00,,27,25,7,1,2,0.925925926
2022010062,22,,,0,0,0,0,0,
2022010062,22,65:00:00,,35,33,12,1,2,0.942857143
2022010063,16,,,0,0,0,0,0,
2022010063,16,60:00:00,,35,32,9,4,3,0.914285714
2022010063,17,20:00,,7,7,1,1,0,1.0
2022010063,17,39:36:00,,14,14,5,1,0,1.0
2022010064,55,59:41:00,,17,17,2,2,0,1.0
2022010064,55,,,0,0,0,0,0,
2022010064,23,59:28:00,,25,22,4,1,3,0.88
2022010064,23,,,0,0,0,0,0,
2022010065,2,20:00,,8,8,2,1,0,1.0
2022010065,2,39:58:00,,17,16,3,1,1,0.941176471
2022010065,4,,,0,0,0,0,0,
2022010065,4,57:40:00,,23,21,5,0,2,0.913043478
2022010066,16,60:00:00,,33,30,0,30,3,0.909090909
2022010066,30,60:00:00,,12,12,0,12,0,1.0
2022010067,26,,,0,0,0,0,0,
2022010067,26,60:00:00,,25,24,5,1,1,0.96
2022010067,24,,,0,0,0,0,0,
2022010067,24,58:17:00,,33,31,5,2,2,0.939393939
2022010068,1,,,0,0,0,0,0,
2022010068,1,60:00:00,,24,24,4,0,0,1.0
2022010068,6,43:06:00,,20,19,2,1,1,0.95
2022010068,6,15:52,,4,4,0,0,0,1.0
2022010069,12,59:40:00,,26,25,0,3,1,0.961538462
2022010069,12,,,0,0,0,0,0,
2022010069,29,26:18:00,,21,18,0,2,3,0.857142857
2022010069,29,33:42:00,,24,19,8,0,5,0.791666667
2022010070,8,59:40:00,,31,26,6,0,5,0.838709677
2022010070,8,,,0,0,0,0,0,
2022010070,10,60:00:00,,30,29,9,0,1,0.966666667
2022010070,10,,,0,0,0,0,0,
2022010071,17,40:00:00,,18,15,1,2,3,0.833333333
2022010071,17,17:29,,6,6,0,1,0,1.0
2022010071,5,59:58:00,,39,37,4,0,2,0.948717949
2022010071,5,,,0,0,0,0,0,
2022010072,25,58:15:00,,29,27,3,0,2,0.931034483
2022010072,25,,,0,0,0,0,0,
2022010072,21,60:00:00,,39,38,11,1,1,0.974358974
2022010072,21,,,0,0,0,0,0,
2022010073,20,59:50:00,,22,21,5,0,1,0.954545455
2022010073,20,,,0,0,0,0,0,
2022010073,55,59:35:00,,25,21,0,1,4,0.84
2022010073,55,,,0,0,0,0,0,
2022010074,22,59:50:00,,30,28,5,0,2,0.933333333
2022010074,22,,,0,0,0,0,0,
2022010074,23,,,0,0,0,0,0,
2022010074,23,60:00:00,,36,29,6,3,7,0.805555556
2022010075,7,,,0,0,0,0,0,
2022010075,7,60:00:00,,25,23,5,0,2,0.92
2022010075,12,,,0,0,0,0,0,
2022010075,12,59:41:00,,29,26,0,1,3,0.896551724
2022010076,4,35:35:00,,18,14,3,0,4,0.777777778
2022010076,4,29:17:00,,15,15,4,0,0,1.0
2022010076,2,64:41:00,,33,30,1,1,3,0.909090909
2022010076,2,,,0,0,0,0,0,
2022010077,8,,,0,0,0,0,0,
2022010077,8,58:48:00,,23,18,0,0,5,0.782608696
2022010077,9,60:00:00,,25,21,7,0,4,0.84
2022010077,9,,,0,0,0,0,0,
2022010078,19,20:00,,17,15,3,0,2,0.882352941
2022010078,19,39:53:00,,11,11,2,0,0,1.0
2022010078,30,,,0,0,0,0,0,
2022010078,30,55:53:00,,27,23,3,0,4,0.851851852
2022010079,54,60:00:00,,53,50,6,2,3,0.943396226
2022010079,54,,,0,0,0,0,0,
2022010079,53,57:06:00,,28,24,4,0,4,0.857142857
2022010079,53,,,0,0,0,0,0,
2022010080,24,,,0,0,0,0,0,
2022010080,24,60:00:00,,36,32,4,1,4,0.888888889
2022010080,26,,,0,0,0,0,0,
2022010080,26,57:48:00,,32,27,5,0,5,0.84375
2022010081,3,,,0,0,0,0,0,
2022010081,3,58:23:00,,26,21,1,0,5,0.807692308
2022010081,6,60:00:00,,32,28,3,0,4,0.875
2022010081,6,,,0,0,0,0,0,
2022010082,15,59:45:00,,33,31,4,0,2,0.939393939
2022010082,15,,,0,0,0,0,0,
2022010082,17,,,0,0,0,0,0,
2022010082,17,59:24:00,,34,31,6,0,3,0.911764706
2022010083,52,59:55:00,,37,37,9,2,0,1.0
2022010083,52,,,0,0,0,0,0,
2022010083,20,30:30:00,,12,9,1,1,3,0.75
2022010083,20,29:10:00,,15,13,3,1,2,0.866666667
2022010084,21,,,0,0,0,0,0,
2022010084,21,59:54:00,,33,32,1,1,1,0.96969697
2022010084,25,18:46,,15,13,1,0,2,0.866666667
2022010084,25,40:00:00,,18,18,1,0,0,1.0
2022010085,23,60:00:00,,21,17,0,17,4,0.80952381
2022010085,22,58:43:00,,31,26,0,26,5,0.838709677
2022010086,8,60:00:00,,33,29,0,29,4,0.878787879
2022010086,9,60:00:00,,29,26,0,26,3,0.896551724
2022010087,2,,,0,0,0,0,0,
2022010087,2,60:00:00,,28,26,5,0,2,0.928571429
2022010087,1,60:00:00,,26,21,1,2,5,0.807692308
2022010087,1,,,0,0,0,0,0,
2022010088,29,59:55:00,,24,24,2,0,0,1.0
2022010088,29,,,0,0,0,0,0,
2022010088,19,49:21:00,,31,24,2,0,7,0.774193548
2022010088,19,10:39,,2,2,0,0,0,1.0
2022010089,13,,,0,0,0,0,0,
2022010089,13,59:36:00,,28,26,4,0,2,0.928571429
2022010089,14,,,0,0,0,0,0,
2022010089,14,59:30:00,,41,38,2,0,3,0.926829268
2022010090,30,,,0,0,0,0,0,
2022010090,30,59:56:00,,26,25,14,1,1,0.961538462
2022010090,16,59:56:00,,23,19,1,1,4,0.826086957
2022010090,16,,,0,0,0,0,0,
2022010091,26,59:38:00,,32,27,0,27,5,0.84375
2022010091,54,59:46:00,,29,25,0,25,4,0.862068966
2022010092,5,,,0,0,0,0,0,
2022010092,5,60:00:00,,23,22,0,0,1,0.956521739
2022010092,7,,,0,0,0,0,0,
2022010092,7,60:00:00,,27,20,1,0,7,0.740740741
2022010093,17,,,0,0,0,0,0,
2022010093,17,60:00:00,,23,21,4,0,2,0.913043478
2022010093,10,59:56:00,,26,23,3,2,3,0.884615385
2022010093,10,,,0,0,0,0,0,
2022010094,22,60:00:00,,33,30,3,0,3,0.909090909
2022010094,22,,,0,0,0,0,0,
2022010094,55,,,0,0,0,0,0,
2022010094,55,59:37:00,,39,35,2,1,4,0.897435897
2022010095,20,59:17:00,,16,11,3,1,5,0.6875
2022010095,20,,,0,0,0,0,0,
2022010095,52,,,0,0,0,0,0,
2022010095,52,60:00:00,,38,35,11,1,3,0.921052632
2022010096,23,,,0,0,0,0,0,
2022010096,23,59:39:00,,7,7,0,1,0,1.0
2022010096,53,,,0,0,0,0,0,
2022010096,53,59:37:00,,32,28,10,2,4,0.875
2022010097,14,,,0,0,0,0,0,
2022010097,14,60:00:00,,29,27,2,0,2,0.931034483
2022010097,13,59:56:00,,31,26,3,1,5,0.838709677
2022010097,13,,,0,0,0,0,0,
2022010098,26,60:00:00,,28,25,5,1,3,0.892857143
2022010098,26,,,0,0,0,0,0,
2022010098,24,20:00,,19,16,6,0,3,0.842105263
2022010098,24,37:39:00,,17,14,0,0,3,0.823529412
2022010099,9,62:45:00,,20,18,0,18,2,0.9
2022010099,8,62:35:00,,29,26,0,26,3,0.896551724
2022010100,30,58:51:00,,23,22,3,0,1,0.956521739
2022010100,30,,,0,0,0,0,0,
2022010100,25,40:00:00,,20,16,1,1,4,0.8
2022010100,25,20:00,,8,7,2,0,1,0.875
2022010101,15,60:16:00,,39,36,7,3,3,0.923076923
2022010101,15,,,0,0,0,0,0,
2022010101,29,,,0,0,0,0,0,
2022010101,29,60:29:00,,32,28,3,2,4,0.875
2022010102,10,60:00:00,,19,18,4,0,1,0.947368421
2022010102,10,,,0,0,0,0,0,
2022010102,17,28:05:00,,11,8,0,1,3,0.727272727
2022010102,17,31:55:00,,15,13,2,1,2,0.866666667
2022010103,6,,,0,0,0,0,0,
2022010103,6,57:44:00,,26,22,5,0,4,0.846153846
2022010103,1,29:52:00,,16,15,2,3,1,0.9375
2022010103,1,30:08:00,,14,12,0,0,2,0.857142857
2022010104,2,60:00:00,,29,28,3,1,1,0.965517241
2022010104,2,,,0,0,0,0,0,
2022010104,3,57:08:00,,16,13,4,0,3,0.8125
2022010104,3,,,0,0,0,0,0,
2022010105,54,33:39:00,,9,9,0,9,0,1.0
2022010105,54,26:21:00,,15,14,0,14,1,0.933333333
2022010105,53,60:00:00,,26,21,0,21,5,0.807692308
2022010106,19,,,0,0,0,0,0,
2022010106,19,60:00:00,,24,24,1,2,0,1.0
2022010106,16,,,0,0,0,0,0,
2022010106,16,59:52:00,,25,19,3,2,6,0.76
2022010107,5814,59:35:00,,31,27,0,27,4,0.870967742
2022010107,5814,,,0,0,0,0,0,
2022010107,18,60:00:00,,18,15,0,15,3,0.833333333
2022010107,18,,,0,0,0,0,0,
2022010108,5524,29:59:00,,15,12,0,12,3,0.8
2022010108,5524,30:01:00,,21,21,0,21,0,1.0
2022010108,28,28:35:00,,10,9,0,9,1,0.9
2022010108,28,31:25:00,,9,9,0,9,0,1.0
2022020001,18,60:00:00,0.0,31,30,8,0,1,0.967741935
2022020001,28,58:42:00,0.0,31,28,8,1,3,0.903225806
2022020002,28,57:22:00,0.0,18,15,2,2,3,0.833333333
2022020002,18,60:00:00,0.0,33,31,7,3,2,0.939393939
2022020003,3,59:41:00,0.0,26,25,7,0,1,0.961538462
2022020003,14,57:56:00,0.0,39,36,13,3,3,0.923076923
2022020004,26,59:12:00,0.0,51,47,5,1,4,0.921568627
2022020004,54,59:48:00,0.0,30,27,0,2,3,0.9
2022020005,15,57:48:00,0.0,29,25,5,2,4,0.862068966
2022020005,6,60:00:00,0.0,35,33,6,2,2,0.942857143
2022020006,12,60:00:00,0.0,32,31,1,0,1,0.96875
2022020006,29,60:00:00,0.0,43,39,5,1,4,0.906976744
2022020007,8,59:47:00,0.0,32,29,4,1,3,0.90625
2022020007,10,59:18:00,0.0,23,19,5,0,4,0.826086957
2022020008,21,59:45:00,0.0,17,15,0,1,2,0.882352941
2022020008,16,60:00:00,0.0,35,30,4,2,5,0.857142857
2022020009,24,60:55:00,0.0,48,44,8,0,4,0.916666667
2022020009,55,60:41:00,0.0,27,22,4,0,5,0.814814815
2022020010,22,59:54:00,0.0,36,33,10,0,3,0.916666667
2022020010,23,58:04:00,0.0,24,20,2,0,4,0.833333333
2022020011,5,59:28:00,0.0,28,26,5,1,2,0.928571429
2022020011,53,59:40:00,0.0,53,47,12,2,6,0.886792453
2022020012,4,60:00:00,0.0,37,35,4,0,2,0.945945946
2022020012,1,57:32:00,0.0,24,20,5,1,4,0.833333333
2022020013,7,60:00:00,0.0,36,35,4,1,1,0.972222222
2022020013,9,59:01:00,0.0,34,32,3,5,2,0.941176471
2022020014,2,58:25:00,0.0,28,26,7,2,2,0.928571429
2022020014,13,59:39:00,0.0,33,32,1,4,1,0.96969697
2022020015,10,59:59:00,0.0,26,24,5,2,2,0.923076923
2022020015,15,56:31:00,0.0,39,36,6,3,3,0.923076923
2022020016,18,58:13:00,0.0,29,25,8,0,4,0.862068966
2022020016,25,60:00:00,0.0,32,31,12,0,1,0.96875
2022020017,30,58:51:00,0.0,35,28,9,1,7,0.8
2022020017,3,59:19:00,0.0,36,33,11,5,3,0.916666667
2022020018,20,60:00:00,0.0,25,22,2,0,3,0.88
2022020018,21,57:38:00,0.0,27,22,1,2,5,0.814814815
2022020019,54,59:54:00,0.0,27,27,6,0,0,1.0
2022020019,16,58:14:00,0.0,37,36,6,2,1,0.972972973
2022020020,26,57:59:00,2.0,21,18,4,0,3,0.857142857
2022020020,55,60:00:00,0.0,27,26,3,1,1,0.962962963
2022020021,29,60:00:00,0.0,39,34,1,0,5,0.871794872
2022020021,14,60:00:00,0.0,28,26,9,3,2,0.928571429
2022020022,17,60:00:00,0.0,29,29,6,1,0,1.0
2022020022,8,58:32:00,0.0,38,37,8,2,1,0.973684211
2022020023,52,60:00:00,0.0,41,40,6,2,1,0.975609756
2022020023,3,58:58:00,0.0,33,30,3,0,3,0.909090909
2022020024,28,58:34:00,0.0,35,33,4,3,2,0.942857143
2022020024,12,60:00:00,0.0,19,18,6,1,1,0.947368421
2022020025,7,59:40:00,0.0,37,33,10,1,4,0.891891892
2022020025,13,60:00:00,0.0,27,24,6,2,3,0.888888889
2022020026,4,60:00:00,0.0,30,28,5,0,2,0.933333333
2022020026,23,57:27:00,0.0,31,28,4,3,3,0.903225806
2022020027,6,59:55:00,0.0,24,21,4,1,3,0.875
2022020027,53,59:28:00,0.0,42,37,4,1,5,0.880952381
2022020028,1,60:00:00,0.0,22,17,3,2,5,0.772727273
2022020028,17,59:31:00,0.0,39,37,6,0,2,0.948717949
2022020029,15,60:00:00,0.0,22,21,5,0,1,0.954545455
2022020029,8,58:25:00,0.0,29,26,7,2,3,0.896551724
2022020030,10,60:00:00,0.0,28,26,2,0,2,0.928571429
2022020030,9,58:24:00,0.0,32,29,0,2,3,0.90625
2022020031,5,59:43:00,0.0,36,34,9,0,2,0.944444444
2022020031,14,59:26:00,0.0,44,39,7,1,5,0.886363636
2022020032,2,59:52:00,0.0,23,22,2,0,1,0.956521739
2022020032,24,40:00:00,0.0,27,22,4,0,5,0.814814815
2022020032,24,20:00,0.0,11,9,4,0,2,0.818181818
2022020033,19,60:00:00,0.0,25,23,0,1,2,0.92
2022020033,29,60:00:00,0.0,25,20,3,0,5,0.8
2022020034,30,20:00,0.0,14,10,6,0,4,0.714285714
2022020034,30,38:20:00,0.0,20,17,2,1,3,0.85
2022020034,26,60:00:00,0.0,35,29,4,2,6,0.828571429
2022020035,25,60:00:00,0.0,30,29,4,0,1,0.966666667
2022020035,18,56:55:00,0.0,21,17,5,0,4,0.80952381
2022020036,22,10:18,0.0,11,7,0,0,4,0.636363636
2022020036,22,48:44:00,0.0,31,31,7,1,0,1.0
2022020036,20,60:00:00,0.0,29,26,5,1,3,0.896551724
2022020037,55,40:00:00,0.0,24,19,1,0,5,0.791666667
2022020037,55,20:00,0.0,6,6,0,0,0,1.0
2022020037,54,60:00:00,0.0,33,31,2,0,2,0.939393939
2022020038,28,59:37:00,0.0,25,20,2,0,5,0.8
2022020038,16,60:00:00,0.0,26,24,6,0,2,0.923076923
2022020039,3,60:00:00,0.0,22,18,2,1,4,0.818181818
2022020039,24,40:00:00,0.0,34,29,6,1,5,0.852941176
2022020039,24,19:11,0.0,9,8,0,0,1,0.888888889
2022020040,10,59:06:00,0.0,18,15,1,0,3,0.833333333
2022020040,53,60:00:00,0.0,28,26,1,3,2,0.928571429
2022020041,6,60:00:00,0.0,41,38,9,2,3,0.926829268
2022020041,13,55:10:00,0.0,33,29,5,1,4,0.878787879
2022020042,8,62:41:00,0.0,28,26,3,1,2,0.928571429
2022020042,5,63:09:00,0.0,39,36,2,4,3,0.923076923
2022020043,15,59:46:00,0.0,30,26,1,0,4,0.866666667
2022020043,23,58:42:00,0.0,30,24,1,0,6,0.8
2022020044,17,60:08:00,0.0,36,31,6,1,5,0.861111111
2022020044,26,59:43:00,0.0,33,29,4,3,4,0.878787879
2022020045,30,56:30:00,0.0,37,32,0,0,5,0.864864865
2022020045,21,60:00:00,0.0,39,36,8,0,3,0.923076923
2022020046,25,60:00:00,0.0,25,24,7,0,1,0.96
2022020046,52,60:00:00,0.0,29,25,8,2,4,0.862068966
2022020047,55,60:00:00,0.0,34,29,6,0,5,0.852941176
2022020047,12,60:00:00,0.0,23,22,2,2,1,0.956521739
2022020048,1,60:00:00,0.0,20,18,5,1,2,0.9
2022020048,24,58:17:00,0.0,41,37,2,1,4,0.902439024
2022020049,9,60:00:00,0.0,34,29,9,0,5,0.852941176
2022020049,6,40:00:00,0.0,25,19,0,0,6,0.76
2022020049,6,19:29,0.0,6,5,0,0,1,0.833333333
2022020050,29,63:21:00,0.0,35,32,6,1,3,0.914285714
2022020050,23,63:21:00,0.0,33,29,1,0,4,0.878787879
2022020051,2,59:53:00,0.0,28,26,4,0,2,0.928571429
2022020051,28,59:34:00,0.0,45,41,5,1,4,0.911111111
2022020052,18,64:51:00,0.0,35,32,10,1,3,0.914285714
2022020052,26,65:00:00,0.0,32,29,8,1,3,0.90625
2022020053,14,58:12:00,0.0,24,21,1,1,3,0.875
2022020053,4,60:00:00,0.0,38,36,2,0,2,0.947368421
2022020054,22,58:04:00,0.0,23,20,5,0,3,0.869565217
2022020054,7,60:00:00,0.0,48,46,6,0,2,0.958333333
2022020055,20,60:00:00,0.0,21,19,4,3,2,0.904761905
2022020055,54,57:58:00,0.0,40,37,9,4,3,0.925
2022020056,13,60:00:00,0.0,33,30,9,1,3,0.909090909
2022020056,4,55:35:00,0.0,36,32,3,6,4,0.888888889
2022020057,21,60:15:00,0.0,28,24,3,0,4,0.857142857
2022020057,52,60:31:00,0.0,33,30,0,0,3,0.909090909
2022020058,55,62:10:00,0.0,28,24,3,1,4,0.857142857
2022020058,19,62:10:00,0.0,35,32,0,0,3,0.914285714
2022020059,6,64:43:00,0.0,31,30,4,2,1,0.967741935
2022020059,24,64:50:00,0.0,36,35,5,1,1,0.972222222
2022020060,8,59:59:00,0.0,27,25,6,1,2,0.925925926
2022020060,53,59:28:00,0.0,29,24,2,3,5,0.827586207
2022020061,10,63:33:00,0.0,28,26,2,3,2,0.928571429
2022020061,25,63:34:00,0.0,43,40,16,3,3,0.930232558
2022020062,5,60:00:00,0.0,40,39,12,0,1,0.975
2022020062,26,40:00:00,0.0,25,22,1,2,3,0.88
2022020062,26,20:00,0.0,9,6,1,0,3,0.666666667
2022020063,29,60:00:00,0.0,26,23,2,0,3,0.884615385
2022020063,18,57:59:00,0.0,41,37,5,2,4,0.902439024
2022020064,3,60:47:00,0.0,27,24,2,0,3,0.888888889
2022020064,28,60:49:00,0.0,23,21,3,0,2,0.913043478
2022020065,9,60:00:00,0.0,24,22,2,0,2,0.916666667
2022020065,15,58:57:00,0.0,42,39,5,0,3,0.928571429
2022020066,2,57:01:00,0.0,42,39,8,0,3,0.928571429
2022020066,1,60:00:00,0.0,17,16,3,0,1,0.941176471
2022020067,30,62:05:00,0.0,26,23,6,0,3,0.884615385
2022020067,23,63:02:00,0.0,37,33,5,0,4,0.891891892
2022020068,20,20:00,0.0,12,9,1,0,3,0.75
2022020068,20,38:58:00,0.0,19,17,1,0,2,0.894736842
2022020068,7,60:00:00,0.0,43,40,2,5,3,0.930232558
2022020069,22,59:47:00,0.0,40,36,6,2,4,0.9
2022020069,12,58:40:00,0.0,32,27,4,0,5,0.84375
2022020070,54,59:52:00,2.0,28,26,0,1,2,0.928571429
2022020070,52,56:41:00,0.0,31,27,4,0,4,0.870967742
2022020071,13,61:42:00,0.0,32,29,7,1,3,0.90625
2022020071,14,62:08:00,0.0,38,36,10,0,2,0.947368421
2022020072,16,22:16,2.0,10,10,3,0,0,1.0
2022020072,16,39:37:00,0.0,18,15,0,0,3,0.833333333
2022020072,17,62:16:00,0.0,29,25,1,3,4,0.862068966
2022020073,21,59:25:00,0.0,38,35,6,0,3,0.921052632
2022020073,55,9:43,0.0,1,1,0,0,0,1.0
2022020073,55,50:17:00,0.0,19,17,2,0,2,0.894736842
2022020074,6,64:49:00,0.0,27,24,5,1,3,0.888888889
2022020074,30,64:40:00,0.0,43,39,11,3,4,0.906976744
2022020075,1,59:53:00,0.0,22,21,1,1,1,0.954545455
2022020075,28,56:36:00,0.0,36,34,6,0,2,0.944444444
2022020076,9,60:00:00,0.0,22,20,6,0,2,0.909090909
2022020076,53,59:59:00,0.0,32,26,1,1,6,0.8125
2022020077,22,58:31:00,0.0,21,20,2,0,1,0.952380952
2022020077,19,60:00:00,0.0,23,23,0,0,0,1.0
2022020078,8,60:00:00,0.0,30,25,3,2,5,0.833333333
2022020078,25,60:00:00,0.0,34,32,2,0,2,0.941176471
2022020079,15,59:54:00,0.0,26,23,0,1,3,0.884615385
2022020079,26,57:24:00,0.0,32,28,4,0,4,0.875
2022020080,14,59:26:00,0.0,35,32,5,0,3,0.914285714
2022020080,2,57:17:00,0.0,26,21,7,3,5,0.807692308
2022020081,29,60:00:00,0.0,39,33,4,0,6,0.846153846
2022020081,5,59:18:00,0.0,32,29,4,1,3,0.90625
2022020082,52,59:46:00,0.0,27,24,1,0,3,0.888888889
2022020082,10,59:42:00,0.0,31,30,3,1,1,0.967741935
2022020083,18,56:32:00,0.0,25,22,1,0,3,0.88
2022020083,4,60:00:00,0.0,32,31,4,0,1,0.96875
2022020084,23,59:48:00,0.0,26,22,0,2,4,0.846153846
2022020084,7,60:00:00,0.0,30,29,4,0,1,0.966666667
2022020085,20,64:30:00,0.0,27,25,3,1,2,0.925925926
2022020085,12,64:18:00,0.0,32,29,7,4,3,0.90625
2022020086,54,57:41:00,0.0,25,22,2,0,3,0.88
2022020086,21,59:33:00,0.0,35,33,5,0,2,0.942857143
2022020087,16,60:00:00,0.0,34,30,7,1,4,0.882352941
2022020087,55,58:30:00,0.0,27,22,4,1,5,0.814814815
2022020088,17,60:00:00,0.0,33,32,5,0,1,0.96969697
2022020088,24,60:00:00,4.0,41,36,11,1,5,0.87804878
2022020089,3,60:00:00,0.0,21,16,0,1,5,0.761904762
2022020089,29,60:00:00,0.0,31,30,7,0,1,0.967741935
2022020090,13,59:50:00,0.0,26,24,10,0,2,0.923076923
2022020090,2,58:36:00,0.0,32,29,7,1,3,0.90625
2022020091,4,59:01:00,0.0,24,22,3,0,2,0.916666667
2022020091,28,60:00:00,0.0,30,30,3,1,0,1.0
2022020092,9,60:00:00,0.0,31,29,2,0,2,0.935483871
2022020092,25,56:43:00,0.0,32,28,6,2,4,0.875
2022020093,1,40:00:00,0.0,18,13,3,3,5,0.722222222
2022020093,1,20:00,0.0,4,3,0,0,1,0.75
2022020093,15,60:00:00,0.0,41,38,8,0,3,0.926829268
2022020094,22,60:00:00,0.0,35,32,7,0,3,0.914285714
2022020094,5,59:56:00,2.0,47,41,1,3,6,0.872340426
2022020095,52,60:00:00,0.0,25,25,3,0,0,1.0
2022020095,19,59:32:00,0.0,42,39,7,0,3,0.928571429
2022020096,54,60:00:00,0.0,23,22,4,0,1,0.956521739
2022020096,10,55:57:00,0.0,33,30,5,0,3,0.909090909
2022020097,23,57:46:00,0.0,39,36,3,0,3,0.923076923
2022020097,12,60:00:00,0.0,16,14,1,2,2,0.875
2022020098,29,35:07:00,0.0,12,8,1,0,4,0.666666667
2022020098,29,22:55,0.0,6,5,1,2,1,0.833333333
2022020098,53,60:00:00,0.0,33,30,5,2,3,0.909090909
2022020099,3,64:00:00,0.0,44,42,5,1,2,0.954545455
2022020099,21,65:00:00,0.0,46,44,12,0,2,0.956521739
2022020100,6,59:55:00,0.0,31,30,3,1,1,0.967741935
2022020100,25,58:55:00,0.0,28,26,5,0,2,0.928571429
2022020101,8,59:08:00,0.0,30,28,6,0,2,0.933333333
2022020101,30,59:44:00,0.0,27,26,2,0,1,0.962962963
2022020102,17,60:00:00,0.0,41,35,0,0,6,0.853658537
2022020102,1,60:00:00,0.0,22,20,5,0,2,0.909090909
2022020103,16,60:00:00,0.0,31,29,5,0,2,0.935483871
2022020103,13,58:11:00,0.0,21,18,2,3,3,0.857142857
2022020104,20,60:00:00,0.0,33,32,7,0,1,0.96969697
2022020104,5,59:37:00,0.0,36,32,8,3,4,0.888888889
2022020105,55,59:36:00,0.0,16,15,5,0,1,0.9375
2022020105,7,59:56:00,0.0,24,19,3,1,5,0.791666667
2022020106,26,60:00:00,0.0,25,23,4,3,2,0.92
2022020106,14,57:48:00,0.0,33,29,2,1,4,0.878787879
2022020107,28,55:32:00,0.0,31,27,2,0,4,0.870967742
2022020107,54,60:00:00,0.0,31,29,2,0,2,0.935483871
2022020108,2,60:00:00,0.0,41,41,8,1,0,1.0
2022020108,3,59:46:00,0.0,29,26,5,1,3,0.896551724
2022020109,19,58:55:00,0.0,27,25,5,0,2,0.925925926
2022020109,22,60:00:00,0.0,38,37,7,1,1,0.973684211
2022020110,24,57:54:00,0.0,29,26,3,0,3,0.896551724
2022020110,14,60:00:00,0.0,21,19,2,1,2,0.904761905
2022020111,6,59:45:00,0.0,29,28,3,1,1,0.965517241
2022020111,17,59:38:00,0.0,33,28,6,0,5,0.848484848
2022020112,4,60:00:00,0.0,51,48,8,1,3,0.941176471
2022020112,13,57:46:00,0.0,22,18,1,0,4,0.818181818
2022020113,9,58:44:00,0.0,39,36,5,2,3,0.923076923
2022020113,30,59:47:00,0.0,29,27,7,0,2,0.931034483
2022020114,7,59:21:00,0.0,34,31,5,0,3,0.911764706
2022020114,8,60:00:00,0.0,45,43,9,4,2,0.955555556
2022020115,18,60:00:00,0.0,35,33,6,0,2,0.942857143
2022020115,19,57:30:00,0.0,41,36,3,4,5,0.87804878
2022020116,16,59:46:00,0.0,38,32,9,5,6,0.842105263
2022020116,22,60:00:00,2.0,36,31,11,1,5,0.861111111
2022020117,25,59:57:00,0.0,27,27,3,1,0,1.0
2022020117,15,56:18:00,0.0,27,25,1,0,2,0.925925926
2022020118,55,58:20:00,0.0,18,14,0,0,4,0.777777778
2022020118,23,60:00:00,0.0,36,32,5,0,4,0.888888889
2022020119,28,60:57:00,0.0,25,22,2,0,3,0.88
2022020119,10,60:57:00,0.0,31,27,1,0,4,0.870967742
2022020120,26,59:37:00,0.0,18,13,5,0,5,0.722222222
2022020120,52,59:08:00,0.0,44,40,3,2,4,0.909090909
2022020121,54,60:00:00,0.0,29,29,4,2,0,1.0
2022020121,24,40:00:00,0.0,18,14,0,0,4,0.777777778
2022020121,24,20:00,0.0,4,4,0,0,0,1.0
2022020122,29,20:00,0.0,6,6,0,0,0,1.0
2022020122,29,40:00:00,0.0,29,25,6,1,4,0.862068966
2022020122,6,59:34:00,0.0,30,30,6,3,0,1.0
2022020123,1,60:00:00,0.0,24,24,8,0,0,1.0
2022020123,21,58:27:00,0.0,23,22,2,0,1,0.956521739
2022020124,12,59:48:00,0.0,31,26,0,0,5,0.838709677
2022020124,2,60:00:00,0.0,35,33,7,0,2,0.942857143
2022020125,23,60:00:00,0.0,35,34,6,0,1,0.971428571
2022020125,5,59:04:00,0.0,28,24,4,0,4,0.857142857
2022020126,53,60:19:00,0.0,35,32,7,0,3,0.914285714
2022020126,52,60:32:00,0.0,21,19,3,2,2,0.904761905
2022020127,25,26:23:00,0.0,10,8,1,0,2,0.8
2022020127,25,33:37:00,0.0,17,13,1,0,4,0.764705882
2022020127,3,59:16:00,0.0,33,30,3,2,3,0.909090909
2022020128,13,59:53:00,0.0,26,23,3,3,3,0.884615385
2022020128,9,57:50:00,0.0,57,53,9,0,4,0.929824561
2022020129,28,58:45:00,0.0,26,22,3,0,4,0.846153846
2022020129,14,59:49:00,0.0,27,24,1,0,3,0.888888889
2022020130,4,64:06:00,0.0,38,34,9,1,4,0.894736842
2022020130,12,64:01:00,0.0,29,26,5,4,3,0.896551724
2022020131,7,60:29:00,0.0,26,23,3,0,3,0.884615385
2022020131,16,60:24:00,0.0,45,41,4,2,4,0.911111111
2022020132,17,60:00:00,0.0,31,30,2,1,1,0.967741935
2022020132,30,57:54:00,0.0,25,23,1,0,2,0.92
2022020133,19,58:39:00,0.0,24,18,4,0,6,0.75
2022020133,8,59:57:00,0.0,30,26,2,0,4,0.866666667
2022020134,26,60:00:00,0.0,28,26,4,3,2,0.928571429
2022020134,10,58:13:00,0.0,29,25,8,0,4,0.862068966
2022020135,2,60:00:00,0.0,37,33,3,1,4,0.891891892
2022020135,21,58:14:00,0.0,43,39,3,0,4,0.906976744
2022020136,18,57:32:00,0.0,34,32,6,1,2,0.941176471
2022020136,15,59:46:00,0.0,34,34,8,1,0,1.0
2022020137,20,58:40:00,0.0,26,23,2,3,3,0.884615385
2022020137,22,59:57:00,0.0,42,40,1,3,2,0.952380952
2022020138,55,60:00:00,0.0,33,32,1,1,1,0.96969697
2022020138,5,58:53:00,0.0,29,27,5,0,2,0.931034483
2022020139,1,60:00:00,0.0,21,20,2,0,1,0.952380952
2022020139,29,60:00:00,2.0,53,46,14,1,7,0.867924528
2022020140,16,65:00:00,0.0,35,32,2,0,3,0.914285714
2022020140,30,65:00:00,0.0,26,23,0,1,3,0.884615385
2022020141,53,59:09:00,0.0,39,36,6,0,3,0.923076923
2022020141,3,60:00:00,0.0,20,18,0,0,2,0.9
2022020142,24,62:15:00,0.0,36,33,3,0,3,0.916666667
2022020142,10,62:15:00,0.0,39,35,3,0,4,0.897435897
2022020143,54,64:34:00,0.0,24,23,3,0,1,0.958333333
2022020143,52,64:35:00,0.0,48,46,5,0,2,0.958333333
2022020144,7,60:00:00,0.0,18,15,0,1,3,0.833333333
2022020144,17,60:00:00,2.0,46,38,4,0,8,0.826086957
2022020145,12,64:54:00,0.0,20,18,2,1,2,0.9
2022020145,15,64:44:00,2.0,35,33,12,2,2,0.942857143
2022020146,19,29:28:00,0.0,11,11,1,1,0,1.0
2022020146,19,29:59:00,0.0,19,14,1,0,5,0.736842105
2022020146,26,59:42:00,0.0,28,27,8,0,1,0.964285714
2022020147,5,63:32:00,0.0,40,34,4,2,6,0.85
2022020147,6,14:06,0.0,4,4,0,1,0,1.0
2022020147,6,48:55:00,0.0,34,29,4,0,5,0.852941176
2022020148,14,59:38:00,0.0,15,12,3,1,3,0.8
2022020148,9,58:05:00,0.0,34,30,14,0,4,0.882352941
2022020149,3,64:07:00,0.0,19,19,3,0,0,1.0
2022020149,4,64:07:00,0.0,36,35,6,2,1,0.972222222
2022020150,15,61:35:00,0.0,31,28,1,1,3,0.903225806
2022020150,54,61:26:00,0.0,21,19,1,0,2,0.904761905
2022020151,30,60:00:00,0.0,35,34,3,1,1,0.971428571
2022020151,8,59:37:00,0.0,30,27,10,0,3,0.9
2022020152,16,2:56,0.0,2,2,0,0,0,1.0
2022020152,16,55:06:00,0.0,30,28,6,1,2,0.933333333
2022020152,2,60:00:00,0.0,22,21,4,1,1,0.954545455
2022020153,25,59:53:00,0.0,32,30,1,1,2,0.9375
2022020153,26,60:00:00,0.0,40,35,3,0,5,0.875
2022020154,22,60:00:00,0.0,23,19,2,1,4,0.826086957
2022020154,18,58:50:00,0.0,36,30,11,0,6,0.833333333
2022020155,20,58:19:00,0.0,26,21,5,1,5,0.807692308
2022020155,55,60:00:00,0.0,40,36,6,1,4,0.9
2022020156,53,60:00:00,0.0,42,41,8,0,1,0.976190476
2022020156,13,57:30:00,0.0,20,18,4,1,2,0.9
2022020157,23,58:01:00,0.0,36,32,0,2,4,0.888888889
2022020157,1,60:00:00,0.0,23,21,1,0,2,0.913043478
2022020158,28,64:02:00,0.0,44,39,10,0,5,0.886363636
2022020158,24,64:27:00,0.0,44,40,8,1,5,0.909090909
2022020159,10,59:41:00,0.0,25,23,6,0,2,0.92
2022020159,4,60:00:00,0.0,44,39,8,2,5,0.886363636
2022020160,7,60:00:00,0.0,21,18,0,1,3,0.857142857
2022020160,5,58:30:00,2.0,31,27,3,1,4,0.870967742
2022020161,3,59:39:00,0.0,36,32,5,3,4,0.888888889
2022020161,6,60:00:00,0.0,20,18,1,0,2,0.9
2022020162,14,65:00:00,0.0,55,52,15,2,3,0.945454545
2022020162,12,65:00:00,0.0,26,23,3,1,3,0.884615385
2022020163,9,30:14:00,0.0,19,14,1,0,5,0.736842105
2022020163,9,27:59:00,0.0,13,13,4,0,0,1.0
2022020163,54,59:53:00,0.0,46,42,5,1,4,0.913043478
2022020164,17,59:47:00,0.0,34,33,5,0,1,0.970588235
2022020164,15,58:20:00,0.0,25,23,3,0,2,0.92
2022020165,52,61:37:00,0.0,22,20,2,2,2,0.909090909
2022020165,8,61:45:00,0.0,36,33,3,0,3,0.916666667
2022020166,19,58:46:00,0.0,29,25,4,0,4,0.862068966
2022020166,2,60:00:00,0.0,34,32,0,0,2,0.941176471
2022020167,30,60:00:00,0.0,23,19,1,0,4,0.826086957
2022020167,55,59:57:00,0.0,22,22,3,0,0,1.0
2022020168,16,61:31:00,0.0,33,32,0,0,1,0.96969697
2022020168,26,61:31:00,0.0,19,17,1,1,2,0.894736842
2022020169,20,57:54:00,0.0,31,28,6,0,3,0.903225806
2022020169,18,60:00:00,0.0,30,29,5,0,1,0.966666667
2022020170,22,58:22:00,0.0,43,39,3,0,4,0.906976744
2022020170,1,28:41:00,0.0,18,16,2,0,2,0.888888889
2022020170,1,31:19:00,0.0,19,18,0,1,1,0.947368421
2022020171,23,60:00:00,0.0,31,26,3,1,5,0.838709677
2022020171,24,59:03:00,0.0,46,39,3,0,7,0.847826087
2022020172,53,11:18,0.0,10,7,5,0,3,0.7
2022020172,53,48:42:00,0.0,26,22,3,1,4,0.846153846
2022020172,25,59:55:00,0.0,30,28,0,2,2,0.933333333
2022020173,28,65:00:00,0.0,44,41,6,0,3,0.931818182
2022020173,13,64:06:00,0.0,39,36,2,0,3,0.923076923
2022020174,12,60:00:00,0.0,25,22,4,1,3,0.88
2022020174,7,59:25:00,0.0,32,28,9,2,4,0.875
2022020175,21,60:00:00,0.0,39,36,12,0,3,0.923076923
2022020175,29,57:23:00,0.0,35,30,7,2,5,0.857142857
2022020176,52,60:00:00,0.0,30,30,1,1,0,1.0
2022020176,16,20:00,0.0,13,12,0,0,1,0.923076923
2022020176,16,39:36:00,0.0,24,21,0,0,3,0.875
2022020177,22,59:55:00,0.0,36,30,6,3,6,0.833333333
2022020177,25,60:00:00,0.0,30,28,5,1,2,0.933333333
2022020178,15,59:29:00,0.0,26,23,5,0,3,0.884615385
2022020178,53,60:00:00,0.0,36,34,4,0,2,0.944444444
2022020179,10,40:00:00,0.0,14,13,1,0,1,0.928571429
2022020179,10,18:54,0.0,7,7,0,1,0,1.0
2022020179,6,58:43:00,0.0,28,26,2,1,2,0.928571429
2022020180,14,60:00:00,0.0,24,21,4,0,3,0.875
2022020180,7,59:37:00,0.0,29,25,2,1,4,0.862068966
2022020181,17,60:00:00,0.0,24,24,3,2,0,1.0
2022020181,2,8:13,0.0,2,1,0,0,1,0.5
2022020181,2,48:56:00,0.0,24,22,5,0,2,0.916666667
2022020182,9,57:58:00,0.0,28,26,1,4,2,0.928571429
2022020182,4,59:56:00,0.0,34,33,6,0,1,0.970588235
2022020183,5,58:26:00,0.0,28,25,3,1,3,0.892857143
2022020183,55,60:00:00,0.0,37,35,5,1,2,0.945945946
2022020184,8,58:02:00,0.0,42,36,10,0,6,0.857142857
2022020184,54,60:00:00,0.0,31,27,0,1,4,0.870967742
2022020185,29,59:51:00,0.0,45,40,1,0,5,0.888888889
2022020185,21,59:21:00,0.0,32,31,0,0,1,0.96875
2022020186,23,65:00:00,0.0,30,27,3,1,3,0.9
2022020186,18,65:00:00,0.0,45,42,9,1,3,0.933333333
2022020187,20,62:38:00,0.0,35,31,5,2,4,0.885714286
2022020187,1,62:14:00,0.0,30,27,8,1,3,0.9
2022020188,28,65:00:00,0.0,25,21,0,1,4,0.84
2022020188,24,64:18:00,0.0,52,48,8,0,4,0.923076923
2022020189,26,60:00:00,0.0,38,34,3,1,4,0.894736842
2022020189,13,58:07:00,0.0,39,34,11,2,5,0.871794872
2022020190,3,62:43:00,0.0,36,33,9,0,3,0.916666667
2022020190,17,62:20:00,0.0,29,27,1,0,2,0.931034483
2022020191,12,57:27:00,0.0,21,18,1,0,3,0.857142857
2022020191,10,60:00:00,0.0,30,29,1,0,1,0.966666667
2022020192,24,59:10:00,0.0,47,43,3,0,4,0.914893617
2022020192,13,59:51:00,0.0,35,32,3,0,3,0.914285714
2022020193,2,64:02:00,0.0,46,43,0,0,3,0.934782609
2022020193,20,64:01:00,0.0,32,28,3,0,4,0.875
2022020194,6,60:00:00,0.0,27,26,3,0,1,0.962962963
2022020194,19,56:31:00,0.0,37,34,6,1,3,0.918918919
2022020195,15,59:57:00,0.0,29,25,0,1,4,0.862068966
2022020195,22,58:57:00,0.0,31,26,1,1,5,0.838709677
2022020196,7,59:53:00,0.0,23,20,3,1,3,0.869565217
2022020196,53,60:00:00,0.0,33,32,8,1,1,0.96969697
2022020197,1,60:00:00,0.0,35,33,2,3,2,0.942857143
2022020197,20,58:23:00,0.0,20,17,4,1,3,0.85
2022020198,3,57:54:00,0.0,26,22,5,0,4,0.846153846
2022020198,2,59:22:00,0.0,40,37,6,2,3,0.925
2022020199,4,60:00:00,0.0,28,27,6,0,1,0.964285714
2022020199,19,60:00:00,0.0,35,30,1,0,5,0.857142857
2022020200,9,58:25:00,0.0,27,22,4,1,5,0.814814815
2022020200,23,60:00:00,0.0,41,37,3,3,4,0.902439024
2022020201,10,60:23:00,0.0,20,16,2,0,4,0.8
2022020201,54,60:23:00,0.0,31,28,6,0,3,0.903225806
2022020202,14,57:49:00,0.0,29,26,5,1,3,0.896551724
2022020202,22,60:00:00,0.0,37,35,6,0,2,0.945945946
2022020203,17,65:00:00,0.0,33,31,0,2,2,0.939393939
2022020203,8,65:00:00,0.0,43,41,12,3,2,0.953488372
2022020204,52,60:00:00,0.0,22,21,0,0,1,0.954545455
2022020204,25,59:14:00,0.0,32,28,0,1,4,0.875
2022020205,55,60:00:00,0.0,25,24,3,0,1,0.96
2022020205,18,41:52:00,0.0,13,13,2,0,0,1.0
2022020205,18,16:25,0.0,6,2,0,0,4,0.333333333
2022020206,26,59:43:00,0.0,21,21,4,1,0,1.0
2022020206,30,58:07:00,0.0,30,29,5,1,1,0.966666667
2022020207,13,60:00:00,0.0,40,40,10,1,0,1.0
2022020207,12,56:58:00,0.0,36,34,10,5,2,0.944444444
2022020208,15,59:47:00,0.0,27,24,2,3,3,0.888888889
2022020208,5,60:00:00,0.0,25,24,2,2,1,0.96
2022020209,8,59:43:00,0.0,33,31,5,0,2,0.939393939
2022020209,23,60:00:00,2.0,29,24,1,1,5,0.827586207
2022020210,24,60:00:00,0.0,39,35,5,0,4,0.897435897
2022020210,30,60:00:00,0.0,32,31,11,1,1,0.96875
2022020211,6,59:24:00,0.0,32,31,6,1,1,0.96875
2022020211,20,59:12:00,0.0,27,25,15,0,2,0.925925926
2022020212,12,60:00:00,0.0,22,20,3,1,2,0.909090909
2022020212,22,59:32:00,0.0,32,25,1,1,7,0.78125
2022020213,1,13:50,0.0,7,7,3,0,0,1.0
2022020213,1,50:37:00,0.0,21,18,1,0,3,0.857142857
2022020213,9,64:27:00,0.0,41,37,3,1,4,0.902439024
2022020214,29,60:00:00,0.0,34,32,0,1,2,0.941176471
2022020214,4,57:56:00,0.0,27,24,4,0,3,0.888888889
2022020215,7,58:11:00,0.0,35,29,2,0,6,0.828571429
2022020215,54,59:07:00,0.0,35,31,6,1,4,0.885714286
2022020216,2,58:53:00,0.0,27,26,2,0,1,0.962962963
2022020216,53,60:00:00,0.0,24,24,4,0,0,1.0
2022020217,17,59:45:00,0.0,33,25,4,1,8,0.757575758
2022020217,3,60:00:00,0.0,20,18,0,0,2,0.9
2022020218,19,60:00:00,0.0,30,27,0,0,3,0.9
2022020218,28,58:11:00,0.0,32,28,3,0,4,0.875
2022020219,21,60:00:00,0.0,35,32,2,0,3,0.914285714
2022020219,18,57:35:00,0.0,35,30,8,1,5,0.857142857
2022020220,26,64:58:00,0.0,32,31,9,1,1,0.96875
2022020220,16,64:58:00,0.0,35,33,6,0,2,0.942857143
2022020221,10,58:25:00,0.0,22,19,2,1,3,0.863636364
2022020221,5,60:00:00,0.0,30,28,8,1,2,0.933333333
2022020222,15,60:00:00,0.0,29,28,9,1,1,0.965517241
2022020222,14,60:00:00,0.0,24,19,4,0,5,0.791666667
2022020223,25,55:47:00,0.0,18,13,4,0,5,0.722222222
2022020223,28,60:00:00,0.0,29,25,1,0,4,0.862068966
2022020224,55,57:52:00,0.0,21,20,4,1,1,0.952380952
2022020224,30,60:00:00,0.0,28,28,0,0,0,1.0
2022020225,4,59:38:00,0.0,26,23,3,3,3,0.884615385
2022020225,9,60:00:00,0.0,38,37,5,1,1,0.973684211
2022020226,13,58:47:00,0.0,31,28,7,0,3,0.903225806
2022020226,22,59:43:00,0.0,42,40,7,1,2,0.952380952
2022020227,1,60:00:00,0.0,18,16,2,0,2,0.888888889
2022020227,53,58:11:00,0.0,26,22,5,1,4,0.846153846
2022020228,7,60:00:00,0.0,30,27,3,1,3,0.9
2022020228,6,59:54:00,0.0,31,30,3,1,1,0.967741935
2022020229,8,61:03:00,0.0,24,20,2,2,4,0.833333333
2022020229,5,60:57:00,0.0,42,37,6,1,5,0.880952381
2022020230,10,60:00:00,0.0,29,27,6,0,2,0.931034483
2022020230,23,58:05:00,0.0,34,31,2,1,3,0.911764706
2022020231,2,60:39:00,0.0,29,26,2,0,3,0.896551724
2022020231,29,60:39:00,0.0,46,42,8,3,4,0.913043478
2022020232,18,60:00:00,0.0,35,34,8,1,1,0.971428571
2022020232,3,56:59:00,0.0,18,16,2,3,2,0.888888889
2022020233,21,59:55:00,0.0,25,24,1,0,1,0.96
2022020233,12,59:34:00,0.0,27,24,10,2,3,0.888888889
2022020234,24,58:18:00,0.0,22,19,1,1,3,0.863636364
2022020234,16,60:00:00,0.0,41,39,3,1,2,0.951219512
2022020235,54,57:56:00,0.0,28,25,9,0,3,0.892857143
2022020235,19,60:00:00,0.0,36,34,0,0,2,0.944444444
2022020236,20,60:00:00,2.0,23,21,0,0,2,0.913043478
2022020236,52,58:21:00,0.0,35,32,2,2,3,0.914285714
2022020237,26,60:00:00,0.0,21,18,3,0,3,0.857142857
2022020237,17,55:56:00,0.0,21,17,1,0,4,0.80952381
2022020238,4,60:00:00,0.0,31,26,6,0,5,0.838709677
2022020238,25,60:00:00,0.0,38,37,9,1,1,0.973684211
2022020239,3,60:00:00,0.0,32,31,7,2,1,0.96875
2022020239,53,60:00:00,0.0,27,23,6,3,4,0.851851852
2022020240,30,64:40:00,0.0,37,35,5,0,2,0.945945946
2022020240,28,65:00:00,0.0,30,28,2,1,2,0.933333333
2022020241,6,60:00:00,0.0,31,29,6,3,2,0.935483871
2022020241,23,58:43:00,2.0,32,28,7,1,4,0.875
2022020242,14,60:00:00,0.0,22,19,3,0,3,0.863636364
2022020242,15,16:22,0.0,9,5,0,0,4,0.555555556
2022020242,15,43:32:00,0.0,25,24,2,3,1,0.96
2022020243,55,60:54:00,0.0,30,27,10,4,3,0.9
2022020243,52,58:55:00,0.0,21,19,3,1,2,0.904761905
2022020244,9,58:32:00,0.0,34,31,2,2,3,0.911764706
2022020244,2,60:00:00,0.0,38,36,10,1,2,0.947368421
2022020245,16,60:00:00,0.0,32,29,10,1,3,0.90625
2022020245,12,59:57:00,0.0,27,27,8,1,0,1.0
2022020246,20,59:55:00,0.0,29,24,5,0,5,0.827586207
2022020246,26,58:24:00,0.0,30,24,4,0,6,0.8
2022020247,21,58:49:00,0.0,39,36,1,2,3,0.923076923
2022020247,19,60:00:00,0.0,47,45,6,1,2,0.957446809
2022020248,14,63:43:00,0.0,32,28,4,0,4,0.875
2022020248,25,63:43:00,0.0,38,33,6,1,5,0.868421053
2022020249,8,56:10:00,0.0,38,34,7,0,4,0.894736842
2022020249,1,60:00:00,0.0,26,25,3,0,1,0.961538462
2022020250,29,30:58:00,0.0,20,18,1,0,2,0.9
2022020250,29,32:16:00,0.0,17,15,2,1,2,0.882352941
2022020250,4,63:14:00,0.0,33,28,0,0,5,0.848484848
2022020251,5,59:21:00,0.0,32,28,1,3,4,0.875
2022020251,10,60:00:00,0.0,37,35,8,0,2,0.945945946
2022020252,7,57:56:00,0.0,32,27,4,0,5,0.84375
2022020252,23,60:00:00,0.0,32,28,5,0,4,0.875
2022020253,13,60:00:00,0.0,43,41,14,0,2,0.953488372
2022020253,15,58:43:00,0.0,42,38,3,5,4,0.904761905
2022020254,18,60:00:00,0.0,33,32,8,0,1,0.96969697
2022020254,30,57:47:00,0.0,25,23,8,0,2,0.92
2022020255,24,62:51:00,0.0,33,31,3,0,2,0.939393939
2022020255,17,64:10:00,0.0,30,27,4,0,3,0.9
2022020256,54,58:35:00,0.0,27,24,0,2,3,0.888888889
2022020256,28,60:00:00,0.0,26,24,2,0,2,0.923076923
2022020257,9,60:00:00,0.0,30,29,5,4,1,0.966666667
2022020257,7,32:36:00,0.0,24,22,1,3,2,0.916666667
2022020257,7,25:33:00,0.0,15,14,5,1,1,0.933333333
2022020258,16,59:59:00,0.0,35,30,2,1,5,0.857142857
2022020258,19,60:00:00,0.0,27,25,6,1,2,0.925925926
2022020259,22,58:13:00,0.0,31,29,3,0,2,0.935483871
2022020259,26,59:50:00,0.0,23,22,0,0,1,0.956521739
2022020260,14,60:00:00,0.0,40,39,3,1,1,0.975
2022020260,20,59:05:00,0.0,23,20,2,1,3,0.869565217
2022020261,12,61:21:00,0.0,15,12,1,1,3,0.8
2022020261,21,61:55:00,0.0,48,46,9,1,2,0.958333333
2022020262,13,37:58:00,0.0,17,16,8,0,1,0.941176471
2022020262,13,20:00,0.0,11,7,0,0,4,0.636363636
2022020262,25,25:55:00,0.0,21,19,1,1,2,0.904761905
2022020262,25,34:05:00,0.0,23,21,2,2,2,0.913043478
2022020263,29,60:00:00,0.0,42,38,0,0,4,0.904761905
2022020263,8,57:33:00,0.0,28,23,0,2,5,0.821428571
2022020264,10,60:04:00,0.0,33,30,0,2,3,0.909090909
2022020264,1,60:45:00,0.0,27,25,2,1,2,0.925925926
2022020265,6,59:40:00,2.0,23,22,0,1,1,0.956521739
2022020265,4,60:00:00,0.0,32,28,7,1,4,0.875
2022020266,52,60:00:00,0.0,31,29,5,0,2,0.935483871
2022020266,24,58:49:00,0.0,32,29,3,0,3,0.90625
2022020267,18,60:00:00,0.0,33,29,3,3,4,0.878787879
2022020267,2,59:02:00,0.0,31,26,2,1,5,0.838709677
2022020268,30,59:37:00,0.0,31,26,8,1,5,0.838709677
2022020268,5,59:30:00,0.0,23,19,4,0,4,0.826086957
2022020269,19,64:56:00,0.0,51,47,6,1,4,0.921568627
2022020269,15,63:47:00,0.0,24,20,1,0,4,0.833333333
2022020270,54,59:49:00,0.0,26,25,4,2,1,0.961538462
2022020270,53,59:53:00,0.0,39,35,12,1,4,0.897435897
2022020271,55,63:39:00,0.0,30,28,5,1,2,0.933333333
2022020271,3,62:45:00,0.0,32,29,3,0,3,0.90625
2022020272,28,57:47:00,0.0,20,14,4,0,6,0.7
2022020272,17,59:58:00,0.0,25,21,1,1,4,0.84
2022020273,23,60:00:00,0.0,38,37,4,2,1,0.973684211
2022020273,26,59:56:00,0.0,25,21,1,0,4,0.84
2022020274,9,23:00,0.0,18,15,4,1,3,0.833333333
2022020274,9,34:35:00,0.0,17,16,4,1,1,0.941176471
2022020274,1,60:00:00,0.0,26,25,5,1,1,0.961538462
2022020275,13,64:38:00,0.0,35,31,6,0,4,0.885714286
2022020275,20,65:00:00,0.0,35,31,5,1,4,0.885714286
2022020276,10,59:38:00,0.0,34,32,14,0,2,0.941176471
2022020276,7,60:00:00,0.0,23,19,1,1,5,0.826086957
2022020277,6,60:00:00,0.0,18,17,1,1,1,0.944444444
2022020277,16,60:00:00,0.0,43,37,3,3,6,0.860465116
2022020278,15,59:31:00,0.0,29,25,4,1,4,0.862068966
2022020278,21,60:00:00,0.0,32,32,1,0,0,1.0
2022020279,29,60:00:00,0.0,37,31,7,0,6,0.837837838
2022020279,17,60:00:00,0.0,28,27,4,0,1,0.964285714
2022020280,8,63:05:00,0.0,29,25,3,1,4,0.862068966
2022020280,4,65:00:00,0.0,32,28,4,1,4,0.875
2022020281,52,58:39:00,0.0,31,29,1,1,2,0.935483871
2022020281,5,60:00:00,0.0,32,32,4,1,0,1.0
2022020282,19,60:00:00,0.0,32,30,6,2,2,0.9375
2022020282,24,39:36:00,0.0,29,24,3,0,5,0.827586207
2022020282,24,20:00,0.0,5,4,0,0,1,0.8
2022020283,30,61:12:00,0.0,21,20,1,0,1,0.952380952
2022020283,12,61:12:00,0.0,21,19,1,0,2,0.904761905
2022020284,25,60:00:00,0.0,29,27,5,2,2,0.931034483
2022020284,2,57:25:00,0.0,34,30,7,2,4,0.882352941
2022020285,18,62:36:00,0.0,39,36,2,4,3,0.923076923
2022020285,14,62:36:00,0.0,32,30,5,1,2,0.9375
2022020286,55,62:23:00,0.0,29,27,0,1,2,0.931034483
2022020286,26,62:23:00,0.0,29,26,2,0,3,0.896551724
2022020287,22,61:17:00,0.0,34,31,8,1,3,0.911764706
2022020287,54,60:35:00,0.0,23,19,3,1,4,0.826086957
2022020288,28,58:36:00,0.0,42,41,5,0,1,0.976190476
2022020288,3,59:38:00,0.0,23,22,3,1,1,0.956521739
2022020289,29,60:00:00,0.0,50,47,5,0,3,0.94
2022020289,13,57:59:00,0.0,23,18,1,0,5,0.782608696
2022020290,16,58:04:00,0.0,24,20,0,3,4,0.833333333
2022020290,5,60:00:00,0.0,32,29,4,0,3,0.90625
2022020291,14,57:59:00,0.0,29,24,5,0,5,0.827586207
2022020291,6,60:00:00,0.0,35,32,1,0,3,0.914285714
2022020292,4,57:46:00,0.0,28,25,2,2,3,0.892857143
2022020292,20,59:56:00,0.0,25,23,4,1,2,0.92
2022020293,1,59:53:00,0.0,30,28,7,0,2,0.933333333
2022020293,22,59:46:00,0.0,28,23,2,0,5,0.821428571
2022020294,52,62:03:00,0.0,27,24,2,2,3,0.888888889
2022020294,12,59:04:00,0.0,23,19,4,0,4,0.826086957
2022020295,10,61:40:00,0.0,24,21,1,0,3,0.875
2022020295,2,61:56:00,0.0,32,30,2,0,2,0.9375
2022020296,19,60:00:00,0.0,28,27,3,0,1,0.964285714
2022020296,24,58:36:00,0.0,26,24,2,0,2,0.923076923
2022020297,18,65:00:00,0.0,27,24,0,1,3,0.888888889
2022020297,53,65:00:00,0.0,45,42,12,0,3,0.933333333
2022020298,25,63:56:00,0.0,35,33,10,1,2,0.942857143
2022020298,21,64:44:00,0.0,24,22,6,2,2,0.916666667
2022020299,28,60:00:00,0.0,38,37,5,0,1,0.973684211
2022020299,9,32:57:00,0.0,23,22,8,0,1,0.956521739
2022020299,9,24:53:00,0.0,7,4,0,0,3,0.571428571
2022020300,23,57:56:00,0.0,38,33,1,0,5,0.868421053
2022020300,54,60:00:00,0.0,29,25,1,0,4,0.862068966
2022020301,8,60:00:00,0.0,38,31,3,3,7,0.815789474
2022020301,7,60:00:00,0.0,31,29,11,0,2,0.935483871
2022020302,26,59:03:00,0.0,24,20,0,0,4,0.833333333
2022020302,3,59:32:00,0.0,38,35,0,0,3,0.921052632
2022020303,12,56:55:00,0.0,26,23,9,0,3,0.884615385
2022020303,53,60:00:00,0.0,36,36,7,0,0,1.0
2022020304,13,59:41:00,0.0,39,37,4,1,2,0.948717949
2022020304,6,58:45:00,0.0,30,26,5,1,4,0.866666667
2022020305,5,65:00:00,0.0,34,33,4,0,1,0.970588235
2022020305,20,64:50:00,0.0,39,38,5,2,1,0.974358974
2022020306,29,57:57:00,0.0,28,26,2,0,2,0.928571429
2022020306,8,59:37:00,0.0,31,30,6,0,1,0.967741935
2022020307,7,59:34:00,0.0,36,34,3,0,2,0.944444444
2022020307,19,60:00:00,0.0,32,26,5,0,6,0.8125
2022020308,1,57:46:00,0.0,20,18,6,0,2,0.9
2022020308,10,60:00:00,0.0,35,34,10,1,1,0.971428571
2022020309,30,59:54:00,0.0,29,28,2,0,1,0.965517241
2022020309,52,60:00:00,0.0,39,33,6,0,6,0.846153846
2022020310,2,60:00:00,0.0,49,49,14,0,0,1.0
2022020310,22,59:52:00,0.0,31,28,3,1,3,0.903225806
2022020311,17,60:00:00,0.0,26,26,5,0,0,1.0
2022020311,18,58:11:00,0.0,28,26,5,2,2,0.928571429
2022020312,15,60:48:00,0.0,23,21,3,1,2,0.913043478
2022020312,4,60:50:00,0.0,32,29,8,2,3,0.90625
2022020313,25,60:00:00,0.0,31,27,5,0,4,0.870967742
2022020313,16,59:05:00,0.0,38,33,1,0,5,0.868421053
2022020314,24,60:00:00,0.0,43,41,3,2,2,0.953488372
2022020314,3,57:25:00,0.0,22,19,1,1,3,0.863636364
2022020315,54,60:00:00,0.0,40,39,2,2,1,0.975
2022020315,9,59:47:00,0.0,35,32,11,0,3,0.914285714
2022020316,55,59:29:00,0.0,26,21,3,1,5,0.807692308
2022020316,28,57:10:00,0.0,26,19,2,0,7,0.730769231
2022020317,21,58:47:00,0.0,25,21,5,2,4,0.84
2022020317,23,59:59:00,0.0,36,33,12,1,3,0.916666667
2022020318,6,16:03,0.0,6,6,0,0,0,1.0
2022020318,6,46:57:00,0.0,30,28,11,0,2,0.933333333
2022020318,12,63:19:00,0.0,41,38,10,1,3,0.926829268
2022020319,15,60:00:00,0.0,32,32,4,0,0,1.0
2022020319,20,60:00:00,0.0,25,22,2,1,3,0.88
2022020320,18,58:23:00,0.0,34,30,3,1,4,0.882352941
2022020320,21,59:56:00,0.0,21,18,0,0,3,0.857142857
2022020321,16,65:00:00,0.0,23,21,1,1,2,0.913043478
2022020321,8,65:00:00,0.0,32,30,12,0,2,0.9375
2022020322,30,56:45:00,0.0,28,24,3,2,4,0.857142857
2022020322,10,59:52:00,0.0,28,25,2,4,3,0.892857143
2022020323,24,60:00:00,0.0,33,28,8,1,5,0.848484848
2022020323,9,59:41:00,0.0,32,31,8,5,1,0.96875
2022020324,4,26:23:00,0.0,8,8,2,0,0,1.0
2022020324,4,33:37:00,0.0,21,17,2,0,4,0.80952381
2022020324,5,60:00:00,0.0,30,29,0,0,1,0.966666667
2022020325,17,65:00:00,0.0,24,21,8,1,3,0.875
2022020325,53,62:51:00,0.0,36,33,8,1,3,0.916666667
2022020326,29,58:04:00,0.0,24,21,7,0,3,0.875
2022020326,2,60:00:00,0.0,26,24,2,1,2,0.923076923
2022020327,7,56:59:00,0.0,44,41,2,2,3,0.931818182
2022020327,1,59:53:00,0.0,34,33,3,0,1,0.970588235
2022020328,14,60:00:00,0.0,27,25,3,0,2,0.925925926
2022020328,19,59:45:00,0.0,26,22,2,0,4,0.846153846
2022020329,54,58:14:00,0.0,28,24,2,0,4,0.857142857
2022020329,55,60:00:00,0.0,22,20,1,0,2,0.909090909
2022020330,25,58:33:00,0.0,28,23,2,3,5,0.821428571
2022020330,52,60:30:00,0.0,41,37,10,0,4,0.902439024
2022020331,28,58:07:00,0.0,28,24,1,2,4,0.857142857
2022020331,26,60:00:00,0.0,31,29,4,0,2,0.935483871
2022020332,3,58:47:00,0.0,32,28,0,4,4,0.875
2022020332,22,60:00:00,0.0,23,20,4,0,3,0.869565217
2022020333,12,60:00:00,0.0,20,18,3,0,2,0.9
2022020333,20,58:34:00,0.0,33,30,2,0,3,0.909090909
2022020334,13,61:08:00,0.0,37,32,3,2,5,0.864864865
2022020334,19,61:08:00,0.0,37,33,2,2,4,0.891891892
2022020335,5,60:00:00,0.0,41,37,8,1,4,0.902439024
2022020335,10,60:00:00,0.0,26,25,2,1,1,0.961538462
2022020336,1,59:57:00,0.0,38,37,7,2,1,0.973684211
2022020336,15,59:17:00,0.0,29,24,2,0,5,0.827586207
2022020337,2,60:00:00,0.0,28,26,2,1,2,0.928571429
2022020337,4,59:54:00,0.0,23,18,4,1,5,0.782608696
2022020338,18,60:00:00,0.0,40,39,12,1,1,0.975
2022020338,29,59:09:00,0.0,28,26,3,0,2,0.928571429
2022020339,21,60:00:00,0.0,42,41,15,1,1,0.976190476
2022020339,25,60:00:00,0.0,36,32,6,2,4,0.888888889
2022020340,54,60:00:00,0.0,36,31,4,2,5,0.861111111
2022020340,23,60:00:00,0.0,27,26,7,0,1,0.962962963
2022020341,30,60:00:00,0.0,23,20,1,0,3,0.869565217
2022020341,53,58:28:00,0.0,29,25,3,0,4,0.862068966
2022020342,16,59:42:00,0.0,44,37,8,1,7,0.840909091
2022020342,52,60:00:00,0.0,25,23,3,1,2,0.92
2022020343,24,43:41:00,0.0,19,14,2,0,5,0.736842105
2022020343,24,15:27,0.0,6,6,1,0,0,1.0
2022020343,55,60:00:00,0.0,29,25,3,0,4,0.862068966
2022020344,28,61:10:00,0.0,20,16,1,0,4,0.8
2022020344,23,61:12:00,0.0,35,32,0,1,3,0.914285714
2022020345,26,60:20:00,0.0,39,36,3,0,3,0.923076923
2022020345,9,60:07:00,0.0,27,25,1,0,2,0.925925926
2022020346,3,57:52:00,0.0,37,33,9,0,4,0.891891892
2022020346,1,60:00:00,2.0,38,35,8,0,3,0.921052632
2022020347,7,62:44:00,0.0,25,19,2,0,6,0.76
2022020347,14,62:23:00,0.0,37,32,2,1,5,0.864864865
2022020348,17,28:37:00,0.0,13,9,1,0,4,0.692307692
2022020348,17,28:34:00,0.0,12,12,2,0,0,1.0
2022020348,10,60:00:00,0.0,44,42,3,0,2,0.954545455
2022020349,29,65:00:00,0.0,36,34,6,1,2,0.944444444
2022020349,54,64:59:00,0.0,28,26,0,1,2,0.928571429
2022020350,19,59:53:00,0.0,23,20,1,0,3,0.869565217
2022020350,25,59:33:00,0.0,24,23,1,0,1,0.958333333
2022020351,22,58:41:00,0.0,28,25,2,0,3,0.892857143
2022020351,13,60:22:00,0.0,40,36,6,0,4,0.9
2022020352,5,61:47:00,0.0,39,36,2,2,3,0.923076923
2022020352,12,62:20:00,0.0,32,30,0,1,2,0.9375
2022020353,4,59:46:00,0.0,24,23,6,0,1,0.958333333
2022020353,2,58:42:00,0.0,32,30,3,1,2,0.9375
2022020354,8,59:41:00,0.0,23,20,13,1,3,0.869565217
2022020354,28,60:00:00,0.0,28,28,4,0,0,1.0
2022020355,6,60:00:00,0.0,28,27,4,0,1,0.964285714
2022020355,14,58:46:00,0.0,25,23,0,1,2,0.92
2022020356,18,63:50:00,0.0,35,34,0,1,1,0.971428571
2022020356,24,63:50:00,0.0,41,39,1,0,2,0.951219512
2022020357,52,59:49:00,0.0,40,40,5,0,0,1.0
2022020357,21,60:00:00,0.0,23,18,4,0,5,0.782608696
2022020358,20,60:00:00,0.0,33,31,3,3,2,0.939393939
2022020358,13,58:44:00,0.0,23,17,3,1,6,0.739130435
2022020359,23,57:19:00,0.0,27,23,1,0,4,0.851851852
2022020359,15,59:39:00,0.0,32,31,6,0,1,0.96875
2022020360,26,24:55:00,0.0,14,9,1,0,5,0.642857143
2022020360,26,37:12:00,0.0,16,12,0,0,4,0.75
2022020360,55,62:05:00,0.0,35,27,5,0,8,0.771428571
2022020361,17,65:00:00,0.0,34,30,4,5,4,0.882352941
2022020361,7,65:00:00,0.0,45,41,14,1,4,0.911111111
2022020362,9,57:41:00,0.0,36,33,5,1,3,0.916666667
2022020362,3,59:57:00,0.0,35,34,5,0,1,0.971428571
2022020363,10,59:19:00,0.0,24,23,0,2,1,0.958333333
2022020363,28,57:57:00,0.0,31,29,6,0,2,0.935483871
2022020364,16,59:08:00,0.0,41,36,13,1,5,0.87804878
2022020364,22,60:00:00,0.0,25,21,5,1,4,0.84
2022020365,7,59:34:00,0.0,33,28,14,0,5,0.848484848
2022020365,21,60:00:00,0.0,28,24,7,0,4,0.857142857
2022020366,1,60:33:00,0.0,24,20,1,0,4,0.833333333
2022020366,18,60:24:00,0.0,28,25,2,1,3,0.892857143
2022020367,4,60:00:00,0.0,27,23,3,0,4,0.851851852
2022020367,14,60:00:00,0.0,22,21,4,0,1,0.954545455
2022020368,5,60:00:00,0.0,37,34,7,2,3,0.918918919
2022020368,54,58:09:00,2.0,47,43,5,2,4,0.914893617
2022020369,19,58:44:00,0.0,34,30,2,0,4,0.882352941
2022020369,12,39:56:00,0.0,15,12,1,1,3,0.8
2022020369,12,20:00,0.0,11,10,0,0,1,0.909090909
2022020370,30,60:00:00,0.0,21,18,3,0,3,0.857142857
2022020370,22,60:00:00,0.0,30,25,2,1,5,0.833333333
2022020371,25,60:00:00,0.0,31,31,9,2,0,1.0
2022020371,24,59:39:00,0.0,41,36,4,1,5,0.87804878
2022020372,20,58:54:00,0.0,19,17,1,0,2,0.894736842
2022020372,8,60:00:00,0.0,46,45,12,1,1,0.97826087
2022020373,23,40:11:00,0.0,14,12,1,1,2,0.857142857
2022020373,23,18:56,0.0,18,15,2,0,3,0.833333333
2022020373,13,60:00:00,0.0,33,32,3,0,1,0.96969697
2022020374,55,60:07:00,0.0,23,21,7,0,2,0.913043478
2022020374,15,60:07:00,2.0,25,22,0,0,3,0.88
2022020375,26,60:00:00,0.0,21,18,6,3,3,0.857142857
2022020375,53,59:31:00,0.0,31,27,7,2,4,0.870967742
2022020376,3,64:42:00,0.0,37,34,5,3,3,0.918918919
2022020376,9,63:54:00,0.0,27,25,4,1,2,0.925925926
2022020377,2,59:14:00,0.0,21,19,4,0,2,0.904761905
2022020377,18,60:00:00,0.0,49,48,8,1,1,0.979591837
2022020378,52,54:33:00,0.0,26,22,0,5,4,0.846153846
2022020378,29,60:00:00,0.0,38,37,9,1,1,0.973684211
2022020379,30,65:00:00,0.0,33,29,3,0,4,0.878787879
2022020379,24,64:09:00,4.0,49,45,2,1,4,0.918367347
2022020380,6,59:55:00,0.0,25,24,1,1,1,0.96
2022020380,21,60:00:00,0.0,40,35,3,2,5,0.875
2022020381,22,60:00:00,0.0,33,30,2,1,3,0.909090909
2022020381,8,57:16:00,0.0,22,17,3,1,5,0.772727273
2022020382,4,57:52:00,0.0,18,15,2,0,3,0.833333333
2022020382,1,59:56:00,0.0,33,31,1,4,2,0.939393939
2022020383,9,59:45:00,0.0,37,35,12,1,2,0.945945946
2022020383,28,60:00:00,0.0,39,34,7,1,5,0.871794872
2022020384,5,59:34:00,0.0,28,26,6,2,2,0.928571429
2022020384,19,37:08:00,0.0,20,19,3,0,1,0.95
2022020384,19,21:51,10.0,17,13,5,0,4,0.764705882
2022020385,14,60:12:00,0.0,39,36,11,1,3,0.923076923
2022020385,10,60:33:00,0.0,33,29,5,2,4,0.878787879
2022020386,17,59:17:00,0.0,24,21,1,1,3,0.875
2022020386,54,60:00:00,0.0,25,24,5,0,1,0.96
2022020387,3,57:35:00,0.0,20,16,2,1,4,0.8
2022020387,16,40:00:00,2.0,22,21,4,0,1,0.954545455
2022020387,16,20:00,0.0,6,5,0,0,1,0.833333333
2022020388,23,64:03:00,0.0,23,21,1,2,2,0.913043478
2022020388,53,63:44:00,0.0,32,29,8,0,3,0.90625
2022020389,55,60:00:00,0.0,28,23,4,0,5,0.821428571
2022020389,13,60:00:00,0.0,36,35,2,1,1,0.972222222
2022020390,20,60:00:00,0.0,29,27,4,1,2,0.931034483
2022020390,15,36:09:00,0.0,26,24,3,1,2,0.923076923
2022020390,15,22:50,0.0,9,7,0,0,2,0.777777778
2022020391,26,57:37:00,0.0,31,27,1,0,4,0.870967742
2022020391,12,59:51:00,0.0,33,31,2,0,2,0.939393939
2022020392,52,60:00:00,0.0,30,28,7,1,2,0.933333333
2022020392,24,59:20:00,0.0,40,35,6,3,5,0.875
2022020393,25,39:50:00,0.0,16,12,0,1,4,0.75
2022020393,25,24:53:00,0.0,15,14,3,0,1,0.933333333
2022020393,30,65:00:00,0.0,35,30,8,1,5,0.857142857
2022020394,29,56:42:00,0.0,35,31,8,2,4,0.885714286
2022020394,17,60:00:00,0.0,34,32,8,4,2,0.941176471
2022020395,7,59:48:00,0.0,29,26,2,0,3,0.896551724
2022020395,28,58:57:00,0.0,37,32,4,0,5,0.864864865
2022020396,2,59:33:00,0.0,21,21,1,1,0,1.0
2022020396,16,60:00:00,0.0,40,37,6,0,3,0.925
2022020397,4,60:00:00,0.0,32,29,3,0,3,0.90625
2022020397,21,57:43:00,0.0,33,29,4,2,4,0.878787879
2022020398,3,60:00:00,0.0,29,25,0,0,4,0.862068966
2022020398,19,56:47:00,0.0,24,18,0,2,6,0.75
2022020399,6,64:25:00,0.0,24,21,5,0,3,0.875
2022020399,54,64:57:00,0.0,43,40,10,0,3,0.930232558
2022020400,22,58:26:00,0.0,50,47,16,1,3,0.94
2022020400,15,59:45:00,0.0,30,28,1,1,2,0.933333333
2022020401,20,60:00:00,0.0,20,18,2,0,2,0.9
2022020401,53,58:07:00,0.0,27,24,3,0,3,0.888888889
2022020402,23,16:17,0.0,9,5,1,0,4,0.555555556
2022020402,23,43:15:00,0.0,17,15,0,0,2,0.882352941
2022020402,8,60:13:00,0.0,32,25,0,0,7,0.78125
2022020403,1,59:58:00,0.0,24,24,5,1,0,1.0
2022020403,16,59:43:00,0.0,29,26,1,0,3,0.896551724
2022020404,5,59:47:00,0.0,39,38,5,4,1,0.974358974
2022020404,29,57:06:00,0.0,34,30,7,0,4,0.882352941
2022020405,14,58:16:00,0.0,24,22,0,2,2,0.916666667
2022020405,17,60:00:00,0.0,46,44,2,0,2,0.956521739
2022020406,9,25:24:00,0.0,14,14,2,0,0,1.0
2022020406,9,32:34:00,0.0,14,9,0,0,5,0.642857143
2022020406,26,59:58:00,0.0,33,31,7,1,2,0.939393939
2022020407,2,59:03:00,0.0,26,21,2,0,5,0.807692308
2022020407,19,60:00:00,0.0,40,36,2,1,4,0.9
2022020408,52,60:00:00,0.0,41,39,6,2,2,0.951219512
2022020408,13,21:43,0.0,15,12,6,0,3,0.8
2022020408,13,38:13:00,0.0,15,14,0,1,1,0.933333333
2022020409,25,58:23:00,0.0,28,25,7,2,3,0.892857143
2022020409,10,60:00:00,0.0,44,44,17,2,0,1.0
2022020410,24,61:56:00,0.0,37,34,3,2,3,0.918918919
2022020410,12,61:56:00,0.0,30,26,6,0,4,0.866666667
2022020411,55,57:36:00,0.0,16,12,2,0,4,0.75
2022020411,8,60:00:00,0.0,33,31,4,1,2,0.939393939
2022020412,29,27:28:00,0.0,9,6,2,0,3,0.666666667
2022020412,29,32:32:00,0.0,21,15,2,0,6,0.714285714
2022020412,7,60:00:00,0.0,24,20,1,2,4,0.833333333
2022020413,4,58:13:00,0.0,25,23,5,0,2,0.92
2022020413,15,59:35:00,0.0,30,29,4,0,1,0.966666667
2022020414,20,59:46:00,0.0,28,25,6,1,3,0.892857143
2022020414,30,57:57:00,0.0,26,22,7,1,4,0.846153846
2022020415,21,60:00:00,0.0,37,33,3,2,4,0.891891892
2022020415,6,59:41:00,0.0,23,23,1,0,0,1.0
2022020416,22,60:00:00,0.0,18,16,1,0,2,0.888888889
2022020416,53,59:48:00,0.0,35,27,8,1,8,0.771428571
2022020417,54,60:00:00,0.0,37,32,10,0,5,0.864864865
2022020417,3,59:14:00,0.0,26,25,8,0,1,0.961538462
2022020418,28,24:25:00,0.0,8,6,0,0,2,0.75
2022020418,28,40:00:00,0.0,19,15,3,0,4,0.789473684
2022020418,23,64:19:00,0.0,39,34,2,0,5,0.871794872
2022020419,13,60:00:00,0.0,20,19,7,0,1,0.95
2022020419,17,60:00:00,0.0,41,36,10,2,5,0.87804878
2022020420,10,59:58:00,0.0,29,29,8,0,0,1.0
2022020420,26,60:00:00,0.0,41,36,6,1,5,0.87804878
2022020421,14,60:00:00,0.0,36,34,0,0,2,0.944444444
2022020421,18,57:46:00,0.0,33,28,1,2,5,0.848484848
2022020422,19,58:41:00,0.0,19,15,2,0,4,0.789473684
2022020422,52,59:45:00,0.0,31,29,4,0,2,0.935483871
2022020423,25,64:31:00,0.0,31,28,6,0,3,0.903225806
2022020423,9,64:31:00,0.0,32,28,7,0,4,0.875
2022020424,29,20:00,0.0,12,12,3,0,0,1.0
2022020424,29,40:00:00,0.0,20,19,5,4,1,0.95
2022020424,20,55:02:00,0.0,26,24,7,0,2,0.923076923
2022020425,1,28:22:00,0.0,15,13,8,0,2,0.866666667
2022020425,1,24:02:00,0.0,17,13,3,0,4,0.764705882
2022020425,2,60:00:00,0.0,29,25,4,0,4,0.862068966
2022020426,7,61:29:00,0.0,33,29,10,0,4,0.878787879
2022020426,5,61:27:00,0.0,31,28,2,0,3,0.903225806
2022020427,15,60:00:00,0.0,26,25,4,2,1,0.961538462
2022020427,55,58:44:00,0.0,36,34,3,0,2,0.944444444
2022020428,16,58:07:00,0.0,32,29,4,0,3,0.90625
2022020428,52,60:00:00,0.0,23,22,4,2,1,0.956521739
2022020429,22,60:00:00,0.0,44,42,15,1,2,0.954545455
2022020429,30,57:40:00,0.0,37,33,2,1,4,0.891891892
2022020430,21,65:00:00,0.0,29,28,0,0,1,0.965517241
2022020430,3,65:00:00,0.0,42,41,2,0,1,0.976190476
2022020431,53,60:00:00,0.0,46,43,9,2,3,0.934782609
2022020431,6,59:19:00,0.0,16,12,3,1,4,0.75
2022020432,54,63:21:00,0.0,28,27,0,0,1,0.964285714
2022020432,4,63:21:00,0.0,34,32,2,0,2,0.941176471
2022020433,24,40:00:00,0.0,19,15,5,0,4,0.789473684
2022020433,24,18:01,0.0,8,7,1,0,1,0.875
2022020433,28,59:55:00,0.0,24,23,2,2,1,0.958333333
2022020434,18,59:28:00,0.0,33,30,6,0,3,0.909090909
2022020434,9,60:00:00,0.0,29,27,7,4,2,0.931034483
2022020435,25,64:29:00,0.0,26,24,3,1,2,0.923076923
2022020435,17,64:29:00,0.0,33,30,4,0,3,0.909090909
2022020436,14,59:54:00,0.0,25,24,3,0,1,0.96
2022020436,13,59:33:00,0.0,38,34,10,0,4,0.894736842
2022020437,5,59:44:00,0.0,38,37,5,0,1,0.973684211
2022020437,7,58:23:00,0.0,31,28,4,1,3,0.903225806
2022020438,10,60:43:00,0.0,26,22,3,1,4,0.846153846
2022020438,20,60:43:00,2.0,34,29,8,0,5,0.852941176
2022020439,8,58:50:00,0.0,34,31,7,0,3,0.911764706
2022020439,26,59:59:00,0.0,22,20,8,1,2,0.909090909
2022020440,2,60:00:00,0.0,29,26,4,2,3,0.896551724
2022020440,12,60:00:00,0.0,16,16,1,0,0,1.0
2022020441,23,59:33:00,0.0,33,30,3,1,3,0.909090909
2022020441,30,60:00:00,0.0,35,35,8,1,0,1.0
2022020442,19,60:29:00,0.0,31,28,4,2,3,0.903225806
2022020442,21,59:19:00,0.0,32,30,2,2,2,0.9375
2022020443,29,60:24:00,0.0,38,33,1,1,5,0.868421053
2022020443,26,60:38:00,0.0,26,20,2,0,6,0.769230769
2022020444,13,59:40:00,0.0,31,27,8,2,4,0.870967742
2022020444,55,60:00:00,0.0,25,23,10,0,2,0.92
2022020445,53,64:35:00,0.0,41,37,1,0,4,0.902439024
2022020445,4,64:25:00,0.0,29,24,2,0,5,0.827586207
2022020446,52,58:21:00,0.0,35,31,5,2,4,0.885714286
2022020446,15,60:00:00,0.0,31,29,6,0,2,0.935483871
2022020447,54,57:33:00,0.0,27,24,3,0,3,0.888888889
2022020447,6,60:00:00,0.0,31,30,5,0,1,0.967741935
2022020448,8,65:00:00,0.0,35,34,7,2,1,0.971428571
2022020448,20,64:42:00,0.0,38,37,14,1,1,0.973684211
2022020449,5,59:55:00,0.0,27,26,3,3,1,0.962962963
2022020449,25,59:32:00,0.0,25,23,2,0,2,0.92
2022020450,3,62:15:00,0.0,29,26,1,0,3,0.896551724
2022020450,1,61:44:00,0.0,23,19,4,1,4,0.826086957
2022020451,9,60:00:00,0.0,32,32,7,2,0,1.0
2022020451,24,60:00:00,0.0,38,35,2,2,3,0.921052632
2022020452,30,59:43:00,0.0,21,20,6,0,1,0.952380952
2022020452,22,59:08:00,0.0,30,28,5,0,2,0.933333333
2022020453,19,62:06:00,0.0,25,25,5,0,0,1.0
2022020453,18,62:23:00,0.0,24,23,3,3,1,0.958333333
2022020454,10,60:00:00,0.0,28,28,2,1,0,1.0
2022020454,24,29:12:00,0.0,15,10,0,0,5,0.666666667
2022020454,24,30:48:00,0.0,27,25,10,0,2,0.925925926
2022020455,13,60:00:00,0.0,22,22,2,0,0,1.0
2022020455,29,59:18:00,0.0,25,22,6,0,3,0.88
2022020456,1,58:12:00,0.0,30,28,0,2,2,0.933333333
2022020456,25,60:00:00,0.0,36,35,3,0,1,0.972222222
2022020457,7,59:50:00,0.0,40,40,9,1,0,1.0
2022020457,26,60:00:00,0.0,31,25,6,1,6,0.806451613
2022020458,6,64:45:00,0.0,26,23,1,0,3,0.884615385
2022020458,2,65:00:00,0.0,33,30,1,2,3,0.909090909
2022020459,14,60:00:00,0.0,38,36,3,0,2,0.947368421
2022020459,55,25:41:00,0.0,10,8,0,0,2,0.8
2022020459,55,34:12:00,0.0,20,16,1,0,4,0.8
2022020460,17,57:50:00,0.0,27,26,0,1,1,0.962962963
2022020460,12,60:00:00,0.0,27,27,0,1,0,1.0
2022020461,18,59:18:00,0.0,36,31,0,3,5,0.861111111
2022020461,22,59:50:00,0.0,32,29,8,0,3,0.90625
2022020462,52,58:50:00,0.0,32,27,2,0,5,0.84375
2022020462,54,60:00:00,0.0,34,29,3,0,5,0.852941176
2022020463,16,60:00:00,0.0,30,23,1,0,7,0.766666667
2022020463,15,59:44:00,0.0,29,26,10,0,3,0.896551724
2022020464,21,60:00:00,0.0,28,26,1,1,2,0.928571429
2022020464,4,56:20:00,0.0,25,22,2,0,3,0.88
2022020465,28,59:54:00,0.0,22,20,3,0,2,0.909090909
2022020465,53,57:41:00,0.0,33,30,2,1,3,0.909090909
2022020466,9,59:55:00,0.0,25,23,3,1,2,0.92
2022020466,8,58:26:00,0.0,31,28,12,0,3,0.903225806
2022020467,30,59:35:00,0.0,17,16,3,1,1,0.941176471
2022020467,17,57:55:00,0.0,21,18,7,0,3,0.857142857
2022020468,20,63:38:00,0.0,27,24,3,2,3,0.888888889
2022020468,23,65:00:00,0.0,38,35,4,1,3,0.921052632
2022020469,8,58:47:00,0.0,30,27,2,0,3,0.9
2022020469,24,60:00:00,0.0,25,23,1,0,2,0.92
2022020470,14,59:36:00,0.0,25,24,1,0,1,0.96
2022020470,29,59:46:00,0.0,28,25,6,0,3,0.892857143
2022020471,15,57:26:00,0.0,26,24,4,1,2,0.923076923
2022020471,25,60:00:00,0.0,46,45,3,1,1,0.97826087
2022020472,6,64:43:00,0.0,30,28,3,2,2,0.933333333
2022020472,26,64:48:00,0.0,35,33,12,4,2,0.942857143
2022020473,1,57:49:00,0.0,24,22,3,1,2,0.916666667
2022020473,4,60:00:00,0.0,49,48,5,5,1,0.979591837
2022020474,13,59:06:00,0.0,38,35,3,2,3,0.921052632
2022020474,5,59:57:00,0.0,34,32,3,0,2,0.941176471
2022020475,12,60:00:00,0.0,17,15,2,0,2,0.882352941
2022020475,55,58:35:00,0.0,39,36,2,2,3,0.923076923
2022020476,3,60:00:00,0.0,23,22,4,0,1,0.956521739
2022020476,10,59:22:00,0.0,19,17,2,3,2,0.894736842
2022020477,52,63:31:00,0.0,26,25,3,1,1,0.961538462
2022020477,18,63:31:00,0.0,41,39,9,0,2,0.951219512
2022020478,16,58:36:00,0.0,24,21,0,1,3,0.875
2022020478,54,60:00:00,0.0,25,24,2,0,1,0.96
2022020479,21,57:20:00,0.0,20,17,1,1,3,0.85
2022020479,7,60:00:00,0.0,41,39,6,0,2,0.951219512
2022020480,22,65:00:00,0.0,32,29,5,1,3,0.90625
2022020480,19,64:20:00,0.0,27,24,5,1,3,0.888888889
2022020481,30,60:00:00,0.0,30,29,6,0,1,0.966666667
2022020481,16,59:41:00,0.0,21,18,2,1,3,0.857142857
2022020482,20,60:00:00,0.0,24,19,2,0,5,0.791666667
2022020482,19,60:00:00,0.0,43,41,6,0,2,0.953488372
2022020483,53,60:00:00,0.0,34,30,14,1,4,0.882352941
2022020483,2,57:36:00,0.0,29,24,8,0,5,0.827586207
2022020484,6,59:11:00,0.0,33,31,11,1,2,0.939393939
2022020484,29,57:05:00,0.0,39,35,0,2,4,0.897435897
2022020485,17,59:19:00,0.0,27,22,9,2,5,0.814814815
2022020485,9,59:04:00,0.0,32,29,11,1,3,0.90625
2022020486,22,58:17:00,0.0,17,13,1,1,4,0.764705882
2022020486,24,60:00:00,0.0,49,46,13,0,3,0.93877551
2022020487,12,62:19:00,0.0,30,26,5,0,4,0.866666667
2022020487,25,62:09:00,0.0,38,33,4,0,5,0.868421053
2022020488,1,57:58:00,0.0,28,25,1,1,3,0.892857143
2022020488,13,60:00:00,0.0,32,30,3,0,2,0.9375
2022020489,4,58:35:00,0.0,33,29,1,1,4,0.878787879
2022020489,3,60:00:00,0.0,32,29,6,1,3,0.90625
2022020490,8,59:50:00,0.0,27,22,7,4,5,0.814814815
2022020490,14,60:00:00,0.0,23,22,2,1,1,0.956521739
2022020491,15,60:00:00,0.0,36,34,3,3,2,0.944444444
2022020491,10,60:00:00,0.0,28,23,1,1,5,0.821428571
2022020492,53,58:59:00,0.0,41,38,12,1,3,0.926829268
2022020492,7,59:39:00,0.0,31,29,10,0,2,0.935483871
2022020493,21,59:28:00,0.0,26,25,3,2,1,0.961538462
2022020493,18,59:02:00,0.0,29,27,8,2,2,0.931034483
2022020494,54,58:48:00,0.0,24,21,1,0,3,0.875
2022020494,2,6:22,0.0,1,1,0,0,0,1.0
2022020494,2,53:38:00,0.0,37,35,1,1,2,0.945945946
2022020495,23,59:56:00,0.0,27,22,1,0,5,0.814814815
2022020495,52,60:00:00,0.0,23,22,0,1,1,0.956521739
2022020496,26,65:00:00,0.0,25,23,3,2,2,0.92
2022020496,28,65:00:00,0.0,41,39,7,2,2,0.951219512
2022020497,30,60:00:00,0.0,28,26,6,1,2,0.928571429
2022020497,9,58:05:00,2.0,22,19,4,1,3,0.863636364
2022020498,12,59:59:00,0.0,25,23,4,1,2,0.92
2022020498,5,57:37:00,0.0,29,26,3,0,3,0.896551724
2022020499,16,60:00:00,0.0,26,19,0,0,7,0.730769231
2022020499,3,60:00:00,0.0,30,29,2,0,1,0.966666667
2022020500,55,60:00:00,0.0,17,15,5,0,2,0.882352941
2022020500,52,59:11:00,0.0,34,31,5,1,3,0.911764706
2022020501,28,57:50:00,0.0,25,20,2,0,5,0.8
2022020501,20,60:00:00,0.0,26,24,7,2,2,0.923076923
2022020502,29,58:18:00,0.0,33,32,0,0,1,0.96969697
2022020502,25,60:00:00,0.0,28,27,1,0,1,0.964285714
2022020503,15,64:38:00,0.0,19,16,3,0,3,0.842105263
2022020503,17,64:38:00,0.0,42,38,4,0,4,0.904761905
2022020504,6,59:49:00,0.0,39,36,5,1,3,0.923076923
2022020504,13,60:00:00,0.0,26,19,3,1,7,0.730769231
2022020505,18,62:12:00,0.0,33,30,1,0,3,0.909090909
2022020505,22,62:05:00,0.0,35,31,2,0,4,0.885714286
2022020506,21,65:00:00,0.0,26,26,2,0,0,1.0
2022020506,2,65:00:00,0.0,46,46,6,0,0,1.0
2022020507,54,57:28:00,0.0,18,15,0,0,3,0.833333333
2022020507,7,60:00:00,0.0,43,41,10,1,2,0.953488372
2022020508,53,60:25:00,0.0,26,23,3,0,3,0.884615385
2022020508,8,61:03:00,0.0,39,37,5,1,2,0.948717949
2022020509,23,59:59:00,0.0,27,22,2,1,5,0.814814815
2022020509,19,59:49:00,0.0,34,33,9,2,1,0.970588235
2022020510,4,60:00:00,0.0,33,30,0,1,3,0.909090909
2022020510,29,59:10:00,0.0,38,34,0,0,4,0.894736842
2022020511,5,59:57:00,0.0,28,26,4,1,2,0.928571429
2022020511,3,58:08:00,0.0,24,21,1,0,3,0.875
2022020512,12,60:00:00,0.0,38,37,12,0,1,0.973684211
2022020512,1,20:00,0.0,7,6,3,0,1,0.857142857
2022020512,1,40:00:00,0.0,13,10,1,0,3,0.769230769
2022020513,10,59:32:00,0.0,19,18,0,0,1,0.947368421
2022020513,14,59:10:00,0.0,38,36,6,0,2,0.947368421
2022020514,52,59:20:00,0.0,36,35,1,3,1,0.972222222
2022020514,9,60:00:00,0.0,24,19,0,1,5,0.791666667
2022020515,55,60:00:00,0.0,24,22,4,5,2,0.916666667
2022020515,19,59:49:00,0.0,32,28,3,1,4,0.875
2022020516,26,60:00:00,0.0,25,24,6,0,1,0.96
2022020516,24,59:29:00,0.0,41,37,9,1,4,0.902439024
2022020517,28,58:28:00,0.0,38,32,2,1,6,0.842105263
2022020517,20,59:55:00,0.0,27,24,6,0,3,0.888888889
2022020518,13,58:22:00,0.0,32,29,1,1,3,0.90625
2022020518,1,60:00:00,0.0,36,34,3,1,2,0.944444444
2022020519,17,60:00:00,0.0,38,34,10,0,4,0.894736842
2022020519,14,59:06:00,0.0,29,24,5,1,5,0.827586207
2022020520,21,61:23:00,0.0,20,19,1,0,1,0.95
2022020520,8,61:44:00,0.0,36,34,1,0,2,0.944444444
2022020521,16,58:28:00,2.0,37,33,2,2,4,0.891891892
2022020521,18,60:00:00,0.0,39,37,5,1,2,0.948717949
2022020522,25,59:42:00,0.0,33,28,1,0,5,0.848484848
2022020522,22,59:48:00,0.0,27,24,5,0,3,0.888888889
2022020523,54,60:00:00,0.0,23,21,1,1,2,0.913043478
2022020523,53,60:00:00,0.0,34,29,9,2,5,0.852941176
2022020524,24,59:31:00,0.0,41,38,17,1,3,0.926829268
2022020524,30,60:00:00,0.0,22,21,0,1,1,0.954545455
2022020525,10,58:39:00,0.0,19,16,3,1,3,0.842105263
2022020525,4,57:50:00,0.0,34,30,4,4,4,0.882352941
2022020526,5,60:23:00,0.0,36,32,5,0,4,0.888888889
2022020526,12,60:23:00,0.0,27,24,2,2,3,0.888888889
2022020527,3,59:28:00,0.0,18,15,3,0,3,0.833333333
2022020527,2,58:43:00,0.0,33,29,12,2,4,0.878787879
2022020528,9,62:04:00,0.0,40,37,2,2,3,0.925
2022020528,15,61:48:00,0.0,25,23,9,0,2,0.92
2022020529,6,59:39:00,0.0,27,25,8,0,2,0.925925926
2022020529,52,57:45:00,0.0,39,36,4,1,3,0.923076923
2022020530,23,63:42:00,0.0,36,31,3,0,5,0.861111111
2022020530,55,65:00:00,0.0,37,32,5,0,5,0.864864865
2022020531,26,63:23:00,0.0,30,27,2,0,3,0.9
2022020531,20,63:23:00,0.0,32,28,6,0,4,0.875
2022020532,28,60:00:00,0.0,26,24,7,3,2,0.923076923
2022020532,30,58:18:00,0.0,24,20,6,0,4,0.833333333
2022020533,1,40:00:00,0.0,18,14,0,0,4,0.777777778
2022020533,1,18:38,0.0,5,5,0,0,0,1.0
2022020533,6,60:00:00,0.0,40,37,1,0,3,0.925
2022020534,9,60:00:00,0.0,24,22,3,0,2,0.916666667
2022020534,17,60:00:00,0.0,42,36,10,0,6,0.857142857
2022020535,12,59:57:00,0.0,31,26,3,2,5,0.838709677
2022020535,4,47:24:00,0.0,30,25,2,1,5,0.833333333
2022020535,4,9:54,0.0,7,6,0,0,1,0.857142857
2022020536,7,59:54:00,0.0,36,33,6,2,3,0.916666667
2022020536,14,57:30:00,0.0,34,29,2,1,5,0.852941176
2022020537,15,59:36:00,0.0,26,25,3,1,1,0.961538462
2022020537,52,58:03:00,0.0,26,23,2,1,3,0.884615385
2022020538,2,60:00:00,0.0,23,22,3,4,1,0.956521739
2022020538,13,58:45:00,0.0,42,38,8,1,4,0.904761905
2022020539,18,64:07:00,0.0,46,43,7,0,3,0.934782609
2022020539,21,64:09:00,0.0,39,37,5,0,2,0.948717949
2022020540,16,60:00:00,0.0,29,27,8,1,2,0.931034483
2022020540,29,23:24,0.0,20,16,0,0,4,0.8
2022020540,29,36:22:00,0.0,18,17,9,0,1,0.944444444
2022020541,25,59:56:00,0.0,24,22,3,2,2,0.916666667
2022020541,8,58:49:00,0.0,35,32,8,1,3,0.914285714
2022020542,22,58:01:00,0.0,29,25,5,0,4,0.862068966
2022020542,23,59:51:00,0.0,33,31,5,2,2,0.939393939
2022020543,53,65:00:00,0.0,27,26,5,2,1,0.962962963
2022020543,26,64:55:00,0.0,24,23,5,0,1,0.958333333
2022020544,24,62:24:00,0.0,45,42,9,3,3,0.933333333
2022020544,20,61:52:00,0.0,23,21,4,0,2,0.913043478
2022020545,54,64:44:00,0.0,29,25,4,0,4,0.862068966
2022020545,19,65:00:00,0.0,32,28,2,4,4,0.875
2022020546,9,65:00:00,0.0,51,49,10,0,2,0.960784314
2022020546,6,64:46:00,0.0,32,30,4,1,2,0.9375
2022020547,29,20:00,0.0,8,7,0,0,2,0.875
2022020547,29,40:00:00,0.0,27,24,0,0,3,0.888888889
2022020547,7,60:00:00,0.0,31,29,2,0,2,0.935483871
2022020548,12,60:00:00,0.0,24,24,3,0,0,1.0
2022020548,16,60:00:00,0.0,49,46,7,0,3,0.93877551
2022020549,3,58:06:00,0.0,29,26,3,1,3,0.896551724
2022020549,15,60:00:00,0.0,32,32,13,0,0,1.0
2022020550,2,59:59:00,0.0,21,20,1,0,1,0.952380952
2022020550,5,60:00:00,0.0,42,37,3,0,5,0.880952381
2022020551,18,59:23:00,0.0,33,30,4,0,3,0.909090909
2022020551,25,60:00:00,0.0,28,26,3,2,2,0.928571429
2022020552,52,59:32:00,0.0,27,24,0,0,3,0.888888889
2022020552,30,60:00:00,0.0,32,31,1,0,1,0.96875
2022020553,19,64:03:00,0.0,37,32,4,1,5,0.864864865
2022020553,10,64:03:00,0.0,34,30,6,1,4,0.882352941
2022020554,53,60:00:00,0.0,31,28,0,1,3,0.903225806
2022020554,21,58:08:00,0.0,32,27,4,0,5,0.84375
2022020555,20,58:41:00,0.0,22,20,5,0,2,0.909090909
2022020555,22,60:00:00,0.0,47,46,4,0,1,0.978723404
2022020556,23,60:00:00,0.0,26,24,1,0,2,0.923076923
2022020556,28,60:00:00,0.0,25,19,1,1,6,0.76
2022020557,26,60:00:00,0.0,25,23,5,0,2,0.92
2022020557,54,58:47:00,0.0,24,21,0,1,3,0.875
2022020558,1,57:35:00,0.0,26,24,4,0,2,0.923076923
2022020558,6,59:49:00,0.0,31,30,0,0,1,0.967741935
2022020559,14,59:53:00,0.0,26,25,7,1,1,0.961538462
2022020559,8,60:00:00,0.0,38,34,1,3,4,0.894736842
2022020560,5,62:13:00,0.0,46,41,8,1,5,0.891304348
2022020560,17,19:24,0.0,12,8,2,0,4,0.666666667
2022020560,17,42:13:00,0.0,19,19,0,0,0,1.0
2022020561,55,58:37:00,0.0,44,41,12,1,3,0.931818182
2022020561,20,59:45:00,0.0,31,29,0,0,2,0.935483871
2022020562,24,64:55:00,0.0,51,49,14,1,2,0.960784314
2022020562,54,12:26,0.0,5,3,0,0,2,0.6
2022020562,54,52:00:00,0.0,22,22,8,1,0,1.0
2022020563,7,59:39:00,0.0,31,28,4,0,3,0.903225806
2022020563,17,58:43:00,0.0,34,29,4,0,5,0.852941176
2022020564,13,60:00:00,0.0,27,25,6,0,2,0.925925926
2022020564,8,59:36:00,0.0,41,34,11,1,7,0.829268293
2022020565,14,64:51:00,0.0,46,45,7,0,1,0.97826087
2022020565,3,65:00:00,0.0,40,39,2,0,1,0.975
2022020566,15,61:14:00,0.0,45,41,2,3,4,0.911111111
2022020566,9,61:31:00,0.0,23,20,2,2,3,0.869565217
2022020567,2,60:00:00,0.0,21,20,2,1,1,0.952380952
2022020567,29,57:47:00,0.0,36,34,2,0,2,0.944444444
2022020568,19,60:00:00,0.0,22,21,2,1,1,0.954545455
2022020568,16,58:41:00,0.0,28,26,5,1,2,0.928571429
2022020569,30,59:09:00,0.0,42,39,8,1,3,0.928571429
2022020569,25,59:46:00,0.0,24,23,3,0,1,0.958333333
2022020570,52,60:00:00,0.0,22,20,3,1,2,0.909090909
2022020570,23,59:42:00,0.0,38,35,0,1,3,0.921052632
2022020571,21,64:51:00,0.0,27,23,2,2,4,0.851851852
2022020571,26,65:00:00,0.0,27,23,1,0,4,0.851851852
2022020572,53,60:00:00,0.0,32,29,3,1,3,0.90625
2022020572,10,58:51:00,0.0,21,17,3,0,4,0.80952381
2022020573,28,61:01:00,0.0,26,22,3,1,4,0.846153846
2022020573,4,60:24:00,0.0,28,25,6,1,3,0.892857143
2022020574,24,60:00:00,0.0,43,37,0,0,6,0.860465116
2022020574,18,60:00:00,0.0,27,26,2,0,1,0.962962963
2022020575,12,59:59:00,0.0,19,19,4,0,0,1.0
2022020575,13,60:00:00,0.0,34,30,5,1,4,0.882352941
2022020576,5,58:43:00,0.0,27,24,7,1,3,0.888888889
2022020576,1,60:00:00,0.0,27,25,12,2,2,0.925925926
2022020577,55,56:05:00,0.0,27,23,0,2,4,0.851851852
2022020577,55,3:55,0.0,5,2,0,0,3,0.4
2022020577,22,60:00:00,0.0,38,36,5,0,2,0.947368421
2022020578,6,63:51:00,0.0,25,21,3,3,4,0.84
2022020578,7,63:16:00,0.0,40,37,9,3,3,0.925
2022020579,54,61:30:00,0.0,37,33,1,0,4,0.891891892
2022020579,18,60:44:00,0.0,32,27,0,0,5,0.84375
2022020580,15,60:00:00,0.0,33,31,1,1,2,0.939393939
2022020580,8,60:00:00,0.0,40,31,3,0,9,0.775
2022020581,26,58:53:00,0.0,22,19,2,3,3,0.863636364
2022020581,4,59:38:00,0.0,29,27,2,1,2,0.931034483
2022020582,14,60:00:00,0.0,31,28,3,0,3,0.903225806
2022020582,53,58:24:00,0.0,35,30,0,1,5,0.857142857
2022020583,29,60:00:00,0.0,28,27,9,1,1,0.964285714
2022020583,16,58:09:00,0.0,37,34,6,0,3,0.918918919
2022020584,17,60:00:00,0.0,23,21,2,2,2,0.913043478
2022020584,9,58:39:00,0.0,25,21,5,1,4,0.84
2022020585,21,23:15,0.0,7,7,0,0,0,1.0
2022020585,21,35:24:00,0.0,24,19,2,0,5,0.791666667
2022020585,10,59:39:00,0.0,28,26,4,0,2,0.928571429
2022020586,25,60:00:00,0.0,31,29,1,0,2,0.935483871
2022020586,28,58:57:00,0.0,30,26,4,1,4,0.866666667
2022020587,20,60:00:00,0.0,24,22,3,0,2,0.916666667
2022020587,23,57:16:00,0.0,30,27,5,2,3,0.9
2022020588,22,58:46:00,0.0,17,15,3,1,2,0.882352941
2022020588,52,60:00:00,0.0,32,31,6,2,1,0.96875
2022020589,19,58:12:00,0.0,31,27,1,0,4,0.870967742
2022020589,30,59:16:00,0.0,31,29,3,0,2,0.935483871
2022020637,25,60:00:00,0.0,28,27,2,0,1,0.964285714
2022020637,13,59:20:00,0.0,33,29,0,3,4,0.878787879
2022020638,52,60:00:00,0.0,38,34,4,0,4,0.894736842
2022020638,23,34:26:00,0.0,14,11,0,1,3,0.785714286
2022020638,23,25:34:00,0.0,13,9,0,0,4,0.692307692
2022020639,15,60:00:00,0.0,38,38,4,3,0,1.0
2022020639,29,58:30:00,0.0,19,18,2,1,1,0.947368421
2022020640,16,61:04:00,0.0,47,44,5,1,3,0.936170213
2022020640,20,20:35,0.0,11,8,0,0,3,0.727272727
2022020640,20,40:29:00,0.0,14,13,0,0,1,0.928571429
2022020641,53,57:22:00,0.0,27,24,6,0,3,0.888888889
2022020641,5,59:59:00,0.0,24,23,5,4,1,0.958333333
2022020642,30,56:27:00,0.0,23,21,5,0,2,0.913043478
2022020642,19,59:44:00,0.0,35,35,6,1,0,1.0
2022020643,4,59:42:00,0.0,35,29,3,5,6,0.828571429
2022020643,10,60:00:00,0.0,36,34,3,2,2,0.944444444
2022020644,24,60:00:00,0.0,42,35,2,1,7,0.833333333
2022020644,6,60:00:00,0.0,29,28,7,1,1,0.965517241
2022020645,9,58:12:00,0.0,36,33,13,1,3,0.916666667
2022020645,18,60:00:00,0.0,38,38,14,0,0,1.0
2022020646,8,58:00:00,0.0,40,37,9,0,3,0.925
2022020646,55,60:00:00,0.0,21,21,3,1,0,1.0
2022020647,26,59:44:00,0.0,31,28,8,1,3,0.903225806
2022020647,22,34:57:00,0.0,13,11,2,0,2,0.846153846
2022020647,22,23:51,0.0,24,21,6,2,3,0.875
2022020648,14,60:00:00,0.0,24,21,2,1,3,0.875
2022020648,29,60:00:00,2.0,46,40,3,1,6,0.869565217
2022020649,3,65:00:00,0.0,32,29,1,0,3,0.90625
2022020649,30,64:32:00,0.0,43,40,7,0,3,0.930232558
2022020650,12,58:55:00,0.0,22,18,5,0,4,0.818181818
2022020650,1,60:00:00,0.0,28,25,4,3,3,0.892857143
2022020651,7,57:45:00,0.0,22,18,0,0,4,0.818181818
2022020651,55,60:00:00,0.0,35,32,6,0,3,0.914285714
2022020652,5,7:05,0.0,5,2,0,0,3,0.4
2022020652,5,52:11:00,0.0,19,18,2,2,1,0.947368421
2022020652,23,58:01:00,0.0,36,31,10,0,5,0.861111111
2022020653,2,65:00:00,0.0,26,25,1,1,1,0.961538462
2022020653,25,65:00:00,0.0,28,27,2,0,1,0.964285714
2022020654,17,59:46:00,0.0,37,32,1,0,5,0.864864865
2022020654,52,57:33:00,0.0,22,16,3,2,6,0.727272727
2022020655,19,60:28:00,0.0,31,28,2,0,3,0.903225806
2022020655,20,60:28:00,0.0,27,23,0,0,4,0.851851852
2022020656,21,58:40:00,0.0,37,33,5,1,5,0.891891892
2022020656,13,60:00:00,0.0,31,27,2,0,4,0.870967742
2022020657,53,57:37:00,0.0,33,29,2,0,4,0.878787879
2022020657,28,60:00:00,0.0,29,27,5,0,2,0.931034483
2022020658,10,60:00:00,0.0,33,32,7,2,1,0.96969697
2022020658,18,58:49:00,0.0,35,33,4,2,2,0.942857143
2022020659,4,59:53:00,0.0,29,26,0,3,3,0.896551724
2022020659,15,58:23:00,0.0,35,31,2,0,4,0.885714286
2022020660,24,40:00:00,0.0,37,31,1,1,6,0.837837838
2022020660,24,20:00,0.0,16,16,2,0,0,1.0
2022020660,22,60:00:00,0.0,23,21,4,0,2,0.913043478
2022020661,26,60:00:00,0.0,30,27,1,0,3,0.9
2022020661,28,57:42:00,0.0,37,33,2,0,4,0.891891892
2022020662,29,60:00:00,0.0,41,35,8,1,6,0.853658537
2022020662,12,60:00:00,0.0,23,21,3,1,2,0.913043478
2022020663,3,59:04:00,0.0,25,24,1,0,1,0.96
2022020663,25,60:35:00,2.0,31,29,7,0,2,0.935483871
2022020664,8,60:00:00,0.0,42,39,3,0,3,0.928571429
2022020664,18,57:50:00,0.0,35,31,0,2,4,0.885714286
2022020665,6,56:55:00,0.0,30,28,3,0,2,0.933333333
2022020665,55,60:00:00,0.0,27,27,2,2,0,1.0
2022020666,17,59:48:00,0.0,33,32,6,1,1,0.96969697
2022020666,10,59:04:00,0.0,22,19,1,1,3,0.863636364
2022020667,14,60:00:00,0.0,40,36,8,0,4,0.9
2022020667,23,57:07:00,0.0,35,30,7,0,5,0.857142857
2022020668,7,58:35:00,0.0,26,23,1,1,3,0.884615385
2022020668,52,60:00:00,0.0,41,39,8,1,2,0.951219512
2022020669,2,59:05:00,0.0,35,33,7,2,2,0.942857143
2022020669,30,60:00:00,0.0,20,19,5,1,1,0.95
2022020670,19,59:36:00,0.0,39,36,1,1,3,0.923076923
2022020670,20,60:00:00,0.0,26,25,5,2,1,0.961538462
2022020671,16,60:00:00,0.0,33,31,5,0,2,0.939393939
2022020671,21,57:55:00,0.0,30,27,7,4,3,0.9
2022020672,53,58:52:00,0.0,46,42,7,0,4,0.913043478
2022020672,9,59:45:00,0.0,29,26,3,0,3,0.896551724
2022020673,54,60:00:00,0.0,39,38,3,1,2,0.974358974
2022020673,13,58:53:00,0.0,32,29,1,1,3,0.90625
2022020674,5,60:00:00,0.0,40,36,7,1,4,0.9
2022020674,52,59:42:00,2.0,23,22,2,0,1,0.956521739
2022020675,24,60:00:00,0.0,39,33,1,0,6,0.846153846
2022020675,1,60:00:00,0.0,33,31,5,0,2,0.939393939
2022020676,28,60:00:00,0.0,41,34,7,3,7,0.829268293
2022020676,22,59:49:00,0.0,26,25,7,0,1,0.961538462
2022020677,25,57:56:00,0.0,36,30,7,2,6,0.833333333
2022020677,20,60:00:00,0.0,33,29,1,2,5,0.878787879
2022020678,17,58:26:00,0.0,25,21,0,1,4,0.84
2022020678,29,59:55:00,0.0,28,25,3,0,3,0.892857143
2022020679,2,60:00:00,0.0,23,22,2,1,1,0.956521739
2022020679,8,58:57:00,0.0,38,36,3,0,2,0.947368421
2022020680,21,60:00:00,0.0,29,29,2,0,0,1.0
2022020680,9,60:00:00,0.0,33,26,1,1,7,0.787878788
2022020681,15,58:18:00,0.0,25,22,1,1,3,0.88
2022020681,4,59:54:00,0.0,40,39,2,4,1,0.975
2022020682,12,60:00:00,0.0,35,34,8,0,1,0.971428571
2022020682,5,58:38:00,0.0,36,34,8,1,2,0.944444444
2022020683,6,60:00:00,0.0,21,18,1,0,3,0.857142857
2022020683,10,58:48:00,0.0,34,30,2,1,4,0.882352941
2022020684,13,60:00:00,0.0,38,35,9,0,3,0.921052632
2022020684,23,57:52:00,0.0,35,31,3,2,4,0.885714286
2022020685,30,59:39:00,0.0,28,27,3,0,1,0.964285714
2022020685,53,58:49:00,0.0,27,25,5,0,2,0.925925926
2022020686,18,57:32:00,0.0,33,28,4,1,5,0.848484848
2022020686,7,60:00:00,0.0,41,38,5,0,3,0.926829268
2022020687,16,47:50:00,0.0,25,21,4,0,4,0.84
2022020687,16,12:08,0.0,5,1,0,0,4,0.2
2022020687,55,59:50:00,0.0,27,22,2,0,5,0.814814815
2022020688,19,59:23:00,0.0,30,26,2,0,4,0.866666667
2022020688,14,60:00:00,0.0,25,23,4,0,2,0.92
2022020689,54,58:34:00,0.0,37,33,5,0,4,0.891891892
2022020689,22,60:00:00,0.0,30,27,1,0,3,0.9
2022020690,26,58:08:00,0.0,27,23,7,0,4,0.851851852
2022020690,1,60:00:00,0.0,37,35,4,1,2,0.945945946
2022020691,3,57:43:00,0.0,31,29,0,0,2,0.935483871
2022020691,8,60:00:00,0.0,39,38,3,1,1,0.974358974
2022020692,12,65:00:00,0.0,32,29,1,2,3,0.90625
2022020692,23,64:03:00,0.0,32,29,0,0,3,0.90625
2022020693,52,59:51:00,0.0,21,20,5,0,1,0.952380952
2022020693,53,58:52:00,0.0,24,22,1,1,2,0.916666667
2022020694,7,59:12:00,0.0,33,30,3,0,3,0.909090909
2022020694,13,60:00:00,0.0,29,28,2,2,1,0.965517241
2022020695,6,60:00:00,0.0,29,29,6,2,0,1.0
2022020695,4,32:25:00,0.0,13,11,2,2,2,0.846153846
2022020695,4,27:35:00,0.0,16,12,0,0,4,0.75
2022020696,21,59:52:00,0.0,29,26,4,0,3,0.896551724
2022020696,17,40:00:00,0.0,22,17,7,1,5,0.772727273
2022020696,17,20:00,0.0,5,4,0,0,1,0.8
2022020697,28,65:00:00,0.0,41,38,6,0,3,0.926829268
2022020697,1,64:05:00,0.0,32,29,4,0,3,0.90625
2022020698,55,59:39:00,0.0,29,27,6,1,2,0.931034483
2022020698,14,60:00:00,0.0,23,22,3,0,1,0.956521739
2022020699,54,55:21:00,0.0,35,32,4,0,3,0.914285714
2022020699,25,60:00:00,0.0,27,27,5,0,0,1.0
2022020700,5,59:25:00,0.0,29,26,4,1,3,0.896551724
2022020700,24,60:33:00,0.0,45,41,6,0,4,0.911111111
2022020701,29,56:54:00,0.0,33,30,3,2,3,0.909090909
2022020701,3,60:00:00,0.0,25,24,5,0,1,0.96
2022020702,2,63:59:00,0.0,35,31,1,0,4,0.885714286
2022020702,15,64:27:00,0.0,30,27,2,0,3,0.9
2022020703,18,60:00:00,0.0,39,38,7,3,1,0.974358974
2022020703,20,58:26:00,0.0,29,27,2,0,2,0.931034483
2022020704,19,59:55:00,0.0,33,32,2,3,1,0.96969697
2022020704,9,58:51:00,0.0,20,18,1,0,2,0.9
2022020705,4,60:00:00,0.0,27,25,3,1,2,0.925925926
2022020705,24,59:49:00,0.0,38,34,9,2,4,0.894736842
2022020706,10,21:41,0.0,8,4,0,1,4,0.5
2022020706,10,40:12:00,0.0,11,11,3,0,0,1.0
2022020706,13,61:53:00,0.0,37,32,8,0,5,0.864864865
2022020707,15,57:21:00,0.0,21,18,2,1,3,0.857142857
2022020707,30,59:47:00,0.0,36,34,2,0,2,0.944444444
2022020708,8,60:00:00,0.0,26,25,2,0,1,0.961538462
2022020708,52,59:18:00,0.0,28,24,1,0,4,0.857142857
2022020709,16,61:43:00,0.0,33,30,2,0,3,0.909090909
2022020709,7,62:24:00,0.0,26,22,0,1,4,0.846153846
2022020710,53,65:00:00,0.0,40,37,4,1,3,0.925
2022020710,17,65:00:00,0.0,23,20,3,0,3,0.869565217
2022020711,22,60:00:00,0.0,31,29,4,0,2,0.935483871
2022020711,55,60:00:00,0.0,33,29,3,1,5,0.878787879
2022020712,9,59:34:00,0.0,19,15,6,1,4,0.789473684
2022020712,5,60:25:00,0.0,40,35,10,0,5,0.875
2022020713,2,59:10:00,0.0,24,20,0,2,4,0.833333333
2022020713,6,59:55:00,0.0,26,25,6,0,1,0.961538462
2022020714,20,58:00:00,0.0,30,27,2,1,3,0.9
2022020714,21,60:00:00,0.0,35,34,2,1,1,0.971428571
2022020715,23,14:35,0.0,10,6,0,0,4,0.6
2022020715,23,42:49:00,0.0,14,14,1,3,0,1.0
2022020715,14,60:00:00,0.0,39,37,5,0,2,0.948717949
2022020716,28,60:00:00,0.0,36,33,2,1,3,0.916666667
2022020716,25,58:18:00,0.0,27,23,2,1,4,0.851851852
2022020717,29,57:04:00,0.0,33,28,6,0,5,0.848484848
2022020717,24,40:00:00,0.0,18,18,3,1,0,1.0
2022020717,24,20:00,0.0,15,12,0,0,3,0.8
2022020718,3,56:27:00,0.0,27,24,3,0,3,0.888888889
2022020718,6,59:54:00,0.0,32,31,4,0,1,0.96875
2022020719,4,57:39:00,0.0,28,25,0,0,3,0.892857143
2022020719,16,60:00:00,0.0,38,37,4,0,1,0.973684211
2022020720,8,20:00,0.0,7,6,3,0,1,0.857142857
2022020720,8,40:00:00,0.0,33,28,13,1,5,0.848484848
2022020720,13,57:39:00,0.0,25,23,7,5,2,0.92
2022020720,13,2:01,0.0,0,0,0,0,0,
2022020721,12,60:00:00,0.0,31,29,12,1,2,0.935483871
2022020721,30,58:04:00,0.0,29,24,10,2,5,0.827586207
2022020722,7,59:41:00,0.0,26,24,3,0,2,0.923076923
2022020722,2,60:12:00,0.0,45,42,5,0,3,0.933333333
2022020723,10,59:32:00,0.0,38,37,8,0,1,0.973684211
2022020723,52,59:22:00,0.0,26,23,1,1,3,0.884615385
2022020724,19,60:00:00,0.0,26,24,3,2,2,0.923076923
2022020724,18,60:00:00,0.0,33,28,3,1,5,0.848484848
2022020725,22,60:00:00,0.0,31,28,3,0,3,0.903225806
2022020725,14,58:23:00,0.0,33,29,3,0,4,0.878787879
2022020726,53,59:25:00,0.0,33,29,5,1,4,0.878787879
2022020726,15,59:55:00,0.0,26,26,1,0,0,1.0
2022020727,54,57:53:00,0.0,25,22,0,0,3,0.88
2022020727,17,60:00:00,0.0,35,33,0,0,2,0.942857143
2022020728,55,61:10:00,0.0,30,27,2,0,3,0.9
2022020728,1,59:56:00,0.0,40,36,1,0,4,0.9
2022020729,26,27:27:00,0.0,17,13,0,0,4,0.764705882
2022020729,26,32:33:00,0.0,7,7,5,0,0,1.0
2022020729,25,60:00:00,0.0,34,34,12,1,0,1.0
2022020730,5,60:00:00,0.0,45,44,10,0,1,0.977777778
2022020730,9,60:00:00,0.0,44,40,6,2,4,0.909090909
2022020731,23,60:00:00,0.0,29,25,7,0,4,0.862068966
2022020731,21,60:00:00,0.0,29,28,7,1,1,0.965517241
2022020732,7,59:51:00,0.0,37,34,2,0,3,0.918918919
2022020732,24,60:00:00,0.0,39,33,4,1,6,0.846153846
2022020733,20,59:52:00,0.0,24,21,7,0,3,0.875
2022020733,14,58:11:00,0.0,39,35,4,2,4,0.897435897
2022020734,13,60:00:00,0.0,32,29,4,1,3,0.90625
2022020734,30,58:44:00,0.0,26,22,3,0,4,0.846153846
2022020735,17,56:13:00,0.0,25,23,4,0,2,0.92
2022020735,4,60:00:00,0.0,31,30,2,0,1,0.967741935
2022020736,29,59:50:00,0.0,25,23,3,1,3,0.92
2022020736,28,58:28:00,0.0,28,24,4,0,4,0.857142857
2022020737,8,61:49:00,0.0,38,36,5,1,2,0.947368421
2022020737,10,61:55:00,0.0,31,28,7,1,3,0.903225806
2022020738,9,59:57:00,0.0,30,25,6,0,5,0.833333333
2022020738,52,59:50:00,0.0,26,25,2,4,1,0.961538462
2022020739,2,57:20:00,0.0,25,21,1,0,4,0.84
2022020739,12,59:42:00,0.0,31,29,2,2,2,0.935483871
2022020740,25,60:00:00,0.0,33,33,5,3,0,1.0
2022020740,53,59:47:00,0.0,39,35,9,1,4,0.897435897
2022020741,19,33:13:00,0.0,11,10,2,0,1,0.909090909
2022020741,19,23:59,0.0,7,3,1,0,4,0.428571429
2022020741,16,60:00:00,0.0,32,29,2,0,3,0.90625
2022020742,18,60:00:00,0.0,34,31,8,0,3,0.911764706
2022020742,26,0:39,0.0,3,1,0,0,2,0.333333333
2022020742,26,56:12:00,0.0,25,22,1,0,3,0.88
2022020743,55,65:00:00,0.0,27,26,4,0,1,0.962962963
2022020743,21,65:00:00,0.0,27,26,2,0,1,0.962962963
2022020744,23,59:14:00,0.0,28,25,0,0,3,0.892857143
2022020744,22,60:00:00,0.0,29,27,2,1,2,0.931034483
2022020745,54,60:00:00,0.0,22,20,3,0,2,0.909090909
2022020745,15,32:04:00,0.0,18,14,1,0,4,0.777777778
2022020745,15,27:24:00,0.0,9,7,0,0,2,0.777777778
2022020746,1,62:07:00,0.0,26,25,0,0,1,0.961538462
2022020746,5,61:42:00,0.0,25,23,2,0,2,0.92
2022020747,16,58:04:00,0.0,27,25,0,0,2,0.925925926
2022020747,26,60:00:00,0.0,19,18,1,0,1,0.947368421
2022020748,6,2:28,0.0,1,1,0,0,0,1.0
2022020748,6,57:25:00,0.0,17,17,0,1,0,1.0
2022020748,28,60:00:00,0.0,22,18,4,0,4,0.818181818
2022020749,4,57:47:00,0.0,29,25,5,0,4,0.862068966
2022020749,52,59:50:00,0.0,31,28,2,1,3,0.903225806
2022020750,53,60:00:00,0.0,36,35,4,0,1,0.972222222
2022020750,54,58:18:00,0.0,22,19,0,4,3,0.863636364
2022020751,3,60:00:00,0.0,35,33,3,1,2,0.942857143
2022020751,13,55:17:00,0.0,25,20,2,0,5,0.8
2022020752,10,60:00:00,0.0,33,31,1,1,2,0.939393939
2022020752,2,60:00:00,0.0,39,34,8,1,5,0.871794872
2022020753,25,60:56:00,0.0,25,22,1,0,3,0.88
2022020753,7,60:56:00,0.0,31,29,1,4,2,0.935483871
2022020754,20,62:25:00,0.0,25,22,2,0,3,0.88
2022020754,29,62:25:00,0.0,49,45,4,1,4,0.918367347
2022020755,8,58:18:00,0.0,28,25,3,2,3,0.892857143
2022020755,6,60:00:00,0.0,22,20,2,1,2,0.909090909
2022020756,5,64:06:00,0.0,39,33,4,1,6,0.846153846
2022020756,13,64:06:00,0.0,49,42,3,0,7,0.857142857
2022020757,4,61:09:00,0.0,38,34,5,0,4,0.894736842
2022020757,26,60:51:00,0.0,31,28,5,1,3,0.903225806
2022020758,14,59:40:00,0.0,35,33,5,0,2,0.942857143
2022020758,30,57:46:00,0.0,38,35,12,0,3,0.921052632
2022020759,1,63:20:00,0.0,30,28,3,0,2,0.933333333
2022020759,54,63:54:00,0.0,36,33,2,1,3,0.916666667
2022020760,17,60:25:00,0.0,30,28,2,0,2,0.933333333
2022020760,28,60:25:00,0.0,35,32,4,0,3,0.914285714
2022020761,19,57:30:00,0.0,30,26,4,2,4,0.866666667
2022020761,7,60:00:00,0.0,28,25,1,0,3,0.892857143
2022020762,18,59:52:00,0.0,33,32,4,0,1,0.96969697
2022020762,52,57:56:00,0.0,41,39,3,0,2,0.951219512
2022020763,53,59:29:00,0.0,42,38,3,1,4,0.904761905
2022020763,24,59:55:00,0.0,39,37,6,0,2,0.948717949
2022020764,21,60:00:00,0.0,39,37,4,0,2,0.948717949
2022020764,15,57:45:00,0.0,26,23,0,0,3,0.884615385
2022020765,23,60:00:00,0.0,14,12,6,3,2,0.857142857
2022020765,16,58:09:00,0.0,47,43,9,0,4,0.914893617
2022020766,9,31:55:00,0.0,22,21,1,1,1,0.954545455
2022020766,9,28:05:00,0.0,14,14,2,0,0,1.0
2022020766,2,58:29:00,0.0,38,36,3,2,2,0.947368421
2022020767,10,59:55:00,0.0,29,27,5,2,2,0.931034483
2022020767,3,60:19:00,0.0,35,32,8,0,3,0.914285714
2022020768,25,61:34:00,0.0,24,21,0,1,3,0.875
2022020768,12,20:00,0.0,6,4,0,0,2,0.666666667
2022020768,12,41:34:00,0.0,15,15,0,0,0,1.0
2022020769,22,62:29:00,0.0,27,24,3,0,3,0.888888889
2022020769,29,62:29:00,0.0,36,34,2,1,2,0.944444444
2022020770,55,60:00:00,0.0,20,19,3,0,1,0.95
2022020770,23,60:00:00,0.0,35,29,2,1,6,0.828571429
2022020771,14,60:00:00,0.0,39,37,1,1,2,0.948717949
2022020771,6,58:00:00,0.0,35,32,2,0,3,0.914285714
2022020772,8,62:36:00,0.0,42,38,2,0,4,0.904761905
2022020772,17,62:36:00,0.0,23,20,5,0,3,0.869565217
2022020773,15,65:00:00,0.0,37,35,0,0,2,0.945945946
2022020773,5,65:00:00,0.0,45,43,13,2,2,0.955555556
2022020774,52,56:42:00,0.0,36,33,3,1,3,0.916666667
2022020774,7,59:33:00,0.0,21,19,1,1,2,0.904761905
2022020775,18,60:00:00,0.0,39,35,8,0,4,0.897435897
2022020775,1,57:10:00,2.0,40,35,5,0,5,0.875
2022020776,21,58:37:00,0.0,31,27,3,0,4,0.870967742
2022020776,24,60:00:00,2.0,44,41,2,0,3,0.931818182
2022020777,20,57:02:00,0.0,28,24,1,1,4,0.857142857
2022020777,16,60:00:00,0.0,35,34,3,0,1,0.971428571
2022020778,30,62:08:00,0.0,30,28,4,0,2,0.933333333
2022020778,4,61:53:00,0.0,23,20,1,0,3,0.869565217
2022020779,53,59:35:00,0.0,33,33,9,0,0,1.0
2022020779,19,60:00:00,0.0,25,21,2,0,5,0.84
2022020780,2,59:54:00,0.0,23,23,9,2,0,1.0
2022020780,17,56:40:00,0.0,29,27,5,0,2,0.931034483
2022020781,13,58:07:00,0.0,32,29,2,0,3,0.90625
2022020781,26,59:21:00,0.0,48,45,5,0,3,0.9375
2022020782,10,60:00:00,0.0,34,28,8,2,6,0.823529412
2022020782,9,60:00:00,0.0,33,31,3,2,2,0.939393939
2022020783,12,59:25:00,0.0,29,26,4,0,3,0.896551724
2022020783,28,60:55:00,0.0,36,31,6,0,5,0.861111111
2022020784,3,59:25:00,0.0,34,33,6,2,1,0.970588235
2022020784,54,59:28:00,0.0,39,36,4,2,3,0.923076923
2022020785,25,60:20:00,0.0,29,26,4,0,3,0.896551724
2022020785,1,60:20:00,0.0,35,33,5,0,2,0.942857143
2022020786,55,59:38:00,0.0,37,33,5,2,4,0.891891892
2022020786,20,60:00:00,0.0,30,28,11,1,2,0.933333333
2022020787,23,60:00:00,0.0,26,24,1,0,2,0.923076923
2022020787,29,59:27:00,0.0,34,29,3,0,5,0.852941176
2022020788,21,60:00:00,0.0,28,26,2,1,2,0.928571429
2022020788,19,58:36:00,0.0,30,27,3,0,3,0.9
2022020789,13,59:31:00,0.0,40,38,13,0,3,0.95
2022020789,6,60:17:00,0.0,37,33,4,1,4,0.891891892
2022020790,14,60:00:00,0.0,28,26,1,2,2,0.928571429
2022020790,26,57:30:00,0.0,25,20,1,0,5,0.8
2022020791,9,60:00:00,0.0,28,28,7,1,0,1.0
2022020791,8,56:08:00,0.0,35,31,4,1,4,0.885714286
2022020792,52,13:12,0.0,3,3,0,0,0,1.0
2022020792,52,46:48:00,0.0,30,26,2,0,4,0.866666667
2022020792,4,60:00:00,0.0,40,40,7,1,0,1.0
2022020793,5,57:53:00,0.0,31,26,1,1,5,0.838709677
2022020793,28,60:00:00,0.0,41,37,2,1,4,0.902439024
2022020794,2,64:28:00,0.0,46,45,8,0,1,0.97826087
2022020794,54,64:08:00,0.0,38,36,5,1,2,0.947368421
2022020795,30,64:27:00,0.0,31,29,0,0,2,0.935483871
2022020795,7,65:00:00,0.0,35,33,8,0,2,0.942857143
2022020796,24,63:34:00,0.0,34,33,3,0,1,0.970588235
2022020796,53,63:34:00,2.0,45,43,5,1,2,0.955555556
2022020797,22,2:26,0.0,1,1,0,0,0,1.0
2022020797,22,57:34:00,0.0,28,25,3,0,3,0.892857143
2022020797,16,60:00:00,0.0,43,36,2,1,7,0.837209302
2022020798,55,60:00:00,0.0,25,24,4,0,1,0.96
2022020798,29,56:55:00,0.0,31,28,1,1,3,0.903225806
2022020799,12,59:53:00,0.0,25,24,8,0,1,0.96
2022020799,6,59:25:00,0.0,35,32,4,2,3,0.914285714
2022020800,10,59:49:00,0.0,24,23,5,1,1,0.958333333
2022020800,15,34:02:00,0.0,20,16,1,1,4,0.8
2022020800,15,25:40:00,0.0,7,6,0,0,1,0.857142857
2022020801,52,60:00:00,0.0,26,24,5,0,2,0.923076923
2022020801,19,58:48:00,0.0,38,35,8,1,3,0.921052632
2022020802,12,64:06:00,0.0,21,17,0,0,4,0.80952381
2022020802,26,64:06:00,0.0,30,25,0,0,5,0.833333333
2022020803,8,58:48:00,0.0,29,24,5,1,5,0.827586207
2022020803,9,59:49:00,0.0,32,28,8,0,4,0.875
2022020804,29,60:26:00,0.0,34,30,3,1,4,0.882352941
2022020804,15,60:26:00,0.0,34,31,1,0,3,0.911764706
2022020805,7,58:39:00,0.0,33,29,3,0,4,0.878787879
2022020805,12,60:00:00,0.0,30,29,4,0,1,0.966666667
2022020806,10,59:55:00,0.0,29,24,1,1,5,0.827586207
2022020806,6,60:00:00,0.0,35,33,0,0,2,0.942857143
2022020807,4,58:02:00,0.0,30,28,2,1,2,0.933333333
2022020807,2,60:00:00,0.0,26,25,2,1,1,0.961538462
2022020808,13,60:00:00,0.0,33,32,2,0,1,0.96969697
2022020808,14,59:54:00,0.0,49,42,6,0,7,0.857142857
2022020809,3,61:37:00,0.0,32,28,5,2,4,0.875
2022020809,20,61:20:00,10.0,33,28,6,1,5,0.848484848
2022020810,1,64:18:00,0.0,30,26,4,1,4,0.866666667
2022020810,23,64:18:00,0.0,34,29,6,0,5,0.852941176
2022020811,25,65:00:00,0.0,34,32,7,2,2,0.941176471
2022020811,24,64:54:00,0.0,41,39,8,1,2,0.951219512
2022020812,53,60:00:00,0.0,35,33,5,0,2,0.942857143
2022020812,30,58:47:00,0.0,36,33,7,1,3,0.916666667
2022020813,5,63:36:00,0.0,42,41,7,0,1,0.976190476
2022020813,21,63:27:00,0.0,38,36,0,1,2,0.947368421
2022020814,14,62:02:00,0.0,22,18,0,2,4,0.818181818
2022020814,28,62:19:00,0.0,37,34,3,0,3,0.918918919
2022020815,17,59:08:00,0.0,26,22,4,3,4,0.846153846
2022020815,22,59:46:00,0.0,32,30,7,1,2,0.9375
2022020816,2,60:00:00,0.0,32,32,4,0,0,1.0
2022020816,55,60:00:00,0.0,28,24,2,0,4,0.857142857
2022020817,18,57:41:00,0.0,29,25,4,0,4,0.862068966
2022020817,54,60:00:00,0.0,17,16,3,0,1,0.941176471
2022020818,16,62:15:00,0.0,26,23,2,1,3,0.884615385
2022020818,24,62:15:00,0.0,29,27,5,0,2,0.931034483
2022020819,3,60:00:00,0.0,25,22,0,0,3,0.88
2022020819,23,58:42:00,0.0,21,17,3,0,4,0.80952381
2022020820,25,60:00:00,0.0,39,38,1,2,1,0.974358974
2022020820,30,57:12:00,0.0,36,33,4,1,3,0.916666667
2022020821,14,60:00:00,0.0,30,30,5,2,0,1.0
2022020821,21,59:44:00,0.0,32,27,8,0,5,0.84375
2022020822,4,65:00:00,0.0,35,34,0,2,1,0.971428571
2022020822,22,65:00:00,0.0,36,35,2,0,1,0.972222222
2022020823,13,60:00:00,0.0,34,33,6,1,1,0.970588235
2022020823,28,58:57:00,0.0,40,38,1,1,2,0.95
2022020824,1,59:46:00,0.0,34,33,5,2,1,0.970588235
2022020824,55,59:26:00,0.0,26,24,1,0,2,0.923076923
2022020825,17,60:00:00,0.0,36,35,4,3,1,0.972222222
2022020825,20,58:50:00,0.0,17,15,7,2,2,0.882352941
2022020826,2,57:03:00,0.0,34,28,5,1,6,0.823529412
2022020826,23,59:38:00,0.0,29,24,6,0,5,0.827586207
2022020827,30,39:59:00,0.0,23,18,0,0,5,0.782608696
2022020827,30,20:00,0.0,8,8,0,0,0,1.0
2022020827,54,18:41,0.0,4,4,0,0,0,1.0
2022020827,54,41:19:00,0.0,24,23,2,0,1,0.958333333
2022020828,3,60:00:00,0.0,29,26,4,1,3,0.896551724
2022020828,55,57:54:00,0.0,27,22,6,2,5,0.814814815
2022020829,29,60:00:00,0.0,41,38,8,3,3,0.926829268
2022020829,10,60:00:00,0.0,30,30,3,2,0,1.0
2022020830,16,63:30:00,0.0,26,23,1,0,3,0.884615385
2022020830,53,63:37:00,0.0,44,40,4,1,4,0.909090909
2022020831,24,60:00:00,0.0,59,53,9,0,6,0.898305085
2022020831,5,60:00:00,0.0,31,28,2,3,3,0.903225806
2022020832,17,59:00:00,0.0,34,32,5,1,2,0.941176471
2022020832,23,60:00:00,0.0,25,20,4,0,5,0.8
2022020833,7,59:45:00,0.0,40,33,3,2,7,0.825
2022020833,20,60:00:00,0.0,23,21,5,5,2,0.913043478
2022020834,9,54:37:00,0.0,37,31,8,1,6,0.837837838
2022020834,9,5:23,0.0,3,3,3,0,0,1.0
2022020834,22,59:43:00,0.0,29,26,3,1,3,0.896551724
2022020835,8,64:38:00,0.0,30,27,2,0,3,0.9
2022020835,2,64:07:00,0.0,31,27,4,0,4,0.870967742
2022020836,4,60:34:00,0.0,25,23,0,0,2,0.92
2022020836,18,60:11:00,0.0,24,23,0,0,1,0.958333333
2022020837,25,59:43:00,0.0,30,28,0,2,2,0.933333333
2022020837,14,59:57:00,0.0,29,28,5,1,1,0.965517241
2022020838,6,58:05:00,0.0,23,21,1,1,2,0.913043478
2022020838,15,60:00:00,0.0,28,27,4,1,1,0.964285714
2022020839,13,57:59:00,0.0,49,45,8,1,4,0.918367347
2022020839,21,60:00:00,0.0,45,42,11,0,3,0.933333333
2022020840,10,56:56:00,0.0,40,36,11,1,4,0.9
2022020840,29,60:00:00,0.0,29,26,2,2,3,0.896551724
2022020841,12,59:26:00,0.0,18,13,1,0,5,0.722222222
2022020841,3,59:50:00,0.0,29,27,4,0,2,0.931034483
2022020842,19,61:02:00,0.0,28,23,3,2,5,0.821428571
2022020842,53,60:24:00,0.0,37,31,11,1,6,0.837837838
2022020843,30,65:00:00,0.0,29,27,3,2,2,0.931034483
2022020843,1,65:00:00,0.0,24,22,1,0,2,0.916666667
2022020844,52,60:00:00,0.0,32,31,7,0,1,0.96875
2022020844,16,56:37:00,0.0,27,24,5,0,3,0.888888889
2022020845,26,60:00:00,0.0,25,25,8,1,0,1.0
2022020845,5,21:58,0.0,15,12,0,0,3,0.8
2022020845,5,37:52:00,0.0,16,13,4,0,3,0.8125
2022020846,8,60:00:00,0.0,31,29,11,0,2,0.935483871
2022020846,22,59:16:00,0.0,30,24,6,3,6,0.8
2022020847,15,58:37:00,0.0,32,29,2,2,3,0.90625
2022020847,28,22:56,0.0,8,8,0,1,0,1.0
2022020847,28,37:04:00,0.0,13,12,2,1,1,0.923076923
2022020848,4,58:24:00,0.0,21,17,1,0,4,0.80952381
2022020848,55,60:00:00,0.0,18,15,2,0,3,0.833333333
2022020849,54,60:00:00,0.0,25,23,7,0,2,0.92
2022020849,24,59:17:00,0.0,39,32,2,0,7,0.820512821
2022020850,9,61:06:00,0.0,37,34,6,0,3,0.918918919
2022020850,20,61:31:00,0.0,25,21,3,0,4,0.84
2022020851,18,59:02:00,0.0,18,15,0,0,3,0.833333333
2022020851,53,60:00:00,0.0,31,29,7,0,2,0.935483871
2022020852,30,64:55:00,0.0,34,33,14,2,1,0.970588235
2022020852,13,64:29:00,0.0,28,27,7,2,1,0.964285714
2022020853,23,60:00:00,0.0,23,17,0,1,6,0.739130435
2022020853,17,59:32:00,0.0,30,29,6,0,1,0.966666667
2022020854,26,60:00:00,0.0,29,27,3,0,2,0.931034483
2022020854,7,59:45:00,0.0,28,23,3,2,5,0.821428571
2022020855,15,58:07:00,0.0,30,27,0,2,3,0.9
2022020855,12,60:00:00,0.0,36,34,6,0,2,0.944444444
2022020856,8,60:00:00,2.0,22,22,3,0,0,1.0
2022020856,16,60:00:00,0.0,31,27,3,0,4,0.870967742
2022020857,29,60:00:00,0.0,32,29,1,0,3,0.90625
2022020857,1,60:00:00,0.0,33,31,2,1,2,0.939393939
2022020858,2,64:54:00,0.0,34,32,8,2,2,0.941176471
2022020858,9,65:00:00,0.0,48,46,14,0,2,0.958333333
2022020859,19,59:40:00,0.0,36,34,5,0,2,0.944444444
2022020859,13,57:34:00,0.0,27,22,0,0,5,0.814814815
2022020860,52,65:00:00,0.0,29,27,5,0,2,0.931034483
2022020860,55,64:58:00,0.0,40,38,5,0,2,0.95
2022020861,25,63:30:00,0.0,37,34,2,0,3,0.918918919
2022020861,6,63:38:00,0.0,31,29,8,1,2,0.935483871
2022020862,21,65:00:00,0.0,35,32,4,0,3,0.914285714
2022020862,14,64:40:00,0.0,46,43,5,3,3,0.934782609
2022020863,28,59:27:00,0.0,27,25,4,0,2,0.925925926
2022020863,5,60:00:00,0.0,39,38,4,1,1,0.974358974
2022020864,10,59:16:00,0.0,29,27,3,1,2,0.931034483
2022020864,16,60:00:00,0.0,42,37,2,2,5,0.880952381
2022020865,53,65:00:00,0.0,47,47,12,2,0,1.0
2022020865,14,64:29:00,0.0,26,26,2,1,0,1.0
2022020866,30,57:50:00,0.0,19,16,1,0,3,0.842105263
2022020866,21,60:00:00,0.0,43,41,0,1,2,0.953488372
2022020867,22,64:46:00,0.0,23,19,1,0,4,0.826086957
2022020867,17,64:50:00,0.0,45,41,3,1,4,0.911111111
2022020868,24,60:00:00,0.0,44,37,10,2,7,0.840909091
2022020868,7,60:00:00,0.0,22,19,0,2,3,0.863636364
2022020869,23,58:44:00,0.0,27,22,1,0,5,0.814814815
2022020869,3,59:55:00,0.0,29,25,2,0,4,0.862068966
2022020870,15,57:46:00,0.0,34,30,6,1,4,0.882352941
2022020870,13,60:00:00,0.0,32,29,0,0,3,0.90625
2022020871,12,59:48:00,0.0,22,20,3,0,2,0.909090909
2022020871,8,60:00:00,0.0,41,35,3,3,6,0.853658537
2022020872,29,60:00:00,0.0,38,37,12,2,1,0.973684211
2022020872,52,57:53:00,0.0,23,21,7,1,2,0.913043478
2022020873,18,60:00:00,0.0,30,25,5,5,5,0.833333333
2022020873,6,60:00:00,0.0,28,28,4,1,0,1.0
2022020874,19,60:00:00,0.0,36,34,2,0,2,0.944444444
2022020874,1,58:58:00,0.0,35,31,4,0,4,0.885714286
2022020875,20,60:00:00,0.0,24,19,3,0,5,0.791666667
2022020875,17,59:56:00,0.0,35,33,5,1,2,0.942857143
2022020876,55,59:42:00,0.0,19,17,0,0,2,0.894736842
2022020876,4,28:34:00,0.0,11,9,0,0,2,0.818181818
2022020876,4,31:26:00,0.0,19,15,6,1,4,0.789473684
2022020877,54,60:00:00,0.0,26,25,2,1,1,0.961538462
2022020877,28,59:32:00,0.0,38,36,16,0,2,0.947368421
2022020878,9,62:40:00,0.0,32,28,4,0,4,0.875
2022020878,16,62:52:00,0.0,31,28,3,2,3,0.903225806
2022020879,2,59:56:00,0.0,44,40,1,0,4,0.909090909
2022020879,5,58:47:00,0.0,28,23,2,0,5,0.821428571
2022020880,30,64:56:00,0.0,30,29,8,1,1,0.966666667
2022020880,25,64:54:00,0.0,32,31,4,0,1,0.96875
2022020881,22,64:54:00,0.0,38,34,5,0,4,0.894736842
2022020881,3,65:00:00,0.0,29,25,6,0,4,0.862068966
2022020882,24,58:38:00,2.0,40,35,5,2,5,0.875
2022020882,26,39:17:00,17.0,17,16,0,2,1,0.941176471
2022020882,26,20:24,0.0,10,8,1,0,2,0.8
2022020883,19,59:34:00,0.0,33,29,7,0,4,0.878787879
2022020883,21,59:38:00,0.0,20,19,3,1,1,0.95
2022020884,18,60:00:00,0.0,33,30,3,2,3,0.909090909
2022020884,13,30:43:00,0.0,14,12,1,0,2,0.857142857
2022020884,13,27:40:00,0.0,11,7,1,0,4,0.636363636
2022020885,6,60:00:00,0.0,28,26,0,0,2,0.928571429
2022020885,2,60:00:00,0.0,27,21,4,0,6,0.777777778
2022020886,5,59:21:00,0.0,42,38,1,3,4,0.904761905
2022020886,1,60:00:00,0.0,31,29,3,1,2,0.935483871
2022020887,25,59:25:00,0.0,36,33,1,2,3,0.916666667
2022020887,29,59:25:00,0.0,29,28,1,0,1,0.965517241
2022020888,10,59:35:00,0.0,30,29,2,0,1,0.966666667
2022020888,8,60:00:00,0.0,41,36,4,0,5,0.87804878
2022020889,12,60:00:00,0.0,25,24,0,1,1,0.96
2022020889,15,60:00:00,0.0,35,31,6,1,4,0.885714286
2022020890,20,61:26:00,0.0,20,18,1,1,2,0.9
2022020890,3,61:28:00,0.0,32,29,2,2,3,0.90625
2022020891,23,60:00:00,0.0,37,35,4,1,2,0.945945946
2022020891,4,57:47:00,0.0,21,17,0,0,4,0.80952381
2022020892,26,64:32:00,0.0,32,27,6,0,5,0.84375
2022020892,53,48:45:00,0.0,23,23,5,0,0,1.0
2022020892,53,15:48,0.0,14,9,1,0,5,0.642857143
2022020893,28,57:44:00,0.0,30,27,0,0,3,0.9
2022020893,7,60:00:00,0.0,35,33,3,2,2,0.942857143
2022020894,55,60:00:00,0.0,23,21,1,0,2,0.913043478
2022020894,17,57:28:00,0.0,26,22,1,0,4,0.846153846
2022020895,54,60:00:00,0.0,24,20,3,1,4,0.833333333
2022020895,14,59:38:00,0.0,25,21,3,0,4,0.84
2022020896,30,60:00:00,0.0,26,23,5,0,3,0.884615385
2022020896,18,58:57:00,0.0,35,31,7,2,4,0.885714286
2022020897,9,60:00:00,0.0,32,30,7,2,2,0.9375
2022020897,19,59:31:00,0.0,34,27,6,4,7,0.794117647
2022020898,21,64:38:00,0.0,40,35,1,2,5,0.875
2022020898,22,64:09:00,0.0,42,36,9,0,6,0.857142857
2022020899,16,60:00:00,0.0,35,32,2,0,3,0.914285714
2022020899,10,58:22:00,0.0,27,23,2,0,4,0.851851852
2022020900,1,59:57:00,0.0,25,23,2,1,2,0.92
2022020900,52,59:34:00,0.0,28,25,1,0,3,0.892857143
2022020901,53,62:00:00,0.0,36,34,8,0,2,0.944444444
2022020901,29,62:00:00,0.0,25,22,0,1,3,0.88
2022020902,13,61:42:00,0.0,32,29,5,1,3,0.90625
2022020902,24,61:42:00,0.0,55,51,4,0,4,0.927272727
2022020903,6,59:45:00,0.0,31,30,1,2,1,0.967741935
2022020903,9,57:12:00,0.0,32,29,9,0,3,0.90625
2022020904,20,58:20:00,0.0,22,18,3,0,4,0.818181818
2022020904,4,60:00:00,0.0,35,32,5,1,3,0.914285714
2022020905,28,59:46:00,0.0,26,26,1,2,0,1.0
2022020905,55,60:00:00,0.0,23,20,2,0,4,0.869565217
2022020906,5,58:28:00,0.0,31,28,4,1,3,0.903225806
2022020906,2,60:00:00,0.0,46,44,4,1,2,0.956521739
2022020907,3,59:48:00,0.0,21,17,1,0,4,0.80952381
2022020907,52,60:00:00,0.0,51,50,10,0,1,0.980392157
2022020908,14,60:00:00,0.0,25,24,5,1,1,0.96
2022020908,24,59:43:00,0.0,44,38,8,2,6,0.863636364
2022020909,15,57:09:00,0.0,25,22,4,3,3,0.88
2022020909,17,60:00:00,0.0,27,26,3,0,1,0.962962963
2022020910,1,59:50:00,0.0,17,13,2,1,4,0.764705882
2022020910,8,60:00:00,0.0,40,38,7,1,2,0.95
2022020911,12,60:00:00,0.0,36,35,5,0,1,0.972222222
2022020911,19,58:16:00,0.0,36,32,0,0,4,0.888888889
2022020912,7,12:09,0.0,10,6,0,0,4,0.6
2022020912,7,46:29:00,0.0,18,17,3,0,1,0.944444444
2022020912,10,60:00:00,0.0,32,29,0,0,3,0.90625
2022020913,30,59:23:00,0.0,34,33,0,1,1,0.970588235
2022020913,26,57:41:00,0.0,20,18,4,1,2,0.9
2022020914,18,64:39:00,0.0,39,35,7,0,4,0.897435897
2022020914,23,61:17:00,0.0,26,22,4,0,4,0.846153846
2022020915,16,63:43:00,0.0,36,34,1,0,2,0.944444444
2022020915,54,65:00:00,0.0,39,37,4,1,2,0.948717949
2022020916,22,59:38:00,0.0,26,24,5,2,2,0.923076923
2022020916,4,57:11:00,0.0,26,23,4,0,3,0.884615385
2022020917,2,60:00:00,0.0,26,25,5,1,1,0.961538462
2022020917,52,57:52:00,0.0,22,20,4,0,2,0.909090909
2022020918,25,57:42:00,0.0,23,19,0,1,4,0.826086957
2022020918,16,60:00:00,0.0,32,29,2,0,3,0.90625
2022020919,53,60:00:00,0.0,51,45,6,1,6,0.882352941
2022020919,20,59:31:00,0.0,14,12,1,0,3,0.857142857
2022020920,15,57:57:00,0.0,20,17,4,0,3,0.85
2022020920,24,60:00:00,0.0,43,41,7,1,2,0.953488372
2022020921,14,61:41:00,0.0,23,17,2,0,6,0.739130435
2022020921,7,61:41:00,0.0,41,36,7,0,5,0.87804878
2022020922,5,20:00,0.0,15,14,0,2,1,0.933333333
2022020922,5,39:50:00,0.0,29,23,2,1,6,0.793103448
2022020922,22,60:00:00,0.0,24,22,3,0,2,0.916666667
2022020923,1,61:54:00,0.0,22,19,2,0,3,0.863636364
2022020923,26,62:30:00,0.0,32,28,4,1,4,0.875
2022020924,29,57:01:00,0.0,25,23,0,0,2,0.92
2022020924,30,60:00:00,0.0,30,30,3,1,0,1.0
2022020925,17,60:00:00,0.0,31,30,5,2,1,0.967741935
2022020925,3,60:00:00,0.0,23,19,3,1,4,0.826086957
2022020926,19,64:45:00,0.0,41,38,6,0,3,0.926829268
2022020926,23,63:20:00,0.0,22,20,5,2,2,0.909090909
2022020927,55,58:32:00,0.0,33,27,1,0,6,0.818181818
2022020927,6,60:00:00,0.0,41,36,5,0,5,0.87804878
2022020928,54,60:42:00,0.0,28,25,8,1,3,0.892857143
2022020928,20,59:46:00,0.0,29,25,2,1,4,0.862068966
2022020929,28,59:23:00,0.0,31,25,2,3,6,0.806451613
2022020929,18,60:00:00,0.0,24,22,3,1,2,0.916666667
2022020930,13,56:59:00,0.0,33,30,5,0,3,0.909090909
2022020930,7,60:00:00,0.0,50,49,6,1,1,0.98
2022020931,10,61:03:00,0.0,25,24,3,1,1,0.96
2022020931,30,60:44:00,0.0,24,22,3,0,2,0.916666667
2022020932,4,60:00:00,0.0,31,26,5,0,5,0.838709677
2022020932,8,60:00:00,0.0,26,24,0,0,2,0.923076923
2022020933,12,60:00:00,0.0,32,32,9,0,0,1.0
2022020933,9,59:01:00,0.0,29,26,0,2,3,0.896551724
2022020934,2,58:38:00,0.0,28,26,2,0,3,0.928571429
2022020934,26,60:00:00,0.0,18,16,2,0,2,0.888888889
2022020935,52,20:00,0.0,10,10,2,2,0,1.0
2022020935,52,40:00:00,0.0,26,21,3,1,5,0.807692308
2022020935,21,60:00:00,0.0,27,26,2,0,1,0.962962963
2022020936,29,59:33:00,0.0,47,42,5,0,5,0.893617021
2022020936,22,25:56:00,0.0,14,10,3,0,4,0.714285714
2022020936,22,32:12:00,0.0,12,10,2,0,2,0.833333333
2022020937,15,60:00:00,0.0,26,23,2,1,3,0.884615385
2022020937,3,40:00:00,0.0,22,17,2,0,5,0.772727273
2022020937,3,19:57,0.0,5,4,0,0,1,0.8
2022020938,12,58:16:00,0.0,16,13,3,0,3,0.8125
2022020938,24,60:00:00,0.0,53,51,8,1,2,0.962264151
2022020939,23,59:27:00,0.0,34,32,6,1,2,0.941176471
2022020939,6,60:00:00,0.0,27,26,4,0,1,0.962962963
2022020940,8,59:48:00,0.0,22,17,0,1,5,0.772727273
2022020940,9,60:00:00,0.0,32,30,4,1,2,0.9375
2022020941,1,60:00:00,0.0,23,23,1,0,0,1.0
2022020941,4,60:00:00,0.0,36,29,2,0,7,0.805555556
2022020942,17,58:56:00,0.0,17,15,0,3,2,0.882352941
2022020942,14,59:54:00,0.0,45,45,6,2,0,1.0
2022020943,19,61:16:00,0.0,48,45,6,1,3,0.9375
2022020943,5,61:16:00,0.0,27,25,4,1,2,0.925925926
2022020944,21,60:00:00,0.0,29,28,2,2,1,0.965517241
2022020944,20,59:38:00,0.0,22,18,0,0,4,0.818181818
2022020945,54,65:00:00,0.0,43,41,8,0,2,0.953488372
2022020945,25,63:23:00,0.0,43,41,9,1,2,0.953488372
2022020946,28,64:51:00,0.0,35,32,7,1,3,0.914285714
2022020946,16,65:00:00,0.0,48,45,2,1,3,0.9375
2022020947,7,60:00:00,0.0,30,26,1,2,4,0.866666667
2022020947,15,30:07:00,0.0,19,14,0,0,5,0.736842105
2022020947,15,29:53:00,0.0,18,16,4,0,2,0.888888889
2022020948,30,64:40:00,0.0,24,22,1,0,2,0.916666667
2022020948,29,64:40:00,0.0,44,41,4,2,3,0.931818182
2022020949,52,57:09:00,0.0,23,20,1,0,3,0.869565217
2022020949,2,60:00:00,0.0,23,23,5,0,0,1.0
2022020950,3,60:00:00,0.0,28,26,4,0,2,0.928571429
2022020950,26,36:23:00,0.0,14,12,2,0,2,0.857142857
2022020950,26,23:37,0.0,7,4,0,0,3,0.571428571
2022020951,5,60:00:00,0.0,29,26,2,0,3,0.896551724
2022020951,14,60:00:00,0.0,36,29,2,1,7,0.805555556
2022020952,53,60:00:00,0.0,34,28,4,0,6,0.823529412
2022020952,18,60:00:00,0.0,27,25,3,0,2,0.925925926
2022020953,55,35:32:00,0.0,12,11,0,0,1,0.916666667
2022020953,55,24:13:00,0.0,21,17,5,0,4,0.80952381
2022020953,10,60:00:00,0.0,27,26,6,0,1,0.962962963
2022020954,22,59:48:00,0.0,28,25,8,0,3,0.892857143
2022020954,6,59:44:00,0.0,24,22,0,1,2,0.916666667
2022020955,25,60:48:00,0.0,21,16,4,1,5,0.761904762
2022020955,23,60:48:00,0.0,38,34,12,1,4,0.894736842
2022020956,21,60:00:00,0.0,31,31,1,0,0,1.0
2022020956,54,59:43:00,0.0,33,31,2,0,2,0.939393939
2022020957,24,59:50:00,0.0,26,24,3,0,2,0.923076923
2022020957,16,58:34:00,0.0,33,29,8,2,4,0.878787879
2022020958,7,59:41:00,0.0,35,31,3,0,4,0.885714286
2022020958,29,60:00:00,0.0,41,38,6,1,3,0.926829268
2022020959,9,60:00:00,0.0,17,16,5,0,1,0.941176471
2022020959,17,60:00:00,0.0,27,21,6,2,6,0.777777778
2022020960,14,56:29:00,0.0,40,37,6,1,3,0.925
2022020960,13,60:00:00,2.0,29,28,5,0,1,0.965517241
2022020961,52,63:57:00,0.0,37,32,6,2,5,0.864864865
2022020961,26,65:00:00,0.0,31,26,3,0,5,0.838709677
2022020962,30,65:00:00,0.0,40,39,0,1,1,0.975
2022020962,2,65:00:00,0.0,31,30,3,0,1,0.967741935
2022020963,18,58:37:00,0.0,33,31,4,0,2,0.939393939
2022020963,5,59:46:00,0.0,25,24,5,1,1,0.96
2022020964,19,58:04:00,0.0,25,21,4,1,4,0.84
2022020964,55,60:00:00,0.0,25,22,4,0,3,0.88
2022020965,20,43:29:00,0.0,15,13,2,2,2,0.866666667
2022020965,20,20:00,0.0,5,3,1,0,2,0.6
2022020965,6,64:23:00,0.0,57,54,7,3,3,0.947368421
2022020966,53,60:00:00,0.0,24,23,3,0,1,0.958333333
2022020966,16,60:00:00,0.0,33,29,2,0,4,0.878787879
2022020967,28,57:38:00,0.0,31,29,4,0,2,0.935483871
2022020967,8,59:50:00,0.0,39,38,5,0,1,0.974358974
2022020968,4,62:32:00,0.0,25,22,0,3,3,0.88
2022020968,3,62:32:00,0.0,28,26,0,0,2,0.928571429
2022020969,22,60:00:00,0.0,28,26,3,2,2,0.928571429
2022020969,10,60:00:00,0.0,32,27,3,0,5,0.84375
2022020970,25,59:36:00,0.0,20,18,3,2,2,0.9
2022020970,53,57:26:00,0.0,41,37,8,1,4,0.902439024
2022020971,21,57:42:00,0.0,28,22,1,1,6,0.785714286
2022020971,1,18:34,0.0,12,12,1,0,0,1.0
2022020971,1,41:26:00,0.0,19,14,0,0,5,0.736842105
2022020972,54,60:00:00,0.0,26,24,0,0,2,0.923076923
2022020972,12,57:58:00,0.0,20,17,0,0,3,0.85
2022020973,24,61:09:00,0.0,39,36,6,3,3,0.923076923
2022020973,15,61:09:00,0.0,23,21,2,0,2,0.913043478
2022020974,6,60:00:00,0.0,27,26,5,0,1,0.962962963
2022020974,7,58:58:00,2.0,40,35,8,1,5,0.875
2022020975,13,58:18:00,0.0,23,21,0,0,2,0.913043478
2022020975,18,60:00:00,0.0,31,30,0,0,1,0.967741935
2022020976,3,57:38:00,0.0,33,29,4,1,4,0.878787879
2022020976,9,60:00:00,0.0,32,29,11,0,3,0.90625
2022020977,14,62:13:00,0.0,32,27,9,1,5,0.84375
2022020977,5,62:13:00,0.0,31,27,5,2,4,0.870967742
2022020978,17,63:12:00,0.0,37,32,6,1,5,0.864864865
2022020978,55,22:59,0.0,12,9,0,0,3,0.75
2022020978,55,40:23:00,0.0,17,16,4,1,1,0.941176471
2022020979,16,58:15:00,0.0,34,31,4,0,3,0.911764706
2022020979,25,60:00:00,0.0,21,19,3,0,2,0.904761905
2022020980,20,59:08:00,0.0,34,32,4,2,2,0.941176471
2022020980,10,60:00:00,0.0,26,25,1,2,1,0.961538462
2022020981,23,58:15:00,0.0,36,34,8,1,2,0.944444444
2022020981,30,59:14:00,0.0,22,21,4,2,1,0.954545455
2022020982,26,59:19:00,0.0,21,19,5,0,2,0.904761905
2022020982,8,58:29:00,0.0,33,30,7,0,3,0.909090909
2022020983,28,59:09:00,0.0,22,17,1,0,5,0.772727273
2022020983,19,60:00:00,0.0,25,22,4,1,3,0.88
2022020984,29,59:08:00,0.0,34,31,5,0,3,0.911764706
2022020984,55,60:00:00,0.0,23,21,6,0,2,0.913043478
2022020985,22,59:42:00,0.0,28,25,2,5,3,0.892857143
2022020985,52,20:00,0.0,9,7,4,0,2,0.777777778
2022020985,52,40:00:00,0.0,24,20,6,2,4,0.833333333
2022020986,53,59:07:00,0.0,42,36,7,2,6,0.857142857
2022020986,12,59:56:00,0.0,18,17,4,1,1,0.944444444
2022020987,24,60:00:00,0.0,28,26,3,0,2,0.928571429
2022020987,8,57:28:00,0.0,33,30,3,1,3,0.909090909
2022020988,54,65:00:00,0.0,50,47,1,1,3,0.94
2022020988,1,64:48:00,0.0,27,24,4,1,3,0.888888889
2022020989,2,59:58:00,0.0,23,22,2,1,1,0.956521739
2022020989,17,59:23:00,0.0,36,32,3,0,4,0.888888889
2022020990,7,60:00:00,0.0,38,34,7,0,4,0.894736842
2022020990,4,60:00:00,0.0,28,28,0,2,0,1.0
2022020991,6,59:55:00,0.0,26,24,3,2,2,0.923076923
2022020991,3,58:41:00,0.0,24,20,5,2,4,0.833333333
2022020992,13,60:00:00,0.0,32,31,4,2,1,0.96875
2022020992,5,59:46:00,0.0,42,38,12,1,4,0.904761905
2022020993,28,60:00:00,0.0,30,22,4,0,8,0.733333333
2022020993,15,60:00:00,0.0,41,38,10,1,3,0.926829268
2022020994,9,59:47:00,0.0,21,19,3,0,2,0.904761905
2022020994,29,36:56:00,0.0,16,15,1,1,1,0.9375
2022020994,29,23:04,0.0,23,19,1,0,4,0.826086957
2022020995,52,60:00:00,0.0,35,30,2,0,5,0.857142857
2022020995,22,58:39:00,0.0,38,32,5,0,6,0.842105263
2022020996,23,60:00:00,0.0,37,36,7,0,1,0.972972973
2022020996,10,58:54:00,0.0,24,20,2,0,4,0.833333333
2022020997,25,59:56:00,0.0,35,32,4,4,3,0.914285714
2022020997,21,27:57:00,0.0,9,8,1,0,1,0.888888889
2022020997,21,31:39:00,0.0,19,14,2,0,5,0.736842105
2022020998,16,58:28:00,0.0,24,22,2,0,2,0.916666667
2022020998,18,59:09:00,0.0,28,27,5,2,1,0.964285714
2022020999,20,60:00:00,0.0,33,30,2,1,3,0.909090909
2022020999,30,60:00:00,0.0,31,31,3,1,0,1.0
2022021000,26,59:39:00,0.0,26,24,5,1,2,0.923076923
2022021000,19,59:49:00,0.0,37,34,3,1,3,0.918918919
2022021001,12,60:00:00,0.0,14,14,3,0,0,1.0
2022021001,14,59:29:00,0.0,38,32,8,2,6,0.842105263
2022021002,4,60:00:00,0.0,26,25,3,1,1,0.961538462
2022021002,17,59:31:00,0.0,36,34,7,0,2,0.944444444
2022021003,54,60:00:00,0.0,28,25,5,0,3,0.892857143
2022021003,8,58:38:00,0.0,28,24,1,1,4,0.857142857
2022021004,53,60:23:00,0.0,40,35,0,0,5,0.875
2022021004,1,60:23:00,0.0,29,25,3,0,4,0.862068966
2022021005,21,61:24:00,0.0,35,32,9,1,3,0.914285714
2022021005,55,60:55:00,0.0,23,21,4,1,2,0.913043478
2022021006,7,58:20:00,0.0,37,34,5,0,3,0.918918919
2022021006,22,60:00:00,0.0,39,37,5,0,2,0.948717949
2022021007,52,61:14:00,0.0,24,21,4,1,3,0.875
2022021007,28,59:43:00,0.0,38,36,7,3,2,0.947368421
2022021008,25,59:53:00,0.0,37,33,8,1,5,0.891891892
2022021008,20,59:47:00,0.0,33,29,3,2,4,0.878787879
2022021009,16,60:00:00,0.0,35,35,5,4,0,1.0
2022021009,9,59:35:00,0.0,21,16,3,1,5,0.761904762
2022021010,23,64:25:00,0.0,32,29,2,0,3,0.90625
2022021010,18,65:00:00,0.0,29,26,5,0,3,0.896551724
2022021011,26,60:00:00,0.0,22,20,4,1,2,0.909090909
2022021011,15,58:00:00,0.0,40,37,4,0,3,0.925
2022021012,8,65:00:00,0.0,39,36,1,1,3,0.923076923
2022021012,12,45:00:00,0.0,14,13,0,0,1,0.928571429
2022021012,12,20:00,0.0,10,8,0,0,2,0.8
2022021013,5,40:08:00,0.0,15,15,2,0,0,1.0
2022021013,5,22:37,0.0,12,8,3,0,4,0.666666667
2022021013,29,42:45:00,0.0,40,35,3,1,5,0.875
2022021013,29,20:00,0.0,7,7,0,1,0,1.0
2022021014,14,60:00:00,0.0,35,33,4,2,2,0.942857143
2022021014,4,59:53:00,0.0,39,34,6,2,5,0.871794872
2022021015,1,57:56:00,0.0,25,21,1,0,4,0.84
2022021015,10,59:16:00,0.0,33,30,4,0,3,0.909090909
2022021016,13,60:00:00,0.0,23,22,4,1,1,0.956521739
2022021016,54,58:02:00,0.0,34,32,1,2,2,0.941176471
2022021017,2,59:20:00,0.0,24,22,0,0,2,0.916666667
2022021017,7,57:28:00,0.0,39,36,3,1,3,0.923076923
2022021018,30,65:00:00,0.0,26,26,3,3,0,1.0
2022021018,20,65:00:00,0.0,40,40,7,4,0,1.0
2022021019,21,60:00:00,0.0,13,13,2,1,0,1.0
2022021019,28,22:45,0.0,24,19,2,0,5,0.791666667
2022021019,28,37:15:00,2.0,19,18,7,2,1,0.947368421
2022021020,53,60:00:00,0.0,42,40,8,1,2,0.952380952
2022021020,19,59:55:00,0.0,27,21,1,3,6,0.777777778
2022021021,55,60:00:00,0.0,22,20,2,0,2,0.909090909
2022021021,24,58:42:00,0.0,30,26,3,2,4,0.866666667
2022021022,17,59:47:00,0.0,20,17,3,0,3,0.85
2022021022,16,57:37:00,0.0,41,37,4,1,4,0.902439024
2022021023,52,58:54:00,0.0,22,19,0,1,3,0.863636364
2022021023,30,60:00:00,0.0,48,46,6,0,2,0.958333333
2022021024,23,60:20:00,0.0,22,20,1,0,2,0.909090909
2022021024,24,60:20:00,0.0,34,31,0,0,3,0.911764706
2022021025,7,60:00:00,2.0,49,39,5,1,10,0.795918367
2022021025,25,60:00:00,0.0,29,25,2,0,4,0.862068966
2022021026,6,58:09:00,0.0,22,19,1,2,3,0.863636364
2022021026,22,60:00:00,0.0,28,26,0,0,2,0.928571429
2022021027,5,61:48:00,0.0,28,24,8,1,4,0.857142857
2022021027,2,60:19:00,0.0,36,33,2,1,3,0.916666667
2022021028,8,65:00:00,0.0,33,30,4,2,3,0.909090909
2022021028,3,65:00:00,0.0,26,23,2,1,3,0.884615385
2022021029,15,65:00:00,0.0,40,38,5,0,2,0.95
2022021029,1,64:45:00,0.0,22,20,3,0,2,0.909090909
2022021030,12,59:45:00,0.0,19,19,0,2,0,1.0
2022021030,4,57:53:00,0.0,29,28,5,0,1,0.965517241
2022021031,14,61:15:00,0.0,21,17,3,3,4,0.80952381
2022021031,54,63:09:00,0.0,37,34,2,0,3,0.918918919
2022021032,19,60:00:00,0.0,34,32,6,0,2,0.941176471
2022021032,28,59:06:00,0.0,30,26,2,3,4,0.866666667
2022021033,21,58:43:00,0.0,30,26,2,2,4,0.866666667
2022021033,26,60:00:00,0.0,30,28,1,0,2,0.933333333
2022021034,53,59:58:00,0.0,40,39,9,1,1,0.975
2022021034,18,55:22:00,0.0,42,39,3,2,3,0.928571429
2022021035,55,58:24:00,0.0,31,26,10,1,5,0.838709677
2022021035,9,60:00:00,0.0,33,29,2,1,4,0.878787879
2022021036,13,62:25:00,0.0,24,21,3,0,3,0.875
2022021036,16,60:36:00,0.0,43,39,6,3,4,0.906976744
2022021037,20,58:29:00,0.0,17,15,0,0,2,0.882352941
2022021037,24,60:00:00,0.0,37,36,4,0,1,0.972972973
2022021038,6,60:00:00,0.0,31,29,5,1,2,0.935483871
2022021038,17,57:42:00,0.0,38,35,7,2,3,0.921052632
2022021039,5,60:00:00,0.0,32,31,10,0,1,0.96875
2022021039,4,58:36:00,0.0,31,27,9,1,4,0.870967742
2022021040,7,62:02:00,0.0,26,24,7,0,2,0.923076923
2022021040,3,61:53:00,0.0,33,32,2,0,1,0.96969697
2022021041,21,61:08:00,0.0,20,18,4,0,2,0.9
2022021041,53,61:38:00,0.0,44,41,6,0,3,0.931818182
2022021042,14,59:43:00,0.0,23,22,1,0,1,0.956521739
2022021042,16,59:20:00,0.0,36,34,1,1,2,0.944444444
2022021043,10,60:00:00,0.0,26,22,4,0,4,0.846153846
2022021043,22,58:43:00,0.0,37,31,7,0,6,0.837837838
2022021044,8,58:47:00,0.0,36,34,0,0,2,0.944444444
2022021044,1,60:00:00,0.0,24,23,0,0,1,0.958333333
2022021045,29,57:57:00,0.0,23,19,1,1,4,0.826086957
2022021045,19,59:27:00,0.0,39,37,3,2,2,0.948717949
2022021046,12,56:21:00,0.0,23,20,0,1,3,0.869565217
2022021046,54,60:00:00,0.0,33,33,1,0,0,1.0
2022021047,13,64:31:00,0.0,27,22,2,4,5,0.814814815
2022021047,52,64:09:00,0.0,48,44,9,1,4,0.916666667
2022021048,2,59:32:00,0.0,27,22,4,2,5,0.814814815
2022021048,15,59:19:00,0.0,18,18,7,0,1,1.0
2022021049,55,63:26:00,0.0,25,21,1,2,4,0.84
2022021049,25,62:30:00,0.0,31,28,2,0,3,0.903225806
2022021050,23,59:56:00,0.0,20,18,3,1,2,0.9
2022021050,9,59:30:00,0.0,29,25,8,0,4,0.862068966
2022021051,28,58:34:00,0.0,28,24,7,1,4,0.857142857
2022021051,30,59:49:00,0.0,37,35,4,0,2,0.945945946
2022021052,26,65:00:00,0.0,30,29,4,2,1,0.966666667
2022021052,18,64:51:00,0.0,27,26,2,0,1,0.962962963
2022021053,17,60:00:00,0.0,33,30,5,0,3,0.909090909
2022021053,6,58:07:00,0.0,25,21,2,0,4,0.84
2022021054,5,61:33:00,0.0,29,27,4,1,2,0.931034483
2022021054,3,61:38:00,0.0,35,32,5,0,3,0.914285714
2022021055,1,59:46:00,0.0,32,32,3,1,0,1.0
2022021055,12,60:00:00,0.0,23,20,4,1,3,0.869565217
2022021056,19,58:30:00,0.0,30,26,2,0,4,0.866666667
2022021056,54,60:00:00,0.0,33,30,1,4,3,0.909090909
2022021057,14,58:06:00,0.0,22,19,2,0,3,0.863636364
2022021057,52,59:57:00,0.0,35,33,7,0,2,0.942857143
2022021058,53,64:09:00,0.0,34,30,4,0,4,0.882352941
2022021058,30,64:09:00,0.0,23,18,0,0,5,0.782608696
2022021059,20,60:00:00,0.0,31,30,6,1,1,0.967741935
2022021059,9,60:00:00,0.0,39,34,6,3,5,0.871794872
2022021060,24,59:19:00,0.0,36,31,1,0,5,0.861111111
2022021060,18,61:12:00,0.0,37,33,1,0,4,0.891891892
2022021061,10,56:15:00,0.0,29,25,5,0,4,0.862068966
2022021061,7,60:00:00,0.0,28,25,3,0,3,0.892857143
2022021062,8,23:58,0.0,15,9,2,0,6,0.6
2022021062,8,36:00:00,0.0,18,16,1,1,2,0.888888889
2022021062,21,60:00:00,0.0,19,15,0,0,4,0.789473684
2022021063,55,60:00:00,0.0,32,27,1,2,5,0.84375
2022021063,25,60:00:00,0.0,28,26,3,0,2,0.928571429
2022021064,5,38:31:00,0.0,14,13,0,0,1,0.928571429
2022021064,5,20:00,0.0,7,3,0,0,4,0.428571429
2022021064,8,60:00:00,0.0,43,39,4,0,4,0.906976744
2022021065,1,59:55:00,0.0,30,26,3,0,4,0.866666667
2022021065,14,60:00:00,0.0,23,22,3,0,1,0.956521739
2022021066,4,58:21:00,0.0,32,28,4,0,4,0.875
2022021066,54,60:00:00,0.0,30,27,3,0,3,0.9
2022021067,3,60:00:00,0.0,31,28,2,0,3,0.903225806
2022021067,15,57:50:00,0.0,35,31,8,1,4,0.885714286
2022021068,12,60:00:00,0.0,24,21,1,0,3,0.875
2022021068,52,58:51:00,0.0,24,20,1,0,4,0.833333333
2022021069,18,60:00:00,0.0,29,28,6,0,1,0.965517241
2022021069,17,57:02:00,0.0,16,14,6,1,2,0.875
2022021070,16,31:12:00,0.0,26,23,1,1,3,0.884615385
2022021070,16,28:48:00,0.0,16,16,2,0,0,1.0
2022021070,6,59:21:00,0.0,28,23,2,0,5,0.821428571
2022021071,22,59:53:00,0.0,32,29,9,0,3,0.90625
2022021071,9,59:46:00,0.0,32,27,3,3,5,0.84375
2022021072,53,63:10:00,0.0,45,42,6,0,3,0.933333333
2022021072,20,63:10:00,0.0,25,21,0,0,4,0.84
2022021073,23,59:44:00,0.0,27,25,4,2,2,0.925925926
2022021073,25,59:19:00,0.0,19,14,1,3,5,0.736842105
2022021074,28,64:17:00,0.0,48,42,7,1,6,0.875
2022021074,29,64:17:00,0.0,32,27,5,0,5,0.84375
2022021075,26,60:00:00,0.0,28,26,2,0,2,0.928571429
2022021075,2,58:17:00,0.0,36,32,1,1,4,0.888888889
2022021076,15,64:32:00,0.0,27,23,1,0,4,0.851851852
2022021076,7,65:00:00,0.0,39,35,3,1,4,0.897435897
2022021077,10,64:19:00,0.0,29,28,4,1,1,0.965517241
2022021077,21,65:00:00,0.0,18,17,3,0,1,0.944444444
2022021078,19,27:35:00,0.0,11,8,1,1,3,0.727272727
2022021078,19,32:05:00,17.0,24,19,4,2,5,0.791666667
2022021078,30,60:00:00,2.0,36,31,2,0,5,0.861111111
2022021079,24,60:00:00,0.0,33,27,2,2,6,0.818181818
2022021079,2,59:57:00,0.0,23,20,2,0,3,0.869565217
2022021080,9,58:44:00,0.0,30,25,2,0,5,0.833333333
2022021080,21,60:00:00,0.0,36,32,9,2,4,0.888888889
2022021081,13,60:00:00,0.0,30,25,0,4,5,0.833333333
2022021081,8,21:29,0.0,18,12,4,0,6,0.666666667
2022021081,8,38:31:00,0.0,24,21,4,0,3,0.875
2022021082,3,59:57:00,0.0,32,30,0,1,2,0.9375
2022021082,5,58:42:00,0.0,34,31,2,0,3,0.911764706
2022021083,1,64:36:00,0.0,24,21,2,0,3,0.875
2022021083,14,65:00:00,0.0,35,32,7,1,3,0.914285714
2022021084,52,57:12:00,0.0,23,21,2,1,2,0.913043478
2022021084,6,60:00:00,0.0,36,36,10,1,0,1.0
2022021085,18,57:37:00,0.0,21,19,0,2,2,0.904761905
2022021085,16,60:00:00,0.0,36,35,3,1,1,0.972222222
2022021086,22,60:00:00,0.0,26,25,3,1,1,0.961538462
2022021086,25,58:37:00,0.0,29,26,3,1,3,0.896551724
2022021087,54,59:11:00,0.0,29,23,0,2,6,0.793103448
2022021087,20,60:00:00,0.0,19,17,4,0,2,0.894736842
2022021088,53,59:39:00,0.0,31,29,10,0,2,0.935483871
2022021088,23,57:57:00,0.0,27,24,0,1,3,0.888888889
2022021089,26,60:00:00,0.0,30,29,7,0,1,0.966666667
2022021089,29,26:02:00,0.0,9,9,1,0,0,1.0
2022021089,29,33:48:00,0.0,27,23,1,0,4,0.851851852
2022021090,28,61:38:00,0.0,32,30,6,1,2,0.9375
2022021090,55,61:37:00,0.0,32,31,2,1,1,0.96875
2022021091,4,60:00:00,0.0,38,36,13,0,2,0.947368421
2022021091,7,60:00:00,0.0,22,17,1,0,5,0.772727273
2022021092,10,60:00:00,0.0,34,32,2,0,2,0.941176471
2022021092,12,60:00:00,0.0,24,19,0,1,5,0.791666667
2022021093,15,58:06:00,0.0,21,17,0,0,4,0.80952381
2022021093,19,60:00:00,0.0,34,32,7,0,2,0.941176471
2022021094,24,59:49:00,0.0,42,38,6,1,4,0.904761905
2022021094,29,58:05:00,0.0,36,31,7,1,5,0.861111111
2022021095,17,45:16:00,0.0,21,16,1,1,5,0.761904762
2022021095,17,14:44,0.0,2,2,0,0,0,1.0
2022021095,21,60:00:00,0.0,34,33,9,3,1,0.970588235
2022021096,30,58:25:00,0.0,37,33,2,2,4,0.891891892
2022021096,6,60:00:00,0.0,31,29,6,1,2,0.935483871
2022021097,18,60:55:00,0.0,34,31,5,1,3,0.911764706
2022021097,52,60:55:00,0.0,20,18,3,0,2,0.9
2022021098,55,32:46:00,0.0,13,10,4,0,3,0.769230769
2022021098,55,26:30:00,0.0,10,7,0,0,3,0.7
2022021098,22,60:00:00,0.0,37,33,5,0,4,0.891891892
2022021099,4,60:26:00,0.0,34,29,1,2,5,0.852941176
2022021099,12,58:13:00,0.0,33,29,7,0,4,0.878787879
2022021100,13,60:00:00,0.0,35,33,4,0,2,0.942857143
2022021100,1,58:11:00,0.0,40,37,10,0,3,0.925
2022021101,14,60:00:00,0.0,21,18,0,2,3,0.857142857
2022021101,8,59:16:00,0.0,40,36,3,1,4,0.9
2022021102,9,63:10:00,0.0,29,25,3,2,4,0.862068966
2022021102,10,65:00:00,0.0,52,48,3,1,4,0.923076923
2022021103,3,60:00:00,2.0,33,33,4,1,0,1.0
2022021103,5,33:17:00,0.0,7,5,1,1,2,0.714285714
2022021103,5,26:43:00,0.0,17,13,3,0,4,0.764705882
2022021104,20,64:47:00,0.0,26,20,3,0,6,0.769230769
2022021104,25,64:47:00,0.0,38,33,0,4,5,0.868421053
2022021105,26,65:00:00,0.0,17,15,0,0,2,0.882352941
2022021105,23,65:00:00,0.0,40,38,3,0,2,0.95
2022021106,53,59:53:00,0.0,34,32,12,2,2,0.941176471
2022021106,16,58:01:00,0.0,20,17,3,1,3,0.85
2022021107,28,59:57:00,0.0,33,29,7,1,4,0.878787879
2022021107,2,60:00:00,0.0,30,29,2,1,1,0.966666667
2022021108,7,60:00:00,0.0,25,18,4,0,7,0.72
2022021108,6,59:29:00,0.0,26,26,4,2,0,1.0
2022021109,30,59:18:00,0.0,36,33,9,1,3,0.916666667
2022021109,15,56:23:00,0.0,40,35,5,0,5,0.875
2022021110,54,60:00:00,0.0,37,35,6,0,2,0.945945946
2022021110,29,23:03,0.0,12,10,0,1,2,0.833333333
2022021110,29,36:57:00,0.0,29,24,0,1,5,0.827586207
2022021111,3,60:00:00,0.0,22,22,5,0,0,1.0
2022021111,18,9:09,0.0,5,1,0,0,4,0.2
2022021111,18,50:51:00,0.0,29,26,3,0,3,0.896551724
2022021112,14,58:42:00,0.0,38,34,1,1,4,0.894736842
2022021112,1,59:56:00,0.0,24,22,3,0,2,0.916666667
2022021113,19,2:36,0.0,1,1,0,0,0,1.0
2022021113,19,57:10:00,0.0,33,33,5,0,0,1.0
2022021113,52,58:57:00,0.0,17,14,2,0,3,0.823529412
2022021114,24,58:07:00,0.0,40,38,7,0,2,0.95
2022021114,23,59:28:00,0.0,18,17,7,0,1,0.944444444
2022021115,5,58:17:00,0.0,21,19,2,1,2,0.904761905
2022021115,9,60:00:00,0.0,49,48,4,0,1,0.979591837
2022021116,17,59:15:00,0.0,25,20,2,1,5,0.8
2022021116,13,60:00:00,0.0,22,20,0,1,2,0.909090909
2022021117,21,60:00:00,0.0,27,27,2,0,0,1.0
2022021117,16,60:00:00,0.0,32,27,1,0,5,0.84375
2022021118,22,64:45:00,0.0,32,28,1,1,4,0.875
2022021118,28,64:45:00,0.0,52,47,9,2,5,0.903846154
2022021119,26,59:45:00,2.0,18,16,4,1,2,0.888888889
2022021119,20,40:00:00,0.0,26,20,4,0,6,0.769230769
2022021119,20,20:00,0.0,13,11,2,1,2,0.846153846
2022021120,3,58:45:00,0.0,39,36,1,0,3,0.923076923
2022021120,12,60:00:00,0.0,31,29,1,3,2,0.935483871
2022021121,15,62:43:00,0.0,39,32,0,0,7,0.820512821
2022021121,29,62:07:00,0.0,37,31,1,0,6,0.837837838
2022021122,4,60:00:00,0.0,44,41,12,1,3,0.931818182
2022021122,13,56:42:00,0.0,23,18,2,0,5,0.782608696
2022021123,1,64:58:00,0.0,29,27,1,1,2,0.931034483
2022021123,30,64:58:00,0.0,48,47,6,1,1,0.979166667
2022021124,7,23:23,0.0,6,6,1,0,0,1.0
2022021124,7,35:52:00,2.0,20,14,3,0,6,0.7
2022021124,18,59:58:00,0.0,31,28,3,1,3,0.903225806
2022021125,6,60:00:00,0.0,41,40,7,2,1,0.975609756
2022021125,9,58:31:00,0.0,35,33,8,1,2,0.942857143
2022021126,8,60:00:00,0.0,33,31,4,1,2,0.939393939
2022021126,14,59:15:00,0.0,20,17,2,0,3,0.85
2022021127,2,59:43:00,0.0,27,25,0,1,2,0.925925926
2022021127,10,59:34:00,0.0,28,22,0,0,6,0.785714286
2022021128,52,60:00:00,0.0,30,29,3,1,1,0.966666667
2022021128,53,59:31:00,0.0,25,23,8,1,2,0.92
2022021129,19,65:00:00,0.0,30,28,4,0,2,0.933333333
2022021129,17,65:00:00,0.0,22,20,2,0,2,0.909090909
2022021130,25,59:11:00,0.0,27,22,0,0,5,0.814814815
2022021130,55,61:52:00,0.0,29,25,5,2,4,0.862068966
2022021131,24,60:00:00,0.0,43,38,6,1,5,0.88372093
2022021131,20,60:00:00,0.0,20,19,2,1,1,0.95
2022021132,23,57:49:00,0.0,27,23,4,0,4,0.851851852
2022021132,54,59:44:00,0.0,34,31,0,1,3,0.911764706
2022021133,21,55:20:00,0.0,44,40,5,2,4,0.909090909
2022021133,5,59:13:00,0.0,30,28,2,0,2,0.933333333
2022021134,22,61:23:00,0.0,17,14,3,0,3,0.823529412
2022021134,53,61:31:00,0.0,31,27,8,0,4,0.870967742
2022021135,15,60:00:00,0.0,28,27,8,0,1,0.964285714
2022021135,16,60:00:00,0.0,28,22,3,2,6,0.785714286
2022021136,4,65:00:00,0.0,24,20,1,0,4,0.833333333
2022021136,30,64:19:00,0.0,34,30,0,0,4,0.882352941
2022021137,6,60:00:00,0.0,31,29,4,1,2,0.935483871
2022021137,8,57:56:00,0.0,21,17,2,1,4,0.80952381
2022021138,12,57:51:00,0.0,16,14,4,0,2,0.875
2022021138,3,59:16:00,0.0,30,29,2,0,1,0.966666667
2022021139,9,60:00:00,0.0,29,27,2,1,2,0.931034483
2022021139,14,59:43:00,0.0,34,28,4,1,6,0.823529412
2022021140,13,58:17:00,0.0,26,21,3,1,5,0.807692308
2022021140,10,60:00:00,0.0,35,33,3,2,2,0.942857143
2022021141,17,24:26:00,0.0,9,8,1,0,1,0.888888889
2022021141,17,32:36:00,0.0,13,10,0,1,3,0.769230769
2022021141,19,59:44:00,0.0,28,25,1,2,3,0.892857143
2022021142,18,65:00:00,0.0,28,27,2,2,1,0.964285714
2022021142,55,65:00:00,0.0,24,23,1,1,1,0.958333333
2022021143,25,60:00:00,0.0,42,40,5,0,2,0.952380952
2022021143,5,58:18:00,0.0,33,30,5,0,3,0.909090909
2022021144,20,57:40:00,0.0,32,29,1,0,3,0.90625
2022021144,54,6:07,0.0,5,5,0,0,0,1.0
2022021144,54,53:53:00,0.0,39,37,4,0,2,0.948717949
2022021145,23,59:48:00,0.0,19,17,2,0,2,0.894736842
2022021145,28,60:00:00,0.0,21,14,4,1,7,0.666666667
2022021146,24,57:31:00,0.0,33,30,1,0,3,0.909090909
2022021146,52,59:52:00,0.0,20,18,1,1,2,0.9
2022021147,29,60:40:00,0.0,38,34,0,1,4,0.894736842
2022021147,2,60:40:00,0.0,27,22,2,0,5,0.814814815
2022021148,7,59:51:00,0.0,31,27,3,1,4,0.870967742
2022021148,1,10:55,0.0,7,4,0,0,3,0.571428571
2022021148,1,47:41:00,0.0,19,17,2,0,2,0.894736842
2022021149,21,59:36:00,0.0,18,17,0,0,1,0.944444444
2022021149,53,58:58:00,0.0,30,27,3,3,3,0.9
2022021150,4,60:00:00,0.0,29,29,9,1,0,1.0
2022021150,17,57:13:00,0.0,21,19,2,3,2,0.904761905
2022021151,6,60:00:00,0.0,27,26,4,4,1,0.962962963
2022021151,14,59:01:00,0.0,34,32,9,1,2,0.941176471
2022021152,18,59:50:00,0.0,39,32,2,2,7,0.820512821
2022021152,55,60:00:00,0.0,16,14,1,0,2,0.875
2022021153,20,60:00:00,0.0,31,28,2,0,3,0.903225806
2022021153,28,59:09:00,0.0,29,25,2,1,4,0.862068966
2022021154,26,60:00:00,0.0,26,25,9,1,1,0.961538462
2022021154,52,59:55:00,0.0,28,25,5,2,3,0.892857143
2022021155,30,60:00:00,0.0,23,22,2,0,1,0.956521739
2022021155,16,59:47:00,0.0,24,22,2,3,2,0.916666667
2022021156,13,58:22:00,0.0,42,38,4,0,4,0.904761905
2022021156,3,59:41:00,0.0,34,31,3,2,3,0.911764706
2022021157,2,58:20:00,0.0,34,33,3,1,1,0.970588235
2022021157,7,59:10:00,0.0,26,26,3,1,0,1.0
2022021158,8,60:00:00,0.0,23,21,7,1,2,0.913043478
2022021158,29,22:58,0.0,8,6,0,0,2,0.75
2022021158,29,37:02:00,0.0,24,18,2,1,6,0.75
2022021159,1,60:00:00,0.0,28,25,0,0,3,0.892857143
2022021159,9,58:52:00,0.0,34,30,1,0,4,0.882352941
2022021160,12,60:00:00,0.0,44,41,10,2,3,0.931818182
2022021160,10,58:44:00,0.0,27,23,7,0,4,0.851851852
2022021161,25,57:43:00,0.0,24,21,5,3,3,0.875
2022021161,23,59:22:00,0.0,26,25,6,0,1,0.961538462
2022021162,5,60:00:00,0.0,34,31,2,4,3,0.911764706
2022021162,15,58:52:00,0.0,40,36,9,0,4,0.9
2022021163,22,62:26:00,0.0,34,30,0,0,4,0.882352941
2022021163,54,62:26:00,0.0,30,27,4,0,3,0.9
2022021164,24,59:33:00,0.0,36,30,0,2,6,0.833333333
2022021164,19,60:00:00,0.0,25,22,3,1,3,0.88
2022021165,53,65:00:00,0.0,32,29,5,2,3,0.90625
2022021165,21,65:00:00,0.0,30,27,5,1,3,0.9
2022021166,12,64:55:00,0.0,38,35,1,1,3,0.921052632
2022021166,6,65:00:00,0.0,37,34,5,0,3,0.918918919
2022021167,18,58:44:00,0.0,34,31,7,1,3,0.911764706
2022021167,10,59:55:00,0.0,25,23,5,0,2,0.92
2022021168,16,58:22:00,0.0,30,27,3,2,3,0.9
2022021168,23,60:00:00,0.0,31,29,5,0,2,0.935483871
2022021169,26,59:05:00,0.0,22,16,1,0,6,0.727272727
2022021169,19,15:50,0.0,17,12,0,0,5,0.705882353
2022021169,19,42:31:00,0.0,14,12,0,0,2,0.857142857
2022021170,9,59:40:00,0.0,34,32,5,1,2,0.941176471
2022021170,13,59:14:00,0.0,26,22,6,2,4,0.846153846
2022021171,7,64:42:00,0.0,41,38,9,0,3,0.926829268
2022021171,8,65:00:00,0.0,33,30,6,1,3,0.909090909
2022021172,2,60:00:00,0.0,31,30,3,0,1,0.967741935
2022021172,1,57:14:00,0.0,34,31,2,0,3,0.911764706
2022021173,30,60:00:00,0.0,36,35,4,0,1,0.972222222
2022021173,55,19:10,0.0,7,6,2,1,1,0.857142857
2022021173,55,40:42:00,0.0,13,9,1,0,4,0.692307692
2022021174,24,60:00:00,0.0,44,39,5,2,5,0.886363636
2022021174,21,59:42:00,0.0,30,29,4,0,1,0.966666667
2022021175,53,57:15:00,0.0,29,24,0,2,5,0.827586207
2022021175,22,59:57:00,0.0,33,29,3,1,4,0.878787879
2022021176,3,60:00:00,0.0,30,28,5,2,2,0.933333333
2022021176,29,59:03:00,0.0,35,30,2,1,5,0.857142857
2022021177,4,60:00:00,0.0,29,27,0,0,2,0.931034483
2022021177,8,58:49:00,0.0,26,24,2,0,2,0.923076923
2022021178,6,57:57:00,0.0,22,21,6,4,1,0.954545455
2022021178,18,60:00:00,0.0,36,35,5,3,1,0.972222222
2022021179,12,57:42:00,0.0,20,17,2,1,3,0.85
2022021179,14,59:41:00,0.0,31,31,3,1,0,1.0
2022021180,17,60:00:00,0.0,39,35,12,0,4,0.897435897
2022021180,5,57:52:00,0.0,24,18,4,0,6,0.75
2022021181,19,60:12:00,0.0,37,32,2,0,5,0.864864865
2022021181,23,58:43:00,0.0,31,25,0,0,6,0.806451613
2022021182,16,56:23:00,12.0,30,26,7,1,4,0.866666667
2022021182,16,3:37,0.0,3,3,0,0,0,1.0
2022021182,25,59:00:00,0.0,18,17,0,2,1,0.944444444
2022021183,20,60:00:00,0.0,33,32,4,1,1,0.96969697
2022021183,26,58:20:00,0.0,32,30,1,3,2,0.9375
2022021184,54,40:00:00,2.0,34,28,0,0,6,0.823529412
2022021184,54,20:00,0.0,5,4,0,0,1,0.8
2022021184,22,60:00:00,0.0,22,18,6,1,4,0.818181818
2022021185,28,60:00:00,0.0,41,41,2,2,0,1.0
2022021185,52,60:00:00,0.0,30,27,3,0,3,0.9
2022021186,10,61:33:00,0.0,29,26,5,2,3,0.896551724
2022021186,13,60:23:00,0.0,40,38,5,1,2,0.95
2022021187,15,65:00:00,0.0,29,28,0,0,1,0.965517241
2022021187,2,65:00:00,0.0,26,25,0,0,1,0.961538462
2022021188,21,57:51:00,0.0,28,25,8,0,3,0.892857143
2022021188,30,59:58:00,0.0,44,42,2,1,2,0.954545455
2022021189,6,60:39:00,0.0,26,25,9,1,1,0.961538462
2022021189,29,60:25:00,0.0,31,29,8,1,2,0.935483871
2022021190,8,58:59:00,0.0,29,25,1,0,4,0.862068966
2022021190,13,60:00:00,0.0,20,18,0,0,2,0.9
2022021191,1,60:00:00,0.0,25,24,1,0,1,0.96
2022021191,3,58:16:00,0.0,31,29,2,2,2,0.935483871
2022021192,5,59:24:00,0.0,28,28,5,3,0,1.0
2022021192,18,59:22:00,0.0,45,43,9,4,2,0.955555556
2022021193,9,61:36:00,0.0,11,7,0,0,4,0.636363636
2022021193,4,61:36:00,0.0,46,41,4,0,5,0.891304348
2022021194,14,60:00:00,0.0,31,30,4,0,1,0.967741935
2022021194,15,59:21:00,0.0,33,29,0,1,4,0.878787879
2022021195,17,59:44:00,0.0,33,31,2,0,2,0.939393939
2022021195,12,60:00:00,0.0,22,19,3,1,3,0.863636364
2022021196,16,57:31:00,0.0,28,24,3,0,4,0.857142857
2022021196,19,60:00:00,2.0,33,30,3,0,3,0.909090909
2022021197,22,59:54:00,0.0,43,43,7,1,0,1.0
2022021197,26,57:17:00,0.0,37,35,3,2,2,0.945945946
2022021198,55,60:00:00,0.0,19,18,3,0,1,0.947368421
2022021198,24,59:55:00,0.0,38,35,1,1,3,0.921052632
2022021199,28,60:50:00,0.0,26,23,4,0,3,0.884615385
2022021199,54,60:50:00,0.0,25,21,1,0,4,0.84
2022021200,7,61:50:00,0.0,33,31,4,0,2,0.939393939
2022021200,3,61:50:00,0.0,34,31,1,0,3,0.911764706
2022021201,52,59:56:00,0.0,25,23,0,1,2,0.92
2022021201,17,60:00:00,0.0,29,23,5,0,6,0.793103448
2022021202,23,63:27:00,0.0,41,36,8,2,5,0.87804878
2022021202,20,63:27:00,0.0,20,16,1,1,4,0.8
2022021203,53,58:29:00,0.0,30,26,10,0,4,0.866666667
2022021203,25,59:41:00,0.0,18,16,0,0,2,0.888888889
2022021204,18,60:00:00,0.0,22,21,6,0,1,0.954545455
2022021204,19,59:27:00,0.0,35,29,3,0,6,0.828571429
2022021205,5,58:35:00,0.0,35,31,4,2,4,0.885714286
2022021205,6,59:56:00,0.0,24,21,7,0,3,0.875
2022021206,4,60:00:00,0.0,29,23,2,1,6,0.793103448
2022021206,7,60:00:00,0.0,42,39,3,0,3,0.928571429
2022021207,8,60:00:00,0.0,50,47,3,0,3,0.94
2022021207,12,60:00:00,0.0,14,14,2,0,0,1.0
2022021208,29,60:00:00,0.0,49,42,6,1,7,0.857142857
2022021208,13,60:00:00,0.0,21,21,7,2,0,1.0
2022021209,14,60:00:00,0.0,38,38,4,0,0,1.0
2022021209,2,31:45:00,0.0,21,17,2,1,4,0.80952381
2022021209,2,28:15:00,0.0,11,10,0,1,1,0.909090909
2022021210,9,15:02,0.0,4,4,0,0,0,1.0
2022021210,9,40:00:00,0.0,16,13,1,0,3,0.8125
2022021210,10,60:00:00,0.0,31,31,4,1,0,1.0
2022021211,16,59:44:00,0.0,39,34,0,0,5,0.871794872
2022021211,1,59:31:00,0.0,17,14,0,1,3,0.823529412
2022021212,21,60:00:00,0.0,28,26,3,0,2,0.928571429
2022021212,25,57:21:00,0.0,30,27,4,2,3,0.9
2022021213,22,60:00:00,0.0,36,36,3,1,0,1.0
2022021213,24,13:26,0.0,9,8,0,0,1,0.888888889
2022021213,24,46:34:00,0.0,36,31,7,0,5,0.861111111
2022021214,55,59:10:00,0.0,18,16,0,0,2,0.888888889
2022021214,26,60:00:00,0.0,26,25,3,0,1,0.961538462
2022021215,54,60:00:00,0.0,30,29,7,0,1,0.966666667
2022021215,30,57:38:00,0.0,42,39,4,0,3,0.928571429
2022021216,53,59:22:00,0.0,31,24,9,0,7,0.774193548
2022021216,28,60:00:00,0.0,31,29,0,1,2,0.935483871
2022021217,15,60:00:00,0.0,34,29,6,0,5,0.852941176
2022021217,3,60:00:00,0.0,28,26,2,1,2,0.928571429
2022021218,19,63:59:00,0.0,31,28,2,0,3,0.903225806
2022021218,6,64:22:00,0.0,38,35,3,1,3,0.921052632
2022021219,12,60:00:00,0.0,22,21,2,0,1,0.954545455
2022021219,2,59:11:00,0.0,35,33,4,2,2,0.942857143
2022021220,29,60:16:00,0.0,27,24,4,1,3,0.888888889
2022021220,9,60:16:00,0.0,22,18,1,0,4,0.818181818
2022021221,5,60:00:00,0.0,33,31,5,1,2,0.939393939
2022021221,4,57:39:00,0.0,30,27,4,0,3,0.9
2022021222,10,16:16,0.0,7,5,1,0,2,0.714285714
2022021222,10,42:48:00,0.0,16,14,0,1,2,0.875
2022021222,17,60:00:00,0.0,45,43,5,1,2,0.955555556
2022021223,52,60:00:00,0.0,32,31,3,0,1,0.96875
2022021223,1,20:00,0.0,6,4,2,0,2,0.666666667
2022021223,1,40:00:00,0.0,21,17,2,0,4,0.80952381
2022021224,20,20:00,0.0,9,7,1,0,2,0.777777778
2022021224,20,39:32:00,0.0,13,11,0,1,2,0.846153846
2022021224,24,58:46:00,0.0,41,36,1,0,5,0.87804878
2022021225,23,58:03:00,0.0,24,21,1,2,3,0.875
2022021225,26,59:59:00,0.0,25,24,4,0,1,0.96
2022021226,30,65:00:00,0.0,26,23,6,1,3,0.884615385
2022021226,54,62:29:00,0.0,33,30,3,0,3,0.909090909
2022021227,25,59:04:00,0.0,27,26,6,0,1,0.962962963
2022021227,18,60:00:00,0.0,26,21,0,0,5,0.807692308
2022021228,55,59:39:00,0.0,21,20,4,1,1,0.952380952
2022021228,53,60:00:00,0.0,32,24,12,0,8,0.75
2022021229,13,60:00:00,0.0,40,39,6,3,1,0.975
2022021229,7,59:08:00,0.0,36,34,7,0,2,0.944444444
2022021230,10,60:00:00,0.0,26,24,4,0,2,0.923076923
2022021230,29,58:57:00,0.0,49,46,12,0,3,0.93877551
2022021231,8,59:46:00,0.0,21,16,4,0,5,0.761904762
2022021231,17,59:44:00,0.0,24,24,3,1,0,1.0
2022021232,12,64:19:00,0.0,28,26,2,0,2,0.928571429
2022021232,9,63:41:00,0.0,37,34,9,0,3,0.918918919
2022021233,1,59:55:00,0.0,23,22,4,1,1,0.956521739
2022021233,5,60:00:00,0.0,37,32,6,5,5,0.864864865
2022021234,19,60:00:00,0.0,34,32,2,2,2,0.941176471
2022021234,4,58:51:00,0.0,31,28,3,1,3,0.903225806
2022021235,18,63:22:00,2.0,32,30,9,0,2,0.9375
2022021235,54,63:30:00,0.0,27,24,1,1,3,0.888888889
2022021236,20,57:15:00,0.0,23,19,0,0,4,0.826086957
2022021236,16,60:00:00,0.0,36,33,2,0,3,0.916666667
2022021237,26,59:35:00,0.0,32,30,4,0,2,0.9375
2022021237,22,60:00:00,0.0,21,20,4,0,1,0.952380952
2022021238,23,58:04:00,0.0,27,23,3,3,4,0.851851852
2022021238,55,59:11:00,0.0,18,16,5,0,2,0.888888889
2022021239,28,63:00:00,0.0,42,38,5,0,4,0.904761905
2022021239,21,63:13:00,0.0,31,28,0,2,3,0.903225806
2022021240,52,58:50:00,0.0,35,32,8,4,3,0.914285714
2022021240,20,59:48:00,2.0,35,34,6,4,1,0.971428571
2022021241,3,59:46:00,0.0,31,28,1,0,3,0.903225806
2022021241,14,60:00:00,0.0,37,31,10,1,6,0.837837838
2022021242,24,59:47:00,0.0,32,30,3,2,2,0.9375
2022021242,22,60:00:00,0.0,28,27,2,1,1,0.964285714
2022021243,1,60:00:00,0.0,17,16,4,0,1,0.941176471
2022021243,29,42:07:00,0.0,24,19,2,3,5,0.791666667
2022021243,29,17:53,0.0,12,9,1,1,3,0.75
2022021244,5,60:00:00,0.0,28,27,6,1,1,0.964285714
2022021244,30,59:57:00,0.0,31,27,3,2,4,0.870967742
2022021245,13,60:00:00,0.0,58,56,16,1,2,0.965517241
2022021245,9,21:24,0.0,12,9,0,2,3,0.75
2022021245,9,38:12:00,0.0,18,14,7,0,4,0.777777778
2022021246,6,62:30:00,0.0,32,31,2,2,1,0.96875
2022021246,10,62:03:00,0.0,33,31,5,2,2,0.939393939
2022021247,8,59:16:00,0.0,26,24,3,1,2,0.923076923
2022021247,15,58:02:00,0.0,31,26,5,2,5,0.838709677
2022021248,17,64:01:00,0.0,36,30,8,0,6,0.833333333
2022021248,7,65:00:00,0.0,32,26,1,3,6,0.8125
2022021249,2,59:36:00,0.0,31,30,2,4,1,0.967741935
2022021249,14,60:00:00,0.0,42,36,2,0,6,0.857142857
2022021250,18,60:00:00,0.0,33,33,0,0,0,1.0
2022021250,12,59:27:00,0.0,22,20,1,0,2,0.909090909
2022021251,19,61:16:00,0.0,24,22,0,0,2,0.916666667
2022021251,3,60:59:00,0.0,22,19,1,0,3,0.863636364
2022021252,25,60:00:00,0.0,25,24,2,0,1,0.96
2022021252,4,60:00:00,0.0,30,26,1,2,4,0.866666667
2022021253,55,60:00:00,0.0,29,27,2,1,2,0.931034483
2022021253,53,60:00:00,0.0,33,30,6,0,4,0.909090909
2022021254,23,60:00:00,0.0,33,33,8,0,0,1.0
2022021254,16,59:15:00,0.0,28,26,9,0,2,0.928571429
2022021255,54,60:00:00,0.0,32,30,0,1,2,0.9375
2022021255,26,38:58:00,0.0,22,22,3,0,0,1.0
2022021255,26,21:02,0.0,15,10,4,0,5,0.666666667
2022021256,28,28:06:00,0.0,19,15,2,0,4,0.789473684
2022021256,28,31:54:00,0.0,12,10,0,0,2,0.833333333
2022021256,21,60:00:00,0.0,23,21,1,0,2,0.913043478
2022021257,7,60:00:00,0.0,34,31,2,0,3,0.911764706
2022021257,12,57:37:00,0.0,30,26,3,0,4,0.866666667
2022021258,30,59:42:00,0.0,40,37,3,1,3,0.925
2022021258,19,59:26:00,0.0,29,25,6,0,4,0.862068966
2022021259,28,60:00:00,0.0,35,29,2,0,6,0.828571429
2022021259,22,60:00:00,0.0,23,22,0,0,1,0.956521739
2022021260,53,63:10:00,0.0,29,25,3,1,4,0.862068966
2022021260,24,63:59:00,0.0,39,34,7,2,5,0.871794872
2022021261,15,59:11:00,0.0,36,33,13,1,3,0.916666667
2022021261,13,59:53:00,0.0,24,22,5,0,2,0.916666667
2022021262,10,58:50:00,0.0,21,20,3,0,1,0.952380952
2022021262,10,1:10,0.0,0,0,0,0,0,
2022021262,8,59:54:00,0.0,46,39,2,2,7,0.847826087
2022021263,29,59:50:00,0.0,28,24,4,0,4,0.857142857
2022021263,3,59:27:00,0.0,20,20,3,0,0,1.0
2022021264,52,60:00:00,0.0,28,28,4,2,0,1.0
2022021264,18,57:52:00,0.0,38,36,6,0,2,0.947368421
2022021265,6,60:00:00,0.0,30,29,4,0,1,0.966666667
2022021265,1,58:04:00,0.0,40,38,3,1,2,0.95
2022021266,17,59:42:00,0.0,28,23,3,0,5,0.821428571
2022021266,5,59:29:00,0.0,20,19,2,0,1,0.95
2022021267,9,60:00:00,0.0,24,20,2,2,4,0.833333333
2022021267,14,58:50:00,0.0,39,33,10,0,6,0.846153846
2022021268,2,60:00:00,0.0,27,27,3,1,0,1.0
2022021268,4,20:00,0.0,3,2,0,0,1,0.666666667
2022021268,4,40:00:00,0.0,18,15,2,0,3,0.833333333
2022021269,25,64:55:00,0.0,20,19,1,1,1,0.95
2022021269,54,64:41:00,0.0,25,24,1,1,1,0.96
2022021270,23,65:00:00,0.0,43,41,5,3,2,0.953488372
2022021270,20,65:00:00,0.0,33,31,6,0,2,0.939393939
2022021271,55,39:42:00,0.0,18,15,5,0,3,0.833333333
2022021271,55,20:00,0.0,11,11,0,0,0,1.0
2022021271,16,60:00:00,0.0,31,24,7,0,7,0.774193548
2022021272,26,57:28:00,0.0,23,19,2,1,4,0.826086957
2022021272,21,60:00:00,0.0,41,38,3,1,3,0.926829268
2022021273,4,57:12:00,0.0,34,29,4,3,5,0.852941176
2022021273,6,60:00:00,0.0,37,34,8,0,3,0.918918919
2022021274,24,64:15:00,0.0,46,41,7,2,5,0.891304348
2022021274,21,64:15:00,0.0,23,19,4,2,4,0.826086957
2022021275,3,65:00:00,0.0,39,37,2,0,2,0.948717949
2022021275,7,65:00:00,0.0,28,26,1,0,2,0.928571429
2022021276,9,59:55:00,0.0,29,27,8,2,2,0.931034483
2022021276,12,57:24:00,0.0,32,29,8,1,3,0.90625
2022021277,15,60:00:00,0.0,40,38,1,0,2,0.95
2022021277,2,56:52:00,0.0,23,20,0,1,3,0.869565217
2022021278,52,60:00:00,0.0,21,19,7,0,2,0.904761905
2022021278,28,59:30:00,0.0,33,27,0,0,6,0.818181818
2022021279,13,64:38:00,0.0,25,23,0,0,2,0.92
2022021279,10,64:38:00,0.0,46,45,2,2,1,0.97826087
2022021280,17,12:10,0.0,5,2,0,0,3,0.4
2022021280,17,47:50:00,0.0,17,14,1,0,3,0.823529412
2022021280,25,40:00:00,0.0,13,12,1,0,1,0.923076923
2022021280,25,20:00,0.0,7,7,1,0,0,1.0
2022021281,16,58:12:00,0.0,21,18,1,2,3,0.857142857
2022021281,30,60:00:00,0.0,42,40,1,2,2,0.952380952
2022021282,20,65:00:00,0.0,29,27,8,1,2,0.931034483
2022021282,18,64:54:00,0.0,44,42,7,5,2,0.954545455
2022021283,53,60:00:00,0.0,37,33,9,2,4,0.891891892
2022021283,55,58:44:00,0.0,23,22,3,0,1,0.956521739
2022021283,55,1:16,0.0,0,0,0,0,0,
2022021284,26,60:00:00,0.0,20,20,4,2,0,1.0
2022021284,23,59:15:00,0.0,27,25,0,1,2,0.925925926
2022021285,1,59:53:00,0.0,38,36,3,3,2,0.947368421
2022021285,7,58:03:00,0.0,28,24,2,0,4,0.857142857
2022021286,5,57:32:00,0.0,25,22,3,1,3,0.88
2022021286,16,60:00:00,0.0,40,38,10,1,2,0.95
2022021287,4,64:44:00,0.0,31,28,2,1,3,0.903225806
2022021287,29,64:44:00,0.0,39,35,4,0,4,0.897435897
2022021288,12,59:48:00,0.0,21,20,0,1,1,0.952380952
2022021288,17,57:38:00,0.0,27,24,2,2,3,0.888888889
2022021289,14,56:59:00,0.0,24,20,3,1,4,0.833333333
2022021289,10,60:00:00,0.0,48,45,18,0,3,0.9375
2022021290,6,9:39,0.0,6,6,0,0,0,1.0
2022021290,6,50:21:00,0.0,21,19,2,0,2,0.904761905
2022021290,15,13:26,0.0,7,6,0,1,1,0.857142857
2022021290,15,45:21:00,0.0,36,33,2,0,3,0.916666667
2022021291,30,58:00:00,0.0,20,17,3,1,3,0.85
2022021291,52,60:00:00,0.0,34,33,11,2,1,0.970588235
2022021292,21,61:21:00,0.0,40,38,6,1,2,0.95
2022021292,22,61:50:00,0.0,29,29,7,2,1,1.0
2022021293,54,60:00:00,0.0,21,20,0,0,1,0.952380952
2022021293,55,60:00:00,0.0,37,33,2,1,4,0.891891892
2022021294,24,58:45:00,0.0,36,33,3,2,3,0.916666667
2022021294,23,59:42:00,0.0,35,33,10,2,2,0.942857143
2022021295,2,60:00:00,0.0,19,17,0,0,2,0.894736842
2022021295,8,58:36:00,0.0,35,31,3,1,4,0.885714286
2022021296,19,59:28:00,0.0,37,32,10,0,5,0.864864865
2022021296,25,59:54:00,0.0,18,16,2,1,2,0.888888889
2022021297,20,59:54:00,0.0,24,23,3,1,1,0.958333333
2022021297,28,58:26:00,0.0,48,46,3,1,2,0.958333333
2022021298,8,59:11:00,0.0,21,16,2,0,5,0.761904762
2022021298,6,60:00:00,2.0,34,30,3,1,4,0.882352941
2022021299,13,56:55:00,0.0,34,30,5,0,4,0.882352941
2022021299,12,60:00:00,0.0,34,30,3,1,4,0.882352941
2022021300,14,60:00:00,0.0,32,32,0,0,0,1.0
2022021300,17,59:25:00,0.0,31,27,3,1,4,0.870967742
2022021301,15,64:33:00,0.0,34,29,1,0,5,0.852941176
2022021301,1,21:05,0.0,11,7,0,0,4,0.636363636
2022021301,1,43:22:00,0.0,20,20,1,0,0,1.0
2022021302,7,61:18:00,0.0,33,30,4,0,3,0.909090909
2022021302,9,61:18:00,0.0,36,32,7,0,4,0.888888889
2022021303,29,60:52:00,0.0,36,34,0,1,2,0.944444444
2022021303,5,61:00:00,0.0,34,31,3,0,3,0.911764706
2022021304,3,56:44:00,0.0,21,18,0,0,3,0.857142857
2022021304,10,60:00:00,0.0,24,22,2,0,2,0.916666667
2022021305,18,62:44:00,0.0,24,21,0,1,3,0.875
2022021305,30,62:44:00,0.0,31,27,3,0,4,0.870967742
2022021306,16,62:28:00,0.0,36,31,0,0,5,0.861111111
2022021306,4,63:09:00,0.0,38,34,0,0,4,0.894736842
2022021307,25,60:00:00,0.0,25,25,0,0,0,1.0
2022021307,19,57:55:00,0.0,34,33,3,2,1,0.970588235
2022021308,22,58:57:00,0.0,29,27,7,0,2,0.931034483
2022021308,28,59:27:00,0.0,36,31,10,1,5,0.861111111
2022021309,21,60:00:00,0.0,20,18,5,0,2,0.9
2022021309,52,59:32:00,0.0,24,21,2,0,3,0.875
2022021310,24,59:35:00,0.0,35,31,11,1,4,0.885714286
2022021310,26,59:43:00,0.0,24,21,2,4,3,0.875
2022021311,53,61:03:00,0.0,24,19,6,0,5,0.791666667
2022021311,23,61:19:00,0.0,28,24,4,1,4,0.857142857
2022021312,55,58:39:00,0.0,18,16,0,1,2,0.888888889
2022021312,54,59:35:00,0.0,31,30,5,1,1,0.967741935
2022030111,6,60:00:00,0.0,32,31,0,2,1,0.96875
2022030111,13,57:10:00,0.0,29,26,3,2,3,0.896551724
2022030112,6,58:34:00,0.0,29,24,4,2,5,0.827586207
2022030112,13,60:00:00,0.0,37,34,7,1,3,0.918918919
2022030113,13,48:32:00,0.0,26,23,2,1,3,0.884615385
2022030113,13,7:55,0.0,9,8,3,0,1,0.888888889
2022030113,6,60:00:00,0.0,31,29,4,3,2,0.935483871
2022030114,13,57:06:00,0.0,30,25,7,0,5,0.833333333
2022030114,6,3:11,0.0,1,1,1,0,0,1.0
2022030114,6,56:49:00,10.0,43,41,10,0,2,0.953488372
2022030115,6,65:50:00,0.0,25,21,1,0,4,0.84
2022030115,13,66:05:00,0.0,47,44,5,2,3,0.936170213
2022030116,13,60:00:00,0.0,34,29,6,2,5,0.852941176
2022030116,6,58:38:00,0.0,32,26,2,0,6,0.8125
2022030117,6,68:35:00,0.0,31,27,4,2,4,0.870967742
2022030117,13,67:39:00,0.0,36,33,5,0,3,0.916666667
2022030121,10,40:00:00,0.0,29,23,9,0,6,0.793103448
2022030121,10,20:00,0.0,5,4,0,0,1,0.8
2022030121,14,60:00:00,0.0,31,28,5,1,3,0.903225806
2022030122,10,59:33:00,0.0,22,20,2,0,2,0.909090909
2022030122,14,60:00:00,0.0,37,30,5,0,7,0.810810811
2022030123,14,78:59:00,0.0,27,23,3,0,4,0.851851852
2022030123,10,78:43:00,0.0,39,36,4,1,3,0.923076923
2022030124,14,64:14:00,0.0,37,32,5,2,5,0.864864865
2022030124,10,63:55:00,0.0,31,27,3,2,4,0.870967742
2022030125,10,56:20:00,0.0,37,34,6,4,3,0.918918919
2022030125,14,60:00:00,0.0,30,28,5,0,2,0.933333333
2022030126,14,64:36:00,0.0,22,20,1,1,2,0.909090909
2022030126,10,64:10:00,0.0,32,31,4,2,1,0.96875
2022030131,12,60:00:00,0.0,26,25,4,1,1,0.961538462
2022030131,2,58:24:00,0.0,37,35,3,1,2,0.945945946
2022030132,12,65:03:00,0.0,26,23,0,1,3,0.884615385
2022030132,2,65:03:00,0.0,36,33,8,0,4,0.916666667
2022030133,2,60:00:00,0.0,31,30,3,1,1,0.967741935
2022030133,12,59:18:00,0.0,36,32,9,0,4,0.888888889
2022030134,2,60:00:00,0.0,29,24,2,0,5,0.827586207
2022030134,12,60:00:00,0.0,29,27,2,1,2,0.931034483
2022030135,12,56:59:00,0.0,22,19,0,2,3,0.863636364
2022030135,2,60:00:00,0.0,36,34,5,2,2,0.944444444
2022030136,2,66:00:00,0.0,41,39,1,2,2,0.951219512
2022030136,12,66:00:00,0.0,34,33,5,0,1,0.970588235
2022030141,1,59:31:00,0.0,22,18,2,3,4,0.818181818
2022030141,3,59:49:00,0.0,28,27,0,0,1,0.964285714
2022030142,1,60:00:00,0.0,30,25,8,1,5,0.833333333
2022030142,3,60:00:00,0.0,24,23,3,0,1,0.958333333
2022030143,3,71:06:00,2.0,28,26,1,2,2,0.928571429
2022030143,1,71:36:00,0.0,36,35,6,0,1,0.972222222
2022030144,3,58:32:00,0.0,22,20,2,0,2,0.909090909
2022030144,1,60:00:00,0.0,23,22,4,0,1,0.956521739
2022030145,1,59:50:00,0.0,23,23,4,1,0,1.0
2022030145,3,59:14:00,0.0,42,39,11,0,3,0.928571429
2022030146,3,59:55:00,0.0,36,34,5,2,2,0.944444444
2022030146,1,52:28:00,0.0,29,24,5,0,5,0.827586207
2022030146,1,2:18,0.0,0,0,0,0,0,
2022030147,1,59:55:00,0.0,31,31,3,0,0,1.0
2022030147,3,59:02:00,0.0,23,20,1,2,3,0.869565217
2022030151,21,57:56:00,0.0,30,27,2,1,3,0.9
2022030151,55,60:00:00,0.0,35,34,5,1,1,0.971428571
2022030152,21,60:00:00,0.0,29,27,1,0,2,0.931034483
2022030152,55,58:06:00,0.0,41,38,4,1,3,0.926829268
2022030153,55,58:19:00,0.0,33,28,2,1,5,0.848484848
2022030153,21,60:00:00,0.0,29,25,2,0,4,0.862068966
2022030154,55,63:00:00,0.0,22,20,3,2,2,0.909090909
2022030154,21,63:00:00,0.0,43,40,8,1,3,0.930232558
2022030155,21,56:33:00,0.0,29,26,1,0,3,0.896551724
2022030155,55,60:00:00,0.0,28,26,5,0,2,0.928571429
2022030156,55,58:12:00,0.0,38,35,12,0,3,0.921052632
2022030156,21,59:44:00,0.0,23,22,4,1,1,0.956521739
2022030157,21,58:09:00,0.0,27,25,0,0,2,0.925925926
2022030157,55,60:00:00,0.0,34,33,1,0,1,0.970588235
2022030161,25,92:05:00,0.0,48,45,7,0,3,0.9375
2022030161,30,92:20:00,0.0,53,51,6,3,2,0.962264151
2022030162,25,59:42:00,0.0,26,23,8,2,3,0.884615385
2022030162,30,60:00:00,0.0,31,24,6,0,7,0.774193548
2022030163,30,60:00:00,0.0,24,23,2,0,1,0.958333333
2022030163,25,57:07:00,0.0,24,20,4,1,4,0.833333333
2022030164,30,56:58:00,0.0,24,21,4,1,3,0.875
2022030164,25,59:26:00,0.0,34,32,2,1,2,0.941176471
2022030165,25,59:53:00,0.0,27,27,6,1,0,1.0
2022030165,30,59:14:00,0.0,24,21,8,1,3,0.875
2022030166,30,16:41,0.0,6,6,4,0,0,1.0
2022030166,30,40:00:00,0.0,26,23,0,0,3,0.884615385
2022030166,25,60:00:00,0.0,24,23,3,1,1,0.958333333
2022030171,54,58:47:00,0.0,30,26,4,1,4,0.866666667
2022030171,52,60:00:00,0.0,17,16,1,1,1,0.941176471
2022030172,54,59:50:00,0.0,33,31,3,1,2,0.939393939
2022030172,52,60:00:00,0.0,39,34,6,0,5,0.871794872
2022030173,52,82:52:00,0.0,48,43,5,1,5,0.895833333
2022030173,54,83:14:00,0.0,34,30,8,0,4,0.882352941
2022030174,52,58:39:00,0.0,29,26,4,0,3,0.896551724
2022030174,54,60:00:00,0.0,26,24,2,0,2,0.923076923
2022030175,54,60:00:00,0.0,30,29,0,0,1,0.966666667
2022030175,52,52:31:00,0.0,25,21,2,0,4,0.84
2022030181,22,69:19:00,0.0,35,31,8,1,4,0.885714286
2022030181,26,67:52:00,0.0,40,37,2,1,3,0.925
2022030182,22,60:00:00,0.0,24,22,3,0,2,0.916666667
2022030182,26,59:20:00,0.0,36,33,2,3,3,0.916666667
2022030183,26,62:50:00,0.0,40,38,5,0,2,0.95
2022030183,22,63:24:00,0.0,31,28,4,0,3,0.903225806
2022030184,26,70:01:00,0.0,42,37,3,0,5,0.880952381
2022030184,22,50:39:00,0.0,28,27,1,0,1,0.964285714
2022030184,22,20:00,0.0,11,8,0,0,3,0.727272727
2022030185,22,59:21:00,0.0,28,25,0,2,3,0.892857143
2022030185,26,28:11:00,0.0,8,6,2,0,2,0.75
2022030185,26,31:49:00,0.0,19,15,1,0,4,0.789473684
2022030186,26,58:23:00,0.0,26,21,0,1,5,0.807692308
2022030186,22,60:00:00,0.0,44,40,5,1,4,0.909090909
2022030211,10,57:11:00,0.0,28,24,2,1,4,0.857142857
2022030211,13,59:28:00,0.0,36,34,9,0,2,0.944444444
2022030212,10,57:40:00,0.0,29,26,1,1,3,0.896551724
2022030212,13,60:00:00,0.0,37,35,7,0,2,0.945945946
2022030213,13,63:02:00,0.0,24,22,0,0,2,0.916666667
2022030213,10,20:37,0.0,8,8,0,0,0,1.0
2022030213,10,42:25:00,0.0,21,18,3,0,3,0.857142857
2022030214,13,58:37:00,0.0,25,23,5,0,2,0.92
2022030214,10,60:00:00,0.0,25,24,5,0,1,0.96
2022030215,10,75:30:00,0.0,43,40,7,1,3,0.930232558
2022030215,13,75:32:00,0.0,52,50,4,1,2,0.961538462
2022030221,12,60:00:00,0.0,18,17,0,1,1,0.944444444
2022030221,1,21:55,0.0,11,8,3,1,3,0.727272727
2022030221,1,37:01:00,0.0,11,10,1,0,1,0.909090909
2022030222,12,60:00:00,0.0,29,28,8,0,1,0.965517241
2022030222,1,40:00:00,0.0,25,21,2,1,4,0.84
2022030222,1,20:00,0.0,10,8,0,0,2,0.8
2022030223,1,60:00:00,0.0,30,26,4,0,4,0.866666667
2022030223,12,20:53,0.0,12,8,0,0,4,0.666666667
2022030223,12,39:07:00,0.0,22,18,1,0,4,0.818181818
2022030224,1,27:00:00,0.0,12,11,1,2,1,0.916666667
2022030224,1,32:46:00,0.0,17,12,2,0,5,0.705882353
2022030224,12,60:00:00,0.0,22,21,2,0,1,0.954545455
2022030225,12,67:09:00,0.0,29,27,1,0,2,0.931034483
2022030225,1,67:02:00,0.0,39,36,3,0,3,0.923076923
2022030231,25,72:17:00,0.0,44,39,4,2,5,0.886363636
2022030231,55,72:17:00,0.0,35,31,4,2,4,0.885714286
2022030232,25,60:00:00,0.0,27,25,1,1,2,0.925925926
2022030232,55,56:53:00,0.0,37,33,7,0,4,0.891891892
2022030233,55,60:00:00,0.0,26,24,6,0,2,0.923076923
2022030233,25,40:00:00,0.0,17,12,0,0,5,0.705882353
2022030233,25,20:00,0.0,8,6,2,1,2,0.75
2022030234,55,18:15,0.0,2,2,0,0,0,1.0
2022030234,55,40:00:00,0.0,22,17,5,0,5,0.772727273
2022030234,25,60:00:00,0.0,19,16,2,0,3,0.842105263
2022030235,25,60:00:00,0.0,31,29,1,1,2,0.935483871
2022030235,55,59:40:00,0.0,20,16,0,1,4,0.8
2022030236,55,60:00:00,0.0,23,20,4,0,3,0.869565217
2022030236,25,24:23:00,0.0,18,14,5,1,4,0.777777778
2022030236,25,32:48:00,0.0,10,9,3,0,1,0.9
2022030237,25,60:00:00,0.0,23,22,0,0,1,0.956521739
2022030237,55,56:15:00,0.0,28,26,0,2,2,0.928571429
2022030241,54,59:47:00,0.0,27,23,2,2,4,0.851851852
2022030241,22,59:30:00,0.0,33,28,4,1,5,0.848484848
2022030242,54,20:00,0.0,4,4,1,1,0,1.0
2022030242,54,40:00:00,0.0,32,27,8,5,5,0.84375
2022030242,22,59:49:00,0.0,31,30,6,0,1,0.967741935
2022030243,22,27:57:00,0.0,10,9,3,0,1,0.9
2022030243,22,32:03:00,0.0,23,19,0,0,4,0.826086957
2022030243,54,47:48:00,0.0,24,24,2,0,0,1.0
2022030243,54,11:44,0.0,4,3,0,0,1,0.75
2022030244,22,59:57:00,2.0,26,25,10,1,1,0.961538462
2022030244,54,58:32:00,0.0,33,29,6,1,4,0.878787879
2022030245,54,60:00:00,0.0,35,32,12,3,3,0.914285714
2022030245,22,22:36,0.0,9,9,5,0,0,1.0
2022030245,22,35:34:00,0.0,22,18,7,0,4,0.818181818
2022030246,22,17:04,0.0,4,4,0,0,0,1.0
2022030246,22,40:00:00,0.0,17,13,2,0,4,0.764705882
2022030246,54,60:00:00,0.0,40,38,5,0,2,0.95
2022030311,12,139:43:00,0.0,60,57,2,0,3,0.95
2022030311,13,139:47:00,0.0,65,63,8,0,2,0.969230769
2022030312,12,61:51:00,0.0,26,24,2,0,2,0.923076923
2022030312,13,61:51:00,0.0,38,37,4,6,1,0.973684211
2022030313,13,59:27:00,0.0,32,32,0,0,0,1.0
2022030313,12,56:38:00,0.0,17,16,5,1,1,0.941176471
2022030314,13,60:00:00,0.0,39,36,10,0,3,0.923076923
2022030314,12,59:55:00,0.0,24,20,3,0,4,0.833333333
2022030321,54,61:35:00,0.0,36,33,6,0,3,0.916666667
2022030321,25,61:19:00,0.0,37,33,3,0,4,0.891891892
2022030322,54,61:04:00,0.0,28,26,2,0,2,0.928571429
2022030322,25,61:12:00,0.0,24,21,0,0,3,0.875
2022030323,25,7:10,0.0,5,2,2,0,3,0.4
2022030323,25,52:33:00,0.0,11,10,3,0,1,0.909090909
2022030323,54,59:46:00,0.0,34,34,1,4,0,1.0
2022030324,25,63:18:00,0.0,39,37,0,0,2,0.948717949
2022030324,54,63:18:00,0.0,42,39,2,0,3,0.928571429
2022030325,54,56:50:00,0.0,34,30,0,0,4,0.882352941
2022030325,25,60:00:00,0.0,29,27,4,0,2,0.931034483
2022030326,25,59:54:00,0.0,29,23,1,0,6,0.793103448
2022030326,54,60:00:00,0.0,23,23,4,1,0,1.0
2022030411,54,60:00:00,0.0,35,33,3,3,2,0.942857143
2022030411,13,59:46:00,0.0,33,29,9,0,4,0.878787879
2022030412,54,60:00:00,0.0,31,29,12,0,2,0.935483871
2022030412,13,32:50:00,0.0,15,12,2,0,3,0.8
2022030412,13,27:10:00,0.0,13,9,2,1,4,0.692307692
2022030413,13,64:11:00,0.0,27,25,5,0,2,0.925925926
2022030413,54,64:27:00,0.0,23,20,4,1,3,0.869565217
2022030414,13,57:34:00,0.0,31,28,0,0,3,0.903225806
2022030414,54,60:00:00,2.0,31,29,1,0,2,0.935483871
2022030415,54,60:00:00,0.0,35,32,1,0,3,0.914285714
2022030415,13,59:11:00,0.0,31,23,2,0,8,0.741935484
2022040671,89,10:00,,9,7,0,0,2,0.777777778
2022040671,89,10:00,,13,11,0,0,2,0.846153846
2022040671,90,10:00,,7,4,0,0,3,0.571428571
2022040671,90,9:25,,7,4,0,0,3,0.571428571
2022040672,87,10:00,,7,4,0,0,3,0.571428571
2022040672,87,10:00,,13,10,0,0,3,0.769230769
2022040672,88,9:17,,13,8,0,0,5,0.615384615
2022040672,88,10:00,,9,5,0,0,4,0.555555556
2022040673,87,10:00,,6,6,0,0,0,1.0
2022040673,87,10:00,,16,11,0,0,5,0.6875
2022040673,89,10:00,,11,7,0,0,4,0.636363636
2022040673,89,10:00,,14,11,0,0,3,0.785714286
2023010001,53,60:00:00,,36,33,0,33,3,0.916666667
2023010001,26,40:00:00,,16,12,0,12,4,0.75
2023010001,26,18:30,,3,3,0,3,0,1.0
2023010002,19,40:00:00,,22,20,1,1,2,0.909090909
2023010002,19,20:00,,6,6,1,0,0,1.0
2023010002,53,58:53:00,,23,20,0,0,3,0.869565217
2023010002,53,,,0,0,0,0,0,
2023010003,53,60:00:00,,21,20,0,20,1,0.952380952
2023010003,19,39:58:00,,33,30,0,30,3,0.909090909
2023010003,19,20:00,,18,16,0,16,2,0.888888889
2023010004,26,20:00,,12,11,0,11,1,0.916666667
2023010004,26,40:00:00,,21,20,0,20,1,0.952380952
2023010004,53,58:53:00,,35,33,0,33,2,0.942857143
2023010005,5,35:02:00,,17,15,3,0,2,0.882352941
2023010005,5,29:58:00,,18,18,0,1,0,1.0
2023010005,29,33:22:00,,11,11,1,1,0,1.0
2023010005,29,31:31:00,,17,15,1,1,2,0.882352941
2023010006,15,31:34:00,,18,18,6,0,0,1.0
2023010006,15,33:26:00,,9,6,1,1,3,0.666666667
2023010006,7,39:55:00,,21,19,3,1,2,0.904761905
2023010006,7,25:00:00,,11,10,0,0,1,0.909090909
2023010007,9,,,0,0,0,0,0,
2023010007,9,60:00:00,,38,36,10,0,2,0.947368421
2023010007,10,17:50,,4,4,0,0,0,1.0
2023010007,10,39:55:00,,28,25,6,1,3,0.892857143
2023010008,21,28:09:00,,10,7,2,0,3,0.7
2023010008,21,31:14:00,,15,14,3,0,1,0.933333333
2023010008,30,59:51:00,,43,40,9,3,3,0.930232558
2023010008,30,,,0,0,0,0,0,
2023010009,6,60:00:00,,29,29,9,0,0,1.0
2023010009,6,,,0,0,0,0,0,
2023010009,3,30:26:00,,14,11,1,1,3,0.785714286
2023010009,3,29:33:00,,8,8,0,0,0,1.0
2023010010,22,,,0,0,0,0,0,
2023010010,22,65:00:00,,26,25,0,0,1,0.961538462
2023010010,52,,,0,0,0,0,0,
2023010010,52,65:00:00,,37,36,4,0,1,0.972972973
2023010011,25,60:00:00,,11,11,0,11,0,1.0
2023010011,53,28:45:00,,26,22,0,22,4,0.846153846
2023010011,53,31:15:00,,24,21,0,21,3,0.875
2023010011,25,20:00,,5,5,0,5,0,1.0
2023010011,25,40:00:00,,6,6,0,6,0,1.0
2023010012,29,22:47,,8,8,1,0,0,1.0
2023010012,29,40:00:00,,21,18,2,1,3,0.857142857
2023010012,5,22:47,,17,16,1,0,1,0.941176471
2023010012,5,39:58:00,,19,16,2,1,3,0.842105263
2023010013,24,30:03:00,,13,13,0,0,0,1.0
2023010013,24,30:17:00,,15,13,4,1,2,0.866666667
2023010013,26,60:37:00,,32,29,4,7,3,0.90625
2023010013,26,,,0,0,0,0,0,
2023010013,24,30:20:00,,14,14,1,0,0,1.0
2023010013,24,30:13:00,,14,12,4,1,2,0.857142857
2023010013,26,60:33:00,,30,27,6,1,3,0.9
2023010014,28,,,0,0,0,0,0,
2023010014,28,60:00:00,,34,32,9,1,2,0.941176471
2023010014,54,40:00:00,,18,13,4,0,5,0.722222222
2023010014,54,16:08,,3,3,0,0,0,1.0
2023010015,20,40:00:00,,20,20,4,0,0,1.0
2023010015,20,20:00,,6,6,1,0,0,1.0
2023010015,23,31:42:00,,18,11,3,0,7,0.611111111
2023010015,23,28:18:00,,8,5,2,1,3,0.625
2023010016,13,29:04:00,,13,13,4,1,0,1.0
2023010016,13,30:13:00,,10,10,0,1,0,1.0
2023010016,18,30:35:00,,17,14,6,0,3,0.823529412
2023010016,18,29:15:00,,21,19,5,2,2,0.904761905
2023010017,13,27:17:00,,15,14,1,0,1,0.933333333
2023010017,13,32:43:00,,15,14,1,1,1,0.933333333
2023010017,18,26:15:00,,8,8,0,0,0,1.0
2023010017,18,32:43:00,,24,20,3,0,4,0.833333333
2023010018,8,31:40:00,,18,16,1,0,2,0.888888889
2023010018,8,26:07:00,,13,11,0,0,2,0.846153846
2023010018,1,12:38,,7,7,2,0,0,1.0
2023010018,1,47:14:00,,18,16,3,0,2,0.888888889
2023010019,10,33:00:00,,17,16,2,2,1,0.941176471
2023010019,10,30:07:00,,22,19,4,0,3,0.863636364
2023010019,9,,,0,0,0,0,0,
2023010019,9,63:48:00,,39,36,6,1,3,0.923076923
2023010020,1,20:00,,10,10,1,0,0,1.0
2023010020,1,40:00:00,,11,11,1,2,0,1.0
2023010020,4,20:00,,10,9,3,1,1,0.9
2023010020,4,40:00:00,,24,19,1,2,5,0.791666667
2023010021,52,60:00:00,,26,26,3,4,0,1.0
2023010021,52,,,0,0,0,0,0,
2023010021,22,60:00:00,,30,25,6,1,5,0.833333333
2023010021,22,,,0,0,0,0,0,
2023010022,20,59:41:00,,29,24,9,3,5,0.827586207
2023010022,20,,,0,0,0,0,0,
2023010022,55,19:57,,5,4,0,0,1,0.8
2023010022,55,40:00:00,,19,17,5,1,2,0.894736842
2023010023,21,33:07:00,,9,8,1,0,1,0.888888889
2023010023,21,26:53:00,,5,4,2,0,1,0.8
2023010023,54,28:11:00,,11,10,1,0,1,0.909090909
2023010023,54,30:38:00,,12,10,4,0,2,0.833333333
2023010024,55,20:00,,6,4,1,0,2,0.666666667
2023010024,55,45:00:00,,15,15,1,1,0,1.0
2023010024,20,65:00:00,,37,35,0,0,2,0.945945946
2023010024,20,,,0,0,0,0,0,
2023010025,7,40:00:00,,19,19,8,0,0,1.0
2023010025,7,20:00,,19,18,1,0,1,0.947368421
2023010025,6,26:00:00,,12,11,1,0,1,0.916666667
2023010025,6,30:24:00,,22,20,3,2,2,0.909090909
2023010026,3,29:38:00,,11,10,2,0,1,0.909090909
2023010026,3,30:22:00,,12,11,0,0,1,0.916666667
2023010026,2,17:05,,6,6,0,0,0,1.0
2023010026,2,40:00:00,,24,20,1,1,4,0.833333333
2023010027,17,30:14:00,,9,7,0,0,2,0.777777778
2023010027,17,29:36:00,,13,12,0,0,1,0.923076923
2023010027,5,,,0,0,0,0,0,
2023010027,5,58:00:00,,33,29,6,1,4,0.878787879
2023010028,12,32:18:00,,14,13,4,0,1,0.928571429
2023010028,12,27:42:00,,14,13,0,0,1,0.928571429
2023010028,14,,,0,0,0,0,0,
2023010028,14,60:00:00,,24,19,2,1,5,0.791666667
2023010029,19,40:00:00,,21,20,6,0,1,0.952380952
2023010029,19,20:00,,11,10,0,0,1,0.909090909
2023010029,29,28:04:00,,10,7,2,0,3,0.7
2023010029,29,30:21:00,,3,3,0,0,0,1.0
2023010030,25,,,0,0,0,0,0,
2023010030,25,60:00:00,,35,34,4,1,1,0.971428571
2023010030,30,33:49:00,,23,20,3,0,3,0.869565217
2023010030,30,25:31:00,,11,8,3,0,3,0.727272727
2023010031,28,59:10:00,,24,21,1,0,3,0.875
2023010031,28,,,0,0,0,0,0,
2023010031,24,,,0,0,0,0,0,
2023010031,24,60:00:00,,17,15,1,0,2,0.882352941
2023010032,10,60:00:00,,15,13,0,13,2,0.866666667
2023010032,7,40:00:00,,28,25,0,25,3,0.892857143
2023010032,7,20:00,,13,11,0,11,2,0.846153846
2023010033,12,30:23:00,,9,8,0,0,1,0.888888889
2023010033,12,29:18:00,,6,6,0,0,0,1.0
2023010033,13,59:43:00,,30,27,5,1,3,0.9
2023010033,13,,,0,0,0,0,0,
2023010034,8,29:45:00,,18,17,3,0,1,0.944444444
2023010034,8,30:15:00,,12,10,2,2,2,0.833333333
2023010034,9,,,0,0,0,0,0,
2023010034,9,58:36:00,,21,17,2,0,4,0.80952381
2023010035,2,30:33:00,,12,12,0,2,0,1.0
2023010035,2,29:27:00,,18,17,5,0,1,0.944444444
2023010035,4,20:00,,6,5,0,0,1,0.833333333
2023010035,4,37:03:00,,13,12,3,0,1,0.923076923
2023010036,52,37:57:00,,14,13,4,0,1,0.928571429
2023010036,52,27:03:00,,19,18,6,0,1,0.947368421
2023010036,20,64:47:00,,21,19,4,2,2,0.904761905
2023010036,20,,,0,0,0,0,0,
2023010037,18,22:58,,11,10,2,2,1,0.909090909
2023010037,18,40:00:00,,17,16,3,0,1,0.941176471
2023010037,14,,,0,0,0,0,0,
2023010037,14,62:58:00,,31,30,7,2,1,0.967741935
2023010038,22,,,0,0,0,0,0,
2023010038,22,60:31:00,,22,21,4,1,1,0.954545455
2023010038,23,60:55:00,,29,27,6,2,2,0.931034483
2023010038,23,,,0,0,0,0,0,
2023010039,54,,,0,0,0,0,0,
2023010039,54,64:10:00,,28,24,4,0,4,0.857142857
2023010039,26,,,0,0,0,0,0,
2023010039,26,63:34:00,,26,23,4,1,3,0.884615385
2023010040,24,59:44:00,,49,47,12,0,2,0.959183673
2023010040,24,,,0,0,0,0,0,
2023010040,28,57:18:00,,26,22,2,1,4,0.846153846
2023010040,28,,,0,0,0,0,0,
2023010041,5,60:00:00,,25,24,4,0,1,0.96
2023010041,7,58:45:00,,29,27,4,3,2,0.931034483
2023010042,15,60:00:00,,30,27,3,0,3,0.9
2023010042,17,16:30,,14,12,3,0,2,0.857142857
2023010042,17,40:00:00,,15,13,2,0,2,0.866666667
2023010043,3,39:55:00,,21,20,7,1,1,0.952380952
2023010043,3,18:03,,5,4,0,1,1,0.8
2023010043,1,30:37:00,,21,19,1,0,2,0.904761905
2023010043,1,29:20:00,,19,19,2,0,0,1.0
2023010044,30,59:26:00,,27,25,2,0,2,0.925925926
2023010044,21,57:26:00,,34,31,4,2,3,0.911764706
2023010045,16,33:47:00,,17,16,2,0,1,0.941176471
2023010045,16,30:15:00,,8,8,0,1,0,1.0
2023010045,19,40:00:00,,20,19,1,2,1,0.95
2023010045,19,24:02:00,,13,12,0,1,1,0.923076923
2023010046,55,40:00:00,,10,9,2,0,1,0.9
2023010046,55,20:00,,7,7,0,0,0,1.0
2023010046,23,56:42:00,,28,25,5,0,3,0.892857143
2023010047,13,59:54:00,,30,28,9,4,2,0.933333333
2023010047,12,58:50:00,,27,24,7,1,3,0.888888889
2023010048,14,60:00:00,,42,42,2,2,0,1.0
2023010048,12,60:00:00,,28,24,1,1,4,0.857142857
2023010049,2,59:54:00,,26,23,3,0,3,0.884615385
2023010049,3,40:00:00,,25,21,3,1,4,0.84
2023010049,3,17:03,,7,7,0,0,0,1.0
2023010050,6,64:40:00,,36,33,1,1,3,0.916666667
2023010050,4,28:59:00,,10,8,1,0,2,0.8
2023010050,4,35:50:00,,17,16,5,0,1,0.941176471
2023010051,8,58:02:00,,26,24,6,2,2,0.923076923
2023010051,10,39:56:00,,17,17,2,0,0,1.0
2023010051,10,20:00,,8,7,2,1,1,0.875
2023010052,9,29:49:00,,18,18,4,0,0,1.0
2023010052,9,30:11:00,,16,15,1,0,1,0.9375
2023010052,52,59:14:00,,32,30,6,2,2,0.9375
2023010053,20,62:19:00,,28,26,5,1,2,0.928571429
2023010053,22,62:12:00,,35,34,8,2,1,0.971428571
2023010054,54,60:00:00,,10,9,2,0,1,0.9
2023010054,53,59:07:00,,27,25,6,3,2,0.925925926
2023010055,24,30:25:00,,12,12,0,12,0,1.0
2023010055,24,28:55:00,,15,11,0,11,4,0.733333333
2023010055,26,60:00:00,,30,27,0,27,3,0.9
2023010056,7,59:51:00,,29,26,3,1,3,0.896551724
2023010056,29,57:39:00,,31,27,5,2,4,0.870967742
2023010057,14,59:28:00,,47,43,8,1,4,0.914893617
2023010057,18,25:58:00,,11,8,1,0,3,0.727272727
2023010057,18,29:50:00,,16,14,5,0,2,0.875
2023010058,30,60:21:00,,23,21,1,1,2,0.913043478
2023010058,16,59:20:00,,32,29,0,3,3,0.90625
2023010059,19,21:01,,16,13,0,13,3,0.8125
2023010059,19,40:00:00,,13,12,0,12,1,0.923076923
2023010059,25,31:23:00,,8,8,0,8,0,1.0
2023010059,25,29:28:00,,7,4,0,4,3,0.571428571
2023010060,4,62:10:00,,22,19,0,2,3,0.863636364
2023010060,1,62:28:00,,31,29,1,0,2,0.935483871
2023010061,8,40:00:00,,15,12,3,2,3,0.8
2023010061,8,17:53,,7,7,1,2,0,1.0
2023010061,10,59:54:00,,34,33,3,3,1,0.970588235
2023010062,17,30:55:00,,16,15,0,0,1,0.9375
2023010062,17,29:05:00,,13,12,2,0,1,0.923076923
2023010062,15,58:49:00,,25,20,5,0,5,0.8
2023010063,23,60:00:00,,26,24,7,0,2,0.923076923
2023010063,22,59:52:00,,28,23,4,1,5,0.821428571
2023010064,28,64:13:00,,30,28,7,0,2,0.933333333
2023010064,26,64:21:00,,35,34,13,2,1,0.971428571
2023010065,9,60:00:00,,35,33,0,33,2,0.942857143
2023010065,13,59:26:00,,30,27,0,27,3,0.9
2023010066,53,59:14:00,,22,17,0,17,5,0.772727273
2023010066,24,58:48:00,,28,24,0,24,4,0.857142857
2023010067,21,64:41:00,,28,25,2,0,3,0.892857143
2023010067,25,23:45,,15,14,5,1,1,0.933333333
2023010067,25,40:00:00,,22,19,1,0,3,0.863636364
2023010068,17,30:17:00,,17,16,6,0,1,0.941176471
2023010068,17,29:43:00,,12,12,2,1,0,1.0
2023010068,16,27:06:00,,11,10,5,0,1,0.909090909
2023010068,16,32:54:00,,23,18,0,1,5,0.782608696
2023010069,5,58:30:00,,23,21,0,21,2,0.913043478
2023010069,9,60:00:00,,40,40,0,40,0,1.0
2023010070,4,59:57:00,,14,13,0,0,1,0.928571429
2023010070,6,58:14:00,,24,21,4,1,3,0.875
2023010071,10,60:29:00,,26,21,3,0,5,0.807692308
2023010071,8,59:22:00,,29,25,7,1,4,0.862068966
2023010072,1,60:00:00,,20,15,3,0,5,0.75
2023010072,2,40:00:00,,18,13,1,0,5,0.722222222
2023010072,2,17:58,,5,4,0,0,1,0.8
2023010073,29,60:00:00,,39,36,4,2,3,0.923076923
2023010073,19,59:04:00,,38,34,7,2,4,0.894736842
2023010074,20,60:00:00,,28,24,1,3,4,0.857142857
2023010074,52,58:34:00,,46,41,6,0,5,0.891304348
2023010075,55,58:01:00,,13,10,2,1,3,0.769230769
2023010075,22,60:00:00,,33,32,6,3,1,0.96969697
2023010076,14,60:00:00,,25,25,0,25,0,1.0
2023010076,13,60:00:00,,22,20,0,20,2,0.909090909
2023010077,6,64:04:00,,41,36,2,1,5,0.87804878
2023010077,15,63:47:00,,20,16,6,1,4,0.8
2023010078,25,40:00:00,,10,9,2,0,1,0.9
2023010078,25,19:37,,8,8,1,1,0,1.0
2023010078,21,58:09:00,,29,27,9,0,2,0.931034483
2023010079,16,60:00:00,,19,17,3,1,2,0.894736842
2023010079,17,29:53:00,,14,13,0,0,1,0.928571429
2023010079,17,27:19:00,,19,17,6,1,2,0.894736842
2023010080,26,59:33:00,,16,15,4,1,1,0.9375
2023010080,24,1:32,,0,0,0,0,0,
2023010080,24,58:28:00,,40,36,1,1,4,0.9
2023010081,54,29:48:00,,15,14,0,0,1,0.933333333
2023010081,54,29:30:00,,14,13,2,1,1,0.928571429
2023010081,28,60:00:00,,18,18,6,0,0,1.0
2023010082,29,60:00:00,,26,23,2,1,3,0.884615385
2023010082,7,58:34:00,,32,28,2,0,4,0.875
2023010083,5,58:01:00,,24,22,2,4,2,0.916666667
2023010083,17,60:00:00,,22,21,8,0,1,0.954545455
2023010084,1,60:00:00,,21,19,4,5,2,0.904761905
2023010084,3,59:41:00,,18,14,6,1,4,0.777777778
2023010085,22,60:00:00,,20,18,4,1,2,0.9
2023010085,20,60:00:00,,44,37,15,1,7,0.840909091
2023010086,23,58:38:00,,15,13,0,13,2,0.866666667
2023010086,55,40:00:00,,16,15,0,15,1,0.9375
2023010086,55,19:44,,7,7,0,7,0,1.0
2023010087,3,58:05:00,,14,12,2,1,2,0.857142857
2023010087,6,59:45:00,,23,22,4,1,1,0.956521739
2023010088,14,59:15:00,,52,46,10,0,6,0.884615385
2023010088,13,60:00:00,,19,16,0,-1,3,0.842105263
2023010089,4,60:00:00,,16,14,5,0,2,0.875
2023010089,2,60:00:00,,31,26,6,1,5,0.838709677
2023010090,29,59:07:00,,37,34,2,3,3,0.918918919
2023010090,15,60:00:00,,22,20,0,0,2,0.909090909
2023010091,18,59:32:00,,41,40,7,1,1,0.975609756
2023010091,12,40:00:00,,26,21,3,0,5,0.807692308
2023010091,12,20:00,,13,13,6,0,0,1.0
2023010092,52,59:04:00,,33,30,13,2,3,0.909090909
2023010092,9,60:00:00,,21,21,8,0,0,1.0
2023010093,25,59:10:00,,28,24,2,1,4,0.857142857
2023010093,19,60:00:00,,24,24,3,0,0,1.0
2023010094,16,65:00:00,,27,25,7,0,2,0.925925926
2023010094,30,64:36:00,,29,27,13,1,2,0.931034483
2023010095,26,60:17:00,,27,24,0,24,3,0.888888889
2023010095,28,60:17:00,,37,33,0,33,4,0.891891892
2023010096,24,7:20,,0,0,0,0,0,
2023010096,24,49:39:00,,17,13,0,2,4,0.764705882
2023010096,53,60:00:00,,35,33,8,0,2,0.942857143
2023010097,54,59:43:00,,34,31,2,1,3,0.911764706
2023010097,21,59:05:00,,26,22,3,2,4,0.846153846
2023010098,10,61:29:00,,23,20,2,0,3,0.869565217
2023010098,17,61:34:00,,38,34,7,2,4,0.894736842
2023010099,12,60:00:00,,23,22,4,1,1,0.956521739
2023010099,18,60:00:00,,34,30,1,4,4,0.882352941
2023010100,2,60:00:00,,30,27,5,3,3,0.9
2023010100,1,60:00:00,,30,30,6,1,0,1.0
2023010101,7,60:00:00,,35,28,5,0,7,0.8
2023010101,5,60:00:00,,37,33,3,2,4,0.891891892
2023010102,22,60:00:00,,36,35,5,1,1,0.972222222
2023010102,55,56:24:00,,25,22,1,1,3,0.88
2023010103,23,59:37:00,,18,17,2,1,1,0.944444444
2023010103,20,59:26:00,,31,28,9,0,3,0.903225806
2023010104,26,59:20:00,,34,28,6,2,6,0.823529412
2023010104,54,60:00:00,,26,22,3,2,4,0.846153846
2023010105,53,60:00:00,,30,29,0,29,1,0.966666667
2023010105,24,59:37:00,,30,23,0,23,7,0.766666667
2023010106,30,59:47:00,,22,22,6,0,0,1.0
2023010106,25,40:00:00,,12,11,4,0,1,0.916666667
2023010106,25,20:00,,11,8,6,0,3,0.727272727
2023010107,13,60:00:00,,23,19,2,2,4,0.826086957
2023010107,14,60:00:00,,29,27,2,1,2,0.931034483
2023010108,15,58:53:00,,24,21,2,1,3,0.875
2023010108,29,60:00:00,,27,25,3,1,2,0.925925926
2023010109,9,60:00:00,,38,32,9,0,6,0.842105263
2023010109,8,59:50:00,,25,21,4,1,4,0.84
2023010110,17,59:44:00,,24,21,3,1,3,0.875
2023010110,10,57:20:00,,32,28,3,1,4,0.875
2023010111,19,20:00,,2,2,0,0,0,1.0
2023010111,19,40:00:00,,14,11,0,0,3,0.785714286
2023010111,16,57:16:00,,23,18,3,0,5,0.782608696
2023020001,14,60:00:00,0.0,31,28,6,1,3,0.903225806
2023020001,18,57:16:00,0.0,33,29,8,0,4,0.878787879
2023020002,5,57:30:00,0.0,35,32,5,1,3,0.914285714
2023020002,16,60:00:00,0.0,41,39,4,0,2,0.951219512
2023020003,54,60:00:00,0.0,33,32,10,0,1,0.96969697
2023020003,55,59:37:00,0.0,27,24,3,0,3,0.888888889
2023020004,12,60:00:00,0.0,30,27,6,4,3,0.9
2023020004,9,59:25:00,0.0,42,37,5,0,5,0.880952381
2023020005,10,62:06:00,0.0,24,19,3,0,5,0.791666667
2023020005,8,65:00:00,0.0,42,37,5,2,5,0.880952381
2023020006,6,59:53:00,0.0,21,20,0,3,1,0.952380952
2023020006,16,59:11:00,0.0,32,30,5,0,2,0.9375
2023020007,20,59:44:00,0.0,37,34,14,0,3,0.918918919
2023020007,52,58:12:00,0.0,21,17,5,1,4,0.80952381
2023020008,26,59:39:00,0.0,36,32,6,1,4,0.888888889
2023020008,21,60:00:00,0.0,36,34,11,0,2,0.944444444
2023020009,23,11:46,0.0,5,5,1,1,0,1.0
2023020009,23,48:05:00,0.0,22,21,5,0,1,0.954545455
2023020009,22,27:30:00,0.0,16,12,5,0,4,0.75
2023020009,22,32:30:00,0.0,16,12,5,0,4,0.75
2023020010,7,58:54:00,0.0,30,26,3,0,4,0.866666667
2023020010,3,60:00:00,0.0,25,24,3,1,1,0.96
2023020011,29,58:01:00,0.0,35,33,3,5,2,0.942857143
2023020011,4,60:00:00,0.0,33,31,4,0,2,0.939393939
2023020012,1,59:58:00,0.0,35,32,4,3,3,0.914285714
2023020012,17,57:48:00,0.0,26,23,4,0,3,0.884615385
2023020013,25,65:00:00,0.0,24,23,0,3,1,0.958333333
2023020013,19,64:50:00,0.0,34,33,3,1,1,0.970588235
2023020014,30,60:00:00,0.0,41,41,7,1,0,1.0
2023020014,13,57:18:00,0.0,21,19,6,1,2,0.904761905
2023020015,18,59:36:00,0.0,23,23,2,0,0,1.0
2023020015,55,57:52:00,0.0,34,32,4,2,2,0.941176471
2023020016,28,60:00:00,0.0,32,28,1,3,4,0.875
2023020016,54,60:00:00,0.0,23,22,2,1,1,0.956521739
2023020017,1,65:00:00,0.0,33,30,6,1,3,0.909090909
2023020017,53,65:00:00,0.0,36,33,5,3,3,0.916666667
2023020018,15,59:56:00,0.0,35,31,3,0,4,0.885714286
2023020018,5,60:00:00,0.0,19,19,1,1,0,1.0
2023020019,9,59:44:00,0.0,21,19,5,1,2,0.904761905
2023020019,4,58:57:00,0.0,31,26,4,2,5,0.838709677
2023020020,52,59:52:00,0.0,33,29,12,1,4,0.878787879
2023020020,13,57:57:00,0.0,34,29,3,1,5,0.852941176
2023020021,6,59:01:00,0.0,36,34,13,3,2,0.944444444
2023020021,18,57:36:00,0.0,30,27,7,2,3,0.9
2023020022,29,20:00,0.0,17,15,3,0,2,0.882352941
2023020022,29,39:54:00,0.0,25,24,1,0,1,0.96
2023020022,3,56:40:00,0.0,21,16,1,0,5,0.761904762
2023020023,17,60:00:00,0.0,25,21,1,0,4,0.84
2023020023,14,57:30:00,0.0,41,36,2,0,5,0.87804878
2023020024,8,60:00:00,0.0,30,28,14,0,2,0.933333333
2023020024,16,58:06:00,0.0,36,33,4,5,3,0.916666667
2023020025,5,59:42:00,0.0,36,34,3,0,2,0.944444444
2023020025,20,57:49:00,0.0,28,24,6,1,4,0.857142857
2023020026,10,60:00:00,0.0,32,28,2,0,4,0.875
2023020026,30,60:00:00,0.0,33,26,2,1,7,0.787878788
2023020027,2,59:51:00,0.0,28,26,1,0,2,0.928571429
2023020027,7,59:32:00,0.0,29,26,3,0,3,0.896551724
2023020028,19,65:00:00,0.0,31,30,1,1,1,0.967741935
2023020028,55,65:00:00,0.0,25,24,2,0,1,0.96
2023020029,22,57:38:00,0.0,16,12,1,0,4,0.75
2023020029,23,60:00:00,0.0,40,37,10,0,3,0.925
2023020030,28,65:00:00,0.0,52,51,9,2,1,0.980769231
2023020030,21,64:12:00,0.0,21,20,4,2,1,0.952380952
2023020031,54,59:03:00,0.0,23,22,4,0,1,0.956521739
2023020031,24,59:51:00,0.0,37,34,9,0,3,0.918918919
2023020032,26,64:24:00,0.0,19,14,3,1,5,0.736842105
2023020032,12,65:00:00,0.0,30,25,3,1,5,0.833333333
2023020033,9,59:34:00,0.0,24,22,3,0,2,0.916666667
2023020033,14,58:28:00,0.0,37,33,3,1,4,0.891891892
2023020034,24,59:39:00,0.0,35,32,8,0,3,0.914285714
2023020034,12,59:21:00,0.0,23,19,1,0,4,0.826086957
2023020035,29,59:16:00,0.0,28,24,4,2,4,0.857142857
2023020035,17,60:00:00,0.0,23,23,6,0,0,1.0
2023020036,1,56:00:00,0.0,30,26,4,1,4,0.866666667
2023020036,13,60:00:00,0.0,34,31,11,0,3,0.911764706
2023020037,3,59:55:00,2.0,27,26,7,0,1,0.962962963
2023020037,53,58:43:00,0.0,28,26,5,1,2,0.928571429
2023020038,10,56:13:00,0.0,30,27,3,0,3,0.9
2023020038,16,60:00:00,0.0,36,35,0,3,1,0.972222222
2023020039,15,65:00:00,0.0,40,38,6,1,2,0.95
2023020039,20,64:48:00,0.0,23,21,3,1,2,0.913043478
2023020040,7,61:46:00,0.0,25,23,3,0,2,0.92
2023020040,14,60:11:00,0.0,31,28,4,0,3,0.903225806
2023020041,8,58:16:00,0.0,35,30,13,2,5,0.857142857
2023020041,30,59:54:00,0.0,28,26,9,1,2,0.928571429
2023020042,4,59:43:00,0.0,26,26,2,3,0,1.0
2023020042,23,57:30:00,0.0,42,40,7,2,2,0.952380952
2023020043,2,59:49:00,0.0,14,14,0,0,0,1.0
2023020043,53,58:02:00,0.0,34,33,5,0,1,0.970588235
2023020044,18,40:00:00,0.0,19,17,4,1,2,0.894736842
2023020044,18,18:52,0.0,11,7,1,0,4,0.636363636
2023020044,22,60:00:00,0.0,44,43,6,0,1,0.977272727
2023020045,52,59:55:00,0.0,29,24,1,2,5,0.827586207
2023020045,26,60:00:00,2.0,27,26,7,2,1,0.962962963
2023020046,55,59:39:00,0.0,27,24,1,1,3,0.888888889
2023020046,21,60:00:00,0.0,38,37,6,4,1,0.973684211
2023020047,28,60:00:00,0.0,42,36,8,7,6,0.857142857
2023020047,12,5:27,0.0,2,1,1,0,1,0.5
2023020047,12,54:12:00,0.0,14,12,3,0,2,0.857142857
2023020048,54,64:14:00,0.0,26,24,2,1,2,0.923076923
2023020048,25,65:00:00,0.0,34,32,9,0,2,0.941176471
2023020049,9,60:00:00,0.0,24,23,4,1,1,0.958333333
2023020049,15,60:00:00,0.0,29,23,5,1,6,0.793103448
2023020050,17,60:00:00,0.0,33,30,6,1,3,0.909090909
2023020050,5,59:25:00,0.0,27,23,2,2,4,0.851851852
2023020051,7,58:58:00,0.0,36,32,8,1,4,0.888888889
2023020051,20,60:00:00,0.0,27,24,7,0,3,0.888888889
2023020052,13,60:00:00,0.0,30,29,5,4,1,0.966666667
2023020052,10,57:50:00,0.0,23,21,8,0,2,0.913043478
2023020053,3,33:51:00,0.0,18,14,1,0,4,0.777777778
2023020053,3,26:07:00,0.0,9,9,0,0,0,1.0
2023020053,18,59:33:00,0.0,24,23,4,0,1,0.958333333
2023020054,4,60:00:00,0.0,23,22,4,1,1,0.956521739
2023020054,22,60:00:00,0.0,32,28,4,0,4,0.875
2023020055,14,60:00:00,0.0,29,26,1,1,3,0.896551724
2023020055,23,57:44:00,0.0,36,32,8,1,4,0.888888889
2023020056,30,58:31:00,0.0,25,20,0,1,5,0.8
2023020056,26,60:00:00,0.0,32,29,4,0,3,0.90625
2023020057,19,59:49:00,0.0,42,36,3,2,6,0.857142857
2023020057,53,59:51:00,0.0,26,24,6,0,2,0.923076923
2023020058,52,59:24:00,0.0,26,22,2,0,4,0.846153846
2023020058,54,59:59:00,0.0,39,36,0,0,3,0.923076923
2023020059,24,57:47:00,0.0,24,21,0,1,3,0.875
2023020059,25,60:00:00,0.0,29,27,4,1,2,0.931034483
2023020060,55,59:47:00,0.0,36,32,3,0,4,0.888888889
2023020060,12,22:38,0.0,18,14,1,1,4,0.777777778
2023020060,12,36:40:00,0.0,17,15,0,0,2,0.882352941
2023020061,21,60:00:00,0.0,18,18,2,1,0,1.0
2023020061,16,60:00:00,0.0,41,37,7,0,4,0.902439024
2023020062,28,56:32:00,0.0,36,33,3,4,3,0.916666667
2023020062,6,60:00:00,0.0,27,26,1,2,1,0.962962963
2023020063,29,60:00:00,0.0,37,36,6,1,1,0.972972973
2023020063,20,57:52:00,0.0,28,26,2,1,2,0.928571429
2023020064,2,61:47:00,0.0,39,34,3,2,5,0.871794872
2023020064,1,62:19:00,0.0,32,28,2,0,4,0.875
2023020065,9,59:36:00,0.0,23,18,3,2,5,0.782608696
2023020065,17,59:21:00,0.0,37,35,11,0,2,0.945945946
2023020066,53,58:38:00,0.0,33,32,9,1,1,0.96969697
2023020066,24,57:52:00,0.0,27,25,7,0,2,0.925925926
2023020067,7,60:00:00,0.0,25,24,5,0,1,0.96
2023020067,2,59:07:00,0.0,43,40,8,2,3,0.930232558
2023020068,13,59:08:00,0.0,30,26,9,1,4,0.866666667
2023020068,23,60:00:00,0.0,36,34,3,0,3,0.944444444
2023020069,8,60:47:00,0.0,33,31,7,1,2,0.939393939
2023020069,15,60:31:00,0.0,28,25,6,0,3,0.892857143
2023020070,14,64:05:00,0.0,52,48,4,2,4,0.923076923
2023020070,10,13:29,0.0,4,1,0,0,3,0.25
2023020070,10,50:36:00,0.0,29,29,3,1,0,1.0
2023020071,16,60:00:00,0.0,24,19,3,1,5,0.791666667
2023020071,54,59:27:00,0.0,24,21,5,1,3,0.875
2023020072,25,62:13:00,0.0,40,36,3,1,4,0.9
2023020072,4,62:13:00,0.0,25,20,0,0,5,0.8
2023020073,30,63:02:00,0.0,54,49,10,1,5,0.907407407
2023020073,29,63:02:00,0.0,28,24,5,0,4,0.857142857
2023020074,18,60:00:00,0.0,32,31,6,1,1,0.96875
2023020074,28,60:00:00,2.0,34,29,8,0,5,0.852941176
2023020075,19,60:00:00,0.0,33,31,3,0,2,0.939393939
2023020075,5,58:02:00,0.0,21,17,3,0,4,0.80952381
2023020076,21,60:00:00,0.0,27,23,6,0,4,0.851851852
2023020076,12,56:57:00,0.0,28,22,5,1,6,0.785714286
2023020077,22,63:44:00,0.0,27,24,5,2,3,0.888888889
2023020077,52,63:53:00,0.0,40,38,1,2,2,0.95
2023020078,55,60:00:00,0.0,27,23,2,2,4,0.851851852
2023020078,3,60:00:00,0.0,19,18,0,0,1,0.947368421
2023020079,26,58:03:00,0.0,25,21,2,2,4,0.84
2023020079,6,60:00:00,0.0,34,32,8,1,2,0.941176471
2023020032,26,64:24,0.0,19,14,3,1,5,0.7368421052631579
2023020032,12,65:00,0.0,30,25,3,1,5,0.8333333333333334
2023020033,9,59:34,0.0,24,22,3,0,2,0.9166666666666666
2023020033,14,58:28,0.0,37,33,3,1,4,0.8918918918918919
2023020034,24,59:39,0.0,35,32,8,0,3,0.9142857142857144
2023020034,12,59:21,0.0,23,19,1,0,4,0.8260869565217391
2023020035,29,59:16,0.0,28,24,4,2,4,0.8571428571428571
2023020035,17,60:00,0.0,23,23,6,0,0,1.0
2023020036,1,56:00,0.0,30,26,4,1,4,0.8666666666666667
2023020036,13,60:00,0.0,34,31,11,0,3,0.9117647058823528
2023020037,3,59:55,2.0,27,26,7,0,1,0.9629629629629628
2023020037,53,58:43,0.0,28,26,5,1,2,0.9285714285714286
2023020038,10,56:13,0.0,30,27,3,0,3,0.9
2023020038,16,60:00,0.0,36,35,0,3,1,0.9722222222222222
2023020039,15,65:00,0.0,40,38,6,1,2,0.95
2023020039,20,64:48,0.0,23,21,3,1,2,0.9130434782608696
2023020040,7,61:46,0.0,25,23,3,0,2,0.92
2023020040,14,60:11,0.0,31,28,4,0,3,0.9032258064516128
2023020041,8,58:16,0.0,35,30,13,2,5,0.8571428571428571
2023020041,30,59:54,0.0,28,26,9,1,2,0.9285714285714286
2023020042,4,59:43,0.0,26,26,2,3,0,1.0
2023020042,23,57:30,0.0,42,40,7,2,2,0.9523809523809524
2023020043,2,59:49,0.0,14,14,0,0,0,1.0
2023020043,53,58:02,0.0,34,33,5,0,1,0.9705882352941176
2023020044,18,40:00,0.0,19,17,4,1,2,0.8947368421052632
2023020044,18,18:52,0.0,11,7,1,0,4,0.6363636363636364
2023020044,22,60:00,0.0,44,43,6,0,1,0.9772727272727272
2023020045,52,59:55,0.0,29,24,1,2,5,0.8275862068965517
2023020045,26,60:00,2.0,27,26,7,2,1,0.9629629629629628
2023020046,55,59:39,0.0,27,24,1,1,3,0.8888888888888888
2023020046,21,60:00,0.0,38,37,6,4,1,0.9736842105263158
2023020047,28,60:00,0.0,42,36,8,7,6,0.8571428571428571
2023020047,12,05:27,0.0,2,1,1,0,1,0.5
2023020047,12,54:12,0.0,14,12,3,0,2,0.8571428571428571
2023020048,54,64:14,0.0,26,24,2,1,2,0.9230769230769232
2023020048,25,65:00,0.0,34,32,9,0,2,0.9411764705882352
2023020049,9,60:00,0.0,24,23,4,1,1,0.9583333333333334
2023020049,15,60:00,0.0,29,23,5,1,6,0.7931034482758621
2023020050,17,60:00,0.0,33,30,6,1,3,0.9090909090909092
2023020050,5,59:25,0.0,27,23,2,2,4,0.8518518518518519
2023020051,7,58:58,0.0,36,32,8,1,4,0.8888888888888888
2023020051,20,60:00,0.0,27,24,7,0,3,0.8888888888888888
2023020052,13,60:00,0.0,30,29,5,4,1,0.9666666666666668
2023020052,10,57:50,0.0,23,21,8,0,2,0.9130434782608696
2023020053,3,33:51,0.0,18,14,1,0,4,0.7777777777777778
2023020053,3,26:07,0.0,9,9,0,0,0,1.0
2023020053,18,59:33,0.0,24,23,4,0,1,0.9583333333333334
2023020054,4,60:00,0.0,23,22,4,1,1,0.9565217391304348
2023020054,22,60:00,0.0,32,28,4,0,4,0.875
2023020055,14,60:00,0.0,29,26,1,1,3,0.896551724137931
2023020055,23,57:44,0.0,36,32,8,1,4,0.8888888888888888
2023020056,30,58:31,0.0,25,20,0,1,5,0.8
2023020056,26,60:00,0.0,32,29,4,0,3,0.90625
2023020057,19,59:49,0.0,42,36,3,2,6,0.8571428571428571
2023020057,53,59:51,0.0,26,24,6,0,2,0.9230769230769232
2023020058,52,59:24,0.0,26,22,2,0,4,0.8461538461538461
2023020058,54,59:59,0.0,39,36,0,0,3,0.9230769230769232
2023020059,24,57:47,0.0,24,21,0,1,3,0.875
2023020059,25,60:00,0.0,29,27,4,1,2,0.9310344827586208
2023020060,55,59:47,0.0,36,32,3,0,4,0.8888888888888888
2023020060,12,22:38,0.0,18,14,1,1,4,0.7777777777777778
2023020060,12,36:40,0.0,17,15,0,0,2,0.8823529411764706
2023020061,21,60:00,0.0,18,18,2,1,0,1.0
2023020061,16,60:00,0.0,41,37,7,0,4,0.902439024390244
2023020062,28,56:32,0.0,36,33,3,4,3,0.9166666666666666
2023020062,6,60:00,0.0,27,26,1,2,1,0.9629629629629628
2023020063,29,60:00,0.0,37,36,6,1,1,0.972972972972973
2023020063,20,57:52,0.0,28,26,2,1,2,0.9285714285714286
2023020064,2,61:47,0.0,39,34,3,2,5,0.8717948717948718
2023020064,1,62:19,0.0,32,28,2,0,4,0.875
2023020065,9,59:36,0.0,23,18,3,2,5,0.782608695652174
2023020065,17,59:21,0.0,37,35,11,0,2,0.945945945945946
2023020066,53,58:38,0.0,33,32,9,1,1,0.9696969696969696
2023020066,24,57:52,0.0,27,25,7,0,2,0.925925925925926
2023020067,7,60:00,0.0,25,24,5,0,1,0.96
2023020067,2,59:07,0.0,43,40,8,2,3,0.9302325581395348
2023020068,13,59:08,0.0,30,26,9,1,4,0.8666666666666667
2023020068,23,60:00,0.0,36,34,3,0,3,0.9444444444444444
2023020069,8,60:47,0.0,33,31,7,1,2,0.9393939393939394
2023020069,15,60:31,0.0,28,25,6,0,3,0.8928571428571429
2023020070,14,64:05,0.0,52,48,4,2,4,0.9230769230769232
2023020070,10,50:36,0.0,29,29,3,1,0,1.0
2023020071,16,60:00,0.0,24,19,3,1,5,0.7916666666666666
2023020071,54,59:27,0.0,24,21,5,1,3,0.875
2023020072,25,62:13,0.0,40,36,3,1,4,0.9
2023020072,4,62:13,0.0,25,20,0,0,5,0.8
2023020073,30,63:02,0.0,54,49,10,1,5,0.9074074074074074
2023020073,29,63:02,0.0,28,24,5,0,4,0.8571428571428571
2023020074,18,60:00,0.0,32,31,6,1,1,0.96875
2023020074,28,60:00,2.0,34,29,8,0,5,0.8529411764705882
2023020075,19,60:00,0.0,33,31,3,0,2,0.9393939393939394
2023020075,5,58:02,0.0,21,17,3,0,4,0.8095238095238095
2023020076,21,60:00,0.0,27,23,6,0,4,0.8518518518518519
2023020076,12,56:57,0.0,28,22,5,1,6,0.7857142857142857
2023020077,22,63:44,0.0,27,24,5,2,3,0.8888888888888888
2023020077,52,63:53,0.0,40,38,1,2,2,0.95
2023020078,55,60:00,0.0,27,23,2,2,4,0.8518518518518519
2023020078,3,60:00,0.0,19,18,0,0,1,0.9473684210526316
2023020079,26,58:03,0.0,25,21,2,2,4,0.84
2023020079,6,60:00,0.0,34,32,8,1,2,0.9411764705882352
2023010065,9,60:00,,35,33,0,33,2,0.9428571428571428
2023010065,13,59:26,,30,27,0,27,3,0.9
2023010066,53,59:14,,22,17,0,17,5,0.7727272727272727
2023010066,24,58:48,,28,24,0,24,4,0.8571428571428571
2023010067,21,64:41,,28,25,2,0,3,0.8928571428571429
2023010067,25,23:45,,15,14,5,1,1,0.9333333333333332
2023010067,25,40:00,,22,19,1,0,3,0.8636363636363636
2023010068,17,30:17,,17,16,6,0,1,0.9411764705882352
2023010068,17,29:43,,12,12,2,1,0,1.0
2023010068,16,27:06,,11,10,5,0,1,0.9090909090909092
2023010068,16,32:54,,23,18,0,1,5,0.782608695652174
2023010069,5,58:30,,23,21,0,21,2,0.9130434782608696
2023010069,9,60:00,,40,40,0,40,0,1.0
2023010070,4,59:57,,14,13,0,0,1,0.9285714285714286
2023010070,6,58:14,,24,21,4,1,3,0.875
2023010071,10,60:29,,26,21,3,0,5,0.8076923076923077
2023010071,8,59:22,,29,25,7,1,4,0.8620689655172413
2023010072,1,60:00,,20,15,3,0,5,0.75
2023010072,2,40:00,,18,13,1,0,5,0.7222222222222222
2023010073,29,60:00,,39,36,4,2,3,0.9230769230769232
2023010073,19,59:04,,38,34,7,2,4,0.8947368421052632
2023010074,20,60:00,,28,24,1,3,4,0.8571428571428571
2023010074,52,58:34,,46,41,6,0,5,0.8913043478260869
2023010075,55,58:01,,13,10,2,1,3,0.7692307692307693
2023010075,22,60:00,,33,32,6,3,1,0.9696969696969696
2023010076,14,60:00,,25,25,0,25,0,1.0
2023010076,13,60:00,,22,20,0,20,2,0.9090909090909092
2023010077,6,64:04,,41,36,2,1,5,0.8780487804878049
2023010077,15,63:47,,20,16,6,1,4,0.8
2023010078,25,40:00,,10,9,2,0,1,0.9
2023010078,21,58:09,,29,27,9,0,2,0.9310344827586208
2023010079,16,60:00,,19,17,3,1,2,0.8947368421052632
2023010079,17,29:53,,14,13,0,0,1,0.9285714285714286
2023010079,17,27:19,,19,17,6,1,2,0.8947368421052632
2023010080,26,59:33,,16,15,4,1,1,0.9375
2023010080,24,01:32,,0,0,0,0,0,
2023010080,24,58:28,,40,36,1,1,4,0.9
2023010081,54,29:48,,15,14,0,0,1,0.9333333333333332
2023010081,54,29:30,,14,13,2,1,1,0.9285714285714286
2023010081,28,60:00,,18,18,6,0,0,1.0
2023010082,29,60:00,,26,23,2,1,3,0.8846153846153846
2023010082,7,58:34,,32,28,2,0,4,0.875
2023010083,5,58:01,,24,22,2,4,2,0.9166666666666666
2023010083,17,60:00,,22,21,8,0,1,0.9545454545454546
2023010084,1,60:00,,21,19,4,5,2,0.9047619047619048
2023010084,3,59:41,,18,14,6,1,4,0.7777777777777778
2023010085,22,60:00,,20,18,4,1,2,0.9
2023010085,20,60:00,,44,37,15,1,7,0.8409090909090909
2023010086,23,58:38,,15,13,0,13,2,0.8666666666666667
2023010086,55,40:00,,16,15,0,15,1,0.9375
2023010087,3,58:05,,14,12,2,1,2,0.8571428571428571
2023010087,6,59:45,,23,22,4,1,1,0.9565217391304348
2023010088,14,59:15,,52,46,10,0,6,0.8846153846153846
2023010088,13,60:00,,19,16,0,-1,3,0.8421052631578947
2023010089,4,60:00,,16,14,5,0,2,0.875
2023010089,2,60:00,,31,26,6,1,5,0.8387096774193549
2023010090,29,59:07,,37,34,2,3,3,0.918918918918919
2023010090,15,60:00,,22,20,0,0,2,0.9090909090909092
2023010091,18,59:32,,41,40,7,1,1,0.975609756097561
2023010091,12,40:00,,26,21,3,0,5,0.8076923076923077
2023010092,52,59:04,,33,30,13,2,3,0.9090909090909092
2023010092,9,60:00,,21,21,8,0,0,1.0
2023010093,25,59:10,,28,24,2,1,4,0.8571428571428571
2023010093,19,60:00,,24,24,3,0,0,1.0
2023010094,16,65:00,,27,25,7,0,2,0.925925925925926
2023010094,30,64:36,,29,27,13,1,2,0.9310344827586208
2023010095,26,60:17,,27,24,0,24,3,0.8888888888888888
2023010095,28,60:17,,37,33,0,33,4,0.8918918918918919
2023010096,24,07:20,,0,0,0,0,0,
2023010096,24,49:39,,17,13,0,2,4,0.7647058823529411
2023010096,53,60:00,,35,33,8,0,2,0.9428571428571428
2023010097,54,59:43,,34,31,2,1,3,0.9117647058823528
2023010097,21,59:05,,26,22,3,2,4,0.8461538461538461
2023010098,10,61:29,,23,20,2,0,3,0.8695652173913043
2023010098,17,61:34,,38,34,7,2,4,0.8947368421052632
2023010099,12,60:00,,23,22,4,1,1,0.9565217391304348
2023010099,18,60:00,,34,30,1,4,4,0.8823529411764706
2023010100,2,60:00,,30,27,5,3,3,0.9
2023010100,1,60:00,,30,30,6,1,0,1.0
2023010101,7,60:00,,35,28,5,0,7,0.8
2023010101,5,60:00,,37,33,3,2,4,0.8918918918918919
2023010102,22,60:00,,36,35,5,1,1,0.9722222222222222
2023010102,55,56:24,,25,22,1,1,3,0.88
2023010103,23,59:37,,18,17,2,1,1,0.9444444444444444
2023010103,20,59:26,,31,28,9,0,3,0.9032258064516128
2023010104,26,59:20,,34,28,6,2,6,0.8235294117647058
2023010104,54,60:00,,26,22,3,2,4,0.8461538461538461
2023010105,53,60:00,,30,29,0,29,1,0.9666666666666668
2023010105,24,59:37,,30,23,0,23,7,0.7666666666666667
2023010106,30,59:47,,22,22,6,0,0,1.0
2023010106,25,40:00,,12,11,4,0,1,0.9166666666666666
2023010106,25,20:00,,11,8,6,0,3,0.7272727272727273
2023010107,13,60:00,,23,19,2,2,4,0.8260869565217391
2023010107,14,60:00,,29,27,2,1,2,0.9310344827586208
2023010108,15,58:53,,24,21,2,1,3,0.875
2023010108,29,60:00,,27,25,3,1,2,0.925925925925926
2023010109,9,60:00,,38,32,9,0,6,0.8421052631578947
2023010109,8,59:50,,25,21,4,1,4,0.84
2023010110,17,59:44,,24,21,3,1,3,0.875
2023010110,10,57:20,,32,28,3,1,4,0.875
2023010111,19,40:00,,14,11,0,0,3,0.7857142857142857
2023010111,16,57:16,,23,18,3,0,5,0.782608695652174
2023020001,14,60:00,0.0,31,28,6,1,3,0.9032258064516128
2023020001,18,57:16,0.0,33,29,8,0,4,0.8787878787878788
2023020002,5,57:30,0.0,35,32,5,1,3,0.9142857142857144
2023020002,16,60:00,0.0,41,39,4,0,2,0.951219512195122
2023020003,54,60:00,0.0,33,32,10,0,1,0.9696969696969696
2023020003,55,59:37,0.0,27,24,3,0,3,0.8888888888888888
2023020004,12,60:00,0.0,30,27,6,4,3,0.9
2023020004,9,59:25,0.0,42,37,5,0,5,0.8809523809523809
2023020005,10,62:06,0.0,24,19,3,0,5,0.7916666666666666
2023020005,8,65:00,0.0,42,37,5,2,5,0.8809523809523809
2023020006,6,59:53,0.0,21,20,0,3,1,0.9523809523809524
2023020006,16,59:11,0.0,32,30,5,0,2,0.9375
2023020007,20,59:44,0.0,37,34,14,0,3,0.918918918918919
2023020007,52,58:12,0.0,21,17,5,1,4,0.8095238095238095
2023020008,26,59:39,0.0,36,32,6,1,4,0.8888888888888888
2023020008,21,60:00,0.0,36,34,11,0,2,0.9444444444444444
2023020009,23,48:05,0.0,22,21,5,0,1,0.9545454545454546
2023020009,22,27:30,0.0,16,12,5,0,4,0.75
2023020009,22,32:30,0.0,16,12,5,0,4,0.75
2023020010,7,58:54,0.0,30,26,3,0,4,0.8666666666666667
2023020010,3,60:00,0.0,25,24,3,1,1,0.96
2023020011,29,58:01,0.0,35,33,3,5,2,0.9428571428571428
2023020011,4,60:00,0.0,33,31,4,0,2,0.9393939393939394
2023020012,1,59:58,0.0,35,32,4,3,3,0.9142857142857144
2023020012,17,57:48,0.0,26,23,4,0,3,0.8846153846153846
2023020013,25,65:00,0.0,24,23,0,3,1,0.9583333333333334
2023020013,19,64:50,0.0,34,33,3,1,1,0.9705882352941176
2023020014,30,60:00,0.0,41,41,7,1,0,1.0
2023020014,13,57:18,0.0,21,19,6,1,2,0.9047619047619048
2023020015,18,59:36,0.0,23,23,2,0,0,1.0
2023020015,55,57:52,0.0,34,32,4,2,2,0.9411764705882352
2023020016,28,60:00,0.0,32,28,1,3,4,0.875
2023020016,54,60:00,0.0,23,22,2,1,1,0.9565217391304348
2023020017,1,65:00,0.0,33,30,6,1,3,0.9090909090909092
2023020017,53,65:00,0.0,36,33,5,3,3,0.9166666666666666
2023020018,15,59:56,0.0,35,31,3,0,4,0.8857142857142857
2023020018,5,60:00,0.0,19,19,1,1,0,1.0
2023020019,9,59:44,0.0,21,19,5,1,2,0.9047619047619048
2023020019,4,58:57,0.0,31,26,4,2,5,0.8387096774193549
2023020020,52,59:52,0.0,33,29,12,1,4,0.8787878787878788
2023020020,13,57:57,0.0,34,29,3,1,5,0.8529411764705882
2023020021,6,59:01,0.0,36,34,13,3,2,0.9444444444444444
2023020021,18,57:36,0.0,30,27,7,2,3,0.9
2023020022,29,20:00,0.0,17,15,3,0,2,0.8823529411764706
2023020022,29,39:54,0.0,25,24,1,0,1,0.96
2023020022,3,56:40,0.0,21,16,1,0,5,0.7619047619047619
2023020023,17,60:00,0.0,25,21,1,0,4,0.84
2023020023,14,57:30,0.0,41,36,2,0,5,0.8780487804878049
2023020024,8,60:00,0.0,30,28,14,0,2,0.9333333333333332
2023020024,16,58:06,0.0,36,33,4,5,3,0.9166666666666666
2023020025,5,59:42,0.0,36,34,3,0,2,0.9444444444444444
2023020025,20,57:49,0.0,28,24,6,1,4,0.8571428571428571
2023020026,10,60:00,0.0,32,28,2,0,4,0.875
2023020026,30,60:00,0.0,33,26,2,1,7,0.7878787878787878
2023020027,2,59:51,0.0,28,26,1,0,2,0.9285714285714286
2023020027,7,59:32,0.0,29,26,3,0,3,0.896551724137931
2023020028,19,65:00,0.0,31,30,1,1,1,0.967741935483871
2023020028,55,65:00,0.0,25,24,2,0,1,0.96
2023020029,22,57:38,0.0,16,12,1,0,4,0.75
2023020029,23,60:00,0.0,40,37,10,0,3,0.925
2023020030,28,65:00,0.0,52,51,9,2,1,0.9807692307692308
2023020030,21,64:12,0.0,21,20,4,2,1,0.9523809523809524
2023020031,54,59:03,0.0,23,22,4,0,1,0.9565217391304348
2023020031,24,59:51,0.0,37,34,9,0,3,0.918918918918919
2023010049,2,59:54,,26,23,3,0,3,0.8846153846153846
2023010049,3,40:00,,25,21,3,1,4,0.84
2023010056,7,59:51,,29,26,3,1,3,0.896551724137931
2023010056,29,57:39,,31,27,5,2,4,0.8709677419354839
2023010057,14,59:28,,47,43,8,1,4,0.9148936170212766
2023010057,18,25:58,,11,8,1,0,3,0.7272727272727273
2023010057,18,29:50,,16,14,5,0,2,0.875
2023010058,30,60:21,,23,21,1,1,2,0.9130434782608696
2023010058,16,59:20,,32,29,0,3,3,0.90625
2023010059,19,40:00,,13,12,0,12,1,0.9230769230769232
2023010059,25,31:23,,8,8,0,8,0,1.0
2023010059,25,29:28,,7,4,0,4,3,0.5714285714285714
2023010060,4,62:10,,22,19,0,2,3,0.8636363636363636
2023010060,1,62:28,,31,29,1,0,2,0.935483870967742
2023010061,8,40:00,,15,12,3,2,3,0.8
2023010061,10,59:54,,34,33,3,3,1,0.9705882352941176
2023010062,17,30:55,,16,15,0,0,1,0.9375
2023010062,17,29:05,,13,12,2,0,1,0.9230769230769232
2023010062,15,58:49,,25,20,5,0,5,0.8
2023010063,23,60:00,,26,24,7,0,2,0.9230769230769232
2023010063,22,59:52,,28,23,4,1,5,0.8214285714285714
2023010064,28,64:13,,30,28,7,0,2,0.9333333333333332
2023010064,26,64:21,,35,34,13,2,1,0.9714285714285714
2023020080,17,60:00,2.0,31,29,4,1,2,0.935483870967742
2023020080,20,59:51,0.0,30,24,9,0,6,0.8
2023020081,24,58:35,0.0,25,23,10,1,2,0.92
2023020081,6,60:00,0.0,31,30,5,1,1,0.967741935483871
2023020080,17,60:00,2.0,31,29,4,1,2,0.9354838709677419
2023020080,20,59:51,0.0,30,24,9,0,6,0.8
2023020081,24,58:35,0.0,25,23,10,1,2,0.92
2023020081,6,60:00,0.0,31,30,5,1,1,0.967741935483871
